ds,traffic_real,traffic_forecast_without_corona,delta,delta_percent,znr
2020-02-01,27206,25419,1787,7.03,1131
2020-02-02,23171,21593,1578,7.31,1131
2020-02-03,31381,31095,286,0.92,1131
2020-02-04,33990,33211,779,2.35,1131
2020-02-05,33990,33212,778,2.34,1131
2020-02-06,33990,33226,764,2.3,1131
2020-02-07,35082,33386,1696,5.08,1131
2020-02-08,27206,25423,1783,7.01,1131
2020-02-09,23171,21549,1622,7.53,1131
2020-02-10,31381,31016,365,1.18,1131
2020-02-11,33990,33109,881,2.66,1131
2020-02-12,33990,33102,888,2.68,1131
2020-02-13,33990,33122,868,2.62,1131
2020-02-14,35082,33303,1779,5.34,1131
2020-02-15,27206,25375,1831,7.22,1131
2020-02-16,23171,21550,1621,7.52,1131
2020-02-17,31381,31078,303,0.97,1131
2020-02-18,33990,33243,747,2.25,1131
2020-02-19,33990,33317,673,2.02,1131
2020-02-20,33990,33425,565,1.69,1131
2020-02-21,35082,33698,1384,4.11,1131
2020-02-22,27206,25866,1340,5.18,1131
2020-02-23,23171,22136,1035,4.68,1131
2020-02-24,31381,31756,-375,-1.18,1131
2020-02-25,33990,34008,-18,-0.05,1131
2020-02-26,33990,34162,-172,-0.5,1131
2020-02-27,33990,34341,-351,-1.02,1131
2020-02-28,35082,34674,408,1.18,1131
2020-02-29,27206,26887,319,1.19,1131
2020-03-01,14870,23190,-8320,-35.88,1131
2020-03-02,22941,32828,-9887,-30.12,1131
2020-03-03,23448,35084,-11636,-33.17,1131
2020-03-04,23448,35225,-11777,-33.43,1131
2020-03-05,23448,35377,-11929,-33.72,1131
2020-03-06,24136,35669,-11533,-32.33,1131
2020-03-07,15597,27829,-12232,-43.95,1131
2020-03-08,14870,24067,-9197,-38.21,1131
2020-03-09,22941,33630,-10689,-31.78,1131
2020-03-10,23448,35803,-12355,-34.51,1131
2020-03-11,23448,35856,-12408,-34.61,1131
2020-03-12,23448,35915,-12467,-34.71,1131
2020-03-13,24136,36114,-11978,-33.17,1131
2020-03-14,15597,28181,-12584,-44.65,1131
2020-03-15,14870,24327,-9457,-38.87,1131
2020-03-16,22941,33804,-10863,-32.14,1131
2020-03-17,23448,35897,-12449,-34.68,1131
2020-03-18,23448,35877,-12429,-34.64,1131
2020-03-19,23448,35873,-12425,-34.64,1131
2020-03-20,24136,36017,-11881,-32.99,1131
2020-03-21,15597,28041,-12444,-44.38,1131
2020-03-22,14870,24155,-9285,-38.44,1131
2020-03-23,22941,33610,-10669,-31.74,1131
2020-03-24,23448,35691,-12243,-34.3,1131
2020-03-25,23448,35670,-12222,-34.26,1131
2020-03-26,23448,35673,-12225,-34.27,1131
2020-03-27,24136,35833,-11697,-32.64,1131
2020-03-28,15597,27878,-12281,-44.05,1131
2020-03-29,14870,24019,-9149,-38.09,1131
2020-03-30,22941,33505,-10564,-31.53,1131
2020-03-31,23448,35618,-12170,-34.17,1131
2020-04-01,19583,35631,-16048,-45.04,1131
2020-04-02,19583,35666,-16083,-45.09,1131
2020-04-03,17821,35857,-18036,-50.3,1131
2020-04-04,11323,27929,-16606,-59.46,1131
2020-04-05,8684,24094,-15410,-63.96,1131
2020-04-06,19105,33597,-14492,-43.13,1131
2020-04-07,19583,35723,-16140,-45.18,1131
2020-04-08,19583,35742,-16159,-45.21,1131
2020-04-09,19583,35778,-16195,-45.27,1131
2020-04-10,17821,35963,-18142,-50.45,1131
2020-04-11,11323,28024,-16701,-59.6,1131
2020-04-12,8684,24173,-15489,-64.08,1131
2020-04-13,19105,33656,-14551,-43.23,1131
2020-04-14,19583,35759,-16176,-45.24,1131
2020-04-15,19583,35752,-16169,-45.23,1131
2020-04-16,19583,35762,-16179,-45.24,1131
2020-04-17,17821,35920,-18099,-50.39,1131
2020-04-18,11323,27956,-16633,-59.5,1131
2020-04-19,8684,24081,-15397,-63.94,1131
2020-04-20,19105,33544,-14439,-43.04,1131
2020-04-21,19583,35631,-16048,-45.04,1131
2020-04-22,19583,35612,-16029,-45.01,1131
2020-04-23,19583,35615,-16032,-45.01,1131
2020-04-24,17821,35772,-17951,-50.18,1131
2020-04-25,11323,27812,-16489,-59.29,1131
2020-04-26,8684,23947,-15263,-63.74,1131
2020-04-27,19105,33424,-14319,-42.84,1131
2020-04-28,19583,35530,-15947,-44.88,1131
2020-04-29,19583,35534,-15951,-44.89,1131
2020-04-30,19583,35562,-15979,-44.93,1131
2020-05-01,26991,35745,-8754,-24.49,1131
2020-05-02,18437,27813,-9376,-33.71,1131
2020-05-03,14648,23974,-9326,-38.9,1131
2020-05-04,26314,33477,-7163,-21.4,1131
2020-05-05,27811,35605,-7794,-21.89,1131
2020-05-06,27811,35627,-7816,-21.94,1131
2020-05-07,27811,35669,-7858,-22.03,1131
2020-05-08,26991,35861,-8870,-24.73,1131
2020-05-09,18437,27931,-9494,-33.99,1131
2020-05-10,14648,24089,-9441,-39.19,1131
2020-05-11,26314,33582,-7268,-21.64,1131
2020-05-12,27811,35694,-7883,-22.08,1131
2020-05-13,27811,35695,-7884,-22.09,1131
2020-05-14,27811,35709,-7898,-22.12,1131
2020-05-15,26991,35870,-8879,-24.75,1131
2020-05-16,18437,27906,-9469,-33.93,1131
2020-05-17,14648,24027,-9379,-39.04,1131
2020-05-18,26314,33482,-7168,-21.41,1131
2020-05-19,27811,35556,-7745,-21.78,1131
2020-05-20,27811,35522,-7711,-21.71,1131
2020-05-21,27811,35504,-7693,-21.67,1131
2020-05-22,26991,35638,-8647,-24.26,1131
2020-05-23,18437,27651,-9214,-33.32,1131
2020-05-24,14648,23757,-9109,-38.34,1131
2020-05-25,26314,33205,-6891,-20.75,1131
2020-05-26,27811,35281,-7470,-21.17,1131
2020-05-27,27811,35256,-7445,-21.12,1131
2020-05-28,27811,35258,-7447,-21.12,1131
2020-05-29,26991,35418,-8427,-23.79,1131
2020-05-30,18437,27467,-9030,-32.88,1131
2020-05-31,14648,23615,-8967,-37.97,1131
2020-06-01,30178,33111,-2933,-8.86,1131
2020-06-02,31620,35239,-3619,-10.27,1131
2020-06-03,31620,35269,-3649,-10.35,1131
2020-06-04,31620,35327,-3707,-10.49,1131
2020-06-05,30030,35542,-5512,-15.51,1131
2020-06-06,22612,27643,-5031,-18.2,1131
2020-06-07,17798,23838,-6040,-25.34,1131
2020-06-08,30178,33373,-3195,-9.57,1131
2020-06-09,31620,35531,-3911,-11.01,1131
2020-06-10,31620,35581,-3961,-11.13,1131
2020-06-11,31620,35645,-4025,-11.29,1131
2020-06-12,30030,35852,-5822,-16.24,1131
2020-06-13,22612,27931,-5319,-19.04,1131
2020-06-14,17798,24087,-6289,-26.11,1131
2020-06-15,30178,33568,-3390,-10.1,1131
2020-06-16,31620,35657,-4037,-11.32,1131
2020-06-17,31620,35621,-4001,-11.23,1131
2020-06-18,31620,35586,-3966,-11.14,1131
2020-06-19,30030,35682,-5652,-15.84,1131
2020-06-20,22612,27638,-5026,-18.19,1131
2020-06-21,17798,23663,-5865,-24.79,1131
2020-06-22,30178,33007,-2829,-8.57,1131
2020-06-23,31620,34955,-3335,-9.54,1131
2020-06-24,31620,34778,-3158,-9.08,1131
2020-06-25,31620,34604,-2984,-8.62,1131
2020-06-26,30030,34567,-4537,-13.13,1131
2020-06-27,22612,26398,-3786,-14.34,1131
2020-06-28,17798,22309,-4511,-20.22,1131
2020-06-29,30178,31553,-1375,-4.36,1131
2020-06-30,31620,33416,-1796,-5.37,1131
2020-07-01,31732,33173,-1441,-4.34,1131
2020-07-02,31732,32953,-1221,-3.71,1131
2020-07-03,30311,32890,-2579,-7.84,1131
2020-07-04,22361,24716,-2355,-9.53,1131
2020-07-05,18541,20645,-2104,-10.19,1131
2020-07-06,29717,29928,-211,-0.71,1131
2020-07-07,31732,31850,-118,-0.37,1131
2020-07-08,31732,31686,46,0.15,1131
2020-07-09,31732,31561,171,0.54,1131
2020-07-10,30311,31609,-1298,-4.11,1131
2020-07-11,22361,23559,-1198,-5.09,1131
2020-07-12,18541,19621,-1080,-5.5,1131
2020-07-13,29717,29043,674,2.32,1131
2020-07-14,31732,31108,624,2.01,1131
2020-07-15,31732,31086,646,2.08,1131
2020-07-16,31732,31100,632,2.03,1131
2020-07-17,30311,31280,-969,-3.1,1131
2020-07-18,22361,23353,-992,-4.25,1131
2020-07-19,18541,19525,-984,-5.04,1131
2020-07-20,29717,29042,675,2.32,1131
2020-07-21,31732,31185,547,1.75,1131
2020-07-22,31732,31223,509,1.63,1131
2020-07-23,31732,31278,454,1.45,1131
2020-07-24,30311,31479,-1168,-3.71,1131
2020-07-25,22361,23553,-1192,-5.06,1131
2020-07-26,18541,19706,-1165,-5.91,1131
2020-07-27,29717,29187,530,1.82,1131
2020-07-28,31732,31278,454,1.45,1131
2020-07-29,31732,31249,483,1.55,1131
2020-07-30,31732,31226,506,1.62,1131
2020-07-31,30311,31339,-1028,-3.28,1131
2020-08-01,22037,23318,-1281,-5.49,1131
2020-08-02,18587,19376,-789,-4.07,1131
2020-08-03,29050,28761,289,1.0,1131
2020-08-04,30248,30760,-512,-1.66,1131
2020-08-05,30248,30647,-399,-1.3,1131
2020-08-06,30248,30548,-300,-0.98,1131
2020-08-07,29210,30600,-1390,-4.54,1131
2020-08-08,22037,22534,-497,-2.21,1131
2020-08-09,18587,18563,24,0.13,1131
2020-08-10,29050,27939,1111,3.98,1131
2020-08-11,30248,29950,298,0.99,1131
2020-08-12,30248,29868,380,1.27,1131
2020-08-13,30248,29822,426,1.43,1131
2020-08-14,29210,29947,-737,-2.46,1131
2020-08-15,22037,21973,64,0.29,1131
2020-08-16,18587,18111,476,2.63,1131
2020-08-17,29050,27612,1438,5.21,1131
2020-08-18,30248,29760,488,1.64,1131
2020-08-19,30248,29827,421,1.41,1131
2020-08-20,30248,29937,311,1.04,1131
2020-08-21,29210,30221,-1011,-3.35,1131
2020-08-22,22037,22406,-369,-1.65,1131
2020-08-23,18587,18702,-115,-0.61,1131
2020-08-24,29050,28354,696,2.45,1131
2020-08-25,30248,30645,-397,-1.3,1131
2020-08-26,30248,30841,-593,-1.92,1131
2020-08-27,30248,31066,-818,-2.63,1131
2020-08-28,29210,31449,-2239,-7.12,1131
2020-08-29,22037,23714,-1677,-7.07,1131
2020-08-30,18587,20070,-1483,-7.39,1131
2020-08-31,29050,29761,-711,-2.39,1131
2020-09-01,33297,32070,1227,3.83,1131
2020-09-02,33297,32263,1034,3.2,1131
2020-09-03,33297,32466,831,2.56,1131
2020-09-04,32270,32806,-536,-1.63,1131
2020-09-05,25243,25013,230,0.92,1131
2020-09-06,20772,21294,-522,-2.45,1131
2020-09-07,31193,30898,295,0.95,1131
2020-09-08,33297,33109,188,0.57,1131
2020-09-09,33297,33198,99,0.3,1131
2020-09-10,33297,33290,7,0.02,1131
2020-09-11,32270,33519,-1249,-3.73,1131
2020-09-12,25243,25615,-372,-1.45,1131
2020-09-13,20772,21789,-1017,-4.67,1131
2020-09-14,31193,31293,-100,-0.32,1131
2020-09-15,33297,33411,-114,-0.34,1131
2020-09-16,33297,33418,-121,-0.36,1131
2020-09-17,33297,33441,-144,-0.43,1131
2020-09-18,32270,33613,-1343,-4.0,1131
2020-09-19,25243,25666,-423,-1.65,1131
2020-09-20,20772,21812,-1040,-4.77,1131
2020-09-21,31193,31301,-108,-0.35,1131
2020-09-22,33297,33419,-122,-0.37,1131
2020-09-23,33297,33437,-140,-0.42,1131
2020-09-24,33297,33483,-186,-0.56,1131
2020-09-25,32270,33688,-1418,-4.21,1131
2020-09-26,25243,25782,-539,-2.09,1131
2020-09-27,20772,21975,-1203,-5.47,1131
2020-09-28,31193,31514,-321,-1.02,1131
2020-09-29,33297,33684,-387,-1.15,1131
2020-09-30,33297,33755,-458,-1.36,1131
2020-10-01,32374,33849,-1475,-4.36,1131
2020-10-02,31023,34100,-3077,-9.02,1131
2020-10-03,24170,26232,-2062,-7.86,1131
2020-10-04,19363,22456,-3093,-13.77,1131
2020-10-05,30893,32017,-1124,-3.51,1131
2020-10-06,32374,34200,-1826,-5.34,1131
2020-10-07,32374,34272,-1898,-5.54,1131
2020-10-08,32374,34359,-1985,-5.78,1131
2020-10-09,31023,34590,-3567,-10.31,1131
2020-10-10,24170,26695,-2525,-9.46,1131
2020-10-11,19363,22882,-3519,-15.38,1131
2020-10-12,30893,32399,-1506,-4.65,1131
2020-10-13,32374,34531,-2157,-6.25,1131
2020-10-14,32374,34549,-2175,-6.3,1131
2020-10-15,32374,34578,-2204,-6.37,1131
2020-10-16,31023,34751,-3728,-10.73,1131
2020-10-17,24170,26797,-2627,-9.8,1131
2020-10-18,19363,22929,-3566,-15.55,1131
2020-10-19,30893,32395,-1502,-4.64,1131
2020-10-20,32374,34482,-2108,-6.11,1131
2020-10-21,32374,34461,-2087,-6.06,1131
2020-10-22,32374,34460,-2086,-6.05,1131
2020-10-23,31023,34612,-3589,-10.37,1131
2020-10-24,24170,26647,-2477,-9.3,1131
2020-10-25,19363,22777,-3414,-14.99,1131
2020-10-26,30893,32251,-1358,-4.21,1131
2020-10-27,32374,34355,-1981,-5.77,1131
2020-10-28,32374,34360,-1986,-5.78,1131
2020-10-29,32374,34392,-2018,-5.87,1131
2020-10-30,31023,34583,-3560,-10.29,1131
2020-10-31,24170,26661,-2491,-9.34,1131
2020-11-01,14200,22837,-8637,-37.82,1131
2020-11-02,27111,32359,-5248,-16.22,1131
2020-11-03,25273,34510,-9237,-26.77,1131
2020-11-04,25273,34558,-9285,-26.87,1131
2020-11-05,25273,34630,-9357,-27.02,1131
2020-11-06,24870,34855,-9985,-28.65,1131
2020-11-07,16194,26961,-10767,-39.94,1131
2020-11-08,14200,23156,-8956,-38.68,1131
2020-11-09,27111,32688,-5577,-17.06,1131
2020-11-10,25273,34838,-9565,-27.46,1131
2020-11-11,25273,34878,-9605,-27.54,1131
2020-11-12,25273,34930,-9657,-27.65,1131
2020-11-13,24870,35126,-10256,-29.2,1131
2020-11-14,16194,27193,-10999,-40.45,1131
2020-11-15,14200,23343,-9143,-39.17,1131
2020-11-16,27111,32822,-5711,-17.4,1131
2020-11-17,25273,34916,-9643,-27.62,1131
2020-11-18,25273,34894,-9621,-27.57,1131
2020-11-19,25273,34885,-9612,-27.55,1131
2020-11-20,24870,35019,-10149,-28.98,1131
2020-11-21,16194,27028,-10834,-40.08,1131
2020-11-22,14200,23123,-8923,-38.59,1131
2020-11-23,27111,32553,-5442,-16.72,1131
2020-11-24,25273,34606,-9333,-26.97,1131
2020-11-25,25273,34552,-9279,-26.86,1131
2020-11-26,25273,34520,-9247,-26.79,1131
2020-11-27,24870,34643,-9773,-28.21,1131
2020-11-28,16194,26652,-10458,-39.24,1131
2020-11-29,14200,22757,-8557,-37.6,1131
2020-11-30,27111,32209,-5098,-15.83,1131
2020-12-01,25357,34293,-8936,-26.06,1131
2020-12-02,25357,34280,-8923,-26.03,1131
2020-12-03,25357,34296,-8939,-26.06,1131
2020-12-04,27602,34473,-6871,-19.93,1131
2020-12-05,18888,26539,-7651,-28.83,1131
2020-12-06,13677,22703,-9026,-39.76,1131
2020-12-07,25181,32214,-7033,-21.83,1131
2020-12-08,25357,34354,-8997,-26.19,1131
2020-12-09,25357,34391,-9034,-26.27,1131
2020-12-10,25357,34451,-9094,-26.4,1131
2020-12-11,27602,34661,-7059,-20.37,1131
2020-12-12,18888,26749,-7861,-29.39,1131
2020-12-13,13677,22922,-9245,-40.33,1131
2020-12-14,25181,32426,-7245,-22.34,1131
2020-12-15,25357,34544,-9187,-26.6,1131
2020-12-16,25357,34543,-9186,-26.59,1131
2020-12-17,25357,34548,-9191,-26.6,1131
2020-12-18,27602,34688,-7086,-20.43,1131
2020-12-19,18888,26690,-7802,-29.23,1131
2020-12-20,13677,22764,-9087,-39.92,1131
2020-12-21,25181,32156,-6975,-21.69,1131
2020-12-22,25357,34152,-8795,-25.75,1131
2020-12-23,25357,34022,-8665,-25.47,1131
2020-12-24,25357,33891,-8534,-25.18,1131
2020-12-25,27602,33893,-6291,-18.56,1131
2020-12-26,18888,25759,-6871,-26.67,1131
2020-12-27,13677,21700,-8023,-36.97,1131
2020-12-28,25181,30966,-5785,-18.68,1131
2020-12-29,25357,32846,-7489,-22.8,1131
2020-12-30,25357,32612,-7255,-22.25,1131
2020-12-31,25357,32394,-7037,-21.72,1131
2021-01-01,23491,32326,-8835,-27.33,1131
2021-01-02,14841,24140,-9299,-38.52,1131
2021-01-03,12207,20051,-7844,-39.12,1131
2021-01-04,22444,29309,-6865,-23.42,1131
2021-01-05,23998,31203,-7205,-23.09,1131
2021-01-06,23998,31005,-7007,-22.6,1131
2021-01-07,23998,30845,-6847,-22.2,1131
2021-01-08,23491,30855,-7364,-23.87,1131
2021-01-09,14841,22767,-7926,-34.81,1131
2021-01-10,12207,18793,-6586,-35.04,1131
2021-01-11,22444,28181,-5737,-20.36,1131
2021-01-12,23998,30216,-6218,-20.58,1131
2021-01-13,23998,30170,-6172,-20.46,1131
2021-01-14,23998,30166,-6168,-20.45,1131
2021-01-15,23491,30336,-6845,-22.56,1131
2021-01-16,14841,22407,-7566,-33.77,1131
2021-01-17,12207,18588,-6381,-34.33,1131
2021-01-18,22444,28124,-5680,-20.2,1131
2021-01-19,23998,30299,-6301,-20.8,1131
2021-01-20,23998,30379,-6381,-21.0,1131
2021-01-21,23998,30487,-6489,-21.28,1131
2021-01-22,23491,30753,-7262,-23.61,1131
2021-01-23,14841,22903,-8062,-35.2,1131
2021-01-24,12207,19143,-6936,-36.23,1131
2021-01-25,22444,28721,-6277,-21.86,1131
2021-01-26,23998,30918,-6920,-22.38,1131
2021-01-27,23998,31002,-7004,-22.59,1131
2021-01-28,23998,31098,-7100,-22.83,1131
2021-01-29,23491,31336,-7845,-25.04,1131
2021-01-30,14841,23444,-8603,-36.7,1131
2021-01-31,12207,19631,-7424,-37.82,1131
2021-02-01,26040,29147,-3107,-10.66,1131
2021-02-02,27148,31275,-4127,-13.2,1131
2021-02-03,27148,31287,-4139,-13.23,1131
2021-02-04,27148,31311,-4163,-13.3,1131
2021-02-05,26806,31478,-4672,-14.84,1131
2021-02-06,18087,23520,-5433,-23.1,1131
2021-02-07,14671,19648,-4977,-25.33,1131
2021-02-08,26040,29114,-3074,-10.56,1131
2021-02-09,27148,31204,-4056,-13.0,1131
2021-02-10,27148,31190,-4042,-12.96,1131
2021-02-11,27148,31201,-4053,-12.99,1131
2021-02-12,26806,31371,-4565,-14.55,1131
2021-02-13,18087,23430,-5343,-22.8,1131
2021-02-14,14671,19590,-4919,-25.11,1131
2021-02-15,26040,29101,-3061,-10.52,1131
2021-02-16,27148,31249,-4101,-13.12,1131
2021-02-17,27148,31305,-4157,-13.28,1131
2021-02-18,27148,31395,-4247,-13.53,1131
2021-02-19,26806,31651,-4845,-15.31,1131
2021-02-20,18087,23802,-5715,-24.01,1131
2021-02-21,14671,20057,-5386,-26.85,1131
2021-02-22,26040,29664,-3624,-12.22,1131
2021-02-23,27148,31905,-4757,-14.91,1131
2021-02-24,27148,32049,-4901,-15.29,1131
2021-02-25,27148,32221,-5073,-15.74,1131
2021-02-26,26806,32551,-5745,-17.65,1131
2021-02-27,18087,24764,-6677,-26.96,1131
2021-02-28,14671,21068,-6397,-30.36,1131
2021-03-01,26896,30711,-3815,-12.42,1131
2021-03-02,28412,32974,-4562,-13.84,1131
2021-03-03,28412,33125,-4713,-14.23,1131
2021-03-04,28412,33289,-4877,-14.65,1131
2021-03-05,28378,33595,-5217,-15.53,1131
2021-03-06,18914,25771,-6857,-26.61,1131
2021-03-07,14655,22025,-7370,-33.46,1131
2021-03-08,26896,31605,-4709,-14.9,1131
2021-03-09,28412,33796,-5384,-15.93,1131
2021-03-10,28412,33866,-5454,-16.1,1131
2021-03-11,28412,33942,-5530,-16.29,1131
2021-03-12,28378,34157,-5779,-16.92,1131
2021-03-13,18914,26239,-7325,-27.92,1131
2021-03-14,14655,22399,-7744,-34.57,1131
2021-03-15,26896,31888,-4992,-15.65,1131
2021-03-16,28412,33990,-5578,-16.41,1131
2021-03-17,28412,33979,-5567,-16.38,1131
2021-03-18,28412,33981,-5569,-16.39,1131
2021-03-19,28378,34129,-5751,-16.85,1131
2021-03-20,18914,26155,-7241,-27.68,1131
2021-03-21,14655,22269,-7614,-34.19,1131
2021-03-22,26896,31723,-4827,-15.22,1131
2021-03-23,28412,33801,-5389,-15.94,1131
2021-03-24,28412,33775,-5363,-15.88,1131
2021-03-25,28412,33773,-5361,-15.87,1131
2021-03-26,28378,33927,-5549,-16.36,1131
2021-03-27,18914,25966,-7052,-27.16,1131
2021-03-28,14655,22100,-7445,-33.69,1131
2021-03-29,26896,31579,-4683,-14.83,1131
2021-03-30,28412,33687,-5275,-15.66,1131
2021-03-31,28412,33694,-5282,-15.68,1131
2021-04-01,25896,33726,-7830,-23.22,1131
2021-04-02,24468,33912,-9444,-27.85,1131
2021-04-03,15982,25982,-10000,-38.49,1131
2021-04-04,13056,22145,-9089,-41.04,1131
2021-04-05,25765,31649,-5884,-18.59,1131
2021-04-06,25896,33776,-7880,-23.33,1131
2021-04-07,25896,33797,-7901,-23.38,1131
2021-04-08,25896,33836,-7940,-23.47,1131
2021-04-09,24468,34024,-9556,-28.09,1131
2021-04-10,15982,26090,-10108,-38.74,1131
2021-04-11,13056,22244,-9188,-41.31,1131
2021-04-12,25765,31732,-5967,-18.8,1131
2021-04-13,25896,33840,-7944,-23.48,1131
2021-04-14,25896,33838,-7942,-23.47,1131
2021-04-15,25896,33852,-7956,-23.5,1131
2021-04-16,24468,34014,-9546,-28.06,1131
2021-04-17,15982,26054,-10072,-38.66,1131
2021-04-18,13056,22181,-9125,-41.14,1131
2021-04-19,25765,31646,-5881,-18.58,1131
2021-04-20,25896,33733,-7837,-23.23,1131
2021-04-21,25896,33714,-7818,-23.19,1131
2021-04-22,25896,33715,-7819,-23.19,1131
2021-04-23,24468,33869,-9401,-27.76,1131
2021-04-24,15982,25906,-9924,-38.31,1131
2021-04-25,13056,22036,-8980,-40.75,1131
2021-04-26,25765,31509,-5744,-18.23,1131
2021-04-27,25896,33609,-7713,-22.95,1131
2021-04-28,25896,33608,-7712,-22.95,1131
2021-04-29,25896,33631,-7735,-23.0,1131
2021-04-30,24468,33809,-9341,-27.63,1131
2021-05-01,21824,25872,-4048,-15.65,1131
2021-05-02,17118,22030,-4912,-22.3,1131
2021-05-03,30992,31530,-538,-1.71,1131
2021-05-04,32514,33656,-1142,-3.39,1131
2021-05-05,32514,33677,-1163,-3.45,1131
2021-05-06,32514,33720,-1206,-3.58,1131
2021-05-07,30337,33914,-3577,-10.55,1131
2021-05-08,21824,25987,-4163,-16.02,1131
2021-05-09,17118,22148,-5030,-22.71,1131
2021-05-10,30992,31646,-654,-2.07,1131
2021-05-11,32514,33764,-1250,-3.7,1131
2021-05-12,32514,33771,-1257,-3.72,1131
2021-05-13,32514,33793,-1279,-3.78,1131
2021-05-14,30337,33961,-3624,-10.67,1131
2021-05-15,21824,26004,-4180,-16.07,1131
2021-05-16,17118,22132,-5014,-22.65,1131
2021-05-17,30992,31593,-601,-1.9,1131
2021-05-18,32514,33673,-1159,-3.44,1131
2021-05-19,32514,33643,-1129,-3.36,1131
2021-05-20,32514,33629,-1115,-3.32,1131
2021-05-21,30337,33764,-3427,-10.15,1131
2021-05-22,21824,25778,-3954,-15.34,1131
2021-05-23,17118,21882,-4764,-21.77,1131
2021-05-24,30992,31327,-335,-1.07,1131
2021-05-25,32514,33398,-884,-2.65,1131
2021-05-26,32514,33367,-853,-2.56,1131
2021-05-27,32514,33360,-846,-2.54,1131
2021-05-28,30337,33512,-3175,-9.47,1131
2021-05-29,21824,25551,-3727,-14.59,1131
2021-05-30,17118,21688,-4570,-21.07,1131
2021-05-31,30992,31173,-181,-0.58,1131
2021-06-01,33899,33291,608,1.83,1131
2021-06-02,33899,33311,588,1.77,1131
2021-06-03,33899,33359,540,1.62,1131
2021-06-04,31580,33567,-1987,-5.92,1131
2021-06-05,25092,25661,-569,-2.22,1131
2021-06-06,19995,21852,-1857,-8.5,1131
2021-06-07,32003,31385,618,1.97,1131
2021-06-08,33899,33544,355,1.06,1131
2021-06-09,33899,33597,302,0.9,1131
2021-06-10,33899,33667,232,0.69,1131
2021-06-11,31580,33884,-2304,-6.8,1131
2021-06-12,25092,25975,-883,-3.4,1131
2021-06-13,19995,22146,-2151,-9.71,1131
2021-06-14,32003,31645,358,1.13,1131
2021-06-15,33899,33754,145,0.43,1131
2021-06-16,33899,33741,158,0.47,1131
2021-06-17,33899,33730,169,0.5,1131
2021-06-18,31580,33851,-2271,-6.71,1131
2021-06-19,25092,25833,-741,-2.87,1131
2021-06-20,19995,21885,-1890,-8.64,1131
2021-06-21,32003,31255,748,2.39,1131
2021-06-22,33899,33228,671,2.02,1131
2021-06-23,33899,33075,824,2.49,1131
2021-06-24,33899,32922,977,2.97,1131
2021-06-25,31580,32904,-1324,-4.02,1131
2021-06-26,25092,24751,341,1.38,1131
2021-06-27,19995,20675,-680,-3.29,1131
2021-06-28,32003,29928,2075,6.93,1131
2021-06-29,33899,31797,2102,6.61,1131
2021-06-30,33899,31555,2344,7.43,1131
2021-07-01,30541,31332,-791,-2.52,1131
2021-07-02,29538,31262,-1724,-5.51,1131
2021-07-03,21608,23078,-1470,-6.37,1131
2021-07-04,17764,18993,-1229,-6.47,1131
2021-07-05,28950,28258,692,2.45,1131
2021-07-06,30541,30160,381,1.26,1131
2021-07-07,30541,29973,568,1.9,1131
2021-07-08,30541,29823,718,2.41,1131
2021-07-09,29538,29845,-307,-1.03,1131
2021-07-10,21608,21768,-160,-0.74,1131
2021-07-11,17764,17804,-40,-0.22,1131
2021-07-12,28950,27199,1751,6.44,1131
2021-07-13,30541,29240,1301,4.45,1131
2021-07-14,30541,29195,1346,4.61,1131
2021-07-15,30541,29188,1353,4.64,1131
2021-07-16,29538,29350,188,0.64,1131
2021-07-17,21608,21407,201,0.94,1131
2021-07-18,17764,17568,196,1.12,1131
2021-07-19,28950,27077,1873,6.92,1131
2021-07-20,30541,29217,1324,4.53,1131
2021-07-21,30541,29254,1287,4.4,1131
2021-07-22,30541,29312,1229,4.19,1131
2021-07-23,29538,29520,18,0.06,1131
2021-07-24,21608,21603,5,0.02,1131
2021-07-25,17764,17769,-5,-0.03,1131
2021-07-26,28950,27265,1685,6.18,1131
2021-07-27,30541,29373,1168,3.98,1131
2021-07-28,30541,29362,1179,4.02,1131
2021-07-29,30541,29356,1185,4.04,1131
2021-07-30,29538,29488,50,0.17,1131
2021-07-31,21608,21485,123,0.57,1131
2021-08-01,18117,17559,558,3.18,1131
2021-08-02,27993,26959,1034,3.84,1131
2021-08-03,29257,28970,287,0.99,1131
2021-08-04,29257,28866,391,1.35,1131
2021-08-05,29257,28774,483,1.68,1131
2021-08-06,28056,28828,-772,-2.68,1131
2021-08-07,21393,20761,632,3.04,1131
2021-08-08,18117,16785,1332,7.94,1131
2021-08-09,27993,26152,1841,7.04,1131
2021-08-10,29257,28149,1108,3.94,1131
2021-08-11,29257,28051,1206,4.3,1131
2021-08-12,29257,27985,1272,4.55,1131
2021-08-13,28056,28087,-31,-0.11,1131
2021-08-14,21393,20087,1306,6.5,1131
2021-08-15,18117,16198,1919,11.85,1131
2021-08-16,27993,25671,2322,9.05,1131
2021-08-17,29257,27789,1468,5.28,1131
2021-08-18,29257,27826,1431,5.14,1131
2021-08-19,29257,27906,1351,4.84,1131
2021-08-20,28056,28162,-106,-0.38,1131
2021-08-21,21393,20321,1072,5.28,1131
2021-08-22,18117,16592,1525,9.19,1131
2021-08-23,27993,26223,1770,6.75,1131
2021-08-24,29257,28494,763,2.68,1131
2021-08-25,29257,28676,581,2.03,1131
2021-08-26,29257,28889,368,1.27,1131
2021-08-27,28056,29264,-1208,-4.13,1131
2021-08-28,21393,21526,-133,-0.62,1131
2021-08-29,18117,17882,235,1.31,1131
2021-08-30,27993,27577,416,1.51,1131
2021-08-31,29257,29893,-636,-2.13,1131
2021-09-01,34766,30098,4668,15.51,1131
2021-09-02,34766,30314,4452,14.69,1131
2021-09-03,34858,30671,4187,13.65,1131
2021-09-04,27145,22896,4249,18.56,1131
2021-09-05,21996,19197,2799,14.58,1131
2021-09-06,33115,28822,4293,14.89,1131
2021-09-07,34766,31054,3712,11.95,1131
2021-09-08,34766,31163,3603,11.56,1131
2021-09-09,34766,31275,3491,11.16,1131
2021-09-10,34858,31523,3335,10.58,1131
2021-09-11,27145,23637,3508,14.84,1131
2021-09-12,21996,19826,2170,10.95,1131
2021-09-13,33115,29343,3772,12.85,1131
2021-09-14,34766,31472,3294,10.47,1131
2021-09-15,34766,31487,3279,10.41,1131
2021-09-16,34766,31515,3251,10.32,1131
2021-09-17,34858,31690,3168,10.0,1131
2021-09-18,27145,23743,3402,14.33,1131
2021-09-19,21996,19887,2109,10.6,1131
2021-09-20,33115,29371,3744,12.75,1131
2021-09-21,34766,31483,3283,10.43,1131
2021-09-22,34766,31493,3273,10.39,1131
2021-09-23,34766,31530,3236,10.26,1131
2021-09-24,34858,31726,3132,9.87,1131
2021-09-25,27145,23809,3336,14.01,1131
2021-09-26,21996,19992,2004,10.02,1131
2021-09-27,33115,29522,3593,12.17,1131
2021-09-28,34766,31683,3083,9.73,1131
2021-09-29,34766,31746,3020,9.51,1131
2021-09-30,34766,31835,2931,9.21,1131
2021-10-01,34047,32080,1967,6.13,1131
2021-10-02,26894,24210,2684,11.09,1131
2021-10-03,21636,20433,1203,5.89,1131
2021-10-04,30513,29996,517,1.72,1131
2021-10-05,33083,32182,901,2.8,1131
2021-10-06,33083,32259,824,2.55,1131
2021-10-07,33083,32353,730,2.26,1131
2021-10-08,34047,32593,1454,4.46,1131
2021-10-09,26894,24707,2187,8.85,1131
2021-10-10,21636,20904,732,3.5,1131
2021-10-11,30513,30432,81,0.27,1131
2021-10-12,33083,32575,508,1.56,1131
2021-10-13,33083,32604,479,1.47,1131
2021-10-14,33083,32644,439,1.34,1131
2021-10-15,34047,32826,1221,3.72,1131
2021-10-16,26894,24881,2013,8.09,1131
2021-10-17,21636,21020,616,2.93,1131
2021-10-18,30513,30492,21,0.07,1131
2021-10-19,33083,32583,500,1.53,1131
2021-10-20,33083,32565,518,1.59,1131
2021-10-21,33083,32564,519,1.59,1131
2021-10-22,34047,32715,1332,4.07,1131
2021-10-23,26894,24747,2147,8.68,1131
2021-10-24,21636,20872,764,3.66,1131
2021-10-25,30513,30340,173,0.57,1131
2021-10-26,33083,32437,646,1.99,1131
2021-10-27,33083,32433,650,2.0,1131
2021-10-28,33083,32456,627,1.93,1131
2021-10-29,34047,32638,1409,4.32,1131
2021-10-30,26894,24708,2186,8.85,1131
2021-10-31,21636,20875,761,3.65,1131
2021-11-01,27371,30389,-3018,-9.93,1131
2021-11-02,29928,32533,-2605,-8.01,1131
2021-11-03,29928,32576,-2648,-8.13,1131
2021-11-04,29928,32644,-2716,-8.32,1131
2021-11-05,31041,32867,-1826,-5.56,1131
2021-11-06,23163,24973,-1810,-7.25,1131
2021-11-07,19958,21169,-1211,-5.72,1131
2021-11-08,27371,30704,-3333,-10.86,1131
2021-11-09,29928,32860,-2932,-8.92,1131
2021-11-10,29928,32906,-2978,-9.05,1131
2021-11-11,29928,32967,-3039,-9.22,1131
2021-11-12,31041,33172,-2131,-6.42,1131
2021-11-13,23163,25251,-2088,-8.27,1131
2021-11-14,19958,21412,-1454,-6.79,1131
2021-11-15,27371,30903,-3532,-11.43,1131
2021-11-16,29928,33008,-3080,-9.33,1131
2021-11-17,29928,32998,-3070,-9.3,1131
2021-11-18,29928,32999,-3071,-9.31,1131
2021-11-19,31041,33143,-2102,-6.34,1131
2021-11-20,23163,25160,-1997,-7.94,1131
2021-11-21,19958,21261,-1303,-6.13,1131
2021-11-22,27371,30696,-3325,-10.83,1131
2021-11-23,29928,32751,-2823,-8.62,1131
2021-11-24,29928,32698,-2770,-8.47,1131
2021-11-25,29928,32664,-2736,-8.38,1131
2021-11-26,31041,32783,-1742,-5.31,1131
2021-11-27,23163,24786,-1623,-6.55,1131
2021-11-28,19958,20883,-925,-4.43,1131
2021-11-29,27371,30326,-2955,-9.74,1131
2021-11-30,29928,32400,-2472,-7.63,1131
2021-12-01,27577,32376,-4799,-14.82,1131
2021-12-02,27577,32380,-4803,-14.83,1131
2021-12-03,24628,32546,-7918,-24.33,1131
2021-12-04,18671,24601,-5930,-24.1,1131
2021-12-05,16079,20756,-4677,-22.53,1131
2021-12-06,27533,30258,-2725,-9.01,1131
2021-12-07,27577,32391,-4814,-14.86,1131
2021-12-08,27577,32423,-4846,-14.95,1131
2021-12-09,27577,32480,-4903,-15.1,1131
2021-12-10,24628,32691,-8063,-24.66,1131
2021-12-11,18671,24782,-6111,-24.66,1131
2021-12-12,16079,20961,-4882,-23.29,1131
2021-12-13,27533,30475,-2942,-9.65,1131
2021-12-14,27577,32606,-5029,-15.42,1131
2021-12-15,27577,32620,-5043,-15.46,1131
2021-12-16,27577,32643,-5066,-15.52,1131
2021-12-17,24628,32803,-8175,-24.92,1131
2021-12-18,18671,24828,-6157,-24.8,1131
2021-12-19,16079,20926,-4847,-23.16,1131
2021-12-20,27533,30343,-2810,-9.26,1131
2021-12-21,27577,32365,-4788,-14.79,1131
2021-12-22,27577,32260,-4683,-14.52,1131
2021-12-23,27577,32154,-4577,-14.23,1131
2021-12-24,24628,32180,-7552,-23.47,1131
2021-12-25,18671,24068,-5397,-22.42,1131
2021-12-26,16079,20028,-3949,-19.72,1131
2021-12-27,27533,29312,-1779,-6.07,1131
2021-12-28,27577,31206,-3629,-11.63,1131
2021-12-29,27577,30982,-3405,-10.99,1131
2021-12-30,27577,30770,-3193,-10.38,1131
2021-12-31,24628,30704,-6076,-19.79,1131
2022-01-01,21344,22516,-1172,-5.21,1131
2022-01-02,15261,18421,-3160,-17.15,1131
2022-01-03,25177,27669,-2492,-9.01,1131
2022-01-04,26627,29548,-2921,-9.89,1131
2022-01-05,26627,29333,-2706,-9.23,1131
2022-01-06,26627,29151,-2524,-8.66,1131
2022-01-07,26483,29138,-2655,-9.11,1131
2022-01-08,21344,21024,320,1.52,1131
2022-01-09,15261,17022,-1761,-10.35,1131
2022-01-10,25177,26381,-1204,-4.56,1131
2022-01-11,26627,28386,-1759,-6.2,1131
2022-01-12,26627,28310,-1683,-5.94,1131
2022-01-13,26627,28277,-1650,-5.84,1131
2022-01-14,26483,28420,-1937,-6.82,1131
2022-01-15,21344,20465,879,4.3,1131
2022-01-16,15261,16622,-1361,-8.19,1131
2022-01-17,25177,26137,-960,-3.67,1131
2022-01-18,26627,28293,-1666,-5.89,1131
2022-01-19,26627,28359,-1732,-6.11,1131
2022-01-20,26627,28456,-1829,-6.43,1131
2022-01-21,26483,28714,-2231,-7.77,1131
2022-01-22,21344,20860,484,2.32,1131
2022-01-23,15261,17099,-1838,-10.75,1131
2022-01-24,25177,26680,-1503,-5.63,1131
2022-01-25,26627,28882,-2255,-7.81,1131
2022-01-26,26627,28974,-2347,-8.1,1131
2022-01-27,26627,29080,-2453,-8.44,1131
2022-01-28,26483,29330,-2847,-9.71,1131
2022-01-29,21344,21451,-107,-0.5,1131
2022-01-30,15261,17652,-2391,-13.55,1131
2020-02-01,60735,57988,2747,4.74,1170
2020-02-02,51654,50320,1334,2.65,1170
2020-02-03,64912,67314,-2402,-3.57,1170
2020-02-04,67694,70108,-2414,-3.44,1170
2020-02-05,67694,70191,-2497,-3.56,1170
2020-02-06,67694,70296,-2602,-3.7,1170
2020-02-07,70830,71580,-750,-1.05,1170
2020-02-08,60735,58544,2191,3.74,1170
2020-02-09,51654,50793,861,1.7,1170
2020-02-10,64912,67711,-2799,-4.13,1170
2020-02-11,67694,70438,-2744,-3.9,1170
2020-02-12,67694,70465,-2771,-3.93,1170
2020-02-13,67694,70526,-2832,-4.02,1170
2020-02-14,70830,71779,-949,-1.32,1170
2020-02-15,60735,58727,2008,3.42,1170
2020-02-16,51654,50975,679,1.33,1170
2020-02-17,64912,67905,-2993,-4.41,1170
2020-02-18,67694,70658,-2964,-4.19,1170
2020-02-19,67694,70724,-3030,-4.28,1170
2020-02-20,67694,70834,-3140,-4.43,1170
2020-02-21,70830,72146,-1316,-1.82,1170
2020-02-22,60735,59160,1575,2.66,1170
2020-02-23,51654,51478,176,0.34,1170
2020-02-24,64912,68482,-3570,-5.21,1170
2020-02-25,67694,71308,-3614,-5.07,1170
2020-02-26,67694,71445,-3751,-5.25,1170
2020-02-27,67694,71622,-3928,-5.48,1170
2020-02-28,70830,72995,-2165,-2.97,1170
2020-02-29,60735,60060,675,1.12,1170
2020-03-01,34258,52419,-18161,-34.65,1170
2020-03-02,48467,69453,-20986,-30.22,1170
2020-03-03,48603,72297,-23694,-32.77,1170
2020-03-04,48603,72437,-23834,-32.9,1170
2020-03-05,48603,72605,-24002,-33.06,1170
2020-03-06,50396,73954,-23558,-31.85,1170
2020-03-07,36162,60983,-24821,-40.7,1170
2020-03-08,34258,53293,-19035,-35.72,1170
2020-03-09,48467,70267,-21800,-31.02,1170
2020-03-10,48603,73040,-24437,-33.46,1170
2020-03-11,48603,73102,-24499,-33.51,1170
2020-03-12,48603,73184,-24581,-33.59,1170
2020-03-13,50396,74442,-24046,-32.3,1170
2020-03-14,36162,61377,-25215,-41.08,1170
2020-03-15,34258,53593,-19335,-36.08,1170
2020-03-16,48467,70472,-22005,-31.23,1170
2020-03-17,48603,73154,-24551,-33.56,1170
2020-03-18,48603,73128,-24525,-33.54,1170
2020-03-19,48603,73128,-24525,-33.54,1170
2020-03-20,50396,74311,-23915,-32.18,1170
2020-03-21,36162,61179,-25017,-40.89,1170
2020-03-22,34258,53337,-19079,-35.77,1170
2020-03-23,48467,70167,-21700,-30.93,1170
2020-03-24,48603,72809,-24206,-33.25,1170
2020-03-25,48603,72753,-24150,-33.19,1170
2020-03-26,48603,72732,-24129,-33.18,1170
2020-03-27,50396,73904,-23508,-31.81,1170
2020-03-28,36162,60768,-24606,-40.49,1170
2020-03-29,34258,52928,-18670,-35.27,1170
2020-03-30,48467,69768,-21301,-30.53,1170
2020-03-31,48603,72425,-23822,-32.89,1170
2020-04-01,42723,72387,-29664,-40.98,1170
2020-04-02,42723,72389,-29666,-40.98,1170
2020-04-03,38837,73584,-34747,-47.22,1170
2020-04-04,26448,60472,-34024,-56.26,1170
2020-04-05,20450,52658,-32208,-61.16,1170
2020-04-06,41745,69521,-27776,-39.95,1170
2020-04-07,42723,72201,-29478,-40.83,1170
2020-04-08,42723,72184,-29461,-40.81,1170
2020-04-09,42723,72203,-29480,-40.83,1170
2020-04-10,38837,73415,-34578,-47.1,1170
2020-04-11,26448,60317,-33869,-56.15,1170
2020-04-12,20450,52514,-32064,-61.06,1170
2020-04-13,41745,69386,-27641,-39.84,1170
2020-04-14,42723,72074,-29351,-40.72,1170
2020-04-15,42723,72064,-29341,-40.72,1170
2020-04-16,42723,72089,-29366,-40.74,1170
2020-04-17,38837,73307,-34470,-47.02,1170
2020-04-18,26448,60215,-33767,-56.08,1170
2020-04-19,20450,52420,-31970,-60.99,1170
2020-04-20,41745,69302,-27557,-39.76,1170
2020-04-21,42723,72000,-29277,-40.66,1170
2020-04-22,42723,72003,-29280,-40.66,1170
2020-04-23,42723,72044,-29321,-40.7,1170
2020-04-24,38837,73279,-34442,-47.0,1170
2020-04-25,26448,60207,-33759,-56.07,1170
2020-04-26,20450,52432,-31982,-61.0,1170
2020-04-27,41745,69336,-27591,-39.79,1170
2020-04-28,42723,72058,-29335,-40.71,1170
2020-04-29,42723,72083,-29360,-40.73,1170
2020-04-30,42723,72146,-29423,-40.78,1170
2020-05-01,57113,73402,-16289,-22.19,1170
2020-05-02,43477,60348,-16871,-27.96,1170
2020-05-03,34257,52589,-18332,-34.86,1170
2020-05-04,55816,69505,-13689,-19.69,1170
2020-05-05,57751,72233,-14482,-20.05,1170
2020-05-06,57751,72262,-14511,-20.08,1170
2020-05-07,57751,72322,-14571,-20.15,1170
2020-05-08,57113,73569,-16456,-22.37,1170
2020-05-09,43477,60503,-17026,-28.14,1170
2020-05-10,34257,52725,-18468,-35.03,1170
2020-05-11,55816,69618,-13802,-19.83,1170
2020-05-12,57751,72320,-14569,-20.15,1170
2020-05-13,57751,72318,-14567,-20.14,1170
2020-05-14,57751,72347,-14596,-20.17,1170
2020-05-15,57113,73561,-16448,-22.36,1170
2020-05-16,43477,60462,-16985,-28.09,1170
2020-05-17,34257,52653,-18396,-34.94,1170
2020-05-18,55816,69518,-13702,-19.71,1170
2020-05-19,57751,72196,-14445,-20.01,1170
2020-05-20,57751,72177,-14426,-19.99,1170
2020-05-21,57751,72194,-14443,-20.01,1170
2020-05-22,57113,73405,-16292,-22.19,1170
2020-05-23,43477,60312,-16835,-27.91,1170
2020-05-24,34257,52518,-18261,-34.77,1170
2020-05-25,55816,69408,-13592,-19.58,1170
2020-05-26,57751,72121,-14370,-19.92,1170
2020-05-27,57751,72145,-14394,-19.95,1170
2020-05-28,57751,72215,-14464,-20.03,1170
2020-05-29,57113,73487,-16374,-22.28,1170
2020-05-30,43477,60460,-16983,-28.09,1170
2020-05-31,34257,52739,-18482,-35.04,1170
2020-06-01,63490,69703,-6213,-8.91,1170
2020-06-02,66636,72492,-5856,-8.08,1170
2020-06-03,66636,72591,-5955,-8.2,1170
2020-06-04,66636,72731,-6095,-8.38,1170
2020-06-05,66473,74067,-7594,-10.25,1170
2020-06-06,55304,61096,-5792,-9.48,1170
2020-06-07,44586,53419,-8833,-16.54,1170
2020-06-08,63490,70415,-6925,-9.83,1170
2020-06-09,66636,73218,-6582,-8.99,1170
2020-06-10,66636,73315,-6679,-9.11,1170
2020-06-11,66636,73435,-6799,-9.26,1170
2020-06-12,66473,74731,-8258,-11.05,1170
2020-06-13,55304,61699,-6395,-10.36,1170
2020-06-14,44586,53941,-9355,-17.34,1170
2020-06-15,63490,70835,-7345,-10.37,1170
2020-06-16,66636,73519,-6883,-9.36,1170
2020-06-17,66636,73478,-6842,-9.31,1170
2020-06-18,66636,73444,-6808,-9.27,1170
2020-06-19,66473,74573,-8100,-10.86,1170
2020-06-20,55304,61363,-6059,-9.87,1170
2020-06-21,44586,53419,-8833,-16.54,1170
2020-06-22,63490,70123,-6633,-9.46,1170
2020-06-23,66636,72616,-5980,-8.24,1170
2020-06-24,66636,72388,-5752,-7.95,1170
2020-06-25,66636,72174,-5538,-7.67,1170
2020-06-26,66473,73133,-6660,-9.11,1170
2020-06-27,55304,59767,-4463,-7.47,1170
2020-06-28,44586,51685,-7099,-13.74,1170
2020-06-29,63490,68272,-4782,-7.0,1170
2020-06-30,66636,70670,-4034,-5.71,1170
2020-07-01,69581,70372,-791,-1.12,1170
2020-07-02,69581,70115,-534,-0.76,1170
2020-07-03,70019,71058,-1039,-1.46,1170
2020-07-04,56344,57705,-1361,-2.36,1170
2020-07-05,49399,49663,-264,-0.53,1170
2020-07-06,65588,66315,-727,-1.1,1170
2020-07-07,69581,68805,776,1.13,1170
2020-07-08,69581,68620,961,1.4,1170
2020-07-09,69581,68496,1085,1.58,1170
2020-07-10,70019,69589,430,0.62,1170
2020-07-11,56344,56398,-54,-0.1,1170
2020-07-12,49399,48527,872,1.8,1170
2020-07-13,65588,65356,232,0.35,1170
2020-07-14,69581,68022,1559,2.29,1170
2020-07-15,69581,68010,1571,2.31,1170
2020-07-16,69581,68051,1530,2.25,1170
2020-07-17,70019,69296,723,1.04,1170
2020-07-18,56344,56243,101,0.18,1170
2020-07-19,49399,48490,909,1.87,1170
2020-07-20,65588,65416,172,0.26,1170
2020-07-21,69581,68155,1426,2.09,1170
2020-07-22,69581,68192,1389,2.04,1170
2020-07-23,69581,68254,1327,1.94,1170
2020-07-24,70019,69496,523,0.75,1170
2020-07-25,56344,56413,-69,-0.12,1170
2020-07-26,49399,48607,792,1.63,1170
2020-07-27,65588,65457,131,0.2,1170
2020-07-28,69581,68100,1481,2.17,1170
2020-07-29,69581,68025,1556,2.29,1170
2020-07-30,69581,67963,1618,2.38,1170
2020-07-31,70019,69071,948,1.37,1170
2020-08-01,56696,55850,846,1.51,1170
2020-08-02,49802,47906,1896,3.96,1170
2020-08-03,65575,64623,952,1.47,1170
2020-08-04,68049,67143,906,1.35,1170
2020-08-05,68049,66957,1092,1.63,1170
2020-08-06,68049,66802,1247,1.87,1170
2020-08-07,68868,67838,1030,1.52,1170
2020-08-08,56696,54570,2126,3.9,1170
2020-08-09,49802,46605,3197,6.86,1170
2020-08-10,65575,63330,2245,3.54,1170
2020-08-11,68049,65888,2161,3.28,1170
2020-08-12,68049,65770,2279,3.47,1170
2020-08-13,68049,65714,2335,3.55,1170
2020-08-14,68868,66878,1990,2.98,1170
2020-08-15,56696,53764,2932,5.45,1170
2020-08-16,49802,45980,3822,8.31,1170
2020-08-17,65575,62906,2669,4.24,1170
2020-08-18,68049,65684,2365,3.6,1170
2020-08-19,68049,65800,2249,3.42,1170
2020-08-20,68049,65988,2061,3.12,1170
2020-08-21,68868,67400,1468,2.18,1170
2020-08-22,56696,54536,2160,3.96,1170
2020-08-23,49802,46995,2807,5.97,1170
2020-08-24,65575,64157,1418,2.21,1170
2020-08-25,68049,67155,894,1.33,1170
2020-08-26,68049,67474,575,0.85,1170
2020-08-27,68049,67842,207,0.31,1170
2020-08-28,68868,69410,-542,-0.78,1170
2020-08-29,56696,56673,23,0.04,1170
2020-08-30,49802,49230,572,1.16,1170
2020-08-31,65575,66458,-883,-1.33,1170
2020-09-01,69757,69491,266,0.38,1170
2020-09-02,69757,69812,-55,-0.08,1170
2020-09-03,69757,70151,-394,-0.56,1170
2020-09-04,71282,71661,-379,-0.53,1170
2020-09-05,60826,58838,1988,3.38,1170
2020-09-06,50434,51284,-850,-1.66,1170
2020-09-07,66350,68379,-2029,-2.97,1170
2020-09-08,69757,71260,-1503,-2.11,1170
2020-09-09,69757,71417,-1660,-2.32,1170
2020-09-10,69757,71580,-1823,-2.55,1170
2020-09-11,71282,72908,-1626,-2.23,1170
2020-09-12,60826,59902,924,1.54,1170
2020-09-13,50434,52166,-1732,-3.32,1170
2020-09-14,66350,69085,-2735,-3.96,1170
2020-09-15,69757,71801,-2044,-2.85,1170
2020-09-16,69757,71803,-2046,-2.85,1170
2020-09-17,69757,71827,-2070,-2.88,1170
2020-09-18,71282,73034,-1752,-2.4,1170
2020-09-19,60826,59924,902,1.51,1170
2020-09-20,50434,52105,-1671,-3.21,1170
2020-09-21,66350,68962,-2612,-3.79,1170
2020-09-22,69757,71634,-1877,-2.62,1170
2020-09-23,69757,71613,-1856,-2.59,1170
2020-09-24,69757,71633,-1876,-2.62,1170
2020-09-25,71282,72851,-1569,-2.15,1170
2020-09-26,60826,59767,1059,1.77,1170
2020-09-27,50434,51987,-1553,-2.99,1170
2020-09-28,66350,68892,-2542,-3.69,1170
2020-09-29,69757,71620,-1863,-2.6,1170
2020-09-30,69757,71658,-1901,-2.65,1170
2020-10-01,68123,71738,-3615,-5.04,1170
2020-10-02,69650,73016,-3366,-4.61,1170
2020-10-03,58329,59989,-1660,-2.77,1170
2020-10-04,46398,52258,-5860,-11.21,1170
2020-10-05,66191,69205,-3014,-4.36,1170
2020-10-06,68123,71966,-3843,-5.34,1170
2020-10-07,68123,72027,-3904,-5.42,1170
2020-10-08,68123,72119,-3996,-5.54,1170
2020-10-09,69650,73396,-3746,-5.1,1170
2020-10-10,58329,60358,-2029,-3.36,1170
2020-10-11,46398,52606,-6208,-11.8,1170
2020-10-12,66191,69522,-3331,-4.79,1170
2020-10-13,68123,72243,-4120,-5.7,1170
2020-10-14,68123,72257,-4134,-5.72,1170
2020-10-15,68123,72298,-4175,-5.77,1170
2020-10-16,69650,73521,-3871,-5.27,1170
2020-10-17,58329,60428,-2099,-3.47,1170
2020-10-18,46398,52623,-6225,-11.83,1170
2020-10-19,66191,69488,-3297,-4.74,1170
2020-10-20,68123,72164,-4041,-5.6,1170
2020-10-21,68123,72141,-4018,-5.57,1170
2020-10-22,68123,72152,-4029,-5.58,1170
2020-10-23,69650,73356,-3706,-5.05,1170
2020-10-24,58329,60253,-1924,-3.19,1170
2020-10-25,46398,52449,-6051,-11.54,1170
2020-10-26,66191,69326,-3135,-4.52,1170
2020-10-27,68123,72024,-3901,-5.42,1170
2020-10-28,68123,72033,-3910,-5.43,1170
2020-10-29,68123,72085,-3962,-5.5,1170
2020-10-30,69650,73336,-3686,-5.03,1170
2020-10-31,58329,60287,-1958,-3.25,1170
2020-11-01,34619,52540,-17921,-34.11,1170
2020-11-02,57131,69475,-12344,-17.77,1170
2020-11-03,54189,72232,-18043,-24.98,1170
2020-11-04,54189,72295,-18106,-25.04,1170
2020-11-05,54189,72397,-18208,-25.15,1170
2020-11-06,55403,73692,-18289,-24.82,1170
2020-11-07,38360,60676,-22316,-36.78,1170
2020-11-08,34619,52953,-18334,-34.62,1170
2020-11-09,57131,69901,-12770,-18.27,1170
2020-11-10,54189,72657,-18468,-25.42,1170
2020-11-11,54189,72707,-18518,-25.47,1170
2020-11-12,54189,72782,-18593,-25.55,1170
2020-11-13,55403,74037,-18634,-25.17,1170
2020-11-14,38360,60969,-22609,-37.08,1170
2020-11-15,34619,53182,-18563,-34.9,1170
2020-11-16,57131,70057,-12926,-18.45,1170
2020-11-17,54189,72732,-18543,-25.49,1170
2020-11-18,54189,72695,-18506,-25.46,1170
2020-11-19,54189,72679,-18490,-25.44,1170
2020-11-20,55403,73842,-18439,-24.97,1170
2020-11-21,38360,60683,-22323,-36.79,1170
2020-11-22,34619,52809,-18190,-34.44,1170
2020-11-23,57131,69603,-12472,-17.92,1170
2020-11-24,54189,72204,-18015,-24.95,1170
2020-11-25,54189,72105,-17916,-24.85,1170
2020-11-26,54189,72039,-17850,-24.78,1170
2020-11-27,55403,73164,-17761,-24.28,1170
2020-11-28,38360,59982,-21622,-36.05,1170
2020-11-29,34619,52100,-17481,-33.55,1170
2020-11-30,57131,68901,-11770,-17.08,1170
2020-12-01,54802,71524,-16722,-23.38,1170
2020-12-02,54802,71460,-16658,-23.31,1170
2020-12-03,54802,71441,-16639,-23.29,1170
2020-12-04,60635,72625,-11990,-16.51,1170
2020-12-05,43865,59510,-15645,-26.29,1170
2020-12-06,32935,51701,-18766,-36.3,1170
2020-12-07,56331,68578,-12247,-17.86,1170
2020-12-08,54802,71278,-16476,-23.12,1170
2020-12-09,54802,71288,-16486,-23.13,1170
2020-12-10,54802,71339,-16537,-23.18,1170
2020-12-11,60635,72583,-11948,-16.46,1170
2020-12-12,43865,59519,-15654,-26.3,1170
2020-12-13,32935,51746,-18811,-36.35,1170
2020-12-14,56331,68644,-12313,-17.94,1170
2020-12-15,54802,71349,-16547,-23.19,1170
2020-12-16,54802,71344,-16542,-23.19,1170
2020-12-17,54802,71361,-16559,-23.2,1170
2020-12-18,60635,72552,-11917,-16.43,1170
2020-12-19,43865,59414,-15549,-26.17,1170
2020-12-20,32935,51550,-18615,-36.11,1170
2020-12-21,56331,68340,-12009,-17.57,1170
2020-12-22,54802,70920,-16118,-22.73,1170
2020-12-23,54802,70778,-15976,-22.57,1170
2020-12-24,54802,70648,-15846,-22.43,1170
2020-12-25,60635,71685,-11050,-15.41,1170
2020-12-26,43865,58390,-14525,-24.88,1170
2020-12-27,32935,50368,-17433,-34.61,1170
2020-12-28,56331,67004,-10673,-15.93,1170
2020-12-29,54802,69438,-14636,-21.08,1170
2020-12-30,54802,69161,-14359,-20.76,1170
2020-12-31,54802,68910,-14108,-20.47,1170
2021-01-01,52820,69844,-17024,-24.37,1170
2021-01-02,34365,56467,-22102,-39.14,1170
2021-01-03,28277,48387,-20110,-41.56,1170
2021-01-04,50976,64988,-14012,-21.56,1170
2021-01-05,53790,67414,-13624,-20.21,1170
2021-01-06,53790,67157,-13367,-19.9,1170
2021-01-07,53790,66952,-13162,-19.66,1170
2021-01-08,52820,67960,-15140,-22.28,1170
2021-01-09,34365,54682,-20317,-37.15,1170
2021-01-10,28277,46724,-18447,-39.48,1170
2021-01-11,50976,63471,-12495,-19.69,1170
2021-01-12,53790,66062,-12272,-18.58,1170
2021-01-13,53790,65985,-12195,-18.48,1170
2021-01-14,53790,65974,-12184,-18.47,1170
2021-01-15,52820,67185,-14365,-21.38,1170
2021-01-16,34365,54115,-19750,-36.5,1170
2021-01-17,28277,46368,-18091,-39.02,1170
2021-01-18,50976,63322,-12346,-19.5,1170
2021-01-19,53790,66114,-12324,-18.64,1170
2021-01-20,53790,66229,-12439,-18.78,1170
2021-01-21,53790,66396,-12606,-18.99,1170
2021-01-22,52820,67769,-14949,-22.06,1170
2021-01-23,34365,54844,-20479,-37.34,1170
2021-01-24,28277,47220,-18943,-40.12,1170
2021-01-25,50976,64276,-13300,-20.69,1170
2021-01-26,53790,67147,-13357,-19.89,1170
2021-01-27,53790,67318,-13528,-20.1,1170
2021-01-28,53790,67519,-13729,-20.33,1170
2021-01-29,52820,68903,-16083,-23.34,1170
2021-01-30,34365,55968,-21603,-38.6,1170
2021-01-31,28277,48316,-20039,-41.47,1170
2021-02-01,59144,65326,-6182,-9.46,1170
2021-02-02,60244,68137,-7893,-11.58,1170
2021-02-03,60244,68237,-7993,-11.71,1170
2021-02-04,60244,68358,-8114,-11.87,1170
2021-02-05,59802,69656,-9854,-14.15,1170
2021-02-06,42518,56633,-14115,-24.92,1170
2021-02-07,35351,48893,-13542,-27.7,1170
2021-02-08,59144,65819,-6675,-10.14,1170
2021-02-09,60244,68552,-8308,-12.12,1170
2021-02-10,60244,68582,-8338,-12.16,1170
2021-02-11,60244,68644,-8400,-12.24,1170
2021-02-12,59802,69895,-10093,-14.44,1170
2021-02-13,42518,56838,-14320,-25.19,1170
2021-02-14,35351,49079,-13728,-27.97,1170
2021-02-15,59144,66000,-6856,-10.39,1170
2021-02-16,60244,68742,-8498,-12.36,1170
2021-02-17,60244,68795,-8551,-12.43,1170
2021-02-18,60244,68892,-8648,-12.55,1170
2021-02-19,59802,70191,-10389,-14.8,1170
2021-02-20,42518,57190,-14672,-25.65,1170
2021-02-21,35351,49495,-14144,-28.58,1170
2021-02-22,59144,66485,-7341,-11.04,1170
2021-02-23,60244,69300,-9056,-13.07,1170
2021-02-24,60244,69427,-9183,-13.23,1170
2021-02-25,60244,69596,-9352,-13.44,1170
2021-02-26,59802,70962,-11160,-15.73,1170
2021-02-27,42518,58024,-15506,-26.72,1170
2021-02-28,35351,50382,-15031,-29.83,1170
2021-03-01,60198,67417,-7219,-10.71,1170
2021-03-02,62344,70265,-7921,-11.27,1170
2021-03-03,62344,70412,-8068,-11.46,1170
2021-03-04,62344,70588,-8244,-11.68,1170
2021-03-05,60673,71948,-11275,-15.67,1170
2021-03-06,45102,58990,-13888,-23.54,1170
2021-03-07,35968,51315,-15347,-29.91,1170
2021-03-08,60198,68305,-8107,-11.87,1170
2021-03-09,62344,71095,-8751,-12.31,1170
2021-03-10,62344,71174,-8830,-12.41,1170
2021-03-11,62344,71274,-8930,-12.53,1170
2021-03-12,60673,72549,-11876,-16.37,1170
2021-03-13,45102,59502,-14400,-24.2,1170
2021-03-14,35968,51734,-15766,-30.48,1170
2021-03-15,60198,68628,-8430,-12.28,1170
2021-03-16,62344,71324,-8980,-12.59,1170
2021-03-17,62344,71310,-8966,-12.57,1170
2021-03-18,62344,71321,-8977,-12.59,1170
2021-03-19,60673,72514,-11841,-16.33,1170
2021-03-20,45102,59389,-14287,-24.06,1170
2021-03-21,35968,51552,-15584,-30.23,1170
2021-03-22,60198,68385,-8187,-11.97,1170
2021-03-23,62344,71030,-8686,-12.23,1170
2021-03-24,62344,70974,-8630,-12.16,1170
2021-03-25,62344,70953,-8609,-12.13,1170
2021-03-26,60673,72122,-11449,-15.87,1170
2021-03-27,45102,58983,-13881,-23.53,1170
2021-03-28,35968,51140,-15172,-29.67,1170
2021-03-29,60198,67976,-7778,-11.44,1170
2021-03-30,62344,70628,-8284,-11.73,1170
2021-03-31,62344,70586,-8242,-11.68,1170
2021-04-01,58923,70582,-11659,-16.52,1170
2021-04-02,56551,71773,-15222,-21.21,1170
2021-04-03,38728,58657,-19929,-33.98,1170
2021-04-04,33590,50839,-17249,-33.93,1170
2021-04-05,59065,67699,-8634,-12.75,1170
2021-04-06,58923,70376,-11453,-16.27,1170
2021-04-07,58923,70356,-11433,-16.25,1170
2021-04-08,58923,70374,-11451,-16.27,1170
2021-04-09,56551,71583,-15032,-21.0,1170
2021-04-10,38728,58484,-19756,-33.78,1170
2021-04-11,33590,50680,-17090,-33.72,1170
2021-04-12,59065,67552,-8487,-12.56,1170
2021-04-13,58923,70238,-11315,-16.11,1170
2021-04-14,58923,70227,-11304,-16.1,1170
2021-04-15,58923,70252,-11329,-16.13,1170
2021-04-16,56551,71468,-14917,-20.87,1170
2021-04-17,38728,58375,-19647,-33.66,1170
2021-04-18,33590,50577,-16987,-33.59,1170
2021-04-19,59065,67456,-8391,-12.44,1170
2021-04-20,58923,70152,-11229,-16.01,1170
2021-04-21,58923,70151,-11228,-16.01,1170
2021-04-22,58923,70188,-11265,-16.05,1170
2021-04-23,56551,71419,-14868,-20.82,1170
2021-04-24,38728,58342,-19614,-33.62,1170
2021-04-25,33590,50564,-16974,-33.57,1170
2021-04-26,59065,67463,-8398,-12.45,1170
2021-04-27,58923,70181,-11258,-16.04,1170
2021-04-28,58923,70203,-11280,-16.07,1170
2021-04-29,58923,70263,-11340,-16.14,1170
2021-04-30,56551,71515,-14964,-20.92,1170
2021-05-01,52530,58460,-5930,-10.14,1170
2021-05-02,41410,50700,-9290,-18.32,1170
2021-05-03,63078,67616,-4538,-6.71,1170
2021-05-04,65355,70346,-4991,-7.09,1170
2021-05-05,65355,70377,-5022,-7.14,1170
2021-05-06,65355,70441,-5086,-7.22,1170
2021-05-07,65106,71692,-6586,-9.19,1170
2021-05-08,52530,58630,-6100,-10.4,1170
2021-05-09,41410,50859,-9449,-18.58,1170
2021-05-10,63078,67758,-4680,-6.91,1170
2021-05-11,65355,70466,-5111,-7.25,1170
2021-05-12,65355,70471,-5116,-7.26,1170
2021-05-13,65355,70505,-5150,-7.3,1170
2021-05-14,65106,71725,-6619,-9.23,1170
2021-05-15,52530,58631,-6101,-10.41,1170
2021-05-16,41410,50826,-9416,-18.53,1170
2021-05-17,63078,67693,-4615,-6.82,1170
2021-05-18,65355,70373,-5018,-7.13,1170
2021-05-19,65355,70353,-4998,-7.1,1170
2021-05-20,65355,70368,-5013,-7.12,1170
2021-05-21,65106,71575,-6469,-9.04,1170
2021-05-22,52530,58475,-5945,-10.17,1170
2021-05-23,41410,50674,-9264,-18.28,1170
2021-05-24,63078,67554,-4476,-6.63,1170
2021-05-25,65355,70255,-4900,-6.97,1170
2021-05-26,65355,70267,-4912,-6.99,1170
2021-05-27,65355,70324,-4969,-7.07,1170
2021-05-28,65106,71581,-6475,-9.05,1170
2021-05-29,52530,58540,-6010,-10.27,1170
2021-05-30,41410,50805,-9395,-18.49,1170
2021-05-31,63078,67756,-4678,-6.9,1170
2021-06-01,69099,70532,-1433,-2.03,1170
2021-06-02,69099,70619,-1520,-2.15,1170
2021-06-03,69099,70751,-1652,-2.33,1170
2021-06-04,69686,72080,-2394,-3.32,1170
2021-06-05,59008,59106,-98,-0.17,1170
2021-06-06,50857,51428,-571,-1.11,1170
2021-06-07,65780,68426,-2646,-3.87,1170
2021-06-08,69099,71237,-2138,-3.0,1170
2021-06-09,69099,71344,-2245,-3.15,1170
2021-06-10,69099,71478,-2379,-3.33,1170
2021-06-11,69686,72792,-3106,-4.27,1170
2021-06-12,59008,59781,-773,-1.29,1170
2021-06-13,50857,52048,-1191,-2.29,1170
2021-06-14,65780,68970,-3190,-4.63,1170
2021-06-15,69099,71685,-2586,-3.61,1170
2021-06-16,69099,71676,-2577,-3.6,1170
2021-06-17,69099,71677,-2578,-3.6,1170
2021-06-18,69686,72840,-3154,-4.33,1170
2021-06-19,59008,59666,-658,-1.1,1170
2021-06-20,50857,51757,-900,-1.74,1170
2021-06-21,65780,68495,-2715,-3.96,1170
2021-06-22,69099,71020,-1921,-2.7,1170
2021-06-23,69099,70821,-1722,-2.43,1170
2021-06-24,69099,70633,-1534,-2.17,1170
2021-06-25,69686,71614,-1928,-2.69,1170
2021-06-26,59008,58267,741,1.27,1170
2021-06-27,50857,50199,658,1.31,1170
2021-06-28,65780,66794,-1014,-1.52,1170
2021-06-29,69099,69196,-97,-0.14,1170
2021-06-30,69099,68896,203,0.29,1170
2021-07-01,62004,68632,-6628,-9.66,1170
2021-07-02,63405,69564,-6159,-8.85,1170
2021-07-03,52871,56194,-3323,-5.91,1170
2021-07-04,43766,48131,-4365,-9.07,1170
2021-07-05,59189,64759,-5570,-8.6,1170
2021-07-06,62004,67221,-5217,-7.76,1170
2021-07-07,62004,67006,-5002,-7.47,1170
2021-07-08,62004,66850,-4846,-7.25,1170
2021-07-09,63405,67909,-4504,-6.63,1170
2021-07-10,52871,54685,-1814,-3.32,1170
2021-07-11,43766,46782,-3016,-6.45,1170
2021-07-12,59189,63580,-4391,-6.91,1170
2021-07-13,62004,66217,-4213,-6.36,1170
2021-07-14,62004,66179,-4175,-6.31,1170
2021-07-15,62004,66197,-4193,-6.33,1170
2021-07-16,63405,67424,-4019,-5.96,1170
2021-07-17,52871,54356,-1485,-2.73,1170
2021-07-18,43766,46594,-2828,-6.07,1170
2021-07-19,59189,63516,-4327,-6.81,1170
2021-07-20,62004,66255,-4251,-6.42,1170
2021-07-21,62004,66297,-4293,-6.48,1170
2021-07-22,62004,66369,-4365,-6.58,1170
2021-07-23,63405,67625,-4220,-6.24,1170
2021-07-24,52871,54559,-1688,-3.09,1170
2021-07-25,43766,46774,-3008,-6.43,1170
2021-07-26,59189,63648,-4459,-7.01,1170
2021-07-27,62004,66317,-4313,-6.5,1170
2021-07-28,62004,66267,-4263,-6.43,1170
2021-07-29,62004,66232,-4228,-6.38,1170
2021-07-30,63405,67365,-3960,-5.88,1170
2021-07-31,52871,54168,-1297,-2.39,1170
2021-08-01,41732,46246,-4514,-9.76,1170
2021-08-02,57076,62981,-5905,-9.38,1170
2021-08-03,58462,65515,-7053,-10.77,1170
2021-08-04,58462,65339,-6877,-10.53,1170
2021-08-05,58462,65190,-6728,-10.32,1170
2021-08-06,58848,66226,-7378,-11.14,1170
2021-08-07,49498,52951,-3453,-6.52,1170
2021-08-08,41732,44975,-3243,-7.21,1170
2021-08-09,57076,61683,-4607,-7.47,1170
2021-08-10,58462,64218,-5756,-8.96,1170
2021-08-11,58462,64072,-5610,-8.76,1170
2021-08-12,58462,63983,-5521,-8.63,1170
2021-08-13,58848,65110,-6262,-9.62,1170
2021-08-14,49498,51956,-2458,-4.73,1170
2021-08-15,41732,44129,-2397,-5.43,1170
2021-08-16,57076,61010,-3934,-6.45,1170
2021-08-17,58462,63742,-5280,-8.28,1170
2021-08-18,58462,63812,-5350,-8.38,1170
2021-08-19,58462,63954,-5492,-8.59,1170
2021-08-20,58848,65322,-6474,-9.91,1170
2021-08-21,49498,52417,-2919,-5.57,1170
2021-08-22,41732,44838,-3106,-6.93,1170
2021-08-23,57076,61966,-4890,-7.89,1170
2021-08-24,58462,64935,-6473,-9.97,1170
2021-08-25,58462,65229,-6767,-10.37,1170
2021-08-26,58462,65579,-7117,-10.85,1170
2021-08-27,58848,67134,-8286,-12.34,1170
2021-08-28,49498,54390,-4892,-8.99,1170
2021-08-29,41732,46946,-5214,-11.11,1170
2021-08-30,57076,64179,-7103,-11.07,1170
2021-08-31,58462,67222,-8760,-13.03,1170
2021-09-01,63843,67559,-3716,-5.5,1170
2021-09-02,63843,67919,-4076,-6.0,1170
2021-09-03,66497,69453,-2956,-4.26,1170
2021-09-04,56786,56658,128,0.23,1170
2021-09-05,46369,49135,-2766,-5.63,1170
2021-09-06,61195,66262,-5067,-7.65,1170
2021-09-07,63843,69178,-5335,-7.71,1170
2021-09-08,63843,69368,-5525,-7.96,1170
2021-09-09,63843,69566,-5723,-8.23,1170
2021-09-10,66497,70927,-4430,-6.25,1170
2021-09-11,56786,57951,-1165,-2.01,1170
2021-09-12,46369,50245,-3876,-7.71,1170
2021-09-13,61195,67190,-5995,-8.92,1170
2021-09-14,63843,69928,-6085,-8.7,1170
2021-09-15,63843,69949,-6106,-8.73,1170
2021-09-16,63843,69989,-6146,-8.78,1170
2021-09-17,66497,71207,-4710,-6.61,1170
2021-09-18,56786,58105,-1319,-2.27,1170
2021-09-19,46369,50291,-3922,-7.8,1170
2021-09-20,61195,67148,-5953,-8.87,1170
2021-09-21,63843,69818,-5975,-8.56,1170
2021-09-22,63843,69791,-5948,-8.52,1170
2021-09-23,63843,69804,-5961,-8.54,1170
2021-09-24,66497,71012,-4515,-6.36,1170
2021-09-25,56786,57918,-1132,-1.95,1170
2021-09-26,46369,50126,-3757,-7.5,1170
2021-09-27,61195,67019,-5824,-8.69,1170
2021-09-28,63843,69735,-5892,-8.45,1170
2021-09-29,63843,69762,-5919,-8.48,1170
2021-09-30,63843,69833,-5990,-8.58,1170
2021-10-01,72807,71103,1704,2.4,1170
2021-10-02,66806,58069,8737,15.05,1170
2021-10-03,54018,50334,3684,7.32,1170
2021-10-04,64940,67278,-2338,-3.48,1170
2021-10-05,70198,70039,159,0.23,1170
2021-10-06,70198,70102,96,0.14,1170
2021-10-07,70198,70198,0,0.0,1170
2021-10-08,72807,71481,1326,1.86,1170
2021-10-09,66806,58450,8356,14.3,1170
2021-10-10,54018,50707,3311,6.53,1170
2021-10-11,64940,67632,-2692,-3.98,1170
2021-10-12,70198,70364,-166,-0.24,1170
2021-10-13,70198,70389,-191,-0.27,1170
2021-10-14,70198,70440,-242,-0.34,1170
2021-10-15,72807,71673,1134,1.58,1170
2021-10-16,66806,58589,8217,14.02,1170
2021-10-17,54018,50791,3227,6.35,1170
2021-10-18,64940,67662,-2722,-4.02,1170
2021-10-19,70198,70343,-145,-0.21,1170
2021-10-20,70198,70321,-123,-0.17,1170
2021-10-21,70198,70333,-135,-0.19,1170
2021-10-22,72807,71534,1273,1.78,1170
2021-10-23,66806,58427,8379,14.34,1170
2021-10-24,54018,50617,3401,6.72,1170
2021-10-25,64940,67487,-2547,-3.77,1170
2021-10-26,70198,70176,22,0.03,1170
2021-10-27,70198,70175,23,0.03,1170
2021-10-28,70198,70216,-18,-0.03,1170
2021-10-29,72807,71456,1351,1.89,1170
2021-10-30,66806,58395,8411,14.4,1170
2021-10-31,54018,50637,3381,6.68,1170
2021-11-01,60674,67563,-6889,-10.2,1170
2021-11-02,65605,70311,-4706,-6.69,1170
2021-11-03,65605,70368,-4763,-6.77,1170
2021-11-04,65605,70465,-4860,-6.9,1170
2021-11-05,68482,71756,-3274,-4.56,1170
2021-11-06,58323,58741,-418,-0.71,1170
2021-11-07,49309,51019,-1710,-3.35,1170
2021-11-08,60674,67972,-7298,-10.74,1170
2021-11-09,65605,70735,-5130,-7.25,1170
2021-11-10,65605,70794,-5189,-7.33,1170
2021-11-11,65605,70881,-5276,-7.44,1170
2021-11-12,68482,72149,-3667,-5.08,1170
2021-11-13,58323,59097,-774,-1.31,1170
2021-11-14,49309,51326,-2017,-3.93,1170
2021-11-15,60674,68218,-7544,-11.06,1170
2021-11-16,65605,70910,-5305,-7.48,1170
2021-11-17,65605,70890,-5285,-7.46,1170
2021-11-18,65605,70891,-5286,-7.46,1170
2021-11-19,68482,72069,-3587,-4.98,1170
2021-11-20,58323,58925,-602,-1.02,1170
2021-11-21,49309,51063,-1754,-3.43,1170
2021-11-22,60674,67866,-7192,-10.6,1170
2021-11-23,65605,70475,-4870,-6.91,1170
2021-11-24,65605,70380,-4775,-6.78,1170
2021-11-25,65605,70316,-4711,-6.7,1170
2021-11-26,68482,71440,-2958,-4.14,1170
2021-11-27,58323,58255,68,0.12,1170
2021-11-28,49309,50366,-1057,-2.1,1170
2021-11-29,60674,67158,-6484,-9.65,1170
2021-11-30,65605,69771,-4166,-5.97,1170
2021-12-01,60342,69693,-9351,-13.42,1170
2021-12-02,60342,69661,-9319,-13.38,1170
2021-12-03,57823,70830,-13007,-18.36,1170
2021-12-04,50392,57700,-7308,-12.67,1170
2021-12-05,42206,49877,-7671,-15.38,1170
2021-12-06,59675,66740,-7065,-10.59,1170
2021-12-07,60342,69428,-9086,-13.09,1170
2021-12-08,60342,69428,-9086,-13.09,1170
2021-12-09,60342,69471,-9129,-13.14,1170
2021-12-10,57823,70711,-12888,-18.23,1170
2021-12-11,50392,57644,-7252,-12.58,1170
2021-12-12,42206,49874,-7668,-15.37,1170
2021-12-13,59675,66777,-7102,-10.64,1170
2021-12-14,60342,69491,-9149,-13.17,1170
2021-12-15,60342,69499,-9157,-13.18,1170
2021-12-16,60342,69532,-9190,-13.22,1170
2021-12-17,57823,70743,-12920,-18.26,1170
2021-12-18,50392,57628,-7236,-12.56,1170
2021-12-19,42206,49789,-7583,-15.23,1170
2021-12-20,59675,66606,-6931,-10.41,1170
2021-12-21,60342,69215,-8873,-12.82,1170
2021-12-22,60342,69103,-8761,-12.68,1170
2021-12-23,60342,69002,-8660,-12.55,1170
2021-12-24,57823,70068,-12245,-17.48,1170
2021-12-25,50392,56800,-6408,-11.28,1170
2021-12-26,42206,48805,-6599,-13.52,1170
2021-12-27,59675,65463,-5788,-8.84,1170
2021-12-28,60342,67917,-7575,-11.15,1170
2021-12-29,60342,67656,-7314,-10.81,1170
2021-12-30,60342,67417,-7075,-10.49,1170
2021-12-31,57823,68359,-10536,-15.41,1170
2022-01-01,54852,54984,-132,-0.24,1170
2022-01-02,39712,46900,-7188,-15.33,1170
2022-01-03,55948,63494,-7546,-11.88,1170
2022-01-04,59732,65907,-6175,-9.37,1170
2022-01-05,59732,65632,-5900,-8.99,1170
2022-01-06,59732,65405,-5673,-8.67,1170
2022-01-07,61704,66386,-4682,-7.05,1170
2022-01-08,54852,53078,1774,3.34,1170
2022-01-09,39712,45088,-5376,-11.92,1170
2022-01-10,55948,61799,-5851,-9.47,1170
2022-01-11,59732,64352,-4620,-7.18,1170
2022-01-12,59732,64237,-4505,-7.01,1170
2022-01-13,59732,64187,-4455,-6.94,1170
2022-01-14,61704,65359,-3655,-5.59,1170
2022-01-15,54852,52252,2600,4.98,1170
2022-01-16,39712,44469,-4757,-10.7,1170
2022-01-17,55948,61390,-5442,-8.86,1170
2022-01-18,59732,64151,-4419,-6.89,1170
2022-01-19,59732,64239,-4507,-7.02,1170
2022-01-20,59732,64384,-4652,-7.23,1170
2022-01-21,61704,65738,-4034,-6.14,1170
2022-01-22,54852,52797,2055,3.89,1170
2022-01-23,39712,45163,-5451,-12.07,1170
2022-01-24,55948,62213,-6265,-10.07,1170
2022-01-25,59732,65082,-5350,-8.22,1170
2022-01-26,59732,65255,-5523,-8.46,1170
2022-01-27,59732,65462,-5730,-8.75,1170
2022-01-28,61704,66854,-5150,-7.7,1170
2022-01-29,54852,53931,921,1.71,1170
2022-01-30,39712,46292,-6580,-14.21,1170
2020-02-01,18253,17115,1138,6.65,1177
2020-02-02,16246,13887,2359,16.99,1177
2020-02-03,23660,23427,233,0.99,1177
2020-02-04,24454,24343,111,0.46,1177
2020-02-05,24454,24296,158,0.65,1177
2020-02-06,24454,24235,219,0.9,1177
2020-02-07,24421,24078,343,1.42,1177
2020-02-08,18253,16765,1488,8.88,1177
2020-02-09,16246,13543,2703,19.96,1177
2020-02-10,23660,23102,558,2.42,1177
2020-02-11,24454,24051,403,1.68,1177
2020-02-12,24454,24050,404,1.68,1177
2020-02-13,24454,24047,407,1.69,1177
2020-02-14,24421,23961,460,1.92,1177
2020-02-15,18253,16731,1522,9.1,1177
2020-02-16,16246,13600,2646,19.46,1177
2020-02-17,23660,23260,400,1.72,1177
2020-02-18,24454,24315,139,0.57,1177
2020-02-19,24454,24425,29,0.12,1177
2020-02-20,24454,24535,-81,-0.33,1177
2020-02-21,24421,24561,-140,-0.57,1177
2020-02-22,18253,17440,813,4.66,1177
2020-02-23,16246,14416,1830,12.69,1177
2020-02-24,23660,24174,-514,-2.13,1177
2020-02-25,24454,25318,-864,-3.41,1177
2020-02-26,24454,25507,-1053,-4.13,1177
2020-02-27,24454,25683,-1229,-4.79,1177
2020-02-28,24421,25762,-1341,-5.21,1177
2020-02-29,18253,18680,-427,-2.29,1177
2020-03-01,10238,15678,-5440,-34.7,1177
2020-03-02,16744,25445,-8701,-34.2,1177
2020-03-03,17235,26582,-9347,-35.16,1177
2020-03-04,17235,26749,-9514,-35.57,1177
2020-03-05,17235,26889,-9654,-35.9,1177
2020-03-06,17335,26920,-9585,-35.61,1177
2020-03-07,11313,19778,-8465,-42.8,1177
2020-03-08,10238,16707,-6469,-38.72,1177
2020-03-09,16744,26396,-9652,-36.57,1177
2020-03-10,17235,27450,-10215,-37.21,1177
2020-03-11,17235,27530,-10295,-37.4,1177
2020-03-12,17235,27582,-10347,-37.51,1177
2020-03-13,17335,27526,-10191,-37.02,1177
2020-03-14,11313,20298,-8985,-44.27,1177
2020-03-15,10238,17147,-6909,-40.29,1177
2020-03-16,16744,26761,-10017,-37.43,1177
2020-03-17,17235,27748,-10513,-37.89,1177
2020-03-18,17235,27771,-10536,-37.94,1177
2020-03-19,17235,27775,-10540,-37.95,1177
2020-03-20,17335,27681,-10346,-37.38,1177
2020-03-21,11313,20426,-9113,-44.61,1177
2020-03-22,10238,17259,-7021,-40.68,1177
2020-03-23,16744,26868,-10124,-37.68,1177
2020-03-24,17235,27860,-10625,-38.14,1177
2020-03-25,17235,27896,-10661,-38.22,1177
2020-03-26,17235,27921,-10686,-38.27,1177
2020-03-27,17335,27855,-10520,-37.77,1177
2020-03-28,11313,20634,-9321,-45.17,1177
2020-03-29,10238,17504,-7266,-41.51,1177
2020-03-30,16744,27152,-10408,-38.33,1177
2020-03-31,17235,28184,-10949,-38.85,1177
2020-04-01,13425,28259,-14834,-52.49,1177
2020-04-02,13425,28321,-14896,-52.6,1177
2020-04-03,13101,28287,-15186,-53.69,1177
2020-04-04,9638,21094,-11456,-54.31,1177
2020-04-05,7094,17985,-10891,-60.56,1177
2020-04-06,13612,27649,-14037,-50.77,1177
2020-04-07,13425,28688,-15263,-53.2,1177
2020-04-08,13425,28764,-15339,-53.33,1177
2020-04-09,13425,28819,-15394,-53.42,1177
2020-04-10,13101,28772,-15671,-54.47,1177
2020-04-11,9638,21560,-11922,-55.3,1177
2020-04-12,7094,18426,-11332,-61.5,1177
2020-04-13,13612,28059,-14447,-51.49,1177
2020-04-14,13425,29065,-15640,-53.81,1177
2020-04-15,13425,29105,-15680,-53.87,1177
2020-04-16,13425,29123,-15698,-53.9,1177
2020-04-17,13101,29040,-15939,-54.89,1177
2020-04-18,9638,21792,-12154,-55.77,1177
2020-04-19,7094,18625,-11531,-61.91,1177
2020-04-20,13612,28230,-14618,-51.78,1177
2020-04-21,13425,29212,-15787,-54.04,1177
2020-04-22,13425,29234,-15809,-54.08,1177
2020-04-23,13425,29240,-15815,-54.09,1177
2020-04-24,13101,29151,-16050,-55.06,1177
2020-04-25,9638,21904,-12266,-56.0,1177
2020-04-26,7094,18745,-11651,-62.16,1177
2020-04-27,13612,28364,-14752,-52.01,1177
2020-04-28,13425,29365,-15940,-54.28,1177
2020-04-29,13425,29410,-15985,-54.35,1177
2020-04-30,13425,29444,-16019,-54.4,1177
2020-05-01,19824,29385,-9561,-32.54,1177
2020-05-02,15164,22170,-7006,-31.6,1177
2020-05-03,11585,19043,-7458,-39.16,1177
2020-05-04,19400,28692,-9292,-32.39,1177
2020-05-05,20564,29722,-9158,-30.81,1177
2020-05-06,20564,29791,-9227,-30.97,1177
2020-05-07,20564,29845,-9281,-31.1,1177
2020-05-08,19824,29799,-9975,-33.47,1177
2020-05-09,15164,22591,-7427,-32.88,1177
2020-05-10,11585,19463,-7878,-40.48,1177
2020-05-11,19400,29104,-9704,-33.34,1177
2020-05-12,20564,30117,-9553,-31.72,1177
2020-05-13,20564,30163,-9599,-31.82,1177
2020-05-14,20564,30185,-9621,-31.87,1177
2020-05-15,19824,30101,-10277,-34.14,1177
2020-05-16,15164,22849,-7685,-33.63,1177
2020-05-17,11585,19672,-8087,-41.11,1177
2020-05-18,19400,29260,-9860,-33.7,1177
2020-05-19,20564,30219,-9655,-31.95,1177
2020-05-20,20564,30209,-9645,-31.93,1177
2020-05-21,20564,30177,-9613,-31.86,1177
2020-05-22,19824,30041,-10217,-34.01,1177
2020-05-23,15164,22740,-7576,-33.32,1177
2020-05-24,11585,19521,-7936,-40.65,1177
2020-05-25,19400,29072,-9672,-33.27,1177
2020-05-26,20564,30002,-9438,-31.46,1177
2020-05-27,20564,29971,-9407,-31.39,1177
2020-05-28,20564,29927,-9363,-31.29,1177
2020-05-29,19824,29789,-9965,-33.45,1177
2020-05-30,15164,22495,-7331,-32.59,1177
2020-05-31,11585,19290,-7705,-39.94,1177
2020-06-01,22890,28866,-5976,-20.7,1177
2020-06-02,24342,29826,-5484,-18.39,1177
2020-06-03,24342,29833,-5491,-18.41,1177
2020-06-04,24342,29831,-5489,-18.4,1177
2020-06-05,22785,29738,-6953,-23.38,1177
2020-06-06,18245,22490,-4245,-18.88,1177
2020-06-07,14356,19332,-4976,-25.74,1177
2020-06-08,22890,28951,-6061,-20.94,1177
2020-06-09,24342,29951,-5609,-18.73,1177
2020-06-10,24342,29991,-5649,-18.84,1177
2020-06-11,24342,30015,-5673,-18.9,1177
2020-06-12,22785,29938,-7153,-23.89,1177
2020-06-13,18245,22695,-4450,-19.61,1177
2020-06-14,14356,19531,-5175,-26.5,1177
2020-06-15,22890,29132,-6242,-21.43,1177
2020-06-16,24342,30100,-5758,-19.13,1177
2020-06-17,24342,30095,-5753,-19.12,1177
2020-06-18,24342,30062,-5720,-19.03,1177
2020-06-19,22785,29915,-7130,-23.83,1177
2020-06-20,18245,22593,-4348,-19.24,1177
2020-06-21,14356,19339,-4983,-25.77,1177
2020-06-22,22890,28842,-5952,-20.64,1177
2020-06-23,24342,29707,-5365,-18.06,1177
2020-06-24,24342,29595,-5253,-17.75,1177
2020-06-25,24342,29453,-5111,-17.35,1177
2020-06-26,22785,29200,-6415,-21.97,1177
2020-06-27,18245,21774,-3529,-16.21,1177
2020-06-28,14356,18422,-4066,-22.07,1177
2020-06-29,22890,27837,-4947,-17.77,1177
2020-06-30,24342,28623,-4281,-14.96,1177
2020-07-01,25070,28446,-3376,-11.87,1177
2020-07-02,25070,28253,-3183,-11.27,1177
2020-07-03,24490,27963,-3473,-12.42,1177
2020-07-04,18681,20519,-1838,-8.96,1177
2020-07-05,16727,17165,-438,-2.55,1177
2020-07-06,23587,26595,-3008,-11.31,1177
2020-07-07,25070,27415,-2345,-8.55,1177
2020-07-08,25070,27288,-2218,-8.13,1177
2020-07-09,25070,27159,-2089,-7.69,1177
2020-07-10,24490,26949,-2459,-9.12,1177
2020-07-11,18681,19596,-915,-4.67,1177
2020-07-12,16727,16344,383,2.34,1177
2020-07-13,23587,25883,-2296,-8.87,1177
2020-07-14,25070,26817,-1747,-6.51,1177
2020-07-15,25070,26806,-1736,-6.48,1177
2020-07-16,25070,26794,-1724,-6.43,1177
2020-07-17,24490,26697,-2207,-8.27,1177
2020-07-18,18681,19451,-770,-3.96,1177
2020-07-19,16727,16298,429,2.63,1177
2020-07-20,23587,25926,-2339,-9.02,1177
2020-07-21,25070,26936,-1866,-6.93,1177
2020-07-22,25070,26988,-1918,-7.11,1177
2020-07-23,25070,27022,-1952,-7.22,1177
2020-07-24,24490,26957,-2467,-9.15,1177
2020-07-25,18681,19725,-1044,-5.29,1177
2020-07-26,16727,16571,156,0.94,1177
2020-07-27,23587,26182,-2595,-9.91,1177
2020-07-28,25070,27160,-2090,-7.7,1177
2020-07-29,25070,27166,-2096,-7.72,1177
2020-07-30,25070,27145,-2075,-7.64,1177
2020-07-31,24490,27013,-2523,-9.34,1177
2020-08-01,20584,19708,876,4.44,1177
2020-08-02,16552,16476,76,0.46,1177
2020-08-03,23259,26006,-2747,-10.56,1177
2020-08-04,24588,26906,-2318,-8.62,1177
2020-08-05,24588,26837,-2249,-8.38,1177
2020-08-06,24588,26745,-2157,-8.07,1177
2020-08-07,24343,26553,-2210,-8.32,1177
2020-08-08,20584,19198,1386,7.22,1177
2020-08-09,16552,15929,623,3.91,1177
2020-08-10,23259,25437,-2178,-8.56,1177
2020-08-11,24588,26329,-1741,-6.61,1177
2020-08-12,24588,26268,-1680,-6.4,1177
2020-08-13,24588,26203,-1615,-6.16,1177
2020-08-14,24343,26052,-1709,-6.56,1177
2020-08-15,20584,18755,1829,9.75,1177
2020-08-16,16552,15559,993,6.38,1177
2020-08-17,23259,25153,-1894,-7.53,1177
2020-08-18,24588,26143,-1555,-5.95,1177
2020-08-19,24588,26190,-1602,-6.12,1177
2020-08-20,24588,26239,-1651,-6.29,1177
2020-08-21,24343,26207,-1864,-7.11,1177
2020-08-22,20584,19032,1552,8.15,1177
2020-08-23,16552,15955,597,3.74,1177
2020-08-24,23259,25666,-2407,-9.38,1177
2020-08-25,24588,26767,-2179,-8.14,1177
2020-08-26,24588,26916,-2328,-8.65,1177
2020-08-27,24588,27056,-2468,-9.12,1177
2020-08-28,24343,27102,-2759,-10.18,1177
2020-08-29,20584,19990,594,2.97,1177
2020-08-30,16552,16961,-409,-2.41,1177
2020-08-31,23259,26702,-3443,-12.89,1177
2020-09-01,25116,27816,-2700,-9.71,1177
2020-09-02,25116,27961,-2845,-10.17,1177
2020-09-03,25116,28080,-2964,-10.56,1177
2020-09-04,24312,28090,-3778,-13.45,1177
2020-09-05,20082,20925,-843,-4.03,1177
2020-09-06,16302,17832,-1530,-8.58,1177
2020-09-07,23426,27497,-4071,-14.81,1177
2020-09-08,25116,28525,-3409,-11.95,1177
2020-09-09,25116,28578,-3462,-12.11,1177
2020-09-10,25116,28600,-3484,-12.18,1177
2020-09-11,24312,28511,-4199,-14.73,1177
2020-09-12,20082,21249,-1167,-5.49,1177
2020-09-13,16302,18060,-1758,-9.73,1177
2020-09-14,23426,27634,-4208,-15.23,1177
2020-09-15,25116,28580,-3464,-12.12,1177
2020-09-16,25116,28558,-3442,-12.05,1177
2020-09-17,25116,28517,-3401,-11.93,1177
2020-09-18,24312,28375,-4063,-14.32,1177
2020-09-19,20082,21073,-991,-4.7,1177
2020-09-20,16302,17858,-1556,-8.71,1177
2020-09-21,23426,27419,-3993,-14.56,1177
2020-09-22,25116,28362,-3246,-11.44,1177
2020-09-23,25116,28352,-3236,-11.41,1177
2020-09-24,25116,28332,-3216,-11.35,1177
2020-09-25,24312,28222,-3910,-13.85,1177
2020-09-26,20082,20959,-877,-4.18,1177
2020-09-27,16302,17789,-1487,-8.36,1177
2020-09-28,23426,27399,-3973,-14.5,1177
2020-09-29,25116,28396,-3280,-11.55,1177
2020-09-30,25116,28437,-3321,-11.68,1177
2020-10-01,24712,28469,-3757,-13.2,1177
2020-10-02,23841,28406,-4565,-16.07,1177
2020-10-03,17691,21186,-3495,-16.5,1177
2020-10-04,14377,18051,-3674,-20.35,1177
2020-10-05,23645,27689,-4044,-14.61,1177
2020-10-06,24712,28704,-3992,-13.91,1177
2020-10-07,24712,28754,-4042,-14.06,1177
2020-10-08,24712,28784,-4072,-14.15,1177
2020-10-09,23841,28710,-4869,-16.96,1177
2020-10-10,17691,21468,-3777,-17.59,1177
2020-10-11,14377,18302,-3925,-21.45,1177
2020-10-12,23645,27901,-4256,-15.25,1177
2020-10-13,24712,28868,-4156,-14.4,1177
2020-10-14,24712,28866,-4154,-14.39,1177
2020-10-15,24712,28838,-4126,-14.31,1177
2020-10-16,23841,28703,-4862,-16.94,1177
2020-10-17,17691,21399,-3708,-17.33,1177
2020-10-18,14377,18172,-3795,-20.88,1177
2020-10-19,23645,27712,-4067,-14.68,1177
2020-10-20,24712,28625,-3913,-13.67,1177
2020-10-21,24712,28572,-3860,-13.51,1177
2020-10-22,24712,28501,-3789,-13.29,1177
2020-10-23,23841,28331,-4490,-15.85,1177
2020-10-24,17691,21001,-3310,-15.76,1177
2020-10-25,14377,17756,-3379,-19.03,1177
2020-10-26,23645,27288,-3643,-13.35,1177
2020-10-27,24712,28202,-3490,-12.38,1177
2020-10-28,24712,28160,-3448,-12.24,1177
2020-10-29,24712,28107,-3395,-12.08,1177
2020-10-30,23841,27964,-4123,-14.74,1177
2020-10-31,17691,20666,-2975,-14.4,1177
2020-11-01,10645,17459,-6814,-39.03,1177
2020-11-02,20096,27033,-6937,-25.66,1177
2020-11-03,18136,27990,-9854,-35.21,1177
2020-11-04,18136,27993,-9857,-35.21,1177
2020-11-05,18136,27984,-9848,-35.19,1177
2020-11-06,18463,27881,-9418,-33.78,1177
2020-11-07,12898,20620,-7722,-37.45,1177
2020-11-08,10645,17444,-6799,-38.98,1177
2020-11-09,20096,27041,-6945,-25.68,1177
2020-11-10,18136,28015,-9879,-35.26,1177
2020-11-11,18136,28025,-9889,-35.29,1177
2020-11-12,18136,28015,-9879,-35.26,1177
2020-11-13,18463,27901,-9438,-33.83,1177
2020-11-14,12898,20620,-7722,-37.45,1177
2020-11-15,10645,17416,-6771,-38.88,1177
2020-11-16,20096,26977,-6881,-25.51,1177
2020-11-17,18136,27907,-9771,-35.01,1177
2020-11-18,18136,27867,-9731,-34.92,1177
2020-11-19,18136,27802,-9666,-34.77,1177
2020-11-20,18463,27631,-9168,-33.18,1177
2020-11-21,12898,20290,-7392,-36.43,1177
2020-11-22,10645,17027,-6382,-37.48,1177
2020-11-23,20096,26530,-6434,-24.25,1177
2020-11-24,18136,27405,-9269,-33.82,1177
2020-11-25,18136,27315,-9179,-33.6,1177
2020-11-26,18136,27206,-9070,-33.34,1177
2020-11-27,18463,26998,-8535,-31.61,1177
2020-11-28,12898,19629,-6731,-34.29,1177
2020-11-29,10645,16345,-5700,-34.87,1177
2020-11-30,20096,25838,-5742,-22.22,1177
2020-12-01,18738,26712,-7974,-29.85,1177
2020-12-02,18738,26631,-7893,-29.64,1177
2020-12-03,18738,26540,-7802,-29.4,1177
2020-12-04,20769,26358,-5589,-21.2,1177
2020-12-05,14820,19023,-4203,-22.09,1177
2020-12-06,10924,15780,-4856,-30.77,1177
2020-12-07,18540,25318,-6778,-26.77,1177
2020-12-08,18738,26242,-7504,-28.6,1177
2020-12-09,18738,26213,-7475,-28.52,1177
2020-12-10,18738,26175,-7437,-28.41,1177
2020-12-11,20769,26045,-5276,-20.26,1177
2020-12-12,14820,18760,-3940,-21.0,1177
2020-12-13,10924,15563,-4639,-29.81,1177
2020-12-14,18540,25142,-6602,-26.26,1177
2020-12-15,18738,26101,-7363,-28.21,1177
2020-12-16,18738,26100,-7362,-28.21,1177
2020-12-17,18738,26081,-7343,-28.15,1177
2020-12-18,20769,25963,-5194,-20.01,1177
2020-12-19,14820,18681,-3861,-20.67,1177
2020-12-20,10924,15479,-4555,-29.43,1177
2020-12-21,18540,25045,-6505,-25.97,1177
2020-12-22,18738,25984,-7246,-27.89,1177
2020-12-23,18738,25956,-7218,-27.81,1177
2020-12-24,18738,25906,-7168,-27.67,1177
2020-12-25,20769,25752,-4983,-19.35,1177
2020-12-26,14820,18431,-3611,-19.59,1177
2020-12-27,10924,15189,-4265,-28.08,1177
2020-12-28,18540,24716,-6176,-24.99,1177
2020-12-29,18738,25617,-6879,-26.85,1177
2020-12-30,18738,25555,-6817,-26.68,1177
2020-12-31,18738,25475,-6737,-26.45,1177
2021-01-01,17464,25297,-7833,-30.96,1177
2021-01-02,12140,17959,-5819,-32.4,1177
2021-01-03,9671,14708,-5037,-34.25,1177
2021-01-04,16288,24233,-7945,-32.79,1177
2021-01-05,17119,25142,-8023,-31.91,1177
2021-01-06,17119,25096,-7977,-31.79,1177
2021-01-07,17119,25040,-7921,-31.63,1177
2021-01-08,17464,24894,-7430,-29.85,1177
2021-01-09,12140,17595,-5455,-31.0,1177
2021-01-10,9671,14389,-4718,-32.79,1177
2021-01-11,16288,23965,-7677,-32.03,1177
2021-01-12,17119,24927,-7808,-31.32,1177
2021-01-13,17119,24936,-7817,-31.35,1177
2021-01-14,17119,24936,-7817,-31.35,1177
2021-01-15,17464,24844,-7380,-29.71,1177
2021-01-16,12140,17597,-5457,-31.01,1177
2021-01-17,9671,14438,-4767,-33.02,1177
2021-01-18,16288,24055,-7767,-32.29,1177
2021-01-19,17119,25051,-7932,-31.66,1177
2021-01-20,17119,25086,-7967,-31.76,1177
2021-01-21,17119,25103,-7984,-31.8,1177
2021-01-22,17464,25019,-7555,-30.2,1177
2021-01-23,12140,17770,-5630,-31.68,1177
2021-01-24,9671,14600,-4929,-33.76,1177
2021-01-25,16288,24197,-7909,-32.69,1177
2021-01-26,17119,25164,-8045,-31.97,1177
2021-01-27,17119,25163,-8044,-31.97,1177
2021-01-28,17119,25138,-8019,-31.9,1177
2021-01-29,17464,25007,-7543,-30.16,1177
2021-01-30,12140,17708,-5568,-31.44,1177
2021-01-31,9671,14487,-4816,-33.24,1177
2021-02-01,19240,24033,-4793,-19.94,1177
2021-02-02,19589,24952,-5363,-21.49,1177
2021-02-03,19589,24907,-5318,-21.35,1177
2021-02-04,19589,24845,-5256,-21.16,1177
2021-02-05,19954,24685,-4731,-19.17,1177
2021-02-06,14476,17366,-2890,-16.64,1177
2021-02-07,11993,14136,-2143,-15.16,1177
2021-02-08,19240,23686,-4446,-18.77,1177
2021-02-09,19589,24621,-5032,-20.44,1177
2021-02-10,19589,24606,-5017,-20.39,1177
2021-02-11,19589,24586,-4997,-20.32,1177
2021-02-12,19954,24482,-4528,-18.5,1177
2021-02-13,14476,17231,-2755,-15.99,1177
2021-02-14,11993,14081,-2088,-14.83,1177
2021-02-15,19240,23720,-4480,-18.89,1177
2021-02-16,19589,24754,-5165,-20.87,1177
2021-02-17,19589,24843,-5254,-21.15,1177
2021-02-18,19589,24933,-5344,-21.43,1177
2021-02-19,19954,24941,-4987,-20.0,1177
2021-02-20,14476,17803,-3327,-18.69,1177
2021-02-21,11993,14764,-2771,-18.77,1177
2021-02-22,19240,24509,-5269,-21.5,1177
2021-02-23,19589,25643,-6054,-23.61,1177
2021-02-24,19589,25825,-6236,-24.15,1177
2021-02-25,19589,25996,-6407,-24.65,1177
2021-02-26,19954,26074,-6120,-23.47,1177
2021-02-27,14476,18992,-4516,-23.78,1177
2021-02-28,11993,15995,-4002,-25.02,1177
2021-03-01,20365,25768,-5403,-20.97,1177
2021-03-02,21054,26913,-5859,-21.77,1177
2021-03-03,21054,27092,-6038,-22.29,1177
2021-03-04,21054,27245,-6191,-22.72,1177
2021-03-05,20793,27290,-6497,-23.81,1177
2021-03-06,16613,20163,-3550,-17.61,1177
2021-03-07,12462,17109,-4647,-27.16,1177
2021-03-08,20365,26814,-6449,-24.05,1177
2021-03-09,21054,27885,-6831,-24.5,1177
2021-03-10,21054,27981,-6927,-24.76,1177
2021-03-11,21054,28048,-6994,-24.94,1177
2021-03-12,20793,28006,-7213,-25.76,1177
2021-03-13,16613,20791,-4178,-20.1,1177
2021-03-14,12462,17650,-5188,-29.39,1177
2021-03-15,20365,27274,-6909,-25.33,1177
2021-03-16,21054,28268,-7214,-25.52,1177
2021-03-17,21054,28295,-7241,-25.59,1177
2021-03-18,21054,28303,-7249,-25.61,1177
2021-03-19,20793,28209,-7416,-26.29,1177
2021-03-20,16613,20954,-4341,-20.72,1177
2021-03-21,12462,17784,-5322,-29.93,1177
2021-03-22,20365,27389,-7024,-25.65,1177
2021-03-23,21054,28375,-7321,-25.8,1177
2021-03-24,21054,28405,-7351,-25.88,1177
2021-03-25,21054,28423,-7369,-25.93,1177
2021-03-26,20793,28349,-7556,-26.65,1177
2021-03-27,16613,21121,-4508,-21.34,1177
2021-03-28,12462,17983,-5521,-30.7,1177
2021-03-29,20365,27624,-7259,-26.28,1177
2021-03-30,21054,28650,-7596,-26.51,1177
2021-03-31,21054,28719,-7665,-26.69,1177
2021-04-01,19917,28777,-8860,-30.79,1177
2021-04-02,19656,28740,-9084,-31.61,1177
2021-04-03,13985,21545,-7560,-35.09,1177
2021-04-04,11896,18436,-6540,-35.47,1177
2021-04-05,20485,28101,-7616,-27.1,1177
2021-04-06,19917,29143,-9226,-31.66,1177
2021-04-07,19917,29222,-9305,-31.84,1177
2021-04-08,19917,29282,-9365,-31.98,1177
2021-04-09,19656,29241,-9585,-32.78,1177
2021-04-10,13985,22034,-8049,-36.53,1177
2021-04-11,11896,18907,-7011,-37.08,1177
2021-04-12,20485,28548,-8063,-28.24,1177
2021-04-13,19917,29561,-9644,-32.62,1177
2021-04-14,19917,29608,-9691,-32.73,1177
2021-04-15,19917,29632,-9715,-32.79,1177
2021-04-16,19656,29554,-9898,-33.49,1177
2021-04-17,13985,22311,-8326,-37.32,1177
2021-04-18,11896,19148,-7252,-37.87,1177
2021-04-19,20485,28756,-8271,-28.76,1177
2021-04-20,19917,29739,-9822,-33.03,1177
2021-04-21,19917,29760,-9843,-33.07,1177
2021-04-22,19917,29766,-9849,-33.09,1177
2021-04-23,19656,29674,-10018,-33.76,1177
2021-04-24,13985,22423,-8438,-37.63,1177
2021-04-25,11896,19260,-7364,-38.23,1177
2021-04-26,20485,28873,-8388,-29.05,1177
2021-04-27,19917,29868,-9951,-33.32,1177
2021-04-28,19917,29907,-9990,-33.4,1177
2021-04-29,19917,29935,-10018,-33.47,1177
2021-04-30,19656,29871,-10215,-34.2,1177
2021-05-01,18464,22650,-4186,-18.48,1177
2021-05-02,14073,19518,-5445,-27.9,1177
2021-05-03,25112,29163,-4051,-13.89,1177
2021-05-04,25852,30189,-4337,-14.37,1177
2021-05-05,25852,30258,-4406,-14.56,1177
2021-05-06,25852,30311,-4459,-14.71,1177
2021-05-07,24369,30267,-5898,-19.49,1177
2021-05-08,18464,23061,-4597,-19.93,1177
2021-05-09,14073,19937,-5864,-29.41,1177
2021-05-10,25112,29584,-4472,-15.12,1177
2021-05-11,25852,30604,-4752,-15.53,1177
2021-05-12,25852,30658,-4806,-15.68,1177
2021-05-13,25852,30689,-4837,-15.76,1177
2021-05-14,24369,30615,-6246,-20.4,1177
2021-05-15,18464,23373,-4909,-21.0,1177
2021-05-16,14073,20207,-6134,-30.36,1177
2021-05-17,25112,29805,-4693,-15.75,1177
2021-05-18,25852,30774,-4922,-15.99,1177
2021-05-19,25852,30773,-4921,-15.99,1177
2021-05-20,25852,30749,-4897,-15.93,1177
2021-05-21,24369,30621,-6252,-20.42,1177
2021-05-22,18464,23325,-4861,-20.84,1177
2021-05-23,14073,20110,-6037,-30.02,1177
2021-05-24,25112,29664,-4552,-15.35,1177
2021-05-25,25852,30594,-4742,-15.5,1177
2021-05-26,25852,30563,-4711,-15.41,1177
2021-05-27,25852,30516,-4664,-15.28,1177
2021-05-28,24369,30373,-6004,-19.77,1177
2021-05-29,18464,23073,-4609,-19.98,1177
2021-05-30,14073,19862,-5789,-29.15,1177
2021-05-31,25112,29429,-4317,-14.67,1177
2021-06-01,26438,30381,-3943,-12.98,1177
2021-06-02,26438,30379,-3941,-12.97,1177
2021-06-03,26438,30368,-3930,-12.94,1177
2021-06-04,25620,30266,-4646,-15.35,1177
2021-06-05,21815,23010,-1195,-5.19,1177
2021-06-06,18504,19845,-1341,-6.76,1177
2021-06-07,26291,29459,-3168,-10.75,1177
2021-06-08,26438,30456,-4018,-13.19,1177
2021-06-09,26438,30494,-4056,-13.3,1177
2021-06-10,26438,30518,-4080,-13.37,1177
2021-06-11,25620,30444,-4824,-15.85,1177
2021-06-12,21815,23207,-1392,-6.0,1177
2021-06-13,18504,20051,-1547,-7.72,1177
2021-06-14,26291,29661,-3370,-11.36,1177
2021-06-15,26438,30642,-4204,-13.72,1177
2021-06-16,26438,30652,-4214,-13.75,1177
2021-06-17,26438,30635,-4197,-13.7,1177
2021-06-18,25620,30506,-4886,-16.02,1177
2021-06-19,21815,23203,-1388,-5.98,1177
2021-06-20,18504,19969,-1465,-7.34,1177
2021-06-21,26291,29492,-3201,-10.85,1177
2021-06-22,26438,30377,-3939,-12.97,1177
2021-06-23,26438,30286,-3848,-12.71,1177
2021-06-24,26438,30162,-3724,-12.35,1177
2021-06-25,25620,29925,-4305,-14.39,1177
2021-06-26,21815,22514,-699,-3.1,1177
2021-06-27,18504,19176,-672,-3.5,1177
2021-06-28,26291,28600,-2309,-8.07,1177
2021-06-29,26438,29393,-2955,-10.05,1177
2021-06-30,26438,29220,-2782,-9.52,1177
2021-07-01,28295,29028,-733,-2.53,1177
2021-07-02,26941,28736,-1795,-6.25,1177
2021-07-03,21070,21285,-215,-1.01,1177
2021-07-04,18172,17923,249,1.39,1177
2021-07-05,26438,27341,-903,-3.3,1177
2021-07-06,28295,28147,148,0.53,1177
2021-07-07,28295,28002,293,1.05,1177
2021-07-08,28295,27855,440,1.58,1177
2021-07-09,26941,27625,-684,-2.48,1177
2021-07-10,21070,20250,820,4.05,1177
2021-07-11,18172,16977,1195,7.04,1177
2021-07-12,26438,26494,-56,-0.21,1177
2021-07-13,28295,27406,889,3.24,1177
2021-07-14,28295,27375,920,3.36,1177
2021-07-15,28295,27344,951,3.48,1177
2021-07-16,26941,27231,-290,-1.06,1177
2021-07-17,21070,19970,1100,5.51,1177
2021-07-18,18172,16806,1366,8.13,1177
2021-07-19,26438,26424,14,0.05,1177
2021-07-20,28295,27428,867,3.16,1177
2021-07-21,28295,27477,818,2.98,1177
2021-07-22,28295,27512,783,2.85,1177
2021-07-23,26941,27449,-508,-1.85,1177
2021-07-24,21070,20223,847,4.19,1177
2021-07-25,18172,17078,1094,6.41,1177
2021-07-26,26438,26699,-261,-0.98,1177
2021-07-27,28295,27690,605,2.18,1177
2021-07-28,28295,27710,585,2.11,1177
2021-07-29,28295,27703,592,2.14,1177
2021-07-30,26941,27586,-645,-2.34,1177
2021-07-31,21070,20297,773,3.81,1177
2021-08-01,17240,17079,161,0.94,1177
2021-08-02,24627,26623,-1996,-7.5,1177
2021-08-03,25801,27535,-1734,-6.3,1177
2021-08-04,25801,27475,-1674,-6.09,1177
2021-08-05,25801,27392,-1591,-5.81,1177
2021-08-06,24768,27204,-2436,-8.95,1177
2021-08-07,20530,19851,679,3.42,1177
2021-08-08,17240,16581,659,3.97,1177
2021-08-09,24627,26084,-1457,-5.59,1177
2021-08-10,25801,26969,-1168,-4.33,1177
2021-08-11,25801,26898,-1097,-4.08,1177
2021-08-12,25801,26819,-1018,-3.8,1177
2021-08-13,24768,26653,-1885,-7.07,1177
2021-08-14,20530,19338,1192,6.16,1177
2021-08-15,17240,16122,1118,6.93,1177
2021-08-16,24627,25695,-1068,-4.16,1177
2021-08-17,25801,26662,-861,-3.23,1177
2021-08-18,25801,26687,-886,-3.32,1177
2021-08-19,25801,26713,-912,-3.41,1177
2021-08-20,24768,26660,-1892,-7.1,1177
2021-08-21,20530,19463,1067,5.48,1177
2021-08-22,17240,16368,872,5.33,1177
2021-08-23,24627,26062,-1435,-5.51,1177
2021-08-24,25801,27147,-1346,-4.96,1177
2021-08-25,25801,27284,-1483,-5.44,1177
2021-08-26,25801,27415,-1614,-5.89,1177
2021-08-27,24768,27455,-2687,-9.79,1177
2021-08-28,20530,20340,190,0.93,1177
2021-08-29,17240,17312,-72,-0.42,1177
2021-08-30,24627,27057,-2430,-8.98,1177
2021-08-31,25801,28177,-2376,-8.43,1177
2021-09-01,26568,28331,-1763,-6.22,1177
2021-09-02,26568,28462,-1894,-6.65,1177
2021-09-03,26457,28486,-2029,-7.12,1177
2021-09-04,21174,21338,-164,-0.77,1177
2021-09-05,19065,18262,803,4.4,1177
2021-09-06,26166,27945,-1779,-6.37,1177
2021-09-07,26568,28992,-2424,-8.36,1177
2021-09-08,26568,29063,-2495,-8.58,1177
2021-09-09,26568,29103,-2535,-8.71,1177
2021-09-10,26457,29031,-2574,-8.87,1177
2021-09-11,21174,21784,-610,-2.8,1177
2021-09-12,19065,18609,456,2.45,1177
2021-09-13,26166,28196,-2030,-7.2,1177
2021-09-14,26568,29151,-2583,-8.86,1177
2021-09-15,26568,29137,-2569,-8.82,1177
2021-09-16,26568,29101,-2533,-8.7,1177
2021-09-17,26457,28962,-2505,-8.65,1177
2021-09-18,21174,21661,-487,-2.25,1177
2021-09-19,19065,18443,622,3.37,1177
2021-09-20,26166,28000,-1834,-6.55,1177
2021-09-21,26568,28938,-2370,-8.19,1177
2021-09-22,26568,28919,-2351,-8.13,1177
2021-09-23,26568,28891,-2323,-8.04,1177
2021-09-24,26457,28771,-2314,-8.04,1177
2021-09-25,21174,21498,-324,-1.51,1177
2021-09-26,19065,18318,747,4.08,1177
2021-09-27,26166,27919,-1753,-6.28,1177
2021-09-28,26568,28906,-2338,-8.09,1177
2021-09-29,26568,28939,-2371,-8.19,1177
2021-09-30,26568,28964,-2396,-8.27,1177
2021-10-01,26332,28895,-2563,-8.87,1177
2021-10-02,20442,21671,-1229,-5.67,1177
2021-10-03,16173,18535,-2362,-12.74,1177
2021-10-04,24460,28173,-3713,-13.18,1177
2021-10-05,26744,29190,-2446,-8.38,1177
2021-10-06,26744,29244,-2500,-8.55,1177
2021-10-07,26744,29279,-2535,-8.66,1177
2021-10-08,26332,29212,-2880,-9.86,1177
2021-10-09,20442,21979,-1537,-6.99,1177
2021-10-10,16173,18823,-2650,-14.08,1177
2021-10-11,24460,28433,-3973,-13.97,1177
2021-10-12,26744,29412,-2668,-9.07,1177
2021-10-13,26744,29421,-2677,-9.1,1177
2021-10-14,26744,29405,-2661,-9.05,1177
2021-10-15,26332,29281,-2949,-10.07,1177
2021-10-16,20442,21988,-1546,-7.03,1177
2021-10-17,16173,18770,-2597,-13.84,1177
2021-10-18,24460,28318,-3858,-13.62,1177
2021-10-19,26744,29238,-2494,-8.53,1177
2021-10-20,26744,29190,-2446,-8.38,1177
2021-10-21,26744,29123,-2379,-8.17,1177
2021-10-22,26332,28954,-2622,-9.06,1177
2021-10-23,20442,21624,-1182,-5.47,1177
2021-10-24,16173,18377,-2204,-11.99,1177
2021-10-25,24460,27906,-3446,-12.35,1177
2021-10-26,26744,28814,-2070,-7.18,1177
2021-10-27,26744,28766,-2022,-7.03,1177
2021-10-28,26744,28707,-1963,-6.84,1177
2021-10-29,26332,28555,-2223,-7.78,1177
2021-10-30,20442,21249,-807,-3.8,1177
2021-10-31,16173,18034,-1861,-10.32,1177
2021-11-01,21506,27599,-6093,-22.08,1177
2021-11-02,23382,28549,-5167,-18.1,1177
2021-11-03,23382,28544,-5162,-18.08,1177
2021-11-04,23382,28529,-5147,-18.04,1177
2021-11-05,22970,28421,-5451,-19.18,1177
2021-11-06,16937,21156,-4219,-19.94,1177
2021-11-07,14650,17979,-3329,-18.52,1177
2021-11-08,21506,27576,-6070,-22.01,1177
2021-11-09,23382,28552,-5170,-18.11,1177
2021-11-10,23382,28565,-5183,-18.14,1177
2021-11-11,23382,28560,-5178,-18.13,1177
2021-11-12,22970,28453,-5483,-19.27,1177
2021-11-13,16937,21180,-4243,-20.03,1177
2021-11-14,14650,17985,-3335,-18.54,1177
2021-11-15,21506,27556,-6050,-21.96,1177
2021-11-16,23382,28497,-5115,-17.95,1177
2021-11-17,23382,28469,-5087,-17.87,1177
2021-11-18,23382,28415,-5033,-17.71,1177
2021-11-19,22970,28254,-5284,-18.7,1177
2021-11-20,16937,20924,-3987,-19.05,1177
2021-11-21,14650,17670,-3020,-17.09,1177
2021-11-22,21506,27182,-5676,-20.88,1177
2021-11-23,23382,28064,-4682,-16.68,1177
2021-11-24,23382,27980,-4598,-16.43,1177
2021-11-25,23382,27875,-4493,-16.12,1177
2021-11-26,22970,27669,-4699,-16.98,1177
2021-11-27,16937,20300,-3363,-16.57,1177
2021-11-28,14650,17015,-2365,-13.9,1177
2021-11-29,21506,26504,-4998,-18.86,1177
2021-11-30,23382,27374,-3992,-14.58,1177
2021-12-01,19411,27286,-7875,-28.86,1177
2021-12-02,19411,27188,-7777,-28.6,1177
2021-12-03,17736,26997,-9261,-34.3,1177
2021-12-04,14619,19653,-5034,-25.61,1177
2021-12-05,11794,16400,-4606,-28.09,1177
2021-12-06,19849,25928,-6079,-23.45,1177
2021-12-07,19411,26842,-7431,-27.68,1177
2021-12-08,19411,26804,-7393,-27.58,1177
2021-12-09,19411,26757,-7346,-27.45,1177
2021-12-10,17736,26619,-8883,-33.37,1177
2021-12-11,14619,19327,-4708,-24.36,1177
2021-12-12,11794,16125,-4331,-26.86,1177
2021-12-13,19849,25700,-5851,-22.77,1177
2021-12-14,19411,26657,-7246,-27.18,1177
2021-12-15,19411,26655,-7244,-27.18,1177
2021-12-16,19411,26637,-7226,-27.13,1177
2021-12-17,17736,26521,-8785,-33.12,1177
2021-12-18,14619,19243,-4624,-24.03,1177
2021-12-19,11794,16046,-4252,-26.5,1177
2021-12-20,19849,25618,-5769,-22.52,1177
2021-12-21,19411,26564,-7153,-26.93,1177
2021-12-22,19411,26543,-7132,-26.87,1177
2021-12-23,19411,26501,-7090,-26.75,1177
2021-12-24,17736,26354,-8618,-32.7,1177
2021-12-25,14619,19041,-4422,-23.22,1177
2021-12-26,11794,15806,-4012,-25.38,1177
2021-12-27,19849,25338,-5489,-21.66,1177
2021-12-28,19411,26244,-6833,-26.04,1177
2021-12-29,19411,26186,-6775,-25.87,1177
2021-12-30,19411,26108,-6697,-25.65,1177
2021-12-31,17736,25930,-8194,-31.6,1177
2022-01-01,15442,18591,-3149,-16.94,1177
2022-01-02,12116,15337,-3221,-21.0,1177
2022-01-03,18854,24859,-6005,-24.16,1177
2022-01-04,19166,25761,-6595,-25.6,1177
2022-01-05,19166,25708,-6542,-25.45,1177
2022-01-06,19166,25644,-6478,-25.26,1177
2022-01-07,19349,25488,-6139,-24.09,1177
2022-01-08,15442,18179,-2737,-15.06,1177
2022-01-09,12116,14963,-2847,-19.03,1177
2022-01-10,18854,24528,-5674,-23.13,1177
2022-01-11,19166,25480,-6314,-24.78,1177
2022-01-12,19166,25479,-6313,-24.78,1177
2022-01-13,19166,25470,-6304,-24.75,1177
2022-01-14,19349,25370,-6021,-23.73,1177
2022-01-15,15442,18116,-2674,-14.76,1177
2022-01-16,12116,14952,-2836,-18.97,1177
2022-01-17,18854,24566,-5712,-23.25,1177
2022-01-18,19166,25560,-6394,-25.02,1177
2022-01-19,19166,25595,-6429,-25.12,1177
2022-01-20,19166,25615,-6449,-25.18,1177
2022-01-21,19349,25534,-6185,-24.22,1177
2022-01-22,15442,18291,-2849,-15.58,1177
2022-01-23,12116,15127,-3011,-19.9,1177
2022-01-24,18854,24732,-5878,-23.77,1177
2022-01-25,19166,25708,-6542,-25.45,1177
2022-01-26,19166,25717,-6551,-25.47,1177
2022-01-27,19166,25701,-6535,-25.43,1177
2022-01-28,19349,25580,-6231,-24.36,1177
2022-01-29,15442,18291,-2849,-15.58,1177
2022-01-30,12116,15078,-2962,-19.64,1177
2020-02-01,20897,19666,1231,6.26,1220
2020-02-02,17915,16963,952,5.61,1220
2020-02-03,26084,26031,53,0.2,1220
2020-02-04,27985,27975,10,0.04,1220
2020-02-05,27985,27953,32,0.11,1220
2020-02-06,27985,27939,46,0.16,1220
2020-02-07,28189,27522,667,2.42,1220
2020-02-08,20897,19736,1161,5.88,1220
2020-02-09,17915,17002,913,5.37,1220
2020-02-10,26084,26047,37,0.14,1220
2020-02-11,27985,27976,9,0.03,1220
2020-02-12,27985,27948,37,0.13,1220
2020-02-13,27985,27936,49,0.18,1220
2020-02-14,28189,27531,658,2.39,1220
2020-02-15,20897,19766,1131,5.72,1220
2020-02-16,17915,17061,854,5.01,1220
2020-02-17,26084,26142,-58,-0.22,1220
2020-02-18,27985,28115,-130,-0.46,1220
2020-02-19,27985,28135,-150,-0.53,1220
2020-02-20,27985,28177,-192,-0.68,1220
2020-02-21,28189,27827,362,1.3,1220
2020-02-22,20897,20118,779,3.87,1220
2020-02-23,17915,17469,446,2.55,1220
2020-02-24,26084,26604,-520,-1.95,1220
2020-02-25,27985,28627,-642,-2.24,1220
2020-02-26,27985,28693,-708,-2.47,1220
2020-02-27,27985,28773,-788,-2.74,1220
2020-02-28,28189,28454,-265,-0.93,1220
2020-02-29,20897,20769,128,0.62,1220
2020-03-01,11796,18134,-6338,-34.95,1220
2020-03-02,18773,27275,-8502,-31.17,1220
2020-03-03,19513,29293,-9780,-33.39,1220
2020-03-04,19513,29346,-9833,-33.51,1220
2020-03-05,19513,29404,-9891,-33.64,1220
2020-03-06,19768,29055,-9287,-31.96,1220
2020-03-07,12426,21331,-8905,-41.75,1220
2020-03-08,11796,18652,-6856,-36.76,1220
2020-03-09,18773,27743,-8970,-32.33,1220
2020-03-10,19513,29707,-10194,-34.32,1220
2020-03-11,19513,29703,-10190,-34.31,1220
2020-03-12,19513,29702,-10189,-34.3,1220
2020-03-13,19768,29294,-9526,-32.52,1220
2020-03-14,12426,21513,-9087,-42.24,1220
2020-03-15,11796,18778,-6982,-37.18,1220
2020-03-16,18773,27816,-9043,-32.51,1220
2020-03-17,19513,29733,-10220,-34.37,1220
2020-03-18,19513,29685,-10172,-34.27,1220
2020-03-19,19513,29647,-10134,-34.18,1220
2020-03-20,19768,29208,-9440,-32.32,1220
2020-03-21,12426,21402,-8976,-41.94,1220
2020-03-22,11796,18650,-6854,-36.75,1220
2020-03-23,18773,27676,-8903,-32.17,1220
2020-03-24,19513,29586,-10073,-34.05,1220
2020-03-25,19513,29539,-10026,-33.94,1220
2020-03-26,19513,29506,-9993,-33.87,1220
2020-03-27,19768,29076,-9308,-32.01,1220
2020-03-28,12426,21282,-8856,-41.61,1220
2020-03-29,11796,18544,-6748,-36.39,1220
2020-03-30,18773,27587,-8814,-31.95,1220
2020-03-31,19513,29516,-10003,-33.89,1220
2020-04-01,15496,29485,-13989,-47.44,1220
2020-04-02,15496,29469,-13973,-47.42,1220
2020-04-03,14140,29055,-14915,-51.33,1220
2020-04-04,9165,21275,-12110,-56.92,1220
2020-04-05,6921,18549,-11628,-62.69,1220
2020-04-06,15036,27600,-12564,-45.52,1220
2020-04-07,15496,29534,-14038,-47.53,1220
2020-04-08,15496,29507,-14011,-47.48,1220
2020-04-09,15496,29492,-13996,-47.46,1220
2020-04-10,14140,29076,-14936,-51.37,1220
2020-04-11,9165,21293,-12128,-56.96,1220
2020-04-12,6921,18563,-11642,-62.72,1220
2020-04-13,15036,27609,-12573,-45.54,1220
2020-04-14,15496,29539,-14043,-47.54,1220
2020-04-15,15496,29508,-14012,-47.49,1220
2020-04-16,15496,29490,-13994,-47.45,1220
2020-04-17,14140,29073,-14933,-51.36,1220
2020-04-18,9165,21292,-12127,-56.96,1220
2020-04-19,6921,18567,-11646,-62.72,1220
2020-04-20,15036,27622,-12586,-45.57,1220
2020-04-21,15496,29564,-14068,-47.58,1220
2020-04-22,15496,29550,-14054,-47.56,1220
2020-04-23,15496,29552,-14056,-47.56,1220
2020-04-24,14140,29159,-15019,-51.51,1220
2020-04-25,9165,21405,-12240,-57.18,1220
2020-04-26,6921,18709,-11788,-63.01,1220
2020-04-27,15036,27795,-12759,-45.9,1220
2020-04-28,15496,29770,-14274,-47.95,1220
2020-04-29,15496,29788,-14292,-47.98,1220
2020-04-30,15496,29823,-14327,-48.04,1220
2020-05-01,22619,29460,-6841,-23.22,1220
2020-05-02,15285,21734,-6449,-29.67,1220
2020-05-03,12390,19063,-6673,-35.0,1220
2020-05-04,21450,28170,-6720,-23.86,1220
2020-05-05,22802,30159,-7357,-24.39,1220
2020-05-06,22802,30186,-7384,-24.46,1220
2020-05-07,22802,30222,-7420,-24.55,1220
2020-05-08,22619,29856,-7237,-24.24,1220
2020-05-09,15285,22118,-6833,-30.89,1220
2020-05-10,12390,19427,-7037,-36.22,1220
2020-05-11,21450,28509,-7059,-24.76,1220
2020-05-12,22802,30466,-7664,-25.16,1220
2020-05-13,22802,30455,-7653,-25.13,1220
2020-05-14,22802,30449,-7647,-25.11,1220
2020-05-15,22619,30036,-7417,-24.69,1220
2020-05-16,15285,22248,-6963,-31.3,1220
2020-05-17,12390,19507,-7117,-36.48,1220
2020-05-18,21450,28537,-7087,-24.83,1220
2020-05-19,22802,30444,-7642,-25.1,1220
2020-05-20,22802,30385,-7583,-24.96,1220
2020-05-21,22802,30336,-7534,-24.84,1220
2020-05-22,22619,29883,-7264,-24.31,1220
2020-05-23,15285,22063,-6778,-30.72,1220
2020-05-24,12390,19296,-6906,-35.79,1220
2020-05-25,21450,28308,-6858,-24.23,1220
2020-05-26,22802,30206,-7404,-24.51,1220
2020-05-27,22802,30146,-7344,-24.36,1220
2020-05-28,22802,30104,-7302,-24.26,1220
2020-05-29,22619,29668,-7049,-23.76,1220
2020-05-30,15285,21871,-6586,-30.11,1220
2020-05-31,12390,19135,-6745,-35.25,1220
2020-06-01,25360,28184,-2824,-10.02,1220
2020-06-02,27017,30123,-3106,-10.31,1220
2020-06-03,27017,30109,-3092,-10.27,1220
2020-06-04,27017,30113,-3096,-10.28,1220
2020-06-05,24825,29724,-4899,-16.48,1220
2020-06-06,18405,21973,-3568,-16.24,1220
2020-06-07,14602,19279,-4677,-24.26,1220
2020-06-08,25360,28365,-3005,-10.59,1220
2020-06-09,27017,30335,-3318,-10.94,1220
2020-06-10,27017,30343,-3326,-10.96,1220
2020-06-11,27017,30361,-3344,-11.01,1220
2020-06-12,24825,29974,-5149,-17.18,1220
2020-06-13,18405,22214,-3809,-17.15,1220
2020-06-14,14602,19499,-4897,-25.11,1220
2020-06-15,25360,28553,-3193,-11.18,1220
2020-06-16,27017,30477,-3460,-11.35,1220
2020-06-17,27017,30429,-3412,-11.21,1220
2020-06-18,27017,30379,-3362,-11.07,1220
2020-06-19,24825,29915,-5090,-17.01,1220
2020-06-20,18405,22071,-3666,-16.61,1220
2020-06-21,14602,19264,-4662,-24.2,1220
2020-06-22,25360,28220,-2860,-10.13,1220
2020-06-23,27017,30046,-3029,-10.08,1220
2020-06-24,27017,29898,-2881,-9.64,1220
2020-06-25,27017,29750,-2733,-9.19,1220
2020-06-26,24825,29192,-4367,-14.96,1220
2020-06-27,18405,21259,-2854,-13.42,1220
2020-06-28,14602,18372,-3770,-20.52,1220
2020-06-29,25360,27259,-1899,-6.97,1220
2020-06-30,27017,29027,-2010,-6.92,1220
2020-07-01,27824,28833,-1009,-3.5,1220
2020-07-02,27824,28655,-831,-2.9,1220
2020-07-03,26290,28082,-1792,-6.38,1220
2020-07-04,18128,20150,-2022,-10.03,1220
2020-07-05,15636,17279,-1643,-9.51,1220
2020-07-06,25601,26197,-596,-2.28,1220
2020-07-07,27824,28011,-187,-0.67,1220
2020-07-08,27824,27877,-53,-0.19,1220
2020-07-09,27824,27770,54,0.19,1220
2020-07-10,26290,27278,-988,-3.62,1220
2020-07-11,18128,19435,-1307,-6.72,1220
2020-07-12,15636,16660,-1024,-6.15,1220
2020-07-13,25601,25677,-76,-0.3,1220
2020-07-14,27824,27590,234,0.85,1220
2020-07-15,27824,27555,269,0.98,1220
2020-07-16,27824,27543,281,1.02,1220
2020-07-17,26290,27140,-850,-3.13,1220
2020-07-18,18128,19377,-1249,-6.45,1220
2020-07-19,15636,16672,-1036,-6.21,1220
2020-07-20,25601,25748,-147,-0.57,1220
2020-07-21,27824,27706,118,0.43,1220
2020-07-22,27824,27702,122,0.44,1220
2020-07-23,27824,27705,119,0.43,1220
2020-07-24,26290,27303,-1013,-3.71,1220
2020-07-25,18128,19527,-1399,-7.16,1220
2020-07-26,15636,16794,-1158,-6.9,1220
2020-07-27,25601,25829,-228,-0.88,1220
2020-07-28,27824,27735,89,0.32,1220
2020-07-29,27824,27668,156,0.56,1220
2020-07-30,27824,27602,222,0.8,1220
2020-07-31,26290,27125,-835,-3.08,1220
2020-08-01,18653,19271,-618,-3.21,1220
2020-08-02,15894,16460,-566,-3.44,1220
2020-08-03,24922,25418,-496,-1.95,1220
2020-08-04,26332,27253,-921,-3.38,1220
2020-08-05,26332,27123,-791,-2.92,1220
2020-08-06,26332,27003,-671,-2.48,1220
2020-08-07,25290,26483,-1193,-4.5,1220
2020-08-08,18653,18600,53,0.28,1220
2020-08-09,15894,15775,119,0.75,1220
2020-08-10,24922,24735,187,0.76,1220
2020-08-11,26332,26589,-257,-0.97,1220
2020-08-12,26332,26495,-163,-0.62,1220
2020-08-13,26332,26428,-96,-0.36,1220
2020-08-14,25290,25978,-688,-2.65,1220
2020-08-15,18653,18180,473,2.6,1220
2020-08-16,15894,15454,440,2.85,1220
2020-08-17,24922,24526,396,1.61,1220
2020-08-18,26332,26501,-169,-0.64,1220
2020-08-19,26332,26536,-204,-0.77,1220
2020-08-20,26332,26603,-271,-1.02,1220
2020-08-21,25290,26290,-1000,-3.8,1220
2020-08-22,18653,18628,25,0.13,1220
2020-08-23,15894,16035,-141,-0.88,1220
2020-08-24,24922,25236,-314,-1.24,1220
2020-08-25,26332,27331,-999,-3.66,1220
2020-08-26,26332,27475,-1143,-4.16,1220
2020-08-27,26332,27640,-1308,-4.73,1220
2020-08-28,25290,27409,-2119,-7.73,1220
2020-08-29,18653,19814,-1161,-5.86,1220
2020-08-30,15894,17272,-1378,-7.98,1220
2020-08-31,24922,26504,-1582,-5.97,1220
2020-09-01,28820,28614,206,0.72,1220
2020-09-02,28820,28756,64,0.22,1220
2020-09-03,28820,28900,-80,-0.28,1220
2020-09-04,27338,28633,-1295,-4.52,1220
2020-09-05,21386,20987,399,1.9,1220
2020-09-06,17420,18381,-961,-5.23,1220
2020-09-07,26726,27537,-811,-2.95,1220
2020-09-08,28820,29562,-742,-2.51,1220
2020-09-09,28820,29612,-792,-2.67,1220
2020-09-10,28820,29659,-839,-2.83,1220
2020-09-11,27338,29293,-1955,-6.67,1220
2020-09-12,21386,21548,-162,-0.75,1220
2020-09-13,17420,18844,-1424,-7.56,1220
2020-09-14,26726,27908,-1182,-4.24,1220
2020-09-15,28820,29846,-1026,-3.44,1220
2020-09-16,28820,29817,-997,-3.34,1220
2020-09-17,28820,29795,-975,-3.27,1220
2020-09-18,27338,29370,-2032,-6.92,1220
2020-09-19,21386,21578,-192,-0.89,1220
2020-09-20,17420,18838,-1418,-7.53,1220
2020-09-21,26726,27878,-1152,-4.13,1220
2020-09-22,28820,29803,-983,-3.3,1220
2020-09-23,28820,29772,-952,-3.2,1220
2020-09-24,28820,29759,-939,-3.16,1220
2020-09-25,27338,29351,-2013,-6.86,1220
2020-09-26,21386,21583,-197,-0.91,1220
2020-09-27,17420,18875,-1455,-7.71,1220
2020-09-28,26726,27950,-1224,-4.38,1220
2020-09-29,28820,29915,-1095,-3.66,1220
2020-09-30,28820,29924,-1104,-3.69,1220
2020-10-01,27608,29950,-2342,-7.82,1220
2020-10-02,27077,29580,-2503,-8.46,1220
2020-10-03,20174,21846,-1672,-7.65,1220
2020-10-04,15494,19167,-3673,-19.16,1220
2020-10-05,26222,28266,-2044,-7.23,1220
2020-10-06,27608,30247,-2639,-8.72,1220
2020-10-07,27608,30265,-2657,-8.78,1220
2020-10-08,27608,30293,-2685,-8.86,1220
2020-10-09,27077,29917,-2840,-9.49,1220
2020-10-10,20174,22169,-1995,-9.0,1220
2020-10-11,15494,19468,-3974,-20.41,1220
2020-10-12,26222,28539,-2317,-8.12,1220
2020-10-13,27608,30486,-2878,-9.44,1220
2020-10-14,27608,30465,-2857,-9.38,1220
2020-10-15,27608,30449,-2841,-9.33,1220
2020-10-16,27077,30027,-2950,-9.82,1220
2020-10-17,20174,22232,-2058,-9.26,1220
2020-10-18,15494,19484,-3990,-20.48,1220
2020-10-19,26222,28509,-2287,-8.02,1220
2020-10-20,27608,30412,-2804,-9.22,1220
2020-10-21,27608,30350,-2742,-9.03,1220
2020-10-22,27608,30299,-2691,-8.88,1220
2020-10-23,27077,29845,-2768,-9.27,1220
2020-10-24,20174,22025,-1851,-8.4,1220
2020-10-25,15494,19258,-3764,-19.55,1220
2020-10-26,26222,28270,-2048,-7.24,1220
2020-10-27,27608,30166,-2558,-8.48,1220
2020-10-28,27608,30105,-2497,-8.29,1220
2020-10-29,27608,30058,-2450,-8.15,1220
2020-10-30,27077,29616,-2539,-8.57,1220
2020-10-31,20174,21811,-1637,-7.51,1220
2020-11-01,11513,19062,-7549,-39.6,1220
2020-11-02,22755,28095,-5340,-19.01,1220
2020-11-03,20884,30015,-9131,-30.42,1220
2020-11-04,20884,29977,-9093,-30.33,1220
2020-11-05,20884,29955,-9071,-30.28,1220
2020-11-06,20500,29535,-9035,-30.59,1220
2020-11-07,13133,21750,-8617,-39.62,1220
2020-11-08,11513,19019,-7506,-39.47,1220
2020-11-09,22755,28067,-5312,-18.93,1220
2020-11-10,20884,29997,-9113,-30.38,1220
2020-11-11,20884,29966,-9082,-30.31,1220
2020-11-12,20884,29946,-9062,-30.26,1220
2020-11-13,20500,29525,-9025,-30.57,1220
2020-11-14,13133,21735,-8602,-39.58,1220
2020-11-15,11513,18996,-7483,-39.39,1220
2020-11-16,22755,28033,-5278,-18.83,1220
2020-11-17,20884,29951,-9067,-30.27,1220
2020-11-18,20884,29907,-9023,-30.17,1220
2020-11-19,20884,29874,-8990,-30.09,1220
2020-11-20,20500,29440,-8940,-30.37,1220
2020-11-21,13133,21639,-8506,-39.31,1220
2020-11-22,11513,18892,-7379,-39.06,1220
2020-11-23,22755,27925,-5170,-18.51,1220
2020-11-24,20884,29842,-8958,-30.02,1220
2020-11-25,20884,29801,-8917,-29.92,1220
2020-11-26,20884,29776,-8892,-29.86,1220
2020-11-27,20500,29356,-8856,-30.17,1220
2020-11-28,13133,21575,-8442,-39.13,1220
2020-11-29,11513,18851,-7338,-38.93,1220
2020-11-30,22755,27912,-5157,-18.48,1220
2020-12-01,21668,29861,-8193,-27.44,1220
2020-12-02,21668,29855,-8187,-27.42,1220
2020-12-03,21668,29867,-8199,-27.45,1220
2020-12-04,23656,29484,-5828,-19.77,1220
2020-12-05,15342,21738,-6396,-29.42,1220
2020-12-06,10977,19049,-8072,-42.37,1220
2020-12-07,21516,28140,-6624,-23.54,1220
2020-12-08,21668,30115,-8447,-28.05,1220
2020-12-09,21668,30128,-8460,-28.08,1220
2020-12-10,21668,30151,-8483,-28.14,1220
2020-12-11,23656,29771,-6115,-20.54,1220
2020-12-12,15342,22018,-6676,-30.32,1220
2020-12-13,10977,19311,-8334,-43.16,1220
2020-12-14,21516,28373,-6857,-24.17,1220
2020-12-15,21668,30307,-8639,-28.5,1220
2020-12-16,21668,30267,-8599,-28.41,1220
2020-12-17,21668,30227,-8559,-28.32,1220
2020-12-18,23656,29772,-6116,-20.54,1220
2020-12-19,15342,21936,-6594,-30.06,1220
2020-12-20,10977,19136,-8159,-42.64,1220
2020-12-21,21516,28098,-6582,-23.43,1220
2020-12-22,21668,29927,-8259,-27.6,1220
2020-12-23,21668,29780,-8112,-27.24,1220
2020-12-24,21668,29629,-7961,-26.87,1220
2020-12-25,23656,29065,-5409,-18.61,1220
2020-12-26,15342,21122,-5780,-27.36,1220
2020-12-27,10977,18222,-7245,-39.76,1220
2020-12-28,21516,27090,-5574,-20.58,1220
2020-12-29,21668,28834,-7166,-24.85,1220
2020-12-30,21668,28612,-6944,-24.27,1220
2020-12-31,21668,28401,-6733,-23.71,1220
2021-01-01,19869,27790,-7921,-28.5,1220
2021-01-02,12204,19816,-7612,-38.41,1220
2021-01-03,10101,16900,-6799,-40.23,1220
2021-01-04,18894,25769,-6875,-26.68,1220
2021-01-05,20303,27531,-7228,-26.25,1220
2021-01-06,20303,27344,-7041,-25.75,1220
2021-01-07,20303,27184,-6881,-25.31,1220
2021-01-08,19869,26638,-6769,-25.41,1220
2021-01-09,12204,18743,-6539,-34.89,1220
2021-01-10,10101,15918,-5817,-36.54,1220
2021-01-11,18894,24888,-5994,-24.08,1220
2021-01-12,20303,26760,-6457,-24.13,1220
2021-01-13,20303,26688,-6385,-23.92,1220
2021-01-14,20303,26647,-6344,-23.81,1220
2021-01-15,19869,26222,-6353,-24.23,1220
2021-01-16,12204,18446,-6242,-33.84,1220
2021-01-17,10101,15738,-5637,-35.82,1220
2021-01-18,18894,24820,-5926,-23.88,1220
2021-01-19,20303,26795,-6492,-24.23,1220
2021-01-20,20303,26819,-6516,-24.3,1220
2021-01-21,20303,26862,-6559,-24.42,1220
2021-01-22,19869,26510,-6641,-25.05,1220
2021-01-23,12204,18794,-6590,-35.06,1220
2021-01-24,10101,16132,-6031,-37.39,1220
2021-01-25,18894,25248,-6354,-25.17,1220
2021-01-26,20303,27244,-6941,-25.48,1220
2021-01-27,20303,27275,-6972,-25.56,1220
2021-01-28,20303,27314,-7011,-25.67,1220
2021-01-29,19869,26947,-7078,-26.27,1220
2021-01-30,12204,19207,-7003,-36.46,1220
2021-01-31,10101,16513,-6412,-38.83,1220
2021-02-01,22503,25589,-3086,-12.06,1220
2021-02-02,23571,27542,-3971,-14.42,1220
2021-02-03,23571,27527,-3956,-14.37,1220
2021-02-04,23571,27519,-3948,-14.35,1220
2021-02-05,22854,27107,-4253,-15.69,1220
2021-02-06,15602,19324,-3722,-19.26,1220
2021-02-07,12220,16591,-4371,-26.35,1220
2021-02-08,22503,25635,-3132,-12.22,1220
2021-02-09,23571,27563,-3992,-14.48,1220
2021-02-10,23571,27531,-3960,-14.38,1220
2021-02-11,23571,27514,-3943,-14.33,1220
2021-02-12,22854,27102,-4248,-15.67,1220
2021-02-13,15602,19329,-3727,-19.28,1220
2021-02-14,12220,16615,-4395,-26.45,1220
2021-02-15,22503,25686,-3183,-12.39,1220
2021-02-16,23571,27648,-4077,-14.75,1220
2021-02-17,23571,27658,-4087,-14.78,1220
2021-02-18,23571,27689,-4118,-14.87,1220
2021-02-19,22854,27329,-4475,-16.37,1220
2021-02-20,15602,19611,-4009,-20.44,1220
2021-02-21,12220,16953,-4733,-27.92,1220
2021-02-22,22503,26081,-3578,-13.72,1220
2021-02-23,23571,28097,-4526,-16.11,1220
2021-02-24,23571,28158,-4587,-16.29,1220
2021-02-25,23571,28236,-4665,-16.52,1220
2021-02-26,22854,27916,-5062,-18.13,1220
2021-02-27,15602,20231,-4629,-22.88,1220
2021-02-28,12220,17599,-5379,-30.56,1220
2021-03-01,23368,26743,-3375,-12.62,1220
2021-03-02,24795,28767,-3972,-13.81,1220
2021-03-03,24795,28826,-4031,-13.98,1220
2021-03-04,24795,28893,-4098,-14.18,1220
2021-03-05,24420,28553,-4133,-14.47,1220
2021-03-06,16271,20840,-4569,-21.92,1220
2021-03-07,12320,18172,-5852,-32.2,1220
2021-03-08,23368,27273,-3905,-14.32,1220
2021-03-09,24795,29248,-4453,-15.22,1220
2021-03-10,24795,29255,-4460,-15.25,1220
2021-03-11,24795,29264,-4469,-15.27,1220
2021-03-12,24420,28866,-4446,-15.4,1220
2021-03-13,16271,21094,-4823,-22.86,1220
2021-03-14,12320,18367,-6047,-32.92,1220
2021-03-15,23368,27412,-4044,-14.75,1220
2021-03-16,24795,29335,-4540,-15.48,1220
2021-03-17,24795,29291,-4496,-15.35,1220
2021-03-18,24795,29257,-4462,-15.25,1220
2021-03-19,24420,28820,-4400,-15.27,1220
2021-03-20,16271,21015,-4744,-22.57,1220
2021-03-21,12320,18262,-5942,-32.54,1220
2021-03-22,23368,27288,-3920,-14.37,1220
2021-03-23,24795,29196,-4401,-15.07,1220
2021-03-24,24795,29146,-4351,-14.93,1220
2021-03-25,24795,29110,-4315,-14.82,1220
2021-03-26,24420,28677,-4257,-14.84,1220
2021-03-27,16271,20880,-4609,-22.07,1220
2021-03-28,12320,18139,-5819,-32.08,1220
2021-03-29,23368,27178,-3810,-14.02,1220
2021-03-30,24795,29104,-4309,-14.81,1220
2021-03-31,24795,29071,-4276,-14.71,1220
2021-04-01,22426,29053,-6627,-22.81,1220
2021-04-02,21094,28637,-7543,-26.34,1220
2021-04-03,13706,20855,-7149,-34.28,1220
2021-04-04,11225,18128,-6903,-38.08,1220
2021-04-05,22379,27180,-4801,-17.66,1220
2021-04-06,22426,29115,-6689,-22.97,1220
2021-04-07,22426,29088,-6662,-22.9,1220
2021-04-08,22426,29074,-6648,-22.87,1220
2021-04-09,21094,28659,-7565,-26.4,1220
2021-04-10,13706,20877,-7171,-34.35,1220
2021-04-11,11225,18148,-6923,-38.15,1220
2021-04-12,22379,27195,-4816,-17.71,1220
2021-04-13,22426,29125,-6699,-23.0,1220
2021-04-14,22426,29094,-6668,-22.92,1220
2021-04-15,22426,29075,-6649,-22.87,1220
2021-04-16,21094,28658,-7564,-26.39,1220
2021-04-17,13706,20874,-7168,-34.34,1220
2021-04-18,11225,18146,-6921,-38.14,1220
2021-04-19,22379,27198,-4819,-17.72,1220
2021-04-20,22426,29136,-6710,-23.03,1220
2021-04-21,22426,29116,-6690,-22.98,1220
2021-04-22,22426,29113,-6687,-22.97,1220
2021-04-23,21094,28714,-7620,-26.54,1220
2021-04-24,13706,20954,-7248,-34.59,1220
2021-04-25,11225,18251,-7026,-38.5,1220
2021-04-26,22379,27332,-4953,-18.12,1220
2021-04-27,22426,29301,-6875,-23.46,1220
2021-04-28,22426,29313,-6887,-23.49,1220
2021-04-29,22426,29343,-6917,-23.57,1220
2021-04-30,21094,28977,-7883,-27.2,1220
2021-05-01,17901,21248,-3347,-15.75,1220
2021-05-02,14190,18574,-4384,-23.6,1220
2021-05-03,26529,27680,-1151,-4.16,1220
2021-05-04,27940,29670,-1730,-5.83,1220
2021-05-05,27940,29699,-1759,-5.92,1220
2021-05-06,27940,29739,-1799,-6.05,1220
2021-05-07,25418,29377,-3959,-13.48,1220
2021-05-08,17901,21645,-3744,-17.3,1220
2021-05-09,14190,18961,-4771,-25.16,1220
2021-05-10,26529,28050,-1521,-5.42,1220
2021-05-11,27940,30016,-2076,-6.92,1220
2021-05-12,27940,30015,-2075,-6.91,1220
2021-05-13,27940,30018,-2078,-6.92,1220
2021-05-14,25418,29614,-4196,-14.17,1220
2021-05-15,17901,21837,-3936,-18.02,1220
2021-05-16,14190,19104,-4914,-25.72,1220
2021-05-17,26529,28143,-1614,-5.73,1220
2021-05-18,27940,30057,-2117,-7.04,1220
2021-05-19,27940,30005,-2065,-6.88,1220
2021-05-20,27940,29960,-2020,-6.74,1220
2021-05-21,25418,29512,-4094,-13.87,1220
2021-05-22,17901,21694,-3793,-17.48,1220
2021-05-23,14190,18927,-4737,-25.03,1220
2021-05-24,26529,27938,-1409,-5.04,1220
2021-05-25,27940,29832,-1892,-6.34,1220
2021-05-26,27940,29769,-1829,-6.14,1220
2021-05-27,27940,29720,-1780,-5.99,1220
2021-05-28,25418,29277,-3859,-13.18,1220
2021-05-29,17901,21473,-3572,-16.63,1220
2021-05-30,14190,18728,-4538,-24.23,1220
2021-05-31,26529,27768,-1239,-4.46,1220
2021-06-01,29612,29698,-86,-0.29,1220
2021-06-02,29612,29675,-63,-0.21,1220
2021-06-03,29612,29671,-59,-0.2,1220
2021-06-04,27558,29275,-1717,-5.87,1220
2021-06-05,22050,21518,532,2.47,1220
2021-06-06,17351,18819,-1468,-7.8,1220
2021-06-07,28139,27902,237,0.85,1220
2021-06-08,29612,29871,-259,-0.87,1220
2021-06-09,29612,29880,-268,-0.9,1220
2021-06-10,29612,29901,-289,-0.97,1220
2021-06-11,27558,29520,-1962,-6.65,1220
2021-06-12,22050,21768,282,1.3,1220
2021-06-13,17351,19063,-1712,-8.98,1220
2021-06-14,28139,28129,10,0.04,1220
2021-06-15,29612,30068,-456,-1.52,1220
2021-06-16,29612,30035,-423,-1.41,1220
2021-06-17,29612,30002,-390,-1.3,1220
2021-06-18,27558,29556,-1998,-6.76,1220
2021-06-19,22050,21730,320,1.47,1220
2021-06-20,17351,18942,-1591,-8.4,1220
2021-06-21,28139,27917,222,0.8,1220
2021-06-22,29612,29760,-148,-0.5,1220
2021-06-23,29612,29628,-16,-0.05,1220
2021-06-24,29612,29496,116,0.39,1220
2021-06-25,27558,28951,-1393,-4.81,1220
2021-06-26,22050,21029,1021,4.86,1220
2021-06-27,17351,18151,-800,-4.41,1220
2021-06-28,28139,27044,1095,4.05,1220
2021-06-29,29612,28815,797,2.77,1220
2021-06-30,29612,28622,990,3.46,1220
2021-07-01,27885,28441,-556,-1.95,1220
2021-07-02,27077,27863,-786,-2.82,1220
2021-07-03,19756,19922,-166,-0.83,1220
2021-07-04,16516,17041,-525,-3.08,1220
2021-07-05,26363,25946,417,1.61,1220
2021-07-06,27885,27744,141,0.51,1220
2021-07-07,27885,27593,292,1.06,1220
2021-07-08,27885,27469,416,1.51,1220
2021-07-09,27077,26958,119,0.44,1220
2021-07-10,19756,19096,660,3.46,1220
2021-07-11,16516,16303,213,1.31,1220
2021-07-12,26363,25302,1061,4.19,1220
2021-07-13,27885,27199,686,2.52,1220
2021-07-14,27885,27148,737,2.71,1220
2021-07-15,27885,27123,762,2.81,1220
2021-07-16,27077,26709,368,1.38,1220
2021-07-17,19756,18937,819,4.32,1220
2021-07-18,16516,16226,290,1.79,1220
2021-07-19,26363,25298,1065,4.21,1220
2021-07-20,27885,27256,629,2.31,1220
2021-07-21,27885,27254,631,2.32,1220
2021-07-22,27885,27263,622,2.28,1220
2021-07-23,27077,26868,209,0.78,1220
2021-07-24,19756,19102,654,3.42,1220
2021-07-25,16516,16380,136,0.83,1220
2021-07-26,26363,25428,935,3.68,1220
2021-07-27,27885,27348,537,1.96,1220
2021-07-28,27885,27297,588,2.15,1220
2021-07-29,27885,27246,639,2.35,1220
2021-07-30,27077,26783,294,1.1,1220
2021-07-31,19756,18943,813,4.29,1220
2021-08-01,17066,16144,922,5.71,1220
2021-08-02,25347,25113,234,0.93,1220
2021-08-03,26386,26957,-571,-2.12,1220
2021-08-04,26386,26832,-446,-1.66,1220
2021-08-05,26386,26715,-329,-1.23,1220
2021-08-06,25575,26196,-621,-2.37,1220
2021-08-07,19725,18310,1415,7.73,1220
2021-08-08,17066,15479,1587,10.25,1220
2021-08-09,25347,24430,917,3.75,1220
2021-08-10,26386,26272,114,0.43,1220
2021-08-11,26386,26162,224,0.86,1220
2021-08-12,26386,26077,309,1.18,1220
2021-08-13,25575,25607,-32,-0.12,1220
2021-08-14,19725,17786,1939,10.9,1220
2021-08-15,17066,15036,2030,13.5,1220
2021-08-16,25347,24083,1264,5.25,1220
2021-08-17,26386,26033,353,1.36,1220
2021-08-18,26386,26042,344,1.32,1220
2021-08-19,26386,26085,301,1.15,1220
2021-08-20,25575,25748,-173,-0.67,1220
2021-08-21,19725,18063,1662,9.2,1220
2021-08-22,17066,15450,1616,10.46,1220
2021-08-23,25347,24632,715,2.9,1220
2021-08-24,26386,26712,-326,-1.22,1220
2021-08-25,26386,26843,-457,-1.7,1220
2021-08-26,26386,26998,-612,-2.27,1220
2021-08-27,25575,26761,-1186,-4.43,1220
2021-08-28,19725,19163,562,2.93,1220
2021-08-29,17066,16621,445,2.68,1220
2021-08-30,25347,25857,-510,-1.97,1220
2021-08-31,26386,27974,-1588,-5.68,1220
2021-09-01,29739,28125,1614,5.74,1220
2021-09-02,29739,28281,1458,5.16,1220
2021-09-03,29447,28028,1419,5.06,1220
2021-09-04,23584,20398,3186,15.62,1220
2021-09-05,19705,17809,1896,10.65,1220
2021-09-06,28548,26983,1565,5.8,1220
2021-09-07,29739,29027,712,2.45,1220
2021-09-08,29739,29095,644,2.21,1220
2021-09-09,29739,29160,579,1.99,1220
2021-09-10,29447,28812,635,2.2,1220
2021-09-11,23584,21083,2501,11.86,1220
2021-09-12,19705,18394,1311,7.13,1220
2021-09-13,28548,27471,1077,3.92,1220
2021-09-14,29739,29420,319,1.08,1220
2021-09-15,29739,29400,339,1.15,1220
2021-09-16,29739,29385,354,1.2,1220
2021-09-17,29447,28964,483,1.67,1220
2021-09-18,23584,21174,2410,11.38,1220
2021-09-19,19705,18434,1271,6.89,1220
2021-09-20,28548,27472,1076,3.92,1220
2021-09-21,29739,29395,344,1.17,1220
2021-09-22,29739,29359,380,1.29,1220
2021-09-23,29739,29339,400,1.36,1220
2021-09-24,29447,28925,522,1.8,1220
2021-09-25,23584,21149,2435,11.51,1220
2021-09-26,19705,18433,1272,6.9,1220
2021-09-27,28548,27501,1047,3.81,1220
2021-09-28,29739,29458,281,0.95,1220
2021-09-29,29739,29460,279,0.95,1220
2021-09-30,29739,29481,258,0.88,1220
2021-10-01,29749,29106,643,2.21,1220
2021-10-02,22549,21369,1180,5.52,1220
2021-10-03,18673,18688,-15,-0.08,1220
2021-10-04,27464,27786,-322,-1.16,1220
2021-10-05,30021,29769,252,0.85,1220
2021-10-06,30021,29789,232,0.78,1220
2021-10-07,30021,29821,200,0.67,1220
2021-10-08,29749,29450,299,1.02,1220
2021-10-09,22549,21708,841,3.87,1220
2021-10-10,18673,19015,-342,-1.8,1220
2021-10-11,27464,28094,-630,-2.24,1220
2021-10-12,30021,30049,-28,-0.09,1220
2021-10-13,30021,30037,-16,-0.05,1220
2021-10-14,30021,30031,-10,-0.03,1220
2021-10-15,29749,29617,132,0.45,1220
2021-10-16,22549,21830,719,3.29,1220
2021-10-17,18673,19090,-417,-2.18,1220
2021-10-18,27464,28121,-657,-2.34,1220
2021-10-19,30021,30030,-9,-0.03,1220
2021-10-20,30021,29974,47,0.16,1220
2021-10-21,30021,29926,95,0.32,1220
2021-10-22,29749,29475,274,0.93,1220
2021-10-23,22549,21656,893,4.12,1220
2021-10-24,18673,18889,-216,-1.14,1220
2021-10-25,27464,27899,-435,-1.56,1220
2021-10-26,30021,29794,227,0.76,1220
2021-10-27,30021,29729,292,0.98,1220
2021-10-28,30021,29680,341,1.15,1220
2021-10-29,29749,29233,516,1.77,1220
2021-10-30,22549,21423,1126,5.26,1220
2021-10-31,18673,18670,3,0.02,1220
2021-11-01,24534,27699,-3165,-11.43,1220
2021-11-02,27201,29614,-2413,-8.15,1220
2021-11-03,27201,29572,-2371,-8.02,1220
2021-11-04,27201,29546,-2345,-7.94,1220
2021-11-05,27585,29123,-1538,-5.28,1220
2021-11-06,19751,21336,-1585,-7.43,1220
2021-11-07,17018,18604,-1586,-8.53,1220
2021-11-08,24534,27651,-3117,-11.27,1220
2021-11-09,27201,29582,-2381,-8.05,1220
2021-11-10,27201,29552,-2351,-7.96,1220
2021-11-11,27201,29534,-2333,-7.9,1220
2021-11-12,27585,29114,-1529,-5.25,1220
2021-11-13,19751,21327,-1576,-7.39,1220
2021-11-14,17018,18591,-1573,-8.46,1220
2021-11-15,24534,27631,-3097,-11.21,1220
2021-11-16,27201,29552,-2351,-7.96,1220
2021-11-17,27201,29510,-2309,-7.82,1220
2021-11-18,27201,29478,-2277,-7.72,1220
2021-11-19,27585,29045,-1460,-5.03,1220
2021-11-20,19751,21245,-1494,-7.03,1220
2021-11-21,17018,18498,-1480,-8.0,1220
2021-11-22,24534,27529,-2995,-10.88,1220
2021-11-23,27201,29444,-2243,-7.62,1220
2021-11-24,27201,29400,-2199,-7.48,1220
2021-11-25,27201,29371,-2170,-7.39,1220
2021-11-26,27585,28945,-1360,-4.7,1220
2021-11-27,19751,21158,-1407,-6.65,1220
2021-11-28,17018,18428,-1410,-7.65,1220
2021-11-29,24534,27482,-2948,-10.73,1220
2021-11-30,27201,29423,-2222,-7.55,1220
2021-12-01,23970,29410,-5440,-18.5,1220
2021-12-02,23970,29416,-5446,-18.51,1220
2021-12-03,21172,29027,-7855,-27.06,1220
2021-12-04,15896,21276,-5380,-25.29,1220
2021-12-05,13317,18583,-5266,-28.34,1220
2021-12-06,23978,27671,-3693,-13.35,1220
2021-12-07,23970,29645,-5675,-19.14,1220
2021-12-08,23970,29659,-5689,-19.18,1220
2021-12-09,23970,29685,-5715,-19.25,1220
2021-12-10,21172,29309,-8137,-27.76,1220
2021-12-11,15896,21564,-5668,-26.28,1220
2021-12-12,13317,18866,-5549,-29.41,1220
2021-12-13,23978,27939,-3961,-14.18,1220
2021-12-14,23970,29886,-5916,-19.8,1220
2021-12-15,23970,29862,-5892,-19.73,1220
2021-12-16,23970,29838,-5868,-19.67,1220
2021-12-17,21172,29402,-8230,-27.99,1220
2021-12-18,15896,21584,-5688,-26.35,1220
2021-12-19,13317,18805,-5488,-29.18,1220
2021-12-20,23978,27788,-3810,-13.71,1220
2021-12-21,23970,29637,-5667,-19.12,1220
2021-12-22,23970,29509,-5539,-18.77,1220
2021-12-23,23970,29378,-5408,-18.41,1220
2021-12-24,21172,28832,-7660,-26.57,1220
2021-12-25,15896,20905,-5009,-23.96,1220
2021-12-26,13317,18018,-4701,-26.09,1220
2021-12-27,23978,26898,-2920,-10.86,1220
2021-12-28,23970,28651,-4681,-16.34,1220
2021-12-29,23970,28436,-4466,-15.71,1220
2021-12-30,23970,28228,-4258,-15.08,1220
2021-12-31,21172,27617,-6445,-23.34,1220
2022-01-01,17650,19640,-1990,-10.13,1220
2022-01-02,13181,16718,-3537,-21.16,1220
2022-01-03,21713,25578,-3865,-15.11,1220
2022-01-04,22891,27328,-4437,-16.24,1220
2022-01-05,22891,27127,-4236,-15.62,1220
2022-01-06,22891,26950,-4059,-15.06,1220
2022-01-07,22991,26386,-3395,-12.87,1220
2022-01-08,17650,18470,-820,-4.44,1220
2022-01-09,13181,15624,-2443,-15.64,1220
2022-01-10,21713,24572,-2859,-11.64,1220
2022-01-11,22891,26421,-3530,-13.36,1220
2022-01-12,22891,26328,-3437,-13.05,1220
2022-01-13,22891,26264,-3373,-12.84,1220
2022-01-14,22991,25819,-2828,-10.95,1220
2022-01-15,17650,18024,-374,-2.08,1220
2022-01-16,13181,15298,-2117,-13.84,1220
2022-01-17,21713,24364,-2651,-10.88,1220
2022-01-18,22891,26326,-3435,-13.05,1220
2022-01-19,22891,26338,-3447,-13.09,1220
2022-01-20,22891,26372,-3481,-13.2,1220
2022-01-21,22991,26014,-3023,-11.62,1220
2022-01-22,17650,18294,-644,-3.52,1220
2022-01-23,13181,15631,-2450,-15.67,1220
2022-01-24,21713,24748,-3035,-12.26,1220
2022-01-25,22891,26747,-3856,-14.42,1220
2022-01-26,22891,26783,-3892,-14.53,1220
2022-01-27,22891,26828,-3937,-14.67,1220
2022-01-28,22991,26468,-3477,-13.14,1220
2022-01-29,17650,18736,-1086,-5.8,1220
2022-01-30,13181,16051,-2870,-17.88,1220
2020-02-01,11119,9451,1668,17.65,1625
2020-02-02,8988,7356,1632,22.19,1625
2020-02-03,13558,11914,1644,13.8,1625
2020-02-04,14458,12603,1855,14.72,1625
2020-02-05,14458,12346,2112,17.11,1625
2020-02-06,14458,12245,2213,18.07,1625
2020-02-07,14782,11781,3001,25.47,1625
2020-02-08,11119,8478,2641,31.15,1625
2020-02-09,8988,6395,2593,40.55,1625
2020-02-10,13558,10980,2578,23.48,1625
2020-02-11,14458,11711,2747,23.46,1625
2020-02-12,14458,11507,2951,25.65,1625
2020-02-13,14458,11470,2988,26.05,1625
2020-02-14,14782,11080,3702,33.41,1625
2020-02-15,11119,7857,3262,41.52,1625
2020-02-16,8988,5859,3129,53.41,1625
2020-02-17,13558,10532,3026,28.73,1625
2020-02-18,14458,11350,3108,27.38,1625
2020-02-19,14458,11231,3227,28.73,1625
2020-02-20,14458,11274,3184,28.24,1625
2020-02-21,14782,10957,3825,34.91,1625
2020-02-22,11119,7797,3322,42.61,1625
2020-02-23,8988,5853,3135,53.56,1625
2020-02-24,13558,10567,2991,28.31,1625
2020-02-25,14458,11413,3045,26.68,1625
2020-02-26,14458,11309,3149,27.85,1625
2020-02-27,14458,11353,3105,27.35,1625
2020-02-28,14782,11024,3758,34.09,1625
2020-02-29,11119,7839,3280,41.84,1625
2020-03-01,5600,5859,-259,-4.42,1625
2020-03-02,9758,10526,-768,-7.3,1625
2020-03-03,9840,11318,-1478,-13.06,1625
2020-03-04,9840,11153,-1313,-11.77,1625
2020-03-05,9840,11132,-1292,-11.61,1625
2020-03-06,9924,10735,-811,-7.55,1625
2020-03-07,6384,7485,-1101,-14.71,1625
2020-03-08,5600,5440,160,2.94,1625
2020-03-09,9758,10048,-290,-2.89,1625
2020-03-10,9840,10788,-948,-8.79,1625
2020-03-11,9840,10579,-739,-6.99,1625
2020-03-12,9840,10524,-684,-6.5,1625
2020-03-13,9924,10106,-182,-1.8,1625
2020-03-14,6384,6845,-461,-6.73,1625
2020-03-15,5600,4803,797,16.59,1625
2020-03-16,9758,9426,332,3.52,1625
2020-03-17,9840,10193,-353,-3.46,1625
2020-03-18,9840,10023,-183,-1.83,1625
2020-03-19,9840,10018,-178,-1.78,1625
2020-03-20,9924,9658,266,2.75,1625
2020-03-21,6384,6463,-79,-1.22,1625
2020-03-22,5600,4492,1108,24.67,1625
2020-03-23,9758,9190,568,6.18,1625
2020-03-24,9840,10032,-192,-1.91,1625
2020-03-25,9840,9936,-96,-0.97,1625
2020-03-26,9840,10002,-162,-1.62,1625
2020-03-27,9924,9708,216,2.22,1625
2020-03-28,6384,6571,-187,-2.85,1625
2020-03-29,5600,4650,950,20.43,1625
2020-03-30,9758,9386,372,3.96,1625
2020-03-31,9840,10256,-416,-4.06,1625
2020-04-01,7872,10175,-2303,-22.63,1625
2020-04-02,7872,10244,-2372,-23.16,1625
2020-04-03,6951,9939,-2988,-30.06,1625
2020-04-04,4373,6779,-2406,-35.49,1625
2020-04-05,3227,4823,-1596,-33.09,1625
2020-04-06,7817,9515,-1698,-17.85,1625
2020-04-07,7872,10331,-2459,-23.8,1625
2020-04-08,7872,10189,-2317,-22.74,1625
2020-04-09,7872,10190,-2318,-22.75,1625
2020-04-10,6951,9814,-2863,-29.17,1625
2020-04-11,4373,6583,-2210,-33.57,1625
2020-04-12,3227,4555,-1328,-29.15,1625
2020-04-13,7817,9178,-1361,-14.83,1625
2020-04-14,7872,9930,-2058,-20.73,1625
2020-04-15,7872,9730,-1858,-19.1,1625
2020-04-16,7872,9682,-1810,-18.69,1625
2020-04-17,6951,9266,-2315,-24.98,1625
2020-04-18,4373,6005,-1632,-27.18,1625
2020-04-19,3227,3959,-732,-18.49,1625
2020-04-20,7817,8575,-758,-8.84,1625
2020-04-21,7872,9330,-1458,-15.63,1625
2020-04-22,7872,9146,-1274,-13.93,1625
2020-04-23,7872,9122,-1250,-13.7,1625
2020-04-24,6951,8741,-1790,-20.48,1625
2020-04-25,4373,5521,-1148,-20.79,1625
2020-04-26,3227,3522,-295,-8.38,1625
2020-04-27,7817,8190,-373,-4.55,1625
2020-04-28,7872,8999,-1127,-12.52,1625
2020-04-29,7872,8869,-997,-11.24,1625
2020-04-30,7872,8898,-1026,-11.53,1625
2020-05-01,11171,8565,2606,30.43,1625
2020-05-02,7358,5389,1969,36.54,1625
2020-05-03,5490,3427,2063,60.2,1625
2020-05-04,11286,8123,3163,38.94,1625
2020-05-05,11744,8951,2793,31.2,1625
2020-05-06,11744,8830,2914,33.0,1625
2020-05-07,11744,8857,2887,32.6,1625
2020-05-08,11171,8512,2659,31.24,1625
2020-05-09,7358,5313,2045,38.49,1625
2020-05-10,5490,3319,2171,65.41,1625
2020-05-11,11286,7974,3312,41.53,1625
2020-05-12,11744,8754,2990,34.16,1625
2020-05-13,11744,8578,3166,36.91,1625
2020-05-14,11744,8547,3197,37.4,1625
2020-05-15,11171,8141,3030,37.22,1625
2020-05-16,7358,4882,2476,50.72,1625
2020-05-17,5490,2829,2661,94.06,1625
2020-05-18,11286,7429,3857,51.92,1625
2020-05-19,11744,8160,3584,43.92,1625
2020-05-20,11744,7943,3801,47.85,1625
2020-05-21,11744,7879,3865,49.05,1625
2020-05-22,11171,7451,3720,49.93,1625
2020-05-23,7358,4180,3178,76.03,1625
2020-05-24,5490,2126,3364,158.23,1625
2020-05-25,11286,6738,4548,67.5,1625
2020-05-26,11744,7491,4253,56.77,1625
2020-05-27,11744,7307,4437,60.72,1625
2020-05-28,11744,7286,4458,61.19,1625
2020-05-29,11171,6908,4263,61.71,1625
2020-05-30,7358,3695,3663,99.13,1625
2020-05-31,5490,1704,3786,222.18,1625
2020-06-01,12808,6380,6428,100.75,1625
2020-06-02,13680,7199,6481,90.03,1625
2020-06-03,13680,7078,6602,93.27,1625
2020-06-04,13680,7117,6563,92.22,1625
2020-06-05,12608,6793,5815,85.6,1625
2020-06-06,8885,3625,5260,145.1,1625
2020-06-07,6922,1669,5253,314.74,1625
2020-06-08,12808,6369,6439,101.1,1625
2020-06-09,13680,7199,6481,90.03,1625
2020-06-10,13680,7076,6604,93.33,1625
2020-06-11,13680,7098,6582,92.73,1625
2020-06-12,12608,6744,5864,86.95,1625
2020-06-13,8885,3532,5353,151.56,1625
2020-06-14,6922,1520,5402,355.39,1625
2020-06-15,12808,6153,6655,108.16,1625
2020-06-16,13680,6906,6774,98.09,1625
2020-06-17,13680,6699,6981,104.21,1625
2020-06-18,13680,6632,7048,106.27,1625
2020-06-19,12608,6186,6422,103.82,1625
2020-06-20,8885,2883,6002,208.19,1625
2020-06-21,6922,782,6140,785.17,1625
2020-06-22,12808,5331,7477,140.26,1625
2020-06-23,13680,6009,7671,127.66,1625
2020-06-24,13680,5736,7944,138.49,1625
2020-06-25,13680,5616,8064,143.59,1625
2020-06-26,12608,5130,7478,145.77,1625
2020-06-27,8885,1802,7083,393.06,1625
2020-06-28,6922,1653,5269,318.75,1625
2020-06-29,12808,4250,8558,201.36,1625
2020-06-30,13680,4951,8729,176.31,1625
2020-07-01,13379,4716,8663,183.69,1625
2020-07-02,13379,4649,8730,187.78,1625
2020-07-03,12792,4229,8563,202.48,1625
2020-07-04,9126,976,8150,835.04,1625
2020-07-05,7261,1487,5774,388.3,1625
2020-07-06,12505,3594,8911,247.94,1625
2020-07-07,13379,4384,8995,205.18,1625
2020-07-08,13379,4237,9142,215.77,1625
2020-07-09,13379,4252,9127,214.65,1625
2020-07-10,12792,3905,8887,227.58,1625
2020-07-11,9126,714,8412,1178.15,1625
2020-07-12,7261,1493,5768,386.34,1625
2020-07-13,12505,3410,9095,266.72,1625
2020-07-14,13379,4211,9168,217.72,1625
2020-07-15,13379,4053,9326,230.1,1625
2020-07-16,13379,4035,9344,231.57,1625
2020-07-17,12792,3632,9160,252.2,1625
2020-07-18,9126,362,8764,2420.99,1625
2020-07-19,7261,1287,5974,464.18,1625
2020-07-20,12505,2833,9672,341.4,1625
2020-07-21,13379,3492,9887,283.13,1625
2020-07-22,13379,3176,10203,321.25,1625
2020-07-23,13379,2985,10394,348.21,1625
2020-07-24,12792,2401,10391,432.78,1625
2020-07-25,9126,1610,7516,466.83,1625
2020-07-26,7261,503,6758,1343.54,1625
2020-07-27,12505,1035,11470,1108.21,1625
2020-07-28,13379,1513,11866,784.27,1625
2020-07-29,13379,1028,12351,1201.46,1625
2020-07-30,13379,684,12695,1855.99,1625
2020-07-31,12792,2199,10593,481.72,1625
2020-08-01,8785,350,8435,2410.0,1625
2020-08-02,7380,350,7030,2008.57,1625
2020-08-03,12295,1448,10847,749.1,1625
2020-08-04,12756,1540,11216,728.31,1625
2020-08-05,12756,1590,11166,702.26,1625
2020-08-06,12756,1528,11228,734.82,1625
2020-08-07,11964,1159,10805,932.27,1625
2020-08-08,8785,1159,7626,657.98,1625
2020-08-09,7380,1159,6221,536.76,1625
2020-08-10,12295,600,11695,1949.17,1625
2020-08-11,12756,866,11890,1372.98,1625
2020-08-12,12756,752,12004,1596.28,1625
2020-08-13,12756,705,12051,1709.36,1625
2020-08-14,11964,335,11629,3471.34,1625
2020-08-15,8785,335,8450,2522.39,1625
2020-08-16,7380,335,7045,2102.99,1625
2020-08-17,12295,345,11950,3463.77,1625
2020-08-18,12756,687,12069,1756.77,1625
2020-08-19,12756,828,11928,1440.58,1625
2020-08-20,12756,804,11952,1486.57,1625
2020-08-21,11964,679,11285,1662.0,1625
2020-08-22,8785,679,8106,1193.81,1625
2020-08-23,7380,679,6701,986.89,1625
2020-08-24,12295,566,11729,2072.26,1625
2020-08-25,12756,848,11908,1404.25,1625
2020-08-26,12756,1022,11734,1148.14,1625
2020-08-27,12756,1095,11661,1064.93,1625
2020-08-28,11964,1006,10958,1089.26,1625
2020-08-29,8785,1006,7779,773.26,1625
2020-08-30,7380,1006,6374,633.6,1625
2020-08-31,12295,713,11582,1624.4,1625
2020-09-01,14034,1235,12799,1036.36,1625
2020-09-02,14034,1193,12841,1076.36,1625
2020-09-03,14034,1164,12870,1105.67,1625
2020-09-04,13632,899,12733,1416.35,1625
2020-09-05,10323,899,9424,1048.28,1625
2020-09-06,8244,899,7345,817.02,1625
2020-09-07,13332,576,12756,2214.58,1625
2020-09-08,14034,1028,13006,1265.18,1625
2020-09-09,14034,865,13169,1522.43,1625
2020-09-10,14034,856,13178,1539.49,1625
2020-09-11,13632,655,12977,1981.22,1625
2020-09-12,10323,655,9668,1476.03,1625
2020-09-13,8244,655,7589,1158.63,1625
2020-09-14,13332,246,13086,5319.51,1625
2020-09-15,14034,765,13269,1734.51,1625
2020-09-16,14034,806,13228,1641.19,1625
2020-09-17,14034,922,13112,1422.13,1625
2020-09-18,13632,558,13074,2343.01,1625
2020-09-19,10323,558,9765,1750.0,1625
2020-09-20,8244,558,7686,1377.42,1625
2020-09-21,13332,671,12661,1886.89,1625
2020-09-22,14034,1337,12697,949.66,1625
2020-09-23,14034,1339,12695,948.1,1625
2020-09-24,14034,1510,12524,829.4,1625
2020-09-25,13632,1575,12057,765.52,1625
2020-09-26,10323,342,9981,2918.42,1625
2020-09-27,8244,342,7902,2310.53,1625
2020-09-28,13332,1854,11478,619.09,1625
2020-09-29,14034,2281,11753,515.26,1625
2020-09-30,14034,2480,11554,465.89,1625
2020-10-01,13848,2700,11148,412.89,1625
2020-10-02,13537,2766,10771,389.41,1625
2020-10-03,10115,1196,8919,745.74,1625
2020-10-04,7610,421,7189,1707.6,1625
2020-10-05,13375,2872,10503,365.7,1625
2020-10-06,13848,3356,10492,312.63,1625
2020-10-07,13848,3390,10458,308.5,1625
2020-10-08,13848,43,13805,32104.65,1625
2020-10-09,13537,3426,10111,295.13,1625
2020-10-10,10115,1977,8138,411.63,1625
2020-10-11,7610,1061,6549,617.25,1625
2020-10-12,13375,3470,9905,285.45,1625
2020-10-13,13848,469,13379,2852.67,1625
2020-10-14,13848,359,13489,3757.38,1625
2020-10-15,13848,385,13463,3496.88,1625
2020-10-16,13537,32,13505,42203.12,1625
2020-10-17,10115,2182,7933,363.57,1625
2020-10-18,7610,1041,6569,631.03,1625
2020-10-19,13375,3462,9913,286.34,1625
2020-10-20,13848,259,13589,5246.72,1625
2020-10-21,13848,103,13745,13344.66,1625
2020-10-22,13848,110,13738,12489.09,1625
2020-10-23,13537,3469,10068,290.23,1625
2020-10-24,10115,1983,8132,410.09,1625
2020-10-25,7610,1285,6325,492.22,1625
2020-10-26,13375,3530,9845,278.9,1625
2020-10-27,13848,204,13644,6688.24,1625
2020-10-28,13848,142,13706,9652.11,1625
2020-10-29,13848,250,13598,5439.2,1625
2020-10-30,13537,8,13529,169112.5,1625
2020-10-31,10115,2489,7626,306.39,1625
2020-11-01,5625,1648,3977,241.32,1625
2020-11-02,11683,3950,7733,195.77,1625
2020-11-03,10792,858,9934,1157.81,1625
2020-11-04,10792,874,9918,1134.78,1625
2020-11-05,10792,1045,9747,932.73,1625
2020-11-06,10542,849,9693,1141.7,1625
2020-11-07,6709,3017,3692,122.37,1625
2020-11-08,5625,2066,3559,172.27,1625
2020-11-09,11683,763,10920,1431.19,1625
2020-11-10,10792,1689,9103,538.96,1625
2020-11-11,10792,1654,9138,552.48,1625
2020-11-12,10792,1756,9036,514.58,1625
2020-11-13,10542,1474,9068,615.2,1625
2020-11-14,6709,3515,3194,90.87,1625
2020-11-15,5625,2481,3144,126.72,1625
2020-11-16,11683,1062,10621,1000.09,1625
2020-11-17,10792,1866,8926,478.35,1625
2020-11-18,10792,1707,9085,532.22,1625
2020-11-19,10792,1688,9104,539.34,1625
2020-11-20,10542,1289,9253,717.84,1625
2020-11-21,6709,3536,3173,89.73,1625
2020-11-22,5625,2514,3111,123.75,1625
2020-11-23,11683,588,11095,1886.9,1625
2020-11-24,10792,1324,9468,715.11,1625
2020-11-25,10792,1114,9678,868.76,1625
2020-11-26,10792,1061,9731,917.15,1625
2020-11-27,10542,647,9895,1529.37,1625
2020-11-28,6709,3362,3347,99.55,1625
2020-11-29,5625,2470,3155,127.73,1625
2020-11-30,11683,7,11676,166800.0,1625
2020-12-01,11475,794,10681,1345.21,1625
2020-12-02,11475,648,10827,1670.83,1625
2020-12-03,11475,669,10806,1615.25,1625
2020-12-04,12513,337,12176,3613.06,1625
2020-12-05,8282,3357,4925,146.71,1625
2020-12-06,5627,2213,3414,154.27,1625
2020-12-07,11546,4799,6747,140.59,1625
2020-12-08,11475,819,10656,1301.1,1625
2020-12-09,11475,745,10730,1440.27,1625
2020-12-10,11475,827,10648,1287.55,1625
2020-12-11,12513,543,11970,2204.42,1625
2020-12-12,8282,3655,4627,126.59,1625
2020-12-13,5627,2580,3047,118.1,1625
2020-12-14,11546,211,11335,5372.04,1625
2020-12-15,11475,1061,10414,981.53,1625
2020-12-16,11475,952,10523,1105.36,1625
2020-12-17,11475,984,10491,1066.16,1625
2020-12-18,12513,633,11880,1876.78,1625
2020-12-19,8282,3803,4479,117.78,1625
2020-12-20,5627,2753,2874,104.4,1625
2020-12-21,11546,25,11521,46084.0,1625
2020-12-22,11475,766,10709,1398.04,1625
2020-12-23,11475,543,10932,2013.26,1625
2020-12-24,11475,459,11016,2400.0,1625
2020-12-25,12513,5345,7168,134.11,1625
2020-12-26,8282,3519,4763,135.35,1625
2020-12-27,5627,2615,3012,115.18,1625
2020-12-28,11546,4830,6716,139.05,1625
2020-12-29,11475,5225,6250,119.62,1625
2020-12-30,11475,5128,6347,123.77,1625
2020-12-31,11475,5085,6390,125.66,1625
2021-01-01,9788,4857,4931,101.52,1625
2021-01-02,6068,3155,2913,92.33,1625
2021-01-03,4866,1919,2947,153.57,1625
2021-01-04,9804,4378,5426,123.94,1625
2021-01-05,10224,4749,5475,115.29,1625
2021-01-06,10224,4814,5410,112.38,1625
2021-01-07,10224,4755,5469,115.02,1625
2021-01-08,9788,4556,5232,114.84,1625
2021-01-09,6068,2884,3184,110.4,1625
2021-01-10,4866,1935,2931,151.47,1625
2021-01-11,9804,4284,5520,128.85,1625
2021-01-12,10224,4685,5539,118.23,1625
2021-01-13,10224,4918,5306,107.89,1625
2021-01-14,10224,4959,5265,106.17,1625
2021-01-15,9788,4376,5412,123.67,1625
2021-01-16,6068,2980,3088,103.62,1625
2021-01-17,4866,2039,2827,138.65,1625
2021-01-18,9804,4311,5493,127.42,1625
2021-01-19,10224,4965,5259,105.92,1625
2021-01-20,10224,4865,5359,110.15,1625
2021-01-21,10224,4797,5427,113.13,1625
2021-01-22,9788,4595,5193,113.01,1625
2021-01-23,6068,3222,2846,88.33,1625
2021-01-24,4866,2120,2746,129.53,1625
2021-01-25,9804,4604,5200,112.95,1625
2021-01-26,10224,4831,5393,111.63,1625
2021-01-27,10224,4836,5388,111.41,1625
2021-01-28,10224,4659,5565,119.45,1625
2021-01-29,9788,4615,5173,112.09,1625
2021-01-30,6068,3025,3043,100.6,1625
2021-01-31,4866,2117,2749,129.85,1625
2021-02-01,11657,4448,7209,162.07,1625
2021-02-02,11812,4757,7055,148.31,1625
2021-02-03,11812,4460,7352,164.84,1625
2021-02-04,11812,4581,7231,157.85,1625
2021-02-05,11354,4356,6998,160.65,1625
2021-02-06,7636,2745,4891,178.18,1625
2021-02-07,5861,1606,4255,264.94,1625
2021-02-08,11657,4029,7628,189.33,1625
2021-02-09,11812,4279,7533,176.05,1625
2021-02-10,11812,4333,7479,172.61,1625
2021-02-11,11812,4280,7532,175.98,1625
2021-02-12,11354,4016,7338,182.72,1625
2021-02-13,7636,2463,5173,210.03,1625
2021-02-14,5861,1616,4245,262.69,1625
2021-02-15,11657,3886,7771,199.97,1625
2021-02-16,11812,4195,7617,181.57,1625
2021-02-17,11812,4184,7628,182.31,1625
2021-02-18,11812,4327,7485,172.98,1625
2021-02-19,11354,4039,7315,181.11,1625
2021-02-20,7636,2524,5112,202.54,1625
2021-02-21,5861,1785,4076,228.35,1625
2021-02-22,11657,4068,7589,186.55,1625
2021-02-23,11812,4588,7224,157.45,1625
2021-02-24,11812,4382,7430,169.56,1625
2021-02-25,11812,4536,7276,160.41,1625
2021-02-26,11354,4324,7030,162.58,1625
2021-02-27,7636,2714,4922,181.36,1625
2021-02-28,5861,1968,3893,197.82,1625
2021-03-01,11637,4186,7451,178.0,1625
2021-03-02,12319,4859,7460,153.53,1625
2021-03-03,12319,4474,7845,175.35,1625
2021-03-04,12319,4560,7759,170.15,1625
2021-03-05,11769,4622,7147,154.63,1625
2021-03-06,8078,2882,5196,180.29,1625
2021-03-07,5895,1823,4072,223.37,1625
2021-03-08,11637,4014,7623,189.91,1625
2021-03-09,12319,4668,7651,163.9,1625
2021-03-10,12319,4533,7786,171.76,1625
2021-03-11,12319,4668,7651,163.9,1625
2021-03-12,11769,4525,7244,160.09,1625
2021-03-13,8078,2780,5298,190.58,1625
2021-03-14,5895,1810,4085,225.69,1625
2021-03-15,11637,4102,7535,183.69,1625
2021-03-16,12319,4815,7504,155.85,1625
2021-03-17,12319,4651,7668,164.87,1625
2021-03-18,12319,4541,7778,171.28,1625
2021-03-19,11769,4301,7468,173.63,1625
2021-03-20,8078,2591,5487,211.77,1625
2021-03-21,5895,1825,4070,223.01,1625
2021-03-22,11637,4327,7310,168.94,1625
2021-03-23,12319,4799,7520,156.7,1625
2021-03-24,12319,4824,7495,155.37,1625
2021-03-25,12319,4744,7575,159.68,1625
2021-03-26,11769,4596,7173,156.07,1625
2021-03-27,8078,3232,4846,149.94,1625
2021-03-28,5895,2142,3753,175.21,1625
2021-03-29,11637,4543,7094,156.15,1625
2021-03-30,12319,4903,7416,151.25,1625
2021-03-31,12319,5027,7292,145.06,1625
2021-04-01,11065,4989,6076,121.79,1625
2021-04-02,10207,4962,5245,105.7,1625
2021-04-03,6435,3359,3076,91.57,1625
2021-04-04,5127,2386,2741,114.88,1625
2021-04-05,10993,4691,6302,134.34,1625
2021-04-06,11065,5169,5896,114.06,1625
2021-04-07,11065,5304,5761,108.62,1625
2021-04-08,11065,5516,5549,100.6,1625
2021-04-09,10207,5219,4988,95.57,1625
2021-04-10,6435,3545,2890,81.52,1625
2021-04-11,5127,2470,2657,107.57,1625
2021-04-12,10993,4863,6130,126.05,1625
2021-04-13,11065,5149,5916,114.9,1625
2021-04-14,11065,5337,5728,107.33,1625
2021-04-15,11065,5143,5922,115.15,1625
2021-04-16,10207,4942,5265,106.54,1625
2021-04-17,6435,3245,3190,98.31,1625
2021-04-18,5127,2434,2693,110.64,1625
2021-04-19,10993,4611,6382,138.41,1625
2021-04-20,11065,5162,5903,114.35,1625
2021-04-21,11065,5004,6061,121.12,1625
2021-04-22,11065,5021,6044,120.37,1625
2021-04-23,10207,5145,5062,98.39,1625
2021-04-24,6435,3351,3084,92.03,1625
2021-04-25,5127,2520,2607,103.45,1625
2021-04-26,10993,4594,6399,139.29,1625
2021-04-27,11065,5149,5916,114.9,1625
2021-04-28,11065,5240,5825,111.16,1625
2021-04-29,11065,5096,5969,117.13,1625
2021-04-30,10207,5161,5046,97.77,1625
2021-05-01,8554,3473,5081,146.3,1625
2021-05-02,6403,2236,4167,186.36,1625
2021-05-03,12702,4793,7909,165.01,1625
2021-05-04,13492,5569,7923,142.27,1625
2021-05-05,13492,5438,8054,148.11,1625
2021-05-06,13492,5456,8036,147.29,1625
2021-05-07,12468,5144,7324,142.38,1625
2021-05-08,8554,3689,4865,131.88,1625
2021-05-09,6403,2810,3593,127.86,1625
2021-05-10,12702,4851,7851,161.84,1625
2021-05-11,13492,5534,7958,143.8,1625
2021-05-12,13492,5232,8260,157.87,1625
2021-05-13,13492,5576,7916,141.97,1625
2021-05-14,12468,5285,7183,135.91,1625
2021-05-15,8554,3604,4950,137.35,1625
2021-05-16,6403,2875,3528,122.71,1625
2021-05-17,12702,5108,7594,148.67,1625
2021-05-18,13492,5603,7889,140.8,1625
2021-05-19,13492,5346,8146,152.38,1625
2021-05-20,13492,5471,8021,146.61,1625
2021-05-21,12468,5393,7075,131.19,1625
2021-05-22,8554,3612,4942,136.82,1625
2021-05-23,6403,2585,3818,147.7,1625
2021-05-24,12702,4945,7757,156.87,1625
2021-05-25,13492,5480,8012,146.2,1625
2021-05-26,13492,5530,7962,143.98,1625
2021-05-27,13492,5316,8176,153.8,1625
2021-05-28,12468,5034,7434,147.68,1625
2021-05-29,8554,3264,5290,162.07,1625
2021-05-30,6403,2696,3707,137.5,1625
2021-05-31,12702,5039,7663,152.07,1625
2021-06-01,13546,5342,8204,153.58,1625
2021-06-02,13546,5275,8271,156.8,1625
2021-06-03,13546,5435,8111,149.24,1625
2021-06-04,12412,5236,7176,137.05,1625
2021-06-05,9093,3852,5241,136.06,1625
2021-06-06,7280,2752,4528,164.53,1625
2021-06-07,12684,4761,7923,166.41,1625
2021-06-08,13546,5408,8138,150.48,1625
2021-06-09,13546,5473,8073,147.51,1625
2021-06-10,13546,5477,8069,147.33,1625
2021-06-11,12412,5347,7065,132.13,1625
2021-06-12,9093,3788,5305,140.05,1625
2021-06-13,7280,3082,4198,136.21,1625
2021-06-14,12684,5306,7378,139.05,1625
2021-06-15,13546,5466,8080,147.82,1625
2021-06-16,13546,5471,8075,147.6,1625
2021-06-17,13546,5611,7935,141.42,1625
2021-06-18,12412,5670,6742,118.91,1625
2021-06-19,9093,3748,5345,142.61,1625
2021-06-20,7280,2818,4462,158.34,1625
2021-06-21,12684,5182,7502,144.77,1625
2021-06-22,13546,5606,7940,141.63,1625
2021-06-23,13546,5533,8013,144.82,1625
2021-06-24,13546,5473,8073,147.51,1625
2021-06-25,12412,5231,7181,137.28,1625
2021-06-26,9093,3750,5343,142.48,1625
2021-06-27,7280,2047,5233,255.64,1625
2021-06-28,12684,4619,8065,174.6,1625
2021-06-29,13546,5091,8455,166.08,1625
2021-06-30,13546,4900,8646,176.45,1625
2021-07-01,10711,5059,5652,111.72,1625
2021-07-02,10605,4854,5751,118.48,1625
2021-07-03,7338,3251,4087,125.72,1625
2021-07-04,6118,2563,3555,138.7,1625
2021-07-05,10188,4719,5469,115.89,1625
2021-07-06,10711,5291,5420,102.44,1625
2021-07-07,10711,5279,5432,102.9,1625
2021-07-08,10711,4890,5821,119.04,1625
2021-07-09,10605,5115,5490,107.33,1625
2021-07-10,7338,3524,3814,108.23,1625
2021-07-11,6118,2388,3730,156.2,1625
2021-07-12,10188,4718,5470,115.94,1625
2021-07-13,10711,5340,5371,100.58,1625
2021-07-14,10711,5102,5609,109.94,1625
2021-07-15,10711,4935,5776,117.04,1625
2021-07-16,10605,5045,5560,110.21,1625
2021-07-17,7338,3297,4041,122.57,1625
2021-07-18,6118,2511,3607,143.65,1625
2021-07-19,10188,4605,5583,121.24,1625
2021-07-20,10711,5260,5451,103.63,1625
2021-07-21,10711,5312,5399,101.64,1625
2021-07-22,10711,4735,5976,126.21,1625
2021-07-23,10605,4671,5934,127.04,1625
2021-07-24,7338,2930,4408,150.44,1625
2021-07-25,6118,2177,3941,181.03,1625
2021-07-26,10188,4486,5702,127.11,1625
2021-07-27,10711,4656,6055,130.05,1625
2021-07-28,10711,4395,6316,143.71,1625
2021-07-29,10711,4186,6525,155.88,1625
2021-07-30,10605,3941,6664,169.09,1625
2021-07-31,7338,2304,5034,218.49,1625
2021-08-01,5851,1058,4793,453.02,1625
2021-08-02,9634,3191,6443,201.91,1625
2021-08-03,9694,3367,6327,187.91,1625
2021-08-04,9694,3413,6281,184.03,1625
2021-08-05,9694,3108,6586,211.9,1625
2021-08-06,9145,2663,6482,243.41,1625
2021-08-07,6854,951,5903,620.72,1625
2021-08-08,5851,951,4900,515.25,1625
2021-08-09,9634,2126,7508,353.15,1625
2021-08-10,9694,2471,7223,292.31,1625
2021-08-11,9694,2616,7078,270.57,1625
2021-08-12,9694,2438,7256,297.62,1625
2021-08-13,9145,1613,7532,466.96,1625
2021-08-14,6854,450,6404,1423.11,1625
2021-08-15,5851,49,5802,11840.82,1625
2021-08-16,9634,2162,7472,345.61,1625
2021-08-17,9694,2395,7299,304.76,1625
2021-08-18,9694,2230,7464,334.71,1625
2021-08-19,9694,2276,7418,325.92,1625
2021-08-20,9145,2255,6890,305.54,1625
2021-08-21,6854,776,6078,783.25,1625
2021-08-22,5851,776,5075,653.99,1625
2021-08-23,9634,2218,7416,334.36,1625
2021-08-24,9694,2567,7127,277.64,1625
2021-08-25,9694,2511,7183,286.06,1625
2021-08-26,9694,2698,6996,259.3,1625
2021-08-27,9145,2751,6394,232.42,1625
2021-08-28,6854,1158,5696,491.88,1625
2021-08-29,5851,197,5654,2870.05,1625
2021-08-30,9634,2583,7051,272.98,1625
2021-08-31,9694,2990,6704,224.21,1625
2021-09-01,13106,3340,9766,292.4,1625
2021-09-02,13106,2769,10337,373.31,1625
2021-09-03,12506,2880,9626,334.24,1625
2021-09-04,9128,1528,7600,497.38,1625
2021-09-05,7300,363,6937,1911.02,1625
2021-09-06,12610,2790,9820,351.97,1625
2021-09-07,13106,3116,9990,320.6,1625
2021-09-08,13106,2573,10533,409.37,1625
2021-09-09,13106,2937,10169,346.24,1625
2021-09-10,12506,2660,9846,370.15,1625
2021-09-11,9128,1017,8111,797.54,1625
2021-09-12,7300,72,7228,10038.89,1625
2021-09-13,12610,2420,10190,421.07,1625
2021-09-14,13106,3070,10036,326.91,1625
2021-09-15,13106,2944,10162,345.18,1625
2021-09-16,13106,2792,10314,369.41,1625
2021-09-17,12506,2623,9883,376.78,1625
2021-09-18,9128,1333,7795,584.77,1625
2021-09-19,7300,450,6850,1522.22,1625
2021-09-20,12610,2976,9634,323.72,1625
2021-09-21,13106,3303,9803,296.79,1625
2021-09-22,13106,3357,9749,290.41,1625
2021-09-23,13106,3494,9612,275.1,1625
2021-09-24,12506,3344,9162,273.98,1625
2021-09-25,9128,2197,6931,315.48,1625
2021-09-26,7300,1018,6282,617.09,1625
2021-09-27,12610,3863,8747,226.43,1625
2021-09-28,13106,4214,8892,211.01,1625
2021-09-29,13106,4425,8681,196.18,1625
2021-09-30,13106,4455,8651,194.19,1625
2021-10-01,13516,4872,8644,177.42,1625
2021-10-02,9827,3445,6382,185.25,1625
2021-10-03,7736,2713,5023,185.15,1625
2021-10-04,12288,5048,7240,143.42,1625
2021-10-05,13645,5699,7946,139.43,1625
2021-10-06,13645,5987,7658,127.91,1625
2021-10-07,13645,5659,7986,141.12,1625
2021-10-08,13516,5647,7869,139.35,1625
2021-10-09,9827,4433,5394,121.68,1625
2021-10-10,7736,3249,4487,138.1,1625
2021-10-11,12288,5810,6478,111.5,1625
2021-10-12,13645,6348,7297,114.95,1625
2021-10-13,13645,6214,7431,119.58,1625
2021-10-14,13645,6298,7347,116.66,1625
2021-10-15,13516,6057,7459,123.15,1625
2021-10-16,9827,4611,5216,113.12,1625
2021-10-17,7736,3694,4042,109.42,1625
2021-10-18,12288,5934,6354,107.08,1625
2021-10-19,13645,6346,7299,115.02,1625
2021-10-20,13645,6574,7071,107.56,1625
2021-10-21,13645,6204,7441,119.94,1625
2021-10-22,13516,6423,7093,110.43,1625
2021-10-23,9827,4708,5119,108.73,1625
2021-10-24,7736,3766,3970,105.42,1625
2021-10-25,12288,6111,6177,101.08,1625
2021-10-26,13645,6546,7099,108.45,1625
2021-10-27,13645,6716,6929,103.17,1625
2021-10-28,13645,6601,7044,106.71,1625
2021-10-29,13516,6541,6975,106.64,1625
2021-10-30,9827,5242,4585,87.47,1625
2021-10-31,7736,4161,3575,85.92,1625
2021-11-01,11656,6554,5102,77.85,1625
2021-11-02,12777,7151,5626,78.67,1625
2021-11-03,12777,7025,5752,81.88,1625
2021-11-04,12777,7043,5734,81.41,1625
2021-11-05,13054,7291,5763,79.04,1625
2021-11-06,8837,5779,3058,52.92,1625
2021-11-07,7500,4919,2581,52.47,1625
2021-11-08,11656,7509,4147,55.23,1625
2021-11-09,12777,7676,5101,66.45,1625
2021-11-10,12777,7765,5012,64.55,1625
2021-11-11,12777,7771,5006,64.42,1625
2021-11-12,13054,7652,5402,70.6,1625
2021-11-13,8837,6315,2522,39.94,1625
2021-11-14,7500,5448,2052,37.67,1625
2021-11-15,11656,7387,4269,57.79,1625
2021-11-16,12777,8002,4775,59.67,1625
2021-11-17,12777,7893,4884,61.88,1625
2021-11-18,12777,8229,4548,55.27,1625
2021-11-19,13054,7837,5217,66.57,1625
2021-11-20,8837,6317,2520,39.89,1625
2021-11-21,7500,5459,2041,37.39,1625
2021-11-22,11656,7843,3813,48.62,1625
2021-11-23,12777,7946,4831,60.8,1625
2021-11-24,12777,7856,4921,62.64,1625
2021-11-25,12777,7879,4898,62.17,1625
2021-11-26,13054,7886,5168,65.53,1625
2021-11-27,8837,6263,2574,41.1,1625
2021-11-28,7500,5229,2271,43.43,1625
2021-11-29,11656,8029,3627,45.17,1625
2021-11-30,12777,7996,4781,59.79,1625
2021-12-01,11535,8141,3394,41.69,1625
2021-12-02,11535,8046,3489,43.36,1625
2021-12-03,10156,7860,2296,29.21,1625
2021-12-04,7262,6364,898,14.11,1625
2021-12-05,6215,5300,915,17.26,1625
2021-12-06,11658,7808,3850,49.31,1625
2021-12-07,11535,8068,3467,42.97,1625
2021-12-08,11535,8074,3461,42.87,1625
2021-12-09,11535,8159,3376,41.38,1625
2021-12-10,10156,8367,1789,21.38,1625
2021-12-11,7262,6454,808,12.52,1625
2021-12-12,6215,5852,363,6.2,1625
2021-12-13,11658,8124,3534,43.5,1625
2021-12-14,11535,8669,2866,33.06,1625
2021-12-15,11535,8840,2695,30.49,1625
2021-12-16,11535,8781,2754,31.36,1625
2021-12-17,10156,8916,1240,13.91,1625
2021-12-18,7262,7121,141,1.98,1625
2021-12-19,6215,6048,167,2.76,1625
2021-12-20,11658,8556,3102,36.26,1625
2021-12-21,11535,8874,2661,29.99,1625
2021-12-22,11535,8586,2949,34.35,1625
2021-12-23,11535,8494,3041,35.8,1625
2021-12-24,10156,8473,1683,19.86,1625
2021-12-25,7262,6856,406,5.92,1625
2021-12-26,6215,5393,822,15.24,1625
2021-12-27,11658,8050,3608,44.82,1625
2021-12-28,11535,8460,3075,36.35,1625
2021-12-29,11535,8212,3323,40.47,1625
2021-12-30,11535,8377,3158,37.7,1625
2021-12-31,10156,8173,1983,24.26,1625
2022-01-01,7896,6298,1598,25.37,1625
2022-01-02,5863,5991,-128,-2.14,1625
2022-01-03,10691,8131,2560,31.48,1625
2022-01-04,11280,8434,2846,33.74,1625
2022-01-05,11280,8018,3262,40.68,1625
2022-01-06,11280,8069,3211,39.79,1625
2022-01-07,11081,8053,3028,37.6,1625
2022-01-08,7896,6538,1358,20.77,1625
2022-01-09,5863,5391,472,8.76,1625
2022-01-10,10691,7821,2870,36.7,1625
2022-01-11,11280,8096,3184,39.33,1625
2022-01-12,11280,8139,3141,38.59,1625
2022-01-13,11280,8248,3032,36.76,1625
2022-01-14,11081,8083,2998,37.09,1625
2022-01-15,7896,6483,1413,21.8,1625
2022-01-16,5863,5394,469,8.69,1625
2022-01-17,10691,7803,2888,37.01,1625
2022-01-18,11280,8644,2636,30.5,1625
2022-01-19,11280,8431,2849,33.79,1625
2022-01-20,11280,8357,2923,34.98,1625
2022-01-21,11081,8328,2753,33.06,1625
2022-01-22,7896,6503,1393,21.42,1625
2022-01-23,5863,5689,174,3.06,1625
2022-01-24,10691,8243,2448,29.7,1625
2022-01-25,11280,8277,3003,36.28,1625
2022-01-26,11280,8490,2790,32.86,1625
2022-01-27,11280,8657,2623,30.3,1625
2022-01-28,11081,8801,2280,25.91,1625
2022-01-29,7896,7017,879,12.53,1625
2022-01-30,5863,5686,177,3.11,1625
2020-02-01,41812,32326,9486,29.34,1608
2020-02-02,37848,29238,8610,29.45,1608
2020-02-03,47596,40733,6863,16.85,1608
2020-02-04,48819,41810,7009,16.76,1608
2020-02-05,48819,41775,7044,16.86,1608
2020-02-06,48819,41673,7146,17.15,1608
2020-02-07,51126,42356,8770,20.71,1608
2020-02-08,41812,32072,9740,30.37,1608
2020-02-09,37848,28956,8892,30.71,1608
2020-02-10,47596,40437,7159,17.7,1608
2020-02-11,48819,41516,7303,17.59,1608
2020-02-12,48819,41498,7321,17.64,1608
2020-02-13,48819,41429,7390,17.84,1608
2020-02-14,51126,42159,8967,21.27,1608
2020-02-15,41812,31935,9877,30.93,1608
2020-02-16,37848,28890,8958,31.01,1608
2020-02-17,47596,40453,7143,17.66,1608
2020-02-18,48819,41621,7198,17.29,1608
2020-02-19,48819,41695,7124,17.09,1608
2020-02-20,48819,41721,7098,17.01,1608
2020-02-21,51126,42545,8581,20.17,1608
2020-02-22,41812,32413,9399,29.0,1608
2020-02-23,37848,29453,8395,28.5,1608
2020-02-24,47596,41093,6503,15.83,1608
2020-02-25,48819,42327,6492,15.34,1608
2020-02-26,48819,42455,6364,14.99,1608
2020-02-27,48819,42522,6297,14.81,1608
2020-02-28,51126,43372,7754,17.88,1608
2020-02-29,41812,33249,8563,25.75,1608
2020-03-01,25977,30284,-4307,-14.22,1608
2020-03-02,36790,41903,-5113,-12.2,1608
2020-03-03,36778,43102,-6324,-14.67,1608
2020-03-04,36778,43182,-6404,-14.83,1608
2020-03-05,36778,43188,-6410,-14.84,1608
2020-03-06,38405,43968,-5563,-12.65,1608
2020-03-07,29142,33766,-4624,-13.69,1608
2020-03-08,25977,30717,-4740,-15.43,1608
2020-03-09,36790,42249,-5459,-12.92,1608
2020-03-10,36778,43359,-6581,-15.18,1608
2020-03-11,36778,43352,-6574,-15.16,1608
2020-03-12,36778,43275,-6497,-15.01,1608
2020-03-13,38405,43978,-5573,-12.67,1608
2020-03-14,29142,33708,-4566,-13.55,1608
2020-03-15,25977,30600,-4623,-15.11,1608
2020-03-16,36790,42083,-5293,-12.58,1608
2020-03-17,36778,43158,-6380,-14.78,1608
2020-03-18,36778,43128,-6350,-14.72,1608
2020-03-19,36778,43040,-6262,-14.55,1608
2020-03-20,38405,43744,-5339,-12.21,1608
2020-03-21,29142,33487,-4345,-12.98,1608
2020-03-22,25977,30404,-4427,-14.56,1608
2020-03-23,36790,41921,-5131,-12.24,1608
2020-03-24,36778,43036,-6258,-14.54,1608
2020-03-25,36778,43054,-6276,-14.58,1608
2020-03-26,36778,43017,-6239,-14.5,1608
2020-03-27,38405,43775,-5370,-12.27,1608
2020-03-28,29142,33571,-4429,-13.19,1608
2020-03-29,25977,30538,-4561,-14.94,1608
2020-03-30,36790,42101,-5311,-12.61,1608
2020-03-31,36778,43257,-6479,-14.98,1608
2020-04-01,33578,43306,-9728,-22.46,1608
2020-04-02,33578,43293,-9715,-22.44,1608
2020-04-03,31688,44063,-12375,-28.08,1608
2020-04-04,23040,33863,-10823,-31.96,1608
2020-04-05,17880,30821,-12941,-41.99,1608
2020-04-06,33528,42365,-8837,-20.86,1608
2020-04-07,33578,43492,-9914,-22.79,1608
2020-04-08,33578,43504,-9926,-22.82,1608
2020-04-09,33578,43444,-9866,-22.71,1608
2020-04-10,31688,44162,-12474,-28.25,1608
2020-04-11,23040,33904,-10864,-32.04,1608
2020-04-12,17880,30802,-12922,-41.95,1608
2020-04-13,33528,42285,-8757,-20.71,1608
2020-04-14,33578,43352,-9774,-22.55,1608
2020-04-15,33578,43306,-9728,-22.46,1608
2020-04-16,33578,43195,-9617,-22.26,1608
2020-04-17,31688,43868,-12180,-27.77,1608
2020-04-18,23040,33573,-10533,-31.37,1608
2020-04-19,17880,30444,-12564,-41.27,1608
2020-04-20,33528,41911,-8383,-20.0,1608
2020-04-21,33578,42973,-9395,-21.86,1608
2020-04-22,33578,42934,-9356,-21.79,1608
2020-04-23,33578,42841,-9263,-21.62,1608
2020-04-24,31688,43543,-11855,-27.23,1608
2020-04-25,23040,33288,-10248,-30.79,1608
2020-04-26,17880,30207,-12327,-40.81,1608
2020-04-27,33528,41729,-8201,-19.65,1608
2020-04-28,33578,42852,-9274,-21.64,1608
2020-04-29,33578,42877,-9299,-21.69,1608
2020-04-30,33578,42849,-9271,-21.64,1608
2020-05-01,43546,43615,-69,-0.16,1608
2020-05-02,34122,33420,702,2.1,1608
2020-05-03,28653,30395,-1742,-5.73,1608
2020-05-04,42254,41964,290,0.69,1608
2020-05-05,43674,43125,549,1.27,1608
2020-05-06,43674,43176,498,1.15,1608
2020-05-07,43674,43162,512,1.19,1608
2020-05-08,43546,43929,-383,-0.87,1608
2020-05-09,34122,33720,402,1.19,1608
2020-05-10,28653,30666,-2013,-6.56,1608
2020-05-11,42254,42193,61,0.14,1608
2020-05-12,43674,43298,376,0.87,1608
2020-05-13,43674,43281,393,0.91,1608
2020-05-14,43674,43188,486,1.13,1608
2020-05-15,43546,43867,-321,-0.73,1608
2020-05-16,34122,33562,560,1.67,1608
2020-05-17,28653,30409,-1756,-5.77,1608
2020-05-18,42254,41833,421,1.01,1608
2020-05-19,43674,42836,838,1.96,1608
2020-05-20,43674,42720,954,2.23,1608
2020-05-21,43674,42533,1141,2.68,1608
2020-05-22,43546,43124,422,0.98,1608
2020-05-23,34122,32743,1379,4.21,1608
2020-05-24,28653,29523,-870,-2.95,1608
2020-05-25,42254,40895,1359,3.32,1608
2020-05-26,43674,41859,1815,4.34,1608
2020-05-27,43674,41719,1955,4.69,1608
2020-05-28,43674,41523,2151,5.18,1608
2020-05-29,43546,42120,1426,3.39,1608
2020-05-30,34122,31758,2364,7.44,1608
2020-05-31,28653,28571,82,0.29,1608
2020-06-01,47766,39988,7778,19.45,1608
2020-06-02,49593,41005,8588,20.94,1608
2020-06-03,49593,40927,8666,21.17,1608
2020-06-04,49593,40798,8795,21.56,1608
2020-06-05,48632,41465,7167,17.28,1608
2020-06-06,39385,31173,8212,26.34,1608
2020-06-07,33905,28054,5851,20.86,1608
2020-06-08,47766,39533,8233,20.83,1608
2020-06-09,49593,40607,8986,22.13,1608
2020-06-10,49593,40575,9018,22.23,1608
2020-06-11,49593,40481,9112,22.51,1608
2020-06-12,48632,41171,7461,18.12,1608
2020-06-13,39385,30890,8495,27.5,1608
2020-06-14,33905,27766,6139,22.11,1608
2020-06-15,47766,39227,8539,21.77,1608
2020-06-16,49593,40269,9324,23.15,1608
2020-06-17,49593,40192,9401,23.39,1608
2020-06-18,49593,40041,9552,23.86,1608
2020-06-19,48632,40665,7967,19.59,1608
2020-06-20,39385,30309,9076,29.94,1608
2020-06-21,33905,27105,6800,25.09,1608
2020-06-22,47766,38482,9284,24.13,1608
2020-06-23,49593,39440,10153,25.74,1608
2020-06-24,49593,39281,10312,26.25,1608
2020-06-25,49593,39054,10539,26.99,1608
2020-06-26,48632,39608,9024,22.78,1608
2020-06-27,39385,29192,10193,34.92,1608
2020-06-28,33905,25940,7965,30.71,1608
2020-06-29,47766,37283,10483,28.12,1608
2020-06-30,49593,38221,11372,29.75,1608
2020-07-01,46125,38058,8067,21.2,1608
2020-07-02,46125,37843,8282,21.89,1608
2020-07-03,47174,38424,8750,22.77,1608
2020-07-04,37436,28049,9387,33.47,1608
2020-07-05,33608,24853,8755,35.23,1608
2020-07-06,45351,36263,9088,25.06,1608
2020-07-07,46125,37276,8849,23.74,1608
2020-07-08,46125,37196,8929,24.01,1608
2020-07-09,46125,37066,9059,24.44,1608
2020-07-10,47174,37734,9440,25.02,1608
2020-07-11,37436,27443,9993,36.41,1608
2020-07-12,33608,24323,9285,38.17,1608
2020-07-13,45351,35799,9552,26.68,1608
2020-07-14,46125,36866,9259,25.12,1608
2020-07-15,46125,36823,9302,25.26,1608
2020-07-16,46125,36712,9413,25.64,1608
2020-07-17,47174,37378,9796,26.21,1608
2020-07-18,37436,27063,10373,38.33,1608
2020-07-19,33608,23895,9713,40.65,1608
2020-07-20,45351,35301,10050,28.47,1608
2020-07-21,46125,36273,9852,27.16,1608
2020-07-22,46125,36114,10011,27.72,1608
2020-07-23,46125,35866,10259,28.6,1608
2020-07-24,47174,36377,10797,29.68,1608
2020-07-25,37436,25891,11545,44.59,1608
2020-07-26,33608,22542,11066,49.09,1608
2020-07-27,45351,33759,11592,34.34,1608
2020-07-28,46125,34539,11586,33.54,1608
2020-07-29,46125,34190,11935,34.91,1608
2020-07-30,46125,33757,12368,36.64,1608
2020-07-31,47174,34095,13079,38.36,1608
2020-08-01,39253,23453,15800,67.37,1608
2020-08-02,35443,19968,15475,77.5,1608
2020-08-03,46847,31073,15774,50.76,1608
2020-08-04,47320,31771,15549,48.94,1608
2020-08-05,47320,31370,15950,50.84,1608
2020-08-06,47320,30921,16399,53.04,1608
2020-08-07,48258,31278,16980,54.29,1608
2020-08-08,39253,20693,18560,89.69,1608
2020-08-09,35443,17302,18141,104.85,1608
2020-08-10,46847,28537,18310,64.16,1608
2020-08-11,47320,29400,17920,60.95,1608
2020-08-12,47320,29198,18122,62.07,1608
2020-08-13,47320,28978,18342,63.3,1608
2020-08-14,48258,29589,18669,63.09,1608
2020-08-15,39253,19279,19974,103.6,1608
2020-08-16,35443,16180,19263,119.05,1608
2020-08-17,46847,27719,19128,69.01,1608
2020-08-18,47320,28893,18427,63.78,1608
2020-08-19,47320,29001,18319,63.17,1608
2020-08-20,47320,29085,18235,62.7,1608
2020-08-21,48258,29990,18268,60.91,1608
2020-08-22,39253,19959,19294,96.67,1608
2020-08-23,35443,17117,18326,107.06,1608
2020-08-24,46847,28888,17959,62.17,1608
2020-08-25,47320,30265,17055,56.35,1608
2020-08-26,47320,30544,16776,54.92,1608
2020-08-27,47320,30766,16554,53.81,1608
2020-08-28,48258,31773,16485,51.88,1608
2020-08-29,39253,21808,17445,79.99,1608
2020-08-30,35443,18998,16445,86.56,1608
2020-08-31,46847,30766,16081,52.27,1608
2020-09-01,51440,32108,19332,60.21,1608
2020-09-02,51440,32323,19117,59.14,1608
2020-09-03,51440,32454,18986,58.5,1608
2020-09-04,52504,33349,19155,57.44,1608
2020-09-05,43334,23254,20080,86.35,1608
2020-09-06,38744,20301,18443,90.85,1608
2020-09-07,49438,31918,17520,54.89,1608
2020-09-08,51440,33105,18335,55.38,1608
2020-09-09,51440,33168,18272,55.09,1608
2020-09-10,51440,33153,18287,55.16,1608
2020-09-11,52504,33913,18591,54.82,1608
2020-09-12,43334,23697,19637,82.87,1608
2020-09-13,38744,20641,18103,87.7,1608
2020-09-14,49438,32176,17262,53.65,1608
2020-09-15,51440,33305,18135,54.45,1608
2020-09-16,51440,33332,18108,54.33,1608
2020-09-17,51440,33307,18133,54.44,1608
2020-09-18,52504,34081,18423,54.06,1608
2020-09-19,43334,23903,19431,81.29,1608
2020-09-20,38744,20907,17837,85.32,1608
2020-09-21,49438,32521,16917,52.02,1608
2020-09-22,51440,33746,17694,52.43,1608
2020-09-23,51440,33883,17557,51.82,1608
2020-09-24,51440,33977,17463,51.4,1608
2020-09-25,52504,34876,17628,50.54,1608
2020-09-26,43334,24825,18509,74.56,1608
2020-09-27,38744,21953,16791,76.49,1608
2020-09-28,49438,33686,15752,46.76,1608
2020-09-29,51440,35019,16421,46.89,1608
2020-09-30,51440,35250,16190,45.93,1608
2020-10-01,51047,35423,15624,44.11,1608
2020-10-02,52732,36381,16351,44.94,1608
2020-10-03,42918,26369,16549,62.76,1608
2020-10-04,36531,23513,13018,55.37,1608
2020-10-05,49770,35239,14531,41.24,1608
2020-10-06,51047,36543,14504,39.69,1608
2020-10-07,51047,36724,14323,39.0,1608
2020-10-08,51047,36825,14222,38.62,1608
2020-10-09,52732,37693,15039,39.9,1608
2020-10-10,42918,27574,15344,55.65,1608
2020-10-11,36531,24600,11931,48.5,1608
2020-10-12,49770,36198,13572,37.49,1608
2020-10-13,51047,37367,13680,36.61,1608
2020-10-14,51047,37411,13636,36.45,1608
2020-10-15,51047,37378,13669,36.57,1608
2020-10-16,52732,38117,14615,38.34,1608
2020-10-17,42918,27877,15041,53.95,1608
2020-10-18,36531,24795,11736,47.33,1608
2020-10-19,49770,36300,13470,37.11,1608
2020-10-20,51047,37393,13654,36.51,1608
2020-10-21,51047,37382,13665,36.56,1608
2020-10-22,51047,37313,13734,36.81,1608
2020-10-23,52732,38038,14694,38.63,1608
2020-10-24,42918,27806,15112,54.35,1608
2020-10-25,36531,24752,11779,47.59,1608
2020-10-26,49770,36305,13465,37.09,1608
2020-10-27,51047,37465,13582,36.25,1608
2020-10-28,51047,37534,13513,36.0,1608
2020-10-29,51047,37558,13489,35.92,1608
2020-10-30,52732,38386,14346,37.37,1608
2020-10-31,42918,28263,14655,51.85,1608
2020-11-01,29741,25319,4422,17.47,1608
2020-11-02,45625,36981,8644,23.37,1608
2020-11-03,43682,38244,5438,14.22,1608
2020-11-04,43682,38407,5275,13.73,1608
2020-11-05,43682,38514,5168,13.42,1608
2020-11-06,44075,39409,4666,11.84,1608
2020-11-07,33206,29335,3871,13.2,1608
2020-11-08,29741,26421,3320,12.57,1608
2020-11-09,45625,38091,7534,19.78,1608
2020-11-10,43682,39341,4341,11.03,1608
2020-11-11,43682,39469,4213,10.67,1608
2020-11-12,43682,39519,4163,10.53,1608
2020-11-13,44075,40337,3738,9.27,1608
2020-11-14,33206,30167,3039,10.07,1608
2020-11-15,29741,27141,2600,9.58,1608
2020-11-16,45625,38685,6940,17.94,1608
2020-11-17,43682,39798,3884,9.76,1608
2020-11-18,43682,39782,3900,9.8,1608
2020-11-19,43682,39684,3998,10.07,1608
2020-11-20,44075,40354,3721,9.22,1608
2020-11-21,33206,30040,3166,10.54,1608
2020-11-22,29741,26877,2864,10.66,1608
2020-11-23,45625,38295,7330,19.14,1608
2020-11-24,43682,39295,4387,11.16,1608
2020-11-25,43682,39184,4498,11.48,1608
2020-11-26,43682,39008,4674,11.98,1608
2020-11-27,44075,39620,4455,11.24,1608
2020-11-28,33206,29270,3936,13.45,1608
2020-11-29,29741,26092,3649,13.99,1608
2020-11-30,45625,37516,8109,21.61,1608
2020-12-01,43367,38544,4823,12.51,1608
2020-12-02,43367,38478,4889,12.71,1608
2020-12-03,43367,38365,5002,13.04,1608
2020-12-04,48010,39056,8954,22.93,1608
2020-12-05,36370,28795,7575,26.31,1608
2020-12-06,28266,25715,2551,9.92,1608
2020-12-07,42704,37242,5462,14.67,1608
2020-12-08,43367,38374,4993,13.01,1608
2020-12-09,43367,38410,4957,12.91,1608
2020-12-10,43367,38394,4973,12.95,1608
2020-12-11,48010,39172,8838,22.56,1608
2020-12-12,36370,28986,7384,25.47,1608
2020-12-13,28266,25966,2300,8.86,1608
2020-12-14,42704,37537,5167,13.77,1608
2020-12-15,43367,38692,4675,12.08,1608
2020-12-16,43367,38732,4635,11.97,1608
2020-12-17,43367,38699,4668,12.06,1608
2020-12-18,48010,39438,8572,21.74,1608
2020-12-19,36370,29194,7176,24.58,1608
2020-12-20,28266,26096,2170,8.32,1608
2020-12-21,42704,37572,5132,13.66,1608
2020-12-22,43367,38617,4750,12.3,1608
2020-12-23,43367,38535,4832,12.54,1608
2020-12-24,43367,38371,4996,13.02,1608
2020-12-25,48010,38973,9037,23.19,1608
2020-12-26,36370,28590,7780,27.21,1608
2020-12-27,28266,25356,2910,11.48,1608
2020-12-28,42704,36699,6005,16.36,1608
2020-12-29,43367,37622,5745,15.27,1608
2020-12-30,43367,37429,5938,15.86,1608
2020-12-31,43367,37169,6198,16.68,1608
2021-01-01,41738,37693,4045,10.73,1608
2021-01-02,29950,27252,2698,9.9,1608
2021-01-03,25521,23980,1541,6.43,1608
2021-01-04,40271,35309,4962,14.05,1608
2021-01-05,41787,36240,5547,15.31,1608
2021-01-06,41787,36079,5708,15.82,1608
2021-01-07,41787,35872,5915,16.49,1608
2021-01-08,41738,36470,5268,14.44,1608
2021-01-09,29950,26121,3829,14.66,1608
2021-01-10,25521,22958,2563,11.16,1608
2021-01-11,40271,34410,5861,17.03,1608
2021-01-12,41787,35474,6313,17.8,1608
2021-01-13,41787,35452,6335,17.87,1608
2021-01-14,41787,35389,6398,18.08,1608
2021-01-15,41738,36132,5606,15.52,1608
2021-01-16,29950,25924,4026,15.53,1608
2021-01-17,25521,22896,2625,11.46,1608
2021-01-18,40271,34473,5798,16.82,1608
2021-01-19,41787,35650,6137,17.21,1608
2021-01-20,41787,35727,6060,16.96,1608
2021-01-21,41787,35745,6042,16.9,1608
2021-01-22,41738,36552,5186,14.19,1608
2021-01-23,29950,26389,3561,13.49,1608
2021-01-24,25521,23388,2133,9.12,1608
2021-01-25,40271,34972,5299,15.15,1608
2021-01-26,41787,36138,5649,15.63,1608
2021-01-27,41787,36188,5599,15.47,1608
2021-01-28,41787,36165,5622,15.55,1608
2021-01-29,41738,36917,4821,13.06,1608
2021-01-30,29950,26690,3260,12.21,1608
2021-01-31,25521,23616,1905,8.07,1608
2021-02-01,45228,35123,10105,28.77,1608
2021-02-02,45743,36211,9532,26.32,1608
2021-02-03,45743,36184,9559,26.42,1608
2021-02-04,45743,36088,9655,26.75,1608
2021-02-05,46374,36774,9600,26.11,1608
2021-02-06,37189,26490,10699,40.39,1608
2021-02-07,30879,23371,7508,32.13,1608
2021-02-08,45228,34847,10381,29.79,1608
2021-02-09,45743,35918,9825,27.35,1608
2021-02-10,45743,35888,9855,27.46,1608
2021-02-11,45743,35806,9937,27.75,1608
2021-02-12,46374,36521,9853,26.98,1608
2021-02-13,37189,26280,10909,41.51,1608
2021-02-14,30879,23218,7661,33.0,1608
2021-02-15,45228,34763,10465,30.1,1608
2021-02-16,45743,35912,9831,27.38,1608
2021-02-17,45743,35970,9773,27.17,1608
2021-02-18,45743,35979,9764,27.14,1608
2021-02-19,46374,36789,9585,26.05,1608
2021-02-20,37189,26643,10546,39.58,1608
2021-02-21,30879,23673,7206,30.44,1608
2021-02-22,45228,35305,9923,28.11,1608
2021-02-23,45743,36534,9209,25.21,1608
2021-02-24,45743,36660,9083,24.78,1608
2021-02-25,45743,36727,9016,24.55,1608
2021-02-26,46374,37581,8793,23.4,1608
2021-02-27,37189,27465,9724,35.41,1608
2021-02-28,30879,24509,6370,25.99,1608
2021-03-01,46012,36139,9873,27.32,1608
2021-03-02,47360,37351,10009,26.8,1608
2021-03-03,47360,37446,9914,26.48,1608
2021-03-04,47360,37468,9892,26.4,1608
2021-03-05,48432,38263,10169,26.58,1608
2021-03-06,39910,28079,11831,42.13,1608
2021-03-07,32136,25046,7090,28.31,1608
2021-03-08,46012,36593,9419,25.74,1608
2021-03-09,47360,37718,9642,25.56,1608
2021-03-10,47360,37725,9635,25.54,1608
2021-03-11,47360,37659,9701,25.76,1608
2021-03-12,48432,38371,10061,26.22,1608
2021-03-13,39910,28108,11802,41.99,1608
2021-03-14,32136,25004,7132,28.52,1608
2021-03-15,46012,36490,9522,26.09,1608
2021-03-16,47360,37564,9796,26.08,1608
2021-03-17,47360,37531,9829,26.19,1608
2021-03-18,47360,37439,9921,26.5,1608
2021-03-19,48432,38137,10295,26.99,1608
2021-03-20,39910,27872,12038,43.19,1608
2021-03-21,32136,24779,7357,29.69,1608
2021-03-22,46012,36286,9726,26.8,1608
2021-03-23,47360,37392,9968,26.66,1608
2021-03-24,47360,37399,9961,26.63,1608
2021-03-25,47360,37353,10007,26.79,1608
2021-03-26,48432,38101,10331,27.11,1608
2021-03-27,39910,27890,12020,43.1,1608
2021-03-28,32136,24850,7286,29.32,1608
2021-03-29,46012,36408,9604,26.38,1608
2021-03-30,47360,37561,9799,26.09,1608
2021-03-31,47360,37610,9750,25.92,1608
2021-04-01,44519,37598,6921,18.41,1608
2021-04-02,44565,38372,6193,16.14,1608
2021-04-03,32652,28176,4476,15.89,1608
2021-04-04,28891,25142,3749,14.91,1608
2021-04-05,44951,36695,8256,22.5,1608
2021-04-06,44519,37831,6688,17.68,1608
2021-04-07,44519,37854,6665,17.61,1608
2021-04-08,44519,37806,6713,17.76,1608
2021-04-09,44565,38536,6029,15.65,1608
2021-04-10,32652,28289,4363,15.42,1608
2021-04-11,28891,25198,3693,14.66,1608
2021-04-12,44951,36691,8260,22.51,1608
2021-04-13,44519,37767,6752,17.88,1608
2021-04-14,44519,37728,6791,18.0,1608
2021-04-15,44519,37622,6897,18.33,1608
2021-04-16,44565,38299,6266,16.36,1608
2021-04-17,32652,28005,4647,16.59,1608
2021-04-18,28891,24875,4016,16.14,1608
2021-04-19,44951,36339,8612,23.7,1608
2021-04-20,44519,37395,7124,19.05,1608
2021-04-21,44519,37349,7170,19.2,1608
2021-04-22,44519,37247,7272,19.52,1608
2021-04-23,44565,37939,6626,17.46,1608
2021-04-24,32652,27672,4980,18.0,1608
2021-04-25,28891,24579,4312,17.54,1608
2021-04-26,44951,36089,8862,24.56,1608
2021-04-27,44519,37199,7320,19.68,1608
2021-04-28,44519,37212,7307,19.64,1608
2021-04-29,44519,37174,7345,19.76,1608
2021-04-30,44565,37931,6634,17.49,1608
2021-05-01,18375,27728,-9353,-33.73,1608
2021-05-02,15636,24697,-9061,-36.69,1608
2021-05-03,21132,36263,-15131,-41.73,1608
2021-05-04,21770,37423,-15653,-41.83,1608
2021-05-05,21770,37477,-15707,-41.91,1608
2021-05-06,21770,37468,-15698,-41.9,1608
2021-05-07,22052,38242,-16190,-42.34,1608
2021-05-08,18375,28043,-9668,-34.48,1608
2021-05-09,15636,25002,-9366,-37.46,1608
2021-05-10,21132,36543,-15411,-42.17,1608
2021-05-11,21770,37664,-15894,-42.2,1608
2021-05-12,21770,37665,-15895,-42.2,1608
2021-05-13,21770,37591,-15821,-42.09,1608
2021-05-14,22052,38288,-16236,-42.4,1608
2021-05-15,18375,28004,-9629,-34.38,1608
2021-05-16,15636,24868,-9232,-37.12,1608
2021-05-17,21132,36311,-15179,-41.8,1608
2021-05-18,21770,37330,-15560,-41.68,1608
2021-05-19,21770,37229,-15459,-41.52,1608
2021-05-20,21770,37054,-15284,-41.25,1608
2021-05-21,22052,37656,-15604,-41.44,1608
2021-05-22,18375,27282,-8907,-32.65,1608
2021-05-23,15636,24067,-8431,-35.03,1608
2021-05-24,21132,35441,-14309,-40.37,1608
2021-05-25,21770,36404,-14634,-40.2,1608
2021-05-26,21770,36260,-14490,-39.96,1608
2021-05-27,21770,36058,-14288,-39.63,1608
2021-05-28,22052,36647,-14595,-39.83,1608
2021-05-29,18375,26275,-7900,-30.07,1608
2021-05-30,15636,23076,-7440,-32.24,1608
2021-05-31,21132,34480,-13348,-38.71,1608
2021-06-01,23215,35484,-12269,-34.58,1608
2021-06-02,23215,35392,-12177,-34.41,1608
2021-06-03,23215,35250,-12035,-34.14,1608
2021-06-04,23037,35904,-12867,-35.84,1608
2021-06-05,18865,25602,-6737,-26.31,1608
2021-06-06,17329,22474,-5145,-22.89,1608
2021-06-07,22382,33946,-11564,-34.07,1608
2021-06-08,23215,35014,-11799,-33.7,1608
2021-06-09,23215,34981,-11766,-33.64,1608
2021-06-10,23215,34887,-11672,-33.46,1608
2021-06-11,23037,35580,-12543,-35.25,1608
2021-06-12,18865,25304,-6439,-25.45,1608
2021-06-13,17329,22189,-4860,-21.9,1608
2021-06-14,22382,33660,-11278,-33.51,1608
2021-06-15,23215,34714,-11499,-33.12,1608
2021-06-16,23215,34652,-11437,-33.01,1608
2021-06-17,23215,34516,-11301,-32.74,1608
2021-06-18,23037,35156,-12119,-34.47,1608
2021-06-19,18865,24815,-5950,-23.98,1608
2021-06-20,17329,21627,-4298,-19.87,1608
2021-06-21,22382,33020,-10638,-32.22,1608
2021-06-22,23215,33990,-10775,-31.7,1608
2021-06-23,23215,33844,-10629,-31.41,1608
2021-06-24,23215,33626,-10411,-30.96,1608
2021-06-25,23037,34187,-11150,-32.61,1608
2021-06-26,18865,23775,-4910,-20.65,1608
2021-06-27,17329,20524,-3195,-15.57,1608
2021-06-28,22382,31866,-9484,-29.76,1608
2021-06-29,23215,32799,-9584,-29.22,1608
2021-06-30,23215,32628,-9413,-28.85,1608
2021-07-01,22605,32402,-9797,-30.24,1608
2021-07-02,23044,32971,-9927,-30.11,1608
2021-07-03,18674,22582,-3908,-17.31,1608
2021-07-04,16610,19370,-2760,-14.25,1608
2021-07-05,22003,30763,-8760,-28.48,1608
2021-07-06,22605,31760,-9155,-28.83,1608
2021-07-07,22605,31664,-9059,-28.61,1608
2021-07-08,22605,31519,-8914,-28.28,1608
2021-07-09,23044,32173,-9129,-28.37,1608
2021-07-10,18674,21871,-3197,-14.62,1608
2021-07-11,16610,18743,-2133,-11.38,1608
2021-07-12,22003,30215,-8212,-27.18,1608
2021-07-13,22605,31281,-8676,-27.74,1608
2021-07-14,22605,31242,-8637,-27.65,1608
2021-07-15,22605,31139,-8534,-27.41,1608
2021-07-16,23044,31816,-8772,-27.57,1608
2021-07-17,18674,21518,-2844,-13.22,1608
2021-07-18,16610,18371,-1761,-9.59,1608
2021-07-19,22003,29801,-7798,-26.17,1608
2021-07-20,22605,30803,-8198,-26.61,1608
2021-07-21,22605,30675,-8070,-26.31,1608
2021-07-22,22605,30461,-7856,-25.79,1608
2021-07-23,23044,31006,-7962,-25.68,1608
2021-07-24,18674,20557,-1883,-9.16,1608
2021-07-25,16610,17244,-634,-3.68,1608
2021-07-26,22003,28495,-6492,-22.78,1608
2021-07-27,22605,29308,-6703,-22.87,1608
2021-07-28,22605,28989,-6384,-22.02,1608
2021-07-29,22605,28583,-5978,-20.91,1608
2021-07-30,23044,28943,-5899,-20.38,1608
2021-07-31,18674,18317,357,1.95,1608
2021-08-01,15640,14843,797,5.37,1608
2021-08-02,20984,25952,-4968,-19.14,1608
2021-08-03,21658,26648,-4990,-18.73,1608
2021-08-04,21658,26238,-4580,-17.46,1608
2021-08-05,21658,25773,-4115,-15.97,1608
2021-08-06,21613,26107,-4494,-17.21,1608
2021-08-07,17274,15492,1782,11.5,1608
2021-08-08,15640,12065,3575,29.63,1608
2021-08-09,20984,23259,-2275,-9.78,1608
2021-08-10,21658,24076,-2418,-10.04,1608
2021-08-11,21658,23823,-2165,-9.09,1608
2021-08-12,21658,23549,-1891,-8.03,1608
2021-08-13,21613,24104,-2491,-10.33,1608
2021-08-14,17274,13737,3537,25.75,1608
2021-08-15,15640,10581,5059,47.81,1608
2021-08-16,20984,22063,-1079,-4.89,1608
2021-08-17,21658,23182,-1524,-6.57,1608
2021-08-18,21658,23238,-1580,-6.8,1608
2021-08-19,21658,23274,-1616,-6.94,1608
2021-08-20,21613,24136,-2523,-10.45,1608
2021-08-21,17274,14066,3208,22.81,1608
2021-08-22,15640,11192,4448,39.74,1608
2021-08-23,20984,22938,-1954,-8.52,1608
2021-08-24,21658,24295,-2637,-10.85,1608
2021-08-25,21658,24562,-2904,-11.82,1608
2021-08-26,21658,24778,-3120,-12.59,1608
2021-08-27,21613,25786,-4173,-16.18,1608
2021-08-28,17274,15827,1447,9.14,1608
2021-08-29,15640,13029,2611,20.04,1608
2021-08-30,20984,24814,-3830,-15.43,1608
2021-08-31,21658,26177,-4519,-17.26,1608
2021-09-01,22879,26417,-3538,-13.39,1608
2021-09-02,22879,26575,-3696,-13.91,1608
2021-09-03,23581,27499,-3918,-14.25,1608
2021-09-04,20004,17433,2571,14.75,1608
2021-09-05,17590,14509,3081,21.24,1608
2021-09-06,21914,26154,-4240,-16.21,1608
2021-09-07,22879,27367,-4488,-16.4,1608
2021-09-08,22879,27453,-4574,-16.66,1608
2021-09-09,22879,27458,-4579,-16.68,1608
2021-09-10,23581,28234,-4653,-16.48,1608
2021-09-11,20004,18029,1975,10.95,1608
2021-09-12,17590,14980,2610,17.42,1608
2021-09-13,21914,26518,-4604,-17.36,1608
2021-09-14,22879,27644,-4765,-17.24,1608
2021-09-15,22879,27665,-4786,-17.3,1608
2021-09-16,22879,27629,-4750,-17.19,1608
2021-09-17,23581,28388,-4807,-16.93,1608
2021-09-18,20004,18192,1812,9.96,1608
2021-09-19,17590,15175,2415,15.91,1608
2021-09-20,21914,26767,-4853,-18.13,1608
2021-09-21,22879,27967,-5088,-18.19,1608
2021-09-22,22879,28080,-5201,-18.52,1608
2021-09-23,22879,28151,-5272,-18.73,1608
2021-09-24,23581,29027,-5446,-18.76,1608
2021-09-25,20004,18955,1049,5.53,1608
2021-09-26,17590,16065,1525,9.49,1608
2021-09-27,21914,27782,-5868,-21.12,1608
2021-09-28,22879,29103,-6224,-21.39,1608
2021-09-29,22879,29327,-6448,-21.99,1608
2021-09-30,22879,29496,-6617,-22.43,1608
2021-10-01,24004,30455,-6451,-21.18,1608
2021-10-02,20009,20447,-438,-2.14,1608
2021-10-03,17363,17601,-238,-1.35,1608
2021-10-04,21640,29340,-7700,-26.24,1608
2021-10-05,22678,30660,-7982,-26.03,1608
2021-10-06,22678,30861,-8183,-26.52,1608
2021-10-07,22678,30984,-8306,-26.81,1608
2021-10-08,24004,31877,-7873,-24.7,1608
2021-10-09,20009,21783,-1774,-8.14,1608
2021-10-10,17363,18834,-1471,-7.81,1608
2021-10-11,21640,30458,-8818,-28.95,1608
2021-10-12,22678,31652,-8974,-28.35,1608
2021-10-13,22678,31719,-9041,-28.5,1608
2021-10-14,22678,31706,-9028,-28.47,1608
2021-10-15,24004,32463,-8459,-26.06,1608
2021-10-16,20009,22238,-2229,-10.02,1608
2021-10-17,17363,19166,-1803,-9.41,1608
2021-10-18,21640,30678,-9038,-29.46,1608
2021-10-19,22678,31775,-9097,-28.63,1608
2021-10-20,22678,31762,-9084,-28.6,1608
2021-10-21,22678,31688,-9010,-28.43,1608
2021-10-22,24004,32405,-8401,-25.93,1608
2021-10-23,20009,22161,-2152,-9.71,1608
2021-10-24,17363,19092,-1729,-9.06,1608
2021-10-25,21640,30627,-8987,-29.34,1608
2021-10-26,22678,31767,-9089,-28.61,1608
2021-10-27,22678,31816,-9138,-28.72,1608
2021-10-28,22678,31819,-9141,-28.73,1608
2021-10-29,24004,32626,-8622,-26.43,1608
2021-10-30,20009,22483,-2474,-11.0,1608
2021-10-31,17363,19521,-2158,-11.05,1608
2021-11-01,31711,31166,545,1.75,1608
2021-11-02,28628,32416,-3788,-11.69,1608
2021-11-03,28628,32570,-3942,-12.1,1608
2021-11-04,28628,32670,-4042,-12.37,1608
2021-11-05,28654,33562,-4908,-14.62,1608
2021-11-06,28768,23490,5278,22.47,1608
2021-11-07,23335,20582,2753,13.38,1608
2021-11-08,31711,32262,-551,-1.71,1608
2021-11-09,28628,33526,-4898,-14.61,1608
2021-11-10,28628,33672,-5044,-14.98,1608
2021-11-11,28628,33743,-5115,-15.16,1608
2021-11-12,28654,34584,-5930,-17.15,1608
2021-11-13,28768,24439,4329,17.71,1608
2021-11-14,23335,21440,1895,8.84,1608
2021-11-15,31711,33012,-1301,-3.94,1608
2021-11-16,28628,34152,-5524,-16.17,1608
2021-11-17,28628,34164,-5536,-16.2,1608
2021-11-18,28628,34092,-5464,-16.03,1608
2021-11-19,28654,34786,-6132,-17.63,1608
2021-11-20,28768,24493,4275,17.45,1608
2021-11-21,23335,21349,1986,9.3,1608
2021-11-22,31711,32782,-1071,-3.27,1608
2021-11-23,28628,33793,-5165,-15.28,1608
2021-11-24,28628,33688,-5060,-15.02,1608
2021-11-25,28628,33516,-4888,-14.58,1608
2021-11-26,28654,34127,-5473,-16.04,1608
2021-11-27,28768,23772,4996,21.02,1608
2021-11-28,23335,20585,2750,13.36,1608
2021-11-29,31711,31998,-287,-0.9,1608
2021-11-30,28628,33011,-4383,-13.28,1608
2021-12-01,44588,32928,11660,35.41,1608
2021-12-02,44588,32797,11791,35.95,1608
2021-12-03,42941,33467,9474,28.31,1608
2021-12-04,37915,23187,14728,63.52,1608
2021-12-05,31771,20087,11684,58.17,1608
2021-12-06,44358,31596,12762,40.39,1608
2021-12-07,44588,32710,11878,36.31,1608
2021-12-08,44588,32732,11856,36.22,1608
2021-12-09,44588,32704,11884,36.34,1608
2021-12-10,42941,33473,9468,28.29,1608
2021-12-11,37915,23282,14633,62.85,1608
2021-12-12,31771,20261,11510,56.81,1608
2021-12-13,44358,31834,12524,39.34,1608
2021-12-14,44588,32996,11592,35.13,1608
2021-12-15,44588,33046,11542,34.93,1608
2021-12-16,44588,33027,11561,35.0,1608
2021-12-17,42941,33784,9157,27.1,1608
2021-12-18,37915,23560,14355,60.93,1608
2021-12-19,31771,20485,11286,55.09,1608
2021-12-20,44358,31985,12373,38.68,1608
2021-12-21,44588,33056,11532,34.89,1608
2021-12-22,44588,33000,11588,35.12,1608
2021-12-23,44588,32862,11726,35.68,1608
2021-12-24,42941,33489,9452,28.22,1608
2021-12-25,37915,23130,14785,63.92,1608
2021-12-26,31771,19916,11855,59.53,1608
2021-12-27,44358,31278,13080,41.82,1608
2021-12-28,44588,32216,12372,38.4,1608
2021-12-29,44588,32035,12553,39.19,1608
2021-12-30,44588,31782,12806,40.29,1608
2021-12-31,42941,32309,10632,32.91,1608
2022-01-01,37726,21867,15859,72.52,1608
2022-01-02,30627,18590,12037,64.75,1608
2022-01-03,42712,29910,12802,42.8,1608
2022-01-04,43712,30827,12885,41.8,1608
2022-01-05,43712,30649,13063,42.62,1608
2022-01-06,43712,30422,13290,43.69,1608
2022-01-07,44538,30997,13541,43.68,1608
2022-01-08,37726,20623,17103,82.93,1608
2022-01-09,30627,17434,13193,75.67,1608
2022-01-10,42712,28859,13853,48.0,1608
2022-01-11,43712,29896,13816,46.21,1608
2022-01-12,43712,29848,13864,46.45,1608
2022-01-13,43712,29760,13952,46.88,1608
2022-01-14,44538,30479,14059,46.13,1608
2022-01-15,37726,20249,17477,86.31,1608
2022-01-16,30627,17203,13424,78.03,1608
2022-01-17,42712,28764,13948,48.49,1608
2022-01-18,43712,29929,13783,46.05,1608
2022-01-19,43712,29997,13715,45.72,1608
2022-01-20,43712,30011,13701,45.65,1608
2022-01-21,44538,30816,13722,44.53,1608
2022-01-22,37726,20655,17071,82.65,1608
2022-01-23,30627,17659,12968,73.44,1608
2022-01-24,42712,29251,13461,46.02,1608
2022-01-25,43712,30428,13284,43.66,1608
2022-01-26,43712,30490,13222,43.37,1608
2022-01-27,43712,30481,13231,43.41,1608
2022-01-28,44538,31247,13291,42.54,1608
2022-01-29,37726,21035,16691,79.35,1608
2022-01-30,30627,17976,12651,70.38,1608
2020-02-01,73033,69242,3791,5.48,1078
2020-02-02,63721,60493,3228,5.34,1078
2020-02-03,71673,71956,-283,-0.39,1078
2020-02-04,73749,73992,-243,-0.33,1078
2020-02-05,73749,74073,-324,-0.44,1078
2020-02-06,73749,74214,-465,-0.63,1078
2020-02-07,78375,77001,1374,1.78,1078
2020-02-08,73033,70011,3022,4.32,1078
2020-02-09,63721,61165,2556,4.18,1078
2020-02-10,71673,72536,-863,-1.19,1078
2020-02-11,73749,74489,-740,-0.99,1078
2020-02-12,73749,74498,-749,-1.01,1078
2020-02-13,73749,74579,-830,-1.11,1078
2020-02-14,78375,77321,1054,1.36,1078
2020-02-15,73033,70300,2733,3.89,1078
2020-02-16,63721,61438,2283,3.72,1078
2020-02-17,71673,72808,-1135,-1.56,1078
2020-02-18,73749,74774,-1025,-1.37,1078
2020-02-19,73749,74808,-1059,-1.42,1078
2020-02-20,73749,74926,-1177,-1.57,1078
2020-02-21,78375,77713,662,0.85,1078
2020-02-22,73033,70744,2289,3.24,1078
2020-02-23,63721,61939,1782,2.88,1078
2020-02-24,71673,73368,-1695,-2.31,1078
2020-02-25,73749,75391,-1642,-2.18,1078
2020-02-26,73749,75479,-1730,-2.29,1078
2020-02-27,73749,75646,-1897,-2.51,1078
2020-02-28,78375,78475,-100,-0.13,1078
2020-02-29,73033,71539,1494,2.09,1078
2020-03-01,45561,62755,-17194,-27.4,1078
2020-03-02,58526,74193,-15667,-21.12,1078
2020-03-03,58719,76214,-17495,-22.96,1078
2020-03-04,58719,76286,-17567,-23.03,1078
2020-03-05,58719,76424,-17705,-23.17,1078
2020-03-06,61752,79212,-17460,-22.04,1078
2020-03-07,50724,72225,-21501,-29.77,1078
2020-03-08,45561,63380,-17819,-28.11,1078
2020-03-09,58526,74748,-16222,-21.7,1078
2020-03-10,58719,76693,-17974,-23.44,1078
2020-03-11,58719,76686,-17967,-23.43,1078
2020-03-12,58719,76744,-18025,-23.49,1078
2020-03-13,61752,79452,-17700,-22.28,1078
2020-03-14,50724,72387,-21663,-29.93,1078
2020-03-15,45561,63469,-17908,-28.22,1078
2020-03-16,58526,74771,-16245,-21.73,1078
2020-03-17,58719,76659,-17940,-23.4,1078
2020-03-18,58719,76604,-17885,-23.35,1078
2020-03-19,58719,76624,-17905,-23.37,1078
2020-03-20,61752,79306,-17554,-22.13,1078
2020-03-21,50724,72226,-21502,-29.77,1078
2020-03-22,45561,63305,-17744,-28.03,1078
2020-03-23,58526,74616,-16090,-21.56,1078
2020-03-24,58719,76522,-17803,-23.27,1078
2020-03-25,58719,76494,-17775,-23.24,1078
2020-03-26,58719,76548,-17829,-23.29,1078
2020-03-27,61752,79270,-17518,-22.1,1078
2020-03-28,50724,72234,-21510,-29.78,1078
2020-03-29,45561,63359,-17798,-28.09,1078
2020-03-30,58526,74716,-16190,-21.67,1078
2020-03-31,58719,76665,-17946,-23.41,1078
2020-04-01,56938,76677,-19739,-25.74,1078
2020-04-02,56938,76766,-19828,-25.83,1078
2020-04-03,54645,79515,-24870,-31.28,1078
2020-04-04,43396,72499,-29103,-40.14,1078
2020-04-05,33265,63635,-30370,-47.73,1078
2020-04-06,56459,74992,-18533,-24.71,1078
2020-04-07,56938,76933,-19995,-25.99,1078
2020-04-08,56938,76928,-19990,-25.99,1078
2020-04-09,56938,76992,-20054,-26.05,1078
2020-04-10,54645,79709,-25064,-31.44,1078
2020-04-11,43396,72654,-29258,-40.27,1078
2020-04-12,33265,63746,-30481,-47.82,1078
2020-04-13,56459,75058,-18599,-24.78,1078
2020-04-14,56938,76952,-20014,-26.01,1078
2020-04-15,56938,76902,-19964,-25.96,1078
2020-04-16,56938,76923,-19985,-25.98,1078
2020-04-17,54645,79602,-24957,-31.35,1078
2020-04-18,43396,72516,-29120,-40.16,1078
2020-04-19,33265,63586,-30321,-47.69,1078
2020-04-20,56459,74885,-18426,-24.61,1078
2020-04-21,56938,76777,-19839,-25.84,1078
2020-04-22,56938,76735,-19797,-25.8,1078
2020-04-23,56938,76776,-19838,-25.84,1078
2020-04-24,54645,79487,-24842,-31.25,1078
2020-04-25,43396,72442,-29046,-40.1,1078
2020-04-26,33265,63562,-30297,-47.67,1078
2020-04-27,56459,74918,-18459,-24.64,1078
2020-04-28,56938,76874,-19936,-25.93,1078
2020-04-29,56938,76900,-19962,-25.96,1078
2020-04-30,56938,77009,-20071,-26.06,1078
2020-05-01,72705,79788,-7083,-8.88,1078
2020-05-02,64141,72807,-8666,-11.9,1078
2020-05-03,53199,63986,-10787,-16.86,1078
2020-05-04,68857,75394,-6537,-8.67,1078
2020-05-05,70365,77390,-7025,-9.08,1078
2020-05-06,70365,77444,-7079,-9.14,1078
2020-05-07,70365,77568,-7203,-9.29,1078
2020-05-08,72705,80346,-7641,-9.51,1078
2020-05-09,64141,73350,-9209,-12.55,1078
2020-05-10,53199,64498,-11299,-17.52,1078
2020-05-11,68857,75859,-7002,-9.23,1078
2020-05-12,70365,77794,-7429,-9.55,1078
2020-05-13,70365,77774,-7409,-9.53,1078
2020-05-14,70365,77814,-7449,-9.57,1078
2020-05-15,72705,80499,-7794,-9.68,1078
2020-05-16,64141,73404,-9263,-12.62,1078
2020-05-17,53199,64451,-11252,-17.46,1078
2020-05-18,68857,75710,-6853,-9.05,1078
2020-05-19,70365,77548,-7183,-9.26,1078
2020-05-20,70365,77438,-7073,-9.13,1078
2020-05-21,70365,77399,-7034,-9.09,1078
2020-05-22,72705,80017,-7312,-9.14,1078
2020-05-23,64141,72873,-8732,-11.98,1078
2020-05-24,53199,63887,-10688,-16.73,1078
2020-05-25,68857,75135,-6278,-8.36,1078
2020-05-26,70365,76983,-6618,-8.6,1078
2020-05-27,70365,76905,-6540,-8.5,1078
2020-05-28,70365,76919,-6554,-8.52,1078
2020-05-29,72705,79612,-6907,-8.68,1078
2020-05-30,64141,72560,-8419,-11.6,1078
2020-05-31,53199,63684,-10485,-16.46,1078
2020-06-01,72269,75056,-2787,-3.71,1078
2020-06-02,74146,77037,-2891,-3.75,1078
2020-06-03,74146,77097,-2951,-3.83,1078
2020-06-04,74146,77251,-3105,-4.02,1078
2020-06-05,74678,80079,-5401,-6.74,1078
2020-06-06,68584,73154,-4570,-6.25,1078
2020-06-07,58239,64390,-6151,-9.55,1078
2020-06-08,72269,75854,-3585,-4.73,1078
2020-06-09,74146,77904,-3758,-4.82,1078
2020-06-10,74146,78004,-3858,-4.95,1078
2020-06-11,74146,78164,-4018,-5.14,1078
2020-06-12,74678,80964,-6286,-7.76,1078
2020-06-13,68584,73972,-5388,-7.28,1078
2020-06-14,58239,65101,-6862,-10.54,1078
2020-06-15,72269,76419,-4150,-5.43,1078
2020-06-16,74146,78282,-4136,-5.28,1078
2020-06-17,74146,78157,-4011,-5.13,1078
2020-06-18,74146,78056,-3910,-5.01,1078
2020-06-19,74678,80563,-5885,-7.3,1078
2020-06-20,68584,73251,-4667,-6.37,1078
2020-06-21,58239,64037,-5798,-9.05,1078
2020-06-22,72269,74996,-2727,-3.64,1078
2020-06-23,74146,76490,-2344,-3.06,1078
2020-06-24,74146,75994,-1848,-2.43,1078
2020-06-25,74146,75528,-1382,-1.83,1078
2020-06-26,74678,77681,-3003,-3.87,1078
2020-06-27,68584,70036,-1452,-2.07,1078
2020-06-28,58239,60517,-2278,-3.76,1078
2020-06-29,72269,71204,1065,1.5,1078
2020-06-30,74146,72467,1679,2.32,1078
2020-07-01,70423,71786,-1363,-1.9,1078
2020-07-02,70423,71185,-762,-1.07,1078
2020-07-03,72088,73258,-1170,-1.6,1078
2020-07-04,67001,65586,1415,2.16,1078
2020-07-05,59566,56098,3468,6.18,1078
2020-07-06,68859,66872,1987,2.97,1078
2020-07-07,70423,68276,2147,3.14,1078
2020-07-08,70423,67788,2635,3.89,1078
2020-07-09,70423,67427,2996,4.44,1078
2020-07-10,72088,69781,2307,3.31,1078
2020-07-11,67001,62427,4574,7.33,1078
2020-07-12,59566,53285,6281,11.79,1078
2020-07-13,68859,64426,4433,6.88,1078
2020-07-14,70423,66209,4214,6.36,1078
2020-07-15,70423,66104,4319,6.53,1078
2020-07-16,70423,66121,4302,6.51,1078
2020-07-17,72088,68840,3248,4.72,1078
2020-07-18,67001,61829,5172,8.37,1078
2020-07-19,59566,53002,6564,12.38,1078
2020-07-20,68859,64421,4438,6.89,1078
2020-07-21,70423,66441,3982,5.99,1078
2020-07-22,70423,66526,3897,5.86,1078
2020-07-23,70423,66684,3739,5.61,1078
2020-07-24,72088,69491,2597,3.74,1078
2020-07-25,67001,62517,4484,7.17,1078
2020-07-26,59566,53673,5893,10.98,1078
2020-07-27,68859,65026,3833,5.89,1078
2020-07-28,70423,66934,3489,5.21,1078
2020-07-29,70423,66864,3559,5.32,1078
2020-07-30,70423,66831,3592,5.37,1078
2020-07-31,72088,69419,2669,3.84,1078
2020-08-01,63960,62203,1757,2.82,1078
2020-08-02,57367,53106,4261,8.02,1078
2020-08-03,65059,64200,859,1.34,1078
2020-08-04,64026,65855,-1829,-2.78,1078
2020-08-05,64026,65546,-1520,-2.32,1078
2020-08-06,64026,65296,-1270,-1.94,1078
2020-08-07,67014,67697,-683,-1.01,1078
2020-08-08,63960,60333,3627,6.01,1078
2020-08-09,57367,51132,6235,12.19,1078
2020-08-10,65059,62173,2886,4.64,1078
2020-08-11,64026,63829,197,0.31,1078
2020-08-12,64026,63578,448,0.7,1078
2020-08-13,64026,63445,581,0.92,1078
2020-08-14,67014,66022,992,1.5,1078
2020-08-15,63960,58892,5068,8.61,1078
2020-08-16,57367,49978,7389,14.78,1078
2020-08-17,65059,61357,3702,6.03,1078
2020-08-18,64026,63394,632,1.0,1078
2020-08-19,64026,63563,463,0.73,1078
2020-08-20,64026,63880,146,0.23,1078
2020-08-21,67014,66928,86,0.13,1078
2020-08-22,63960,60280,3680,6.1,1078
2020-08-23,57367,51852,5515,10.64,1078
2020-08-24,65059,63709,1350,2.12,1078
2020-08-25,64026,66209,-2183,-3.3,1078
2020-08-26,64026,66815,-2789,-4.17,1078
2020-08-27,64026,67533,-3507,-5.19,1078
2020-08-28,67014,70941,-3927,-5.54,1078
2020-08-29,63960,64604,-644,-1.0,1078
2020-08-30,57367,56432,935,1.66,1078
2020-08-31,65059,68485,-3426,-5.0,1078
2020-09-01,69539,71117,-1578,-2.22,1078
2020-09-02,69539,71791,-2252,-3.14,1078
2020-09-03,69539,72512,-2973,-4.1,1078
2020-09-04,73678,75859,-2181,-2.88,1078
2020-09-05,70488,69399,1089,1.57,1078
2020-09-06,62431,61045,1386,2.27,1078
2020-09-07,68482,72863,-4381,-6.01,1078
2020-09-08,69539,75214,-5675,-7.55,1078
2020-09-09,69539,75566,-6027,-7.98,1078
2020-09-10,69539,75933,-6394,-8.42,1078
2020-09-11,73678,78901,-5223,-6.62,1078
2020-09-12,70488,72046,-1558,-2.16,1078
2020-09-13,62431,63289,-858,-1.36,1078
2020-09-14,68482,74707,-6225,-8.33,1078
2020-09-15,69539,76666,-7127,-9.3,1078
2020-09-16,69539,76643,-7104,-9.27,1078
2020-09-17,69539,76659,-7120,-9.29,1078
2020-09-18,73678,79305,-5627,-7.1,1078
2020-09-19,70488,72164,-1676,-2.32,1078
2020-09-20,62431,63160,-729,-1.15,1078
2020-09-21,68482,74374,-5892,-7.92,1078
2020-09-22,69539,76172,-6633,-8.71,1078
2020-09-23,69539,76032,-6493,-8.54,1078
2020-09-24,69539,75976,-6437,-8.47,1078
2020-09-25,73678,78592,-4914,-6.25,1078
2020-09-26,70488,71460,-972,-1.36,1078
2020-09-27,62431,62502,-71,-0.11,1078
2020-09-28,68482,73792,-5310,-7.2,1078
2020-09-29,69539,75693,-6154,-8.13,1078
2020-09-30,69539,75677,-6138,-8.11,1078
2020-10-01,69140,75760,-6620,-8.74,1078
2020-10-02,73786,78524,-4738,-6.03,1078
2020-10-03,69099,71543,-2444,-3.42,1078
2020-10-04,60230,62733,-2503,-3.99,1078
2020-10-05,69682,74163,-4481,-6.04,1078
2020-10-06,69140,76191,-7051,-9.25,1078
2020-10-07,69140,76285,-7145,-9.37,1078
2020-10-08,69140,76457,-7317,-9.57,1078
2020-10-09,73786,79286,-5500,-6.94,1078
2020-10-10,69099,72345,-3246,-4.49,1078
2020-10-11,60230,63549,-3319,-5.22,1078
2020-10-12,69682,74966,-5284,-7.05,1078
2020-10-13,69140,76955,-7815,-10.16,1078
2020-10-14,69140,76987,-7847,-10.19,1078
2020-10-15,69140,77074,-7934,-10.29,1078
2020-10-16,73786,79801,-6015,-7.54,1078
2020-10-17,69099,72742,-3643,-5.01,1078
2020-10-18,60230,63816,-3586,-5.62,1078
2020-10-19,69682,75097,-5415,-7.21,1078
2020-10-20,69140,76947,-7807,-10.15,1078
2020-10-21,69140,76841,-7701,-10.02,1078
2020-10-22,69140,76796,-7656,-9.97,1078
2020-10-23,73786,79400,-5614,-7.07,1078
2020-10-24,69099,72232,-3133,-4.34,1078
2020-10-25,60230,63213,-2983,-4.72,1078
2020-10-26,69682,74418,-4736,-6.36,1078
2020-10-27,69140,76214,-7074,-9.28,1078
2020-10-28,69140,76074,-6934,-9.11,1078
2020-10-29,69140,76017,-6877,-9.05,1078
2020-10-30,73786,78631,-4845,-6.16,1078
2020-10-31,69099,71491,-2392,-3.35,1078
2020-11-01,49437,62521,-13084,-20.93,1078
2020-11-02,64207,73790,-9583,-12.99,1078
2020-11-03,60231,75664,-15433,-20.4,1078
2020-11-04,60231,75612,-15381,-20.34,1078
2020-11-05,60231,75650,-15419,-20.38,1078
2020-11-06,63708,78362,-14654,-18.7,1078
2020-11-07,54330,71320,-16990,-23.82,1078
2020-11-08,49437,62443,-13006,-20.83,1078
2020-11-09,64207,73799,-9592,-13.0,1078
2020-11-10,60231,75748,-15517,-20.49,1078
2020-11-11,60231,75757,-15526,-20.49,1078
2020-11-12,60231,75841,-15610,-20.58,1078
2020-11-13,63708,78581,-14873,-18.93,1078
2020-11-14,54330,71549,-17219,-24.07,1078
2020-11-15,49437,62662,-13225,-21.11,1078
2020-11-16,64207,73988,-9781,-13.22,1078
2020-11-17,60231,75889,-15658,-20.63,1078
2020-11-18,60231,75834,-15603,-20.58,1078
2020-11-19,60231,75838,-15607,-20.58,1078
2020-11-20,63708,78486,-14778,-18.83,1078
2020-11-21,54330,71351,-17021,-23.86,1078
2020-11-22,49437,62355,-12918,-20.72,1078
2020-11-23,64207,73569,-9362,-12.73,1078
2020-11-24,60231,75358,-15127,-20.07,1078
2020-11-25,60231,75194,-14963,-19.9,1078
2020-11-26,60231,75097,-14866,-19.8,1078
2020-11-27,63708,77653,-13945,-17.96,1078
2020-11-28,54330,70440,-16110,-22.87,1078
2020-11-29,49437,61381,-11944,-19.46,1078
2020-11-30,64207,72550,-8343,-11.5,1078
2020-12-01,59734,74312,-14578,-19.62,1078
2020-12-02,59734,74142,-14408,-19.43,1078
2020-12-03,59734,74057,-14323,-19.34,1078
2020-12-04,69391,76644,-7253,-9.46,1078
2020-12-05,59475,69481,-10006,-14.4,1078
2020-12-06,46968,60488,-13520,-22.35,1078
2020-12-07,60098,71736,-11638,-16.22,1078
2020-12-08,59734,73589,-13855,-18.83,1078
2020-12-09,59734,73517,-13783,-18.75,1078
2020-12-10,59734,73536,-13802,-18.77,1078
2020-12-11,69391,76228,-6837,-8.97,1078
2020-12-12,59475,69166,-9691,-14.01,1078
2020-12-13,46968,60268,-13300,-22.07,1078
2020-12-14,60098,71602,-11504,-16.07,1078
2020-12-15,59734,73528,-13794,-18.76,1078
2020-12-16,59734,73513,-13779,-18.74,1078
2020-12-17,59734,73569,-13835,-18.81,1078
2020-12-18,69391,76279,-6888,-9.03,1078
2020-12-19,59475,69214,-9739,-14.07,1078
2020-12-20,46968,60291,-13323,-22.1,1078
2020-12-21,60098,71577,-11479,-16.04,1078
2020-12-22,59734,73433,-13699,-18.66,1078
2020-12-23,59734,73329,-13595,-18.54,1078
2020-12-24,59734,73279,-13545,-18.48,1078
2020-12-25,69391,75866,-6475,-8.53,1078
2020-12-26,59475,68667,-9192,-13.39,1078
2020-12-27,46968,59600,-12632,-21.19,1078
2020-12-28,60098,70738,-10640,-15.04,1078
2020-12-29,59734,72446,-12712,-17.55,1078
2020-12-30,59734,72197,-12463,-17.26,1078
2020-12-31,59734,72010,-12276,-17.05,1078
2021-01-01,67579,74472,-6893,-9.26,1078
2021-01-02,56136,67163,-11027,-16.42,1078
2021-01-03,48248,58006,-9758,-16.82,1078
2021-01-04,62538,69076,-6538,-9.46,1078
2021-01-05,64033,70741,-6708,-9.48,1078
2021-01-06,64033,70476,-6443,-9.14,1078
2021-01-07,64033,70300,-6267,-8.91,1078
2021-01-08,67579,72803,-5224,-7.18,1078
2021-01-09,56136,65562,-9426,-14.38,1078
2021-01-10,48248,56501,-8253,-14.61,1078
2021-01-11,62538,67694,-5156,-7.62,1078
2021-01-12,64033,69505,-5472,-7.87,1078
2021-01-13,64033,69406,-5373,-7.74,1078
2021-01-14,64033,69415,-5382,-7.75,1078
2021-01-15,67579,72116,-4537,-6.29,1078
2021-01-16,56136,65084,-8948,-13.75,1078
2021-01-17,48248,56238,-7990,-14.21,1078
2021-01-18,62538,67646,-5108,-7.55,1078
2021-01-19,64033,69670,-5637,-8.09,1078
2021-01-20,64033,69777,-5744,-8.23,1078
2021-01-21,64033,69980,-5947,-8.5,1078
2021-01-22,67579,72861,-5282,-7.25,1078
2021-01-23,56136,65991,-9855,-14.93,1078
2021-01-24,48248,57286,-9038,-15.78,1078
2021-01-25,62538,68813,-6275,-9.12,1078
2021-01-26,64033,70931,-6898,-9.72,1078
2021-01-27,64033,71108,-7075,-9.95,1078
2021-01-28,64033,71356,-7323,-10.26,1078
2021-01-29,67579,74257,-6678,-8.99,1078
2021-01-30,56136,67383,-11247,-16.69,1078
2021-01-31,48248,58652,-10404,-17.74,1078
2021-02-01,70044,70134,-90,-0.13,1078
2021-02-02,68909,72189,-3280,-4.54,1078
2021-02-03,68909,72288,-3379,-4.67,1078
2021-02-04,68909,72448,-3539,-4.88,1078
2021-02-05,73600,75253,-1653,-2.2,1078
2021-02-06,69516,68279,1237,1.81,1078
2021-02-07,59394,59447,-53,-0.09,1078
2021-02-08,70044,70829,-785,-1.11,1078
2021-02-09,68909,72791,-3882,-5.33,1078
2021-02-10,68909,72805,-3896,-5.35,1078
2021-02-11,68909,72890,-3981,-5.46,1078
2021-02-12,73600,75632,-2032,-2.69,1078
2021-02-13,69516,68609,907,1.32,1078
2021-02-14,59394,59742,-348,-0.58,1078
2021-02-15,70044,71105,-1061,-1.49,1078
2021-02-16,68909,73062,-4153,-5.68,1078
2021-02-17,68909,73086,-4177,-5.72,1078
2021-02-18,68909,73192,-4283,-5.85,1078
2021-02-19,73600,75968,-2368,-3.12,1078
2021-02-20,69516,68989,527,0.76,1078
2021-02-21,59394,60173,-779,-1.29,1078
2021-02-22,70044,71591,-1547,-2.16,1078
2021-02-23,68909,73607,-4698,-6.38,1078
2021-02-24,68909,73688,-4779,-6.49,1078
2021-02-25,68909,73851,-4942,-6.69,1078
2021-02-26,73600,76678,-3078,-4.01,1078
2021-02-27,69516,69742,-226,-0.32,1078
2021-02-28,59394,60960,-1566,-2.57,1078
2021-03-01,70557,72403,-1846,-2.55,1078
2021-03-02,70539,74431,-3892,-5.23,1078
2021-03-03,70539,74513,-3974,-5.33,1078
2021-03-04,70539,74662,-4123,-5.52,1078
2021-03-05,75751,77464,-1713,-2.21,1078
2021-03-06,71710,70490,1220,1.73,1078
2021-03-07,60960,61660,-700,-1.14,1078
2021-03-08,70557,73044,-2487,-3.4,1078
2021-03-09,70539,75004,-4465,-5.95,1078
2021-03-10,70539,75012,-4473,-5.96,1078
2021-03-11,70539,75083,-4544,-6.05,1078
2021-03-12,75751,77804,-2053,-2.64,1078
2021-03-13,71710,70749,961,1.36,1078
2021-03-14,60960,61841,-881,-1.42,1078
2021-03-15,70557,73151,-2594,-3.55,1078
2021-03-16,70539,75043,-4504,-6.0,1078
2021-03-17,70539,74991,-4452,-5.94,1078
2021-03-18,70539,75012,-4473,-5.96,1078
2021-03-19,75751,77692,-1941,-2.5,1078
2021-03-20,71710,70609,1101,1.56,1078
2021-03-21,60960,61683,-723,-1.17,1078
2021-03-22,70557,72987,-2430,-3.33,1078
2021-03-23,70539,74885,-4346,-5.8,1078
2021-03-24,70539,74848,-4309,-5.76,1078
2021-03-25,70539,74894,-4355,-5.81,1078
2021-03-26,75751,77607,-1856,-2.39,1078
2021-03-27,71710,70563,1147,1.63,1078
2021-03-28,60960,61680,-720,-1.17,1078
2021-03-29,70557,73029,-2472,-3.38,1078
2021-03-30,70539,74973,-4434,-5.91,1078
2021-03-31,70539,74981,-4442,-5.92,1078
2021-04-01,65607,75068,-9461,-12.6,1078
2021-04-02,67794,77817,-10023,-12.88,1078
2021-04-03,59513,70802,-11289,-15.94,1078
2021-04-04,51331,61940,-10609,-17.13,1078
2021-04-05,66228,73303,-7075,-9.65,1078
2021-04-06,65607,75250,-9643,-12.81,1078
2021-04-07,65607,75252,-9645,-12.82,1078
2021-04-08,65607,75324,-9717,-12.9,1078
2021-04-09,67794,78050,-10256,-13.14,1078
2021-04-10,59513,71004,-11491,-16.18,1078
2021-04-11,51331,62105,-10774,-17.35,1078
2021-04-12,66228,73425,-7197,-9.8,1078
2021-04-13,65607,75327,-9720,-12.9,1078
2021-04-14,65607,75283,-9676,-12.85,1078
2021-04-15,65607,75309,-9702,-12.88,1078
2021-04-16,67794,77991,-10197,-13.07,1078
2021-04-17,59513,70906,-11393,-16.07,1078
2021-04-18,51331,61975,-10644,-17.17,1078
2021-04-19,66228,73270,-7042,-9.61,1078
2021-04-20,65607,75157,-9550,-12.71,1078
2021-04-21,65607,75108,-9501,-12.65,1078
2021-04-22,65607,75139,-9532,-12.69,1078
2021-04-23,67794,77839,-10045,-12.9,1078
2021-04-24,59513,70782,-11269,-15.92,1078
2021-04-25,51331,61889,-10558,-17.06,1078
2021-04-26,66228,73232,-7004,-9.56,1078
2021-04-27,65607,75175,-9568,-12.73,1078
2021-04-28,65607,75188,-9581,-12.74,1078
2021-04-29,65607,75286,-9679,-12.86,1078
2021-04-30,67794,78054,-10260,-13.14,1078
2021-05-01,68187,71066,-2879,-4.05,1078
2021-05-02,57706,62239,-4533,-7.28,1078
2021-05-03,68798,73643,-4845,-6.58,1078
2021-05-04,70735,75639,-4904,-6.48,1078
2021-05-05,70735,75695,-4960,-6.55,1078
2021-05-06,70735,75824,-5089,-6.71,1078
2021-05-07,73568,78611,-5043,-6.42,1078
2021-05-08,68187,71626,-3439,-4.8,1078
2021-05-09,57706,62787,-5081,-8.09,1078
2021-05-10,68798,74164,-5366,-7.24,1078
2021-05-11,70735,76117,-5382,-7.07,1078
2021-05-12,70735,76115,-5380,-7.07,1078
2021-05-13,70735,76175,-5440,-7.14,1078
2021-05-14,73568,78879,-5311,-6.73,1078
2021-05-15,68187,71803,-3616,-5.04,1078
2021-05-16,57706,62867,-5161,-8.21,1078
2021-05-17,68798,74142,-5344,-7.21,1078
2021-05-18,70735,75993,-5258,-6.92,1078
2021-05-19,70735,75893,-5158,-6.8,1078
2021-05-20,70735,75861,-5126,-6.76,1078
2021-05-21,73568,78482,-4914,-6.26,1078
2021-05-22,68187,71336,-3149,-4.41,1078
2021-05-23,57706,62346,-4640,-7.44,1078
2021-05-24,68798,73584,-4786,-6.5,1078
2021-05-25,70735,75419,-4684,-6.21,1078
2021-05-26,70735,75324,-4589,-6.09,1078
2021-05-27,70735,75317,-4582,-6.08,1078
2021-05-28,73568,77987,-4419,-5.67,1078
2021-05-29,68187,70910,-2723,-3.84,1078
2021-05-30,57706,62008,-4302,-6.94,1078
2021-05-31,68798,73353,-4555,-6.21,1078
2021-06-01,73481,75308,-1827,-2.43,1078
2021-06-02,73481,75343,-1862,-2.47,1078
2021-06-03,73481,75474,-1993,-2.64,1078
2021-06-04,74430,78284,-3854,-4.92,1078
2021-06-05,69458,71344,-1886,-2.64,1078
2021-06-06,61749,62571,-822,-1.31,1078
2021-06-07,71831,74032,-2201,-2.97,1078
2021-06-08,73481,76085,-2604,-3.42,1078
2021-06-09,73481,76196,-2715,-3.56,1078
2021-06-10,73481,76374,-2893,-3.79,1078
2021-06-11,74430,79199,-4769,-6.02,1078
2021-06-12,69458,72240,-2782,-3.85,1078
2021-06-13,61749,63410,-1661,-2.62,1078
2021-06-14,71831,74774,-2943,-3.94,1078
2021-06-15,73481,76690,-3209,-4.18,1078
2021-06-16,73481,76624,-3143,-4.1,1078
2021-06-17,73481,76587,-3106,-4.06,1078
2021-06-18,74430,79160,-4730,-5.98,1078
2021-06-19,69458,71915,-2457,-3.42,1078
2021-06-20,61749,62771,-1022,-1.63,1078
2021-06-21,71831,73797,-1966,-2.66,1078
2021-06-22,73481,75358,-1877,-2.49,1078
2021-06-23,73481,74925,-1444,-1.93,1078
2021-06-24,73481,74516,-1035,-1.39,1078
2021-06-25,74430,76721,-2291,-2.99,1078
2021-06-26,69458,69120,338,0.49,1078
2021-06-27,61749,59637,2112,3.54,1078
2021-06-28,71831,70351,1480,2.1,1078
2021-06-29,73481,71631,1850,2.58,1078
2021-06-30,73481,70956,2525,3.56,1078
2021-07-01,73412,70351,3061,4.35,1078
2021-07-02,74649,72408,2241,3.09,1078
2021-07-03,65771,64711,1060,1.64,1078
2021-07-04,58316,55189,3127,5.67,1078
2021-07-05,71578,65919,5659,8.58,1078
2021-07-06,73412,67271,6141,9.13,1078
2021-07-07,73412,66725,6687,10.02,1078
2021-07-08,73412,66299,7113,10.73,1078
2021-07-09,74649,68585,6064,8.84,1078
2021-07-10,65771,61161,4610,7.54,1078
2021-07-11,58316,51947,6369,12.26,1078
2021-07-12,71578,63017,8561,13.59,1078
2021-07-13,73412,64732,8680,13.41,1078
2021-07-14,73412,64562,8850,13.71,1078
2021-07-15,73412,64520,8892,13.78,1078
2021-07-16,74649,67186,7463,11.11,1078
2021-07-17,65771,60130,5641,9.38,1078
2021-07-18,58316,51266,7050,13.75,1078
2021-07-19,71578,62658,8920,14.24,1078
2021-07-20,73412,64661,8751,13.53,1078
2021-07-21,73412,64739,8673,13.4,1078
2021-07-22,73412,64899,8513,13.12,1078
2021-07-23,74649,67718,6931,10.24,1078
2021-07-24,65771,60765,5006,8.24,1078
2021-07-25,58316,51949,6367,12.26,1078
2021-07-26,71578,63338,8240,13.01,1078
2021-07-27,73412,65287,8125,12.45,1078
2021-07-28,73412,65264,8148,12.48,1078
2021-07-29,73412,65279,8133,12.46,1078
2021-07-30,74649,67916,6733,9.91,1078
2021-07-31,65771,60749,5022,8.27,1078
2021-08-01,56912,51698,5214,10.09,1078
2021-08-02,69755,62835,6920,11.01,1078
2021-08-03,70658,64526,6132,9.5,1078
2021-08-04,70658,64247,6411,9.98,1078
2021-08-05,70658,64019,6639,10.37,1078
2021-08-06,71493,66433,5060,7.62,1078
2021-08-07,63584,59071,4513,7.64,1078
2021-08-08,56912,49861,7051,14.14,1078
2021-08-09,69755,60883,8872,14.57,1078
2021-08-10,70658,62508,8150,13.04,1078
2021-08-11,70658,62216,8442,13.57,1078
2021-08-12,70658,62031,8627,13.91,1078
2021-08-13,71493,64547,6946,10.76,1078
2021-08-14,63584,57347,6237,10.88,1078
2021-08-15,56912,48356,8556,17.69,1078
2021-08-16,69755,59652,10103,16.94,1078
2021-08-17,70658,61602,9056,14.7,1078
2021-08-18,70658,61682,8976,14.55,1078
2021-08-19,70658,61908,8750,14.13,1078
2021-08-20,71493,64867,6626,10.21,1078
2021-08-21,63584,58133,5451,9.38,1078
2021-08-22,56912,49623,7289,14.69,1078
2021-08-23,69755,61405,8350,13.6,1078
2021-08-24,70658,63837,6821,10.69,1078
2021-08-25,70658,64383,6275,9.75,1078
2021-08-26,70658,65053,5605,8.62,1078
2021-08-27,71493,68424,3069,4.49,1078
2021-08-28,63584,62061,1523,2.45,1078
2021-08-29,56912,53874,3038,5.64,1078
2021-08-30,69755,65926,3829,5.81,1078
2021-08-31,70658,68569,2089,3.05,1078
2021-09-01,74631,69264,5367,7.75,1078
2021-09-02,74631,70019,4612,6.59,1078
2021-09-03,78566,73408,5158,7.03,1078
2021-09-04,73381,67000,6381,9.52,1078
2021-09-05,63271,58705,4566,7.78,1078
2021-09-06,73342,70590,2752,3.9,1078
2021-09-07,74631,73011,1620,2.22,1078
2021-09-08,74631,73436,1195,1.63,1078
2021-09-09,74631,73878,753,1.02,1078
2021-09-10,78566,76920,1646,2.14,1078
2021-09-11,73381,70138,3243,4.62,1078
2021-09-12,63271,61452,1819,2.96,1078
2021-09-13,73342,72935,407,0.56,1078
2021-09-14,74631,74954,-323,-0.43,1078
2021-09-15,74631,74984,-353,-0.47,1078
2021-09-16,74631,75046,-415,-0.55,1078
2021-09-17,78566,77731,835,1.07,1078
2021-09-18,73381,70619,2762,3.91,1078
2021-09-19,63271,61638,1633,2.65,1078
2021-09-20,73342,72864,478,0.66,1078
2021-09-21,74631,74668,-37,-0.05,1078
2021-09-22,74631,74526,105,0.14,1078
2021-09-23,74631,74460,171,0.23,1078
2021-09-24,78566,77062,1504,1.95,1078
2021-09-25,73381,69910,3471,4.96,1078
2021-09-26,63271,60928,2343,3.85,1078
2021-09-27,73342,72191,1151,1.59,1078
2021-09-28,74631,74064,567,0.77,1078
2021-09-29,74631,74019,612,0.83,1078
2021-09-30,74631,74073,558,0.75,1078
2021-10-01,77910,76810,1100,1.43,1078
2021-10-02,73598,69805,3793,5.43,1078
2021-10-03,62902,60974,1928,3.16,1078
2021-10-04,71304,72386,-1082,-1.49,1078
2021-10-05,73377,74401,-1024,-1.38,1078
2021-10-06,73377,74487,-1110,-1.49,1078
2021-10-07,73377,74655,-1278,-1.71,1078
2021-10-08,77910,77487,423,0.55,1078
2021-10-09,73598,70553,3045,4.32,1078
2021-10-10,62902,61768,1134,1.84,1078
2021-10-11,71304,73201,-1897,-2.59,1078
2021-10-12,73377,75210,-1833,-2.44,1078
2021-10-13,73377,75263,-1886,-2.51,1078
2021-10-14,73377,75375,-1998,-2.65,1078
2021-10-15,77910,78127,-217,-0.28,1078
2021-10-16,73598,71095,2503,3.52,1078
2021-10-17,62902,62195,707,1.14,1078
2021-10-18,71304,73501,-2197,-2.99,1078
2021-10-19,73377,75375,-1998,-2.65,1078
2021-10-20,73377,75290,-1913,-2.54,1078
2021-10-21,73377,75263,-1886,-2.51,1078
2021-10-22,77910,77882,28,0.04,1078
2021-10-23,73598,70724,2874,4.06,1078
2021-10-24,62902,61711,1191,1.93,1078
2021-10-25,71304,72919,-1615,-2.21,1078
2021-10-26,73377,74714,-1337,-1.79,1078
2021-10-27,73377,74568,-1191,-1.6,1078
2021-10-28,73377,74502,-1125,-1.51,1078
2021-10-29,77910,77104,806,1.05,1078
2021-10-30,73598,69950,3648,5.22,1078
2021-10-31,62902,60962,1940,3.18,1078
2021-11-01,65655,72214,-6559,-9.08,1078
2021-11-02,68949,74068,-5119,-6.91,1078
2021-11-03,68949,73998,-5049,-6.82,1078
2021-11-04,68949,74018,-5069,-6.85,1078
2021-11-05,72187,76713,-4526,-5.9,1078
2021-11-06,66879,69656,-2777,-3.99,1078
2021-11-07,58365,60767,-2402,-3.95,1078
2021-11-08,65655,72113,-6458,-8.96,1078
2021-11-09,68949,74056,-5107,-6.9,1078
2021-11-10,68949,74064,-5115,-6.91,1078
2021-11-11,68949,74149,-5200,-7.01,1078
2021-11-12,72187,76894,-4707,-6.12,1078
2021-11-13,66879,69870,-2991,-4.28,1078
2021-11-14,58365,60995,-2630,-4.31,1078
2021-11-15,65655,72336,-6681,-9.24,1078
2021-11-16,68949,74255,-5306,-7.15,1078
2021-11-17,68949,74219,-5270,-7.1,1078
2021-11-18,68949,74244,-5295,-7.13,1078
2021-11-19,72187,76912,-4725,-6.14,1078
2021-11-20,66879,69799,-2920,-4.18,1078
2021-11-21,58365,60823,-2458,-4.04,1078
2021-11-22,65655,72057,-6402,-8.88,1078
2021-11-23,68949,73864,-4915,-6.65,1078
2021-11-24,68949,73715,-4766,-6.47,1078
2021-11-25,68949,73630,-4681,-6.36,1078
2021-11-26,72187,76195,-4008,-5.26,1078
2021-11-27,66879,68988,-2109,-3.06,1078
2021-11-28,58365,59931,-1566,-2.61,1078
2021-11-29,65655,71097,-5442,-7.65,1078
2021-11-30,68949,72854,-3905,-5.36,1078
2021-12-01,67077,72675,-5598,-7.7,1078
2021-12-02,67077,72577,-5500,-7.58,1078
2021-12-03,66948,75150,-8202,-10.91,1078
2021-12-04,64209,67970,-3761,-5.53,1078
2021-12-05,53429,58957,-5528,-9.38,1078
2021-12-06,66372,70186,-3814,-5.43,1078
2021-12-07,67077,72019,-4942,-6.86,1078
2021-12-08,67077,71928,-4851,-6.74,1078
2021-12-09,67077,71928,-4851,-6.74,1078
2021-12-10,66948,74603,-7655,-10.26,1078
2021-12-11,64209,67527,-3318,-4.91,1078
2021-12-12,53429,58618,-5189,-8.85,1078
2021-12-13,66372,69944,-3572,-5.11,1078
2021-12-14,67077,71865,-4788,-6.66,1078
2021-12-15,67077,71850,-4773,-6.64,1078
2021-12-16,67077,71911,-4834,-6.72,1078
2021-12-17,66948,74629,-7681,-10.29,1078
2021-12-18,64209,67576,-3367,-4.98,1078
2021-12-19,53429,58669,-5240,-8.93,1078
2021-12-20,66372,69975,-3603,-5.15,1078
2021-12-21,67077,71854,-4777,-6.65,1078
2021-12-22,67077,71774,-4697,-6.54,1078
2021-12-23,67077,71751,-4674,-6.51,1078
2021-12-24,66948,74366,-7418,-9.97,1078
2021-12-25,64209,67195,-2986,-4.44,1078
2021-12-26,53429,58156,-4727,-8.13,1078
2021-12-27,66372,69320,-2948,-4.25,1078
2021-12-28,67077,71052,-3975,-5.59,1078
2021-12-29,67077,70824,-3747,-5.29,1078
2021-12-30,67077,70655,-3578,-5.06,1078
2021-12-31,66948,73131,-6183,-8.45,1078
2022-01-01,67371,65831,1540,2.34,1078
2022-01-02,53593,56678,-3085,-5.44,1078
2022-01-03,65016,67747,-2731,-4.03,1078
2022-01-04,66625,69405,-2780,-4.01,1078
2022-01-05,66625,69128,-2503,-3.62,1078
2022-01-06,66625,68935,-2310,-3.35,1078
2022-01-07,70404,71416,-1012,-1.42,1078
2022-01-08,67371,64149,3222,5.02,1078
2022-01-09,53593,55057,-1464,-2.66,1078
2022-01-10,65016,66216,-1200,-1.81,1078
2022-01-11,66625,67990,-1365,-2.01,1078
2022-01-12,66625,67853,-1228,-1.81,1078
2022-01-13,66625,67822,-1197,-1.76,1078
2022-01-14,70404,70483,-79,-0.11,1078
2022-01-15,67371,63412,3959,6.24,1078
2022-01-16,53593,54527,-934,-1.71,1078
2022-01-17,65016,65898,-882,-1.34,1078
2022-01-18,66625,67888,-1263,-1.86,1078
2022-01-19,66625,67965,-1340,-1.97,1078
2022-01-20,66625,68142,-1517,-2.23,1078
2022-01-21,70404,71001,-597,-0.84,1078
2022-01-22,67371,64113,3258,5.08,1078
2022-01-23,53593,55395,-1802,-3.25,1078
2022-01-24,65016,66913,-1897,-2.84,1078
2022-01-25,66625,69028,-2403,-3.48,1078
2022-01-26,66625,69205,-2580,-3.73,1078
2022-01-27,66625,69458,-2833,-4.08,1078
2022-01-28,70404,72368,-1964,-2.71,1078
2022-01-29,67371,65506,1865,2.85,1078
2022-01-30,53593,56790,-3197,-5.63,1078
2020-02-01,24533,23564,969,4.11,1217
2020-02-02,19200,18499,701,3.79,1217
2020-02-03,28940,29262,-322,-1.1,1217
2020-02-04,31033,31083,-50,-0.16,1217
2020-02-05,31033,31089,-56,-0.18,1217
2020-02-06,31033,31102,-69,-0.22,1217
2020-02-07,31573,30977,596,1.92,1217
2020-02-08,24533,23536,997,4.24,1217
2020-02-09,19200,18434,766,4.16,1217
2020-02-10,28940,29171,-231,-0.79,1217
2020-02-11,31033,30976,57,0.18,1217
2020-02-12,31033,30977,56,0.18,1217
2020-02-13,31033,30998,35,0.11,1217
2020-02-14,31573,30894,679,2.2,1217
2020-02-15,24533,23485,1048,4.46,1217
2020-02-16,19200,18426,774,4.2,1217
2020-02-17,28940,29217,-277,-0.95,1217
2020-02-18,31033,31085,-52,-0.17,1217
2020-02-19,31033,31157,-124,-0.4,1217
2020-02-20,31033,31255,-222,-0.71,1217
2020-02-21,31573,31231,342,1.1,1217
2020-02-22,24533,23905,628,2.63,1217
2020-02-23,19200,18929,271,1.43,1217
2020-02-24,28940,29800,-860,-2.89,1217
2020-02-25,31033,31745,-712,-2.24,1217
2020-02-26,31033,31888,-855,-2.68,1217
2020-02-27,31033,32048,-1015,-3.17,1217
2020-02-28,31573,32078,-505,-1.57,1217
2020-02-29,24533,24795,-262,-1.06,1217
2020-03-01,12615,19850,-7235,-36.45,1217
2020-03-02,20692,30740,-10048,-32.69,1217
2020-03-03,21147,32690,-11543,-35.31,1217
2020-03-04,21147,32826,-11679,-35.58,1217
2020-03-05,21147,32967,-11820,-35.85,1217
2020-03-06,21535,32964,-11429,-34.67,1217
2020-03-07,13694,25637,-11943,-46.59,1217
2020-03-08,12615,20638,-8023,-38.87,1217
2020-03-09,20692,31465,-10773,-34.24,1217
2020-03-10,21147,33344,-12197,-36.58,1217
2020-03-11,21147,33402,-12255,-36.69,1217
2020-03-12,21147,33461,-12314,-36.8,1217
2020-03-13,21535,33374,-11839,-35.47,1217
2020-03-14,13694,25961,-12267,-47.25,1217
2020-03-15,12615,20878,-8263,-39.58,1217
2020-03-16,20692,31621,-10929,-34.56,1217
2020-03-17,21147,33421,-12274,-36.73,1217
2020-03-18,21147,33405,-12258,-36.7,1217
2020-03-19,21147,33395,-12248,-36.68,1217
2020-03-20,21535,33246,-11711,-35.23,1217
2020-03-21,13694,25778,-12084,-46.88,1217
2020-03-22,12615,20647,-8032,-38.9,1217
2020-03-23,20692,31352,-10660,-34.0,1217
2020-03-24,21147,33120,-11973,-36.15,1217
2020-03-25,21147,33080,-11933,-36.07,1217
2020-03-26,21147,33054,-11907,-36.02,1217
2020-03-27,21535,32894,-11359,-34.53,1217
2020-03-28,13694,25422,-11728,-46.13,1217
2020-03-29,12615,20291,-7676,-37.83,1217
2020-03-30,20692,31000,-10308,-33.25,1217
2020-03-31,21147,32776,-11629,-35.48,1217
2020-04-01,17939,32745,-14806,-45.22,1217
2020-04-02,17939,32730,-14791,-45.19,1217
2020-04-03,15938,32583,-16645,-51.08,1217
2020-04-04,9795,25123,-15328,-61.01,1217
2020-04-05,7572,20004,-12432,-62.15,1217
2020-04-06,17538,30724,-13186,-42.92,1217
2020-04-07,17939,32510,-14571,-44.82,1217
2020-04-08,17939,32488,-14549,-44.78,1217
2020-04-09,17939,32481,-14542,-44.77,1217
2020-04-10,15938,32340,-16402,-50.72,1217
2020-04-11,9795,24888,-15093,-60.64,1217
2020-04-12,7572,19776,-12204,-61.71,1217
2020-04-13,17538,30504,-12966,-42.51,1217
2020-04-14,17939,32299,-14360,-44.46,1217
2020-04-15,17939,32289,-14350,-44.44,1217
2020-04-16,17939,32296,-14357,-44.45,1217
2020-04-17,15938,32173,-16235,-50.46,1217
2020-04-18,9795,24741,-14946,-60.41,1217
2020-04-19,7572,19655,-12083,-61.48,1217
2020-04-20,17538,30413,-12875,-42.33,1217
2020-04-21,17939,32243,-14304,-44.36,1217
2020-04-22,17939,32271,-14332,-44.41,1217
2020-04-23,17939,32321,-14382,-44.5,1217
2020-04-24,15938,32245,-16307,-50.57,1217
2020-04-25,9795,24863,-15068,-60.6,1217
2020-04-26,7572,19830,-12258,-61.82,1217
2020-04-27,17538,30641,-13103,-42.76,1217
2020-04-28,17939,32524,-14585,-44.84,1217
2020-04-29,17939,32606,-14667,-44.98,1217
2020-04-30,17939,32707,-14768,-45.15,1217
2020-05-01,24962,32678,-7716,-23.61,1217
2020-05-02,16317,25338,-9021,-35.6,1217
2020-05-03,12572,20340,-7768,-38.19,1217
2020-05-04,24868,31179,-6311,-20.24,1217
2020-05-05,26418,33082,-6664,-20.14,1217
2020-05-06,26418,33174,-6756,-20.37,1217
2020-05-07,26418,33275,-6857,-20.61,1217
2020-05-08,24962,33235,-8273,-24.89,1217
2020-05-09,16317,25874,-9557,-36.94,1217
2020-05-10,12572,20843,-8271,-39.68,1217
2020-05-11,24868,31639,-6771,-21.4,1217
2020-05-12,26418,33490,-7072,-21.12,1217
2020-05-13,26418,33519,-7101,-21.18,1217
2020-05-14,26418,33550,-7132,-21.26,1217
2020-05-15,24962,33433,-8471,-25.34,1217
2020-05-16,16317,25990,-9673,-37.22,1217
2020-05-17,12572,20875,-8303,-39.77,1217
2020-05-18,24868,31585,-6717,-21.27,1217
2020-05-19,26418,33350,-6932,-20.79,1217
2020-05-20,26418,33296,-6878,-20.66,1217
2020-05-21,26418,33248,-6830,-20.54,1217
2020-05-22,24962,33059,-8097,-24.49,1217
2020-05-23,16317,25551,-9234,-36.14,1217
2020-05-24,12572,20380,-7808,-38.31,1217
2020-05-25,24868,31046,-6178,-19.9,1217
2020-05-26,26418,32778,-6360,-19.4,1217
2020-05-27,26418,32703,-6285,-19.22,1217
2020-05-28,26418,32647,-6229,-19.08,1217
2020-05-29,24962,32462,-7500,-23.1,1217
2020-05-30,16317,24971,-8654,-34.66,1217
2020-05-31,12572,19828,-7256,-36.59,1217
2020-06-01,28720,30532,-1812,-5.93,1217
2020-06-02,30460,32310,-1850,-5.73,1217
2020-06-03,30460,32290,-1830,-5.67,1217
2020-06-04,30460,32293,-1833,-5.68,1217
2020-06-05,28098,32172,-4074,-12.66,1217
2020-06-06,20051,24744,-4693,-18.97,1217
2020-06-07,15248,19664,-4416,-22.46,1217
2020-06-08,28720,30426,-1706,-5.61,1217
2020-06-09,30460,32258,-1798,-5.57,1217
2020-06-10,30460,32283,-1823,-5.65,1217
2020-06-11,30460,32322,-1862,-5.76,1217
2020-06-12,28098,32225,-4127,-12.81,1217
2020-06-13,20051,24809,-4758,-19.18,1217
2020-06-14,15248,19726,-4478,-22.7,1217
2020-06-15,28720,30472,-1752,-5.75,1217
2020-06-16,30460,32273,-1813,-5.62,1217
2020-06-17,30460,32252,-1792,-5.56,1217
2020-06-18,30460,32232,-1772,-5.5,1217
2020-06-19,28098,32062,-3964,-12.36,1217
2020-06-20,20051,24562,-4511,-18.37,1217
2020-06-21,15248,19386,-4138,-21.35,1217
2020-06-22,28720,30031,-1311,-4.37,1217
2020-06-23,30460,31726,-1266,-3.99,1217
2020-06-24,30460,31596,-1136,-3.6,1217
2020-06-25,30460,31467,-1007,-3.2,1217
2020-06-26,28098,31190,-3092,-9.91,1217
2020-06-27,20051,23589,-3538,-15.0,1217
2020-06-28,15248,18320,-3072,-16.77,1217
2020-06-29,28720,28882,-162,-0.56,1217
2020-06-30,30460,30506,-46,-0.15,1217
2020-07-01,29287,30321,-1034,-3.41,1217
2020-07-02,29287,30151,-864,-2.87,1217
2020-07-03,27497,29852,-2355,-7.89,1217
2020-07-04,18604,22246,-3642,-16.37,1217
2020-07-05,14814,16991,-2177,-12.81,1217
2020-07-06,26865,27584,-719,-2.61,1217
2020-07-07,29287,29257,30,0.1,1217
2020-07-08,29287,29136,151,0.52,1217
2020-07-09,29287,29046,241,0.83,1217
2020-07-10,27497,28839,-1342,-4.65,1217
2020-07-11,18604,21336,-2732,-12.8,1217
2020-07-12,14814,16190,-1376,-8.5,1217
2020-07-13,26865,26899,-34,-0.13,1217
2020-07-14,29287,28690,597,2.08,1217
2020-07-15,29287,28686,601,2.1,1217
2020-07-16,29287,28709,578,2.01,1217
2020-07-17,27497,28608,-1111,-3.88,1217
2020-07-18,18604,21202,-2598,-12.25,1217
2020-07-19,14814,16142,-1328,-8.23,1217
2020-07-20,26865,26923,-58,-0.22,1217
2020-07-21,29287,28769,518,1.8,1217
2020-07-22,29287,28804,483,1.68,1217
2020-07-23,29287,28848,439,1.52,1217
2020-07-24,27497,28751,-1254,-4.36,1217
2020-07-25,18604,21330,-2726,-12.78,1217
2020-07-26,14814,16238,-1424,-8.77,1217
2020-07-27,26865,26971,-106,-0.39,1217
2020-07-28,29287,28755,532,1.85,1217
2020-07-29,29287,28716,571,1.99,1217
2020-07-30,29287,28676,611,2.13,1217
2020-07-31,27497,28487,-990,-3.48,1217
2020-08-01,18169,20972,-2803,-13.37,1217
2020-08-02,14723,15784,-1061,-6.72,1217
2020-08-03,26668,26423,245,0.93,1217
2020-08-04,28004,28120,-116,-0.41,1217
2020-08-05,28004,28002,2,0.01,1217
2020-08-06,28004,27895,109,0.39,1217
2020-08-07,25807,27653,-1846,-6.68,1217
2020-08-08,18169,20101,-1932,-9.61,1217
2020-08-09,14723,14896,-173,-1.16,1217
2020-08-10,26668,25537,1131,4.43,1217
2020-08-11,28004,27256,748,2.74,1217
2020-08-12,28004,27183,821,3.02,1217
2020-08-13,28004,27141,863,3.18,1217
2020-08-14,25807,26986,-1179,-4.37,1217
2020-08-15,18169,19540,-1371,-7.02,1217
2020-08-16,14723,14458,265,1.83,1217
2020-08-17,26668,25239,1429,5.66,1217
2020-08-18,28004,27111,893,3.29,1217
2020-08-19,28004,27199,805,2.96,1217
2020-08-20,28004,27328,676,2.47,1217
2020-08-21,25807,27346,-1539,-5.63,1217
2020-08-22,18169,20073,-1904,-9.49,1217
2020-08-23,14723,15162,-439,-2.9,1217
2020-08-24,26668,26106,562,2.15,1217
2020-08-25,28004,28132,-128,-0.45,1217
2020-08-26,28004,28362,-358,-1.26,1217
2020-08-27,28004,28615,-611,-2.14,1217
2020-08-28,25807,28741,-2934,-10.21,1217
2020-08-29,18169,21556,-3387,-15.71,1217
2020-08-30,14723,16711,-1988,-11.9,1217
2020-08-31,26668,27699,-1031,-3.72,1217
2020-09-01,31164,29746,1418,4.77,1217
2020-09-02,31164,29975,1189,3.97,1217
2020-09-03,31164,30206,958,3.17,1217
2020-09-04,29769,30288,-519,-1.71,1217
2020-09-05,21488,23041,-1553,-6.74,1217
2020-09-06,17884,18115,-231,-1.28,1217
2020-09-07,29214,29009,205,0.71,1217
2020-09-08,31164,30950,214,0.69,1217
2020-09-09,31164,31062,102,0.33,1217
2020-09-10,31164,31171,-7,-0.02,1217
2020-09-11,29769,31127,-1358,-4.36,1217
2020-09-12,21488,23754,-2266,-9.54,1217
2020-09-13,17884,18705,-821,-4.39,1217
2020-09-14,29214,29481,-267,-0.91,1217
2020-09-15,31164,31312,-148,-0.47,1217
2020-09-16,31164,31325,-161,-0.51,1217
2020-09-17,31164,31346,-182,-0.58,1217
2020-09-18,29769,31228,-1459,-4.67,1217
2020-09-19,21488,23795,-2307,-9.7,1217
2020-09-20,17884,18702,-818,-4.37,1217
2020-09-21,29214,29449,-235,-0.8,1217
2020-09-22,31164,31266,-102,-0.33,1217
2020-09-23,31164,31279,-115,-0.37,1217
2020-09-24,31164,31313,-149,-0.48,1217
2020-09-25,29769,31221,-1452,-4.65,1217
2020-09-26,21488,23824,-2336,-9.81,1217
2020-09-27,17884,18775,-891,-4.75,1217
2020-09-28,29214,29572,-358,-1.21,1217
2020-09-29,31164,31442,-278,-0.88,1217
2020-09-30,31164,31512,-348,-1.1,1217
2020-10-01,30606,31601,-995,-3.15,1217
2020-10-02,30124,31562,-1438,-4.56,1217
2020-10-03,21954,24213,-2259,-9.33,1217
2020-10-04,16744,19206,-2462,-12.82,1217
2020-10-05,29620,30038,-418,-1.39,1217
2020-10-06,30606,31934,-1328,-4.16,1217
2020-10-07,30606,32019,-1413,-4.41,1217
2020-10-08,30606,32114,-1508,-4.7,1217
2020-10-09,30124,32070,-1946,-6.07,1217
2020-10-10,21954,24706,-2752,-11.14,1217
2020-10-11,16744,19674,-2930,-14.89,1217
2020-10-12,29620,30472,-852,-2.8,1217
2020-10-13,30606,32326,-1720,-5.32,1217
2020-10-14,30606,32363,-1757,-5.43,1217
2020-10-15,30606,32406,-1800,-5.55,1217
2020-10-16,30124,32305,-2181,-6.75,1217
2020-10-17,21954,24883,-2929,-11.77,1217
2020-10-18,16744,19794,-3050,-15.41,1217
2020-10-19,29620,30537,-917,-3.0,1217
2020-10-20,30606,32339,-1733,-5.36,1217
2020-10-21,30606,32330,-1724,-5.33,1217
2020-10-22,30606,32332,-1726,-5.34,1217
2020-10-23,30124,32199,-2075,-6.44,1217
2020-10-24,21954,24752,-2798,-11.3,1217
2020-10-25,16744,19647,-2903,-14.78,1217
2020-10-26,29620,30383,-763,-2.51,1217
2020-10-27,30606,32188,-1582,-4.91,1217
2020-10-28,30606,32189,-1583,-4.92,1217
2020-10-29,30606,32210,-1604,-4.98,1217
2020-10-30,30124,32103,-1979,-6.16,1217
2020-10-31,21954,24688,-2734,-11.07,1217
2020-11-01,12342,19620,-7278,-37.09,1217
2020-11-02,25293,30395,-5102,-16.79,1217
2020-11-03,24341,32241,-7900,-24.5,1217
2020-11-04,24341,32284,-7943,-24.6,1217
2020-11-05,24341,32344,-8003,-24.74,1217
2020-11-06,23454,32273,-8819,-27.33,1217
2020-11-07,14577,24890,-10313,-41.43,1217
2020-11-08,12342,19848,-7506,-37.82,1217
2020-11-09,25293,30642,-5349,-17.46,1217
2020-11-10,24341,32500,-8159,-25.1,1217
2020-11-11,24341,32546,-8205,-25.21,1217
2020-11-12,24341,32601,-8260,-25.34,1217
2020-11-13,23454,32517,-9063,-27.87,1217
2020-11-14,14577,25112,-10535,-41.95,1217
2020-11-15,12342,20040,-7698,-38.41,1217
2020-11-16,25293,30798,-5505,-17.87,1217
2020-11-17,24341,32614,-8273,-25.37,1217
2020-11-18,24341,32613,-8272,-25.36,1217
2020-11-19,24341,32618,-8277,-25.38,1217
2020-11-20,23454,32483,-9029,-27.8,1217
2020-11-21,14577,25027,-10450,-41.75,1217
2020-11-22,12342,19906,-7564,-38.0,1217
2020-11-23,25293,30617,-5324,-17.39,1217
2020-11-24,24341,32392,-8051,-24.85,1217
2020-11-25,24341,32355,-8014,-24.77,1217
2020-11-26,24341,32333,-7992,-24.72,1217
2020-11-27,23454,32177,-8723,-27.11,1217
2020-11-28,14577,24709,-10132,-41.01,1217
2020-11-29,12342,19586,-7244,-36.99,1217
2020-11-30,25293,30304,-5011,-16.54,1217
2020-12-01,23999,32094,-8095,-25.22,1217
2020-12-02,23999,32081,-8082,-25.19,1217
2020-12-03,23999,32089,-8090,-25.21,1217
2020-12-04,26449,31970,-5521,-17.27,1217
2020-12-05,17627,24545,-6918,-28.18,1217
2020-12-06,12222,19466,-7244,-37.21,1217
2020-12-07,23142,30231,-7089,-23.45,1217
2020-12-08,23999,32067,-8068,-25.16,1217
2020-12-09,23999,32098,-8099,-25.23,1217
2020-12-10,23999,32146,-8147,-25.34,1217
2020-12-11,26449,32061,-5612,-17.5,1217
2020-12-12,17627,24662,-7035,-28.53,1217
2020-12-13,12222,19601,-7379,-37.65,1217
2020-12-14,23142,30373,-7231,-23.81,1217
2020-12-15,23999,32204,-8205,-25.48,1217
2020-12-16,23999,32219,-8220,-25.51,1217
2020-12-17,23999,32238,-8239,-25.56,1217
2020-12-18,26449,32111,-5662,-17.63,1217
2020-12-19,17627,24658,-7031,-28.51,1217
2020-12-20,12222,19532,-7310,-37.43,1217
2020-12-21,23142,30229,-7087,-23.44,1217
2020-12-22,23999,31976,-7977,-24.95,1217
2020-12-23,23999,31900,-7901,-24.77,1217
2020-12-24,23999,31822,-7823,-24.58,1217
2020-12-25,26449,31596,-5147,-16.29,1217
2020-12-26,17627,24043,-6416,-26.69,1217
2020-12-27,12222,18818,-6596,-35.05,1217
2020-12-28,23142,29420,-6278,-21.34,1217
2020-12-29,23999,31078,-7079,-22.78,1217
2020-12-30,23999,30922,-6923,-22.39,1217
2020-12-31,23999,30775,-6776,-22.02,1217
2021-01-01,17550,30492,-12942,-42.44,1217
2021-01-02,11673,22896,-11223,-49.02,1217
2021-01-03,9583,17643,-8060,-45.68,1217
2021-01-04,18218,28234,-10016,-35.47,1217
2021-01-05,18251,29898,-11647,-38.96,1217
2021-01-06,18251,29764,-11513,-38.68,1217
2021-01-07,18251,29656,-11405,-38.46,1217
2021-01-08,17550,29428,-11878,-40.36,1217
2021-01-09,11673,21901,-10228,-46.7,1217
2021-01-10,9583,16732,-7149,-42.73,1217
2021-01-11,18218,27417,-9199,-33.55,1217
2021-01-12,18251,29186,-10935,-37.47,1217
2021-01-13,18251,29163,-10912,-37.42,1217
2021-01-14,18251,29172,-10921,-37.44,1217
2021-01-15,17550,29063,-11513,-39.61,1217
2021-01-16,11673,21656,-9983,-46.1,1217
2021-01-17,9583,16603,-7020,-42.28,1217
2021-01-18,18218,27400,-9182,-33.51,1217
2021-01-19,18251,29273,-11022,-37.65,1217
2021-01-20,18251,29346,-11095,-37.81,1217
2021-01-21,18251,29438,-11187,-38.0,1217
2021-01-22,17550,29401,-11851,-40.31,1217
2021-01-23,11673,22052,-10379,-47.07,1217
2021-01-24,9583,17042,-7459,-43.77,1217
2021-01-25,18218,27868,-9650,-34.63,1217
2021-01-26,18251,29755,-11504,-38.66,1217
2021-01-27,18251,29828,-11577,-38.81,1217
2021-01-28,18251,29908,-11657,-38.98,1217
2021-01-29,17550,29845,-12295,-41.2,1217
2021-01-30,11673,22460,-10787,-48.03,1217
2021-01-31,9583,17406,-7823,-44.94,1217
2021-02-01,17231,28180,-10949,-38.85,1217
2021-02-02,17815,30011,-12196,-40.64,1217
2021-02-03,17815,30026,-12211,-40.67,1217
2021-02-04,17815,30046,-12231,-40.71,1217
2021-02-05,17383,29927,-12544,-41.92,1217
2021-02-06,12045,22489,-10444,-46.44,1217
2021-02-07,9341,17389,-8048,-46.28,1217
2021-02-08,17231,28124,-10893,-38.73,1217
2021-02-09,17815,29926,-12111,-40.47,1217
2021-02-10,17815,29921,-12106,-40.46,1217
2021-02-11,17815,29935,-12120,-40.49,1217
2021-02-12,17383,29820,-12437,-41.71,1217
2021-02-13,12045,22399,-10354,-46.23,1217
2021-02-14,9341,17328,-7987,-46.09,1217
2021-02-15,17231,28104,-10873,-38.69,1217
2021-02-16,17815,29957,-12142,-40.53,1217
2021-02-17,17815,30013,-12198,-40.64,1217
2021-02-18,17815,30096,-12281,-40.81,1217
2021-02-19,17383,30057,-12674,-42.17,1217
2021-02-20,12045,22716,-10671,-46.98,1217
2021-02-21,9341,17727,-8386,-47.31,1217
2021-02-22,17231,28586,-11355,-39.72,1217
2021-02-23,17815,30521,-12706,-41.63,1217
2021-02-24,17815,30655,-12840,-41.89,1217
2021-02-25,17815,30810,-12995,-42.18,1217
2021-02-26,17383,30836,-13453,-43.63,1217
2021-02-27,12045,23551,-11506,-48.86,1217
2021-02-28,9341,18607,-9266,-49.8,1217
2021-03-01,18503,29501,-10998,-37.28,1217
2021-03-02,19745,31457,-11712,-37.23,1217
2021-03-03,19745,31600,-11855,-37.52,1217
2021-03-04,19745,31751,-12006,-37.81,1217
2021-03-05,19623,31760,-12137,-38.21,1217
2021-03-06,12438,24446,-12008,-49.12,1217
2021-03-07,9347,19461,-10114,-51.97,1217
2021-03-08,18503,30303,-11800,-38.94,1217
2021-03-09,19745,32198,-12453,-38.68,1217
2021-03-10,19745,32272,-12527,-38.82,1217
2021-03-11,19745,32347,-12602,-38.96,1217
2021-03-12,19623,32275,-12652,-39.2,1217
2021-03-13,12438,24877,-12439,-50.0,1217
2021-03-14,9347,19807,-10460,-52.81,1217
2021-03-15,18503,30564,-12061,-39.46,1217
2021-03-16,19745,32375,-12630,-39.01,1217
2021-03-17,19745,32369,-12624,-39.0,1217
2021-03-18,19745,32368,-12623,-39.0,1217
2021-03-19,19623,32226,-12603,-39.11,1217
2021-03-20,12438,24764,-12326,-49.77,1217
2021-03-21,9347,19637,-10290,-52.4,1217
2021-03-22,18503,30345,-11842,-39.02,1217
2021-03-23,19745,32115,-12370,-38.52,1217
2021-03-24,19745,32075,-12330,-38.44,1217
2021-03-25,19745,32048,-12303,-38.39,1217
2021-03-26,19623,31888,-12265,-38.46,1217
2021-03-27,12438,24414,-11976,-49.05,1217
2021-03-28,9347,19282,-9935,-51.52,1217
2021-03-29,18503,29988,-11485,-38.3,1217
2021-03-30,19745,31762,-12017,-37.83,1217
2021-03-31,19745,31729,-11984,-37.77,1217
2021-04-01,17879,31711,-13832,-43.62,1217
2021-04-02,16027,31562,-15535,-49.22,1217
2021-04-03,9650,24100,-14450,-59.96,1217
2021-04-04,8049,18980,-10931,-57.59,1217
2021-04-05,17717,29698,-11981,-40.34,1217
2021-04-06,17879,31483,-13604,-43.21,1217
2021-04-07,17879,31460,-13581,-43.17,1217
2021-04-08,17879,31452,-13573,-43.15,1217
2021-04-09,16027,31310,-15283,-48.81,1217
2021-04-10,9650,23856,-14206,-59.55,1217
2021-04-11,8049,18743,-10694,-57.06,1217
2021-04-12,17717,29468,-11751,-39.88,1217
2021-04-13,17879,31261,-13382,-42.81,1217
2021-04-14,17879,31247,-13368,-42.78,1217
2021-04-15,17879,31250,-13371,-42.79,1217
2021-04-16,16027,31121,-15094,-48.5,1217
2021-04-17,9650,23684,-14034,-59.26,1217
2021-04-18,8049,18591,-10542,-56.7,1217
2021-04-19,17717,29340,-11623,-39.61,1217
2021-04-20,17879,31162,-13283,-42.63,1217
2021-04-21,17879,31181,-13302,-42.66,1217
2021-04-22,17879,31222,-13343,-42.74,1217
2021-04-23,16027,31136,-15109,-48.53,1217
2021-04-24,9650,23744,-14094,-59.36,1217
2021-04-25,8049,18700,-10651,-56.96,1217
2021-04-26,17717,29502,-11785,-39.95,1217
2021-04-27,17879,31376,-13497,-43.02,1217
2021-04-28,17879,31450,-13571,-43.15,1217
2021-04-29,17879,31543,-13664,-43.32,1217
2021-04-30,16027,31509,-15482,-49.14,1217
2021-05-01,13500,24165,-10665,-44.13,1217
2021-05-02,10741,19164,-8423,-43.95,1217
2021-05-03,21236,30003,-8767,-29.22,1217
2021-05-04,22712,31908,-9196,-28.82,1217
2021-05-05,22712,32004,-9292,-29.03,1217
2021-05-06,22712,32110,-9398,-29.27,1217
2021-05-07,20801,32078,-11277,-35.15,1217
2021-05-08,13500,24726,-11226,-45.4,1217
2021-05-09,10741,19707,-8966,-45.5,1217
2021-05-10,21236,30516,-9280,-30.41,1217
2021-05-11,22712,32380,-9668,-29.86,1217
2021-05-12,22712,32425,-9713,-29.96,1217
2021-05-13,22712,32471,-9759,-30.05,1217
2021-05-14,20801,32371,-11570,-35.74,1217
2021-05-15,13500,24944,-11444,-45.88,1217
2021-05-16,10741,19844,-9103,-45.87,1217
2021-05-17,21236,30569,-9333,-30.53,1217
2021-05-18,22712,32348,-9636,-29.79,1217
2021-05-19,22712,32306,-9594,-29.7,1217
2021-05-20,22712,32269,-9557,-29.62,1217
2021-05-21,20801,32088,-11287,-35.18,1217
2021-05-22,13500,24587,-11087,-45.09,1217
2021-05-23,10741,19420,-8679,-44.69,1217
2021-05-24,21236,30088,-8852,-29.42,1217
2021-05-25,22712,31819,-9107,-28.62,1217
2021-05-26,22712,31741,-9029,-28.45,1217
2021-05-27,22712,31680,-8968,-28.31,1217
2021-05-28,20801,31488,-10687,-33.94,1217
2021-05-29,13500,23988,-10488,-43.72,1217
2021-05-30,10741,18835,-8094,-42.97,1217
2021-05-31,21236,29527,-8291,-28.08,1217
2021-06-01,22713,31294,-8581,-27.42,1217
2021-06-02,22713,31261,-8548,-27.34,1217
2021-06-03,22713,31253,-8540,-27.33,1217
2021-06-04,20071,31119,-11048,-35.5,1217
2021-06-05,15289,23682,-8393,-35.44,1217
2021-06-06,11313,18592,-7279,-39.15,1217
2021-06-07,21222,29348,-8126,-27.69,1217
2021-06-08,22713,31174,-8461,-27.14,1217
2021-06-09,22713,31197,-8484,-27.19,1217
2021-06-10,22713,31236,-8523,-27.29,1217
2021-06-11,20071,31140,-11069,-35.55,1217
2021-06-12,15289,23730,-8441,-35.57,1217
2021-06-13,11313,18655,-7342,-39.36,1217
2021-06-14,21222,29412,-8190,-27.85,1217
2021-06-15,22713,31226,-8513,-27.26,1217
2021-06-16,22713,31220,-8507,-27.25,1217
2021-06-17,22713,31217,-8504,-27.24,1217
2021-06-18,20071,31066,-10995,-35.39,1217
2021-06-19,15289,23586,-8297,-35.18,1217
2021-06-20,11313,18430,-7117,-38.62,1217
2021-06-21,21222,29096,-7874,-27.06,1217
2021-06-22,22713,30810,-8097,-26.28,1217
2021-06-23,22713,30700,-7987,-26.02,1217
2021-06-24,22713,30588,-7875,-25.75,1217
2021-06-25,20071,30328,-10257,-33.82,1217
2021-06-26,15289,22741,-7452,-32.77,1217
2021-06-27,11313,17482,-6169,-35.29,1217
2021-06-28,21222,28052,-6830,-24.35,1217
2021-06-29,22713,29681,-6968,-23.48,1217
2021-06-30,22713,29497,-6784,-23.0,1217
2021-07-01,13644,29326,-15682,-53.47,1217
2021-07-02,13401,29021,-15620,-53.82,1217
2021-07-03,8565,21407,-12842,-59.99,1217
2021-07-04,7684,16139,-8455,-52.39,1217
2021-07-05,14166,26718,-12552,-46.98,1217
2021-07-06,13644,28373,-14729,-51.91,1217
2021-07-07,13644,28234,-14590,-51.68,1217
2021-07-08,13644,28123,-14479,-51.48,1217
2021-07-09,13401,27894,-14493,-51.96,1217
2021-07-10,8565,20369,-11804,-57.95,1217
2021-07-11,7684,15202,-7518,-49.45,1217
2021-07-12,14166,25889,-11723,-45.28,1217
2021-07-13,13644,27660,-14016,-50.67,1217
2021-07-14,13644,27637,-13993,-50.63,1217
2021-07-15,13644,27644,-14000,-50.64,1217
2021-07-16,13401,27530,-14129,-51.32,1217
2021-07-17,8565,20113,-11548,-57.42,1217
2021-07-18,7684,15045,-7361,-48.93,1217
2021-07-19,14166,25821,-11655,-45.14,1217
2021-07-20,13644,27667,-14023,-50.68,1217
2021-07-21,13644,27704,-14060,-50.75,1217
2021-07-22,13644,27754,-14110,-50.84,1217
2021-07-23,13401,27665,-14264,-51.56,1217
2021-07-24,8565,20256,-11691,-57.72,1217
2021-07-25,7684,15178,-7494,-49.37,1217
2021-07-26,14166,25926,-11760,-45.36,1217
2021-07-27,13644,27728,-14084,-50.79,1217
2021-07-28,13644,27707,-14063,-50.76,1217
2021-07-29,13644,27685,-14041,-50.72,1217
2021-07-30,13401,27515,-14114,-51.3,1217
2021-07-31,8565,20016,-11451,-57.21,1217
2021-08-01,3106,14844,-11738,-79.08,1217
2021-08-02,5865,25496,-19631,-77.0,1217
2021-08-03,5841,27203,-21362,-78.53,1217
2021-08-04,5841,27093,-21252,-78.44,1217
2021-08-05,5841,26990,-21149,-78.36,1217
2021-08-06,4970,26749,-21779,-81.42,1217
2021-08-07,3648,19194,-15546,-80.99,1217
2021-08-08,3106,13981,-10875,-77.78,1217
2021-08-09,5865,24610,-18745,-76.17,1217
2021-08-10,5841,26315,-20474,-77.8,1217
2021-08-11,5841,26222,-20381,-77.72,1217
2021-08-12,5841,26158,-20317,-77.67,1217
2021-08-13,4970,25977,-21007,-80.87,1217
2021-08-14,3648,18503,-14855,-80.28,1217
2021-08-15,3106,13391,-10285,-76.81,1217
2021-08-16,5865,24141,-18276,-75.71,1217
2021-08-17,5841,25980,-20139,-77.52,1217
2021-08-18,5841,26037,-20196,-77.57,1217
2021-08-19,5841,26133,-20292,-77.65,1217
2021-08-20,4970,26121,-21151,-80.97,1217
2021-08-21,3648,18820,-15172,-80.62,1217
2021-08-22,3106,13881,-10775,-77.62,1217
2021-08-23,5865,24802,-18937,-76.35,1217
2021-08-24,5841,26808,-20967,-78.21,1217
2021-08-25,5841,27021,-21180,-78.38,1217
2021-08-26,5841,27262,-21421,-78.57,1217
2021-08-27,4970,27379,-22409,-81.85,1217
2021-08-28,3648,20190,-16542,-81.93,1217
2021-08-29,3106,15344,-12238,-79.76,1217
2021-08-30,5865,26337,-20472,-77.73,1217
2021-08-31,5841,28392,-22551,-79.43,1217
2021-09-01,12139,28632,-16493,-57.6,1217
2021-09-02,12139,28878,-16739,-57.96,1217
2021-09-03,11748,28977,-17229,-59.46,1217
2021-09-04,9026,21750,-12724,-58.5,1217
2021-09-05,6317,16846,-10529,-62.5,1217
2021-09-06,11259,27763,-16504,-59.45,1217
2021-09-07,12139,29727,-17588,-59.17,1217
2021-09-08,12139,29863,-17724,-59.35,1217
2021-09-09,12139,29994,-17855,-59.53,1217
2021-09-10,11748,29973,-18225,-60.8,1217
2021-09-11,9026,22620,-13594,-60.1,1217
2021-09-12,6317,17590,-11273,-64.09,1217
2021-09-13,11259,28383,-17124,-60.33,1217
2021-09-14,12139,30227,-18088,-59.84,1217
2021-09-15,12139,30252,-18113,-59.87,1217
2021-09-16,12139,30281,-18142,-59.91,1217
2021-09-17,11748,30169,-18421,-61.06,1217
2021-09-18,9026,22738,-13712,-60.3,1217
2021-09-19,6317,17645,-11328,-64.2,1217
2021-09-20,11259,28389,-17130,-60.34,1217
2021-09-21,12139,30201,-18062,-59.81,1217
2021-09-22,12139,30208,-18069,-59.82,1217
2021-09-23,12139,30233,-18094,-59.85,1217
2021-09-24,11748,30132,-18384,-61.01,1217
2021-09-25,9026,22724,-13698,-60.28,1217
2021-09-26,6317,17664,-11347,-64.24,1217
2021-09-27,11259,28450,-17191,-60.43,1217
2021-09-28,12139,30311,-18172,-59.95,1217
2021-09-29,12139,30371,-18232,-60.03,1217
2021-09-30,12139,30452,-18313,-60.14,1217
2021-10-01,11348,30406,-19058,-62.68,1217
2021-10-02,7744,23052,-15308,-66.41,1217
2021-10-03,6216,18042,-11826,-65.55,1217
2021-10-04,10593,28872,-18279,-63.31,1217
2021-10-05,12156,30769,-18613,-60.49,1217
2021-10-06,12156,30857,-18701,-60.61,1217
2021-10-07,12156,30956,-18800,-60.73,1217
2021-10-08,11348,30918,-19570,-63.3,1217
2021-10-09,7744,23562,-15818,-67.13,1217
2021-10-10,6216,18539,-12323,-66.47,1217
2021-10-11,10593,29347,-18754,-63.9,1217
2021-10-12,12156,31212,-19056,-61.05,1217
2021-10-13,12156,31260,-19104,-61.11,1217
2021-10-14,12156,31313,-19157,-61.18,1217
2021-10-15,11348,31224,-19876,-63.66,1217
2021-10-16,7744,23812,-16068,-67.48,1217
2021-10-17,6216,18732,-12516,-66.82,1217
2021-10-18,10593,29482,-18889,-64.07,1217
2021-10-19,12156,31291,-19135,-61.15,1217
2021-10-20,12156,31286,-19130,-61.15,1217
2021-10-21,12156,31291,-19135,-61.15,1217
2021-10-22,11348,31159,-19811,-63.58,1217
2021-10-23,7744,23712,-15968,-67.34,1217
2021-10-24,6216,18605,-12389,-66.59,1217
2021-10-25,10593,29337,-18744,-63.89,1217
2021-10-26,12156,31138,-18982,-60.96,1217
2021-10-27,12156,31133,-18977,-60.95,1217
2021-10-28,12156,31147,-18991,-60.97,1217
2021-10-29,11348,31032,-19684,-63.43,1217
2021-10-30,7744,23609,-15865,-67.2,1217
2021-10-31,6216,18533,-12317,-66.46,1217
2021-11-01,15773,29300,-13527,-46.17,1217
2021-11-02,17271,31140,-13869,-44.54,1217
2021-11-03,17271,31176,-13905,-44.6,1217
2021-11-04,17271,31231,-13960,-44.7,1217
2021-11-05,17835,31156,-13321,-42.76,1217
2021-11-06,13040,23771,-10731,-45.14,1217
2021-11-07,9953,18728,-8775,-46.85,1217
2021-11-08,15773,29523,-13750,-46.57,1217
2021-11-09,17271,31383,-14112,-44.97,1217
2021-11-10,17271,31433,-14162,-45.05,1217
2021-11-11,17271,31493,-14222,-45.16,1217
2021-11-12,17835,31416,-13581,-43.23,1217
2021-11-13,13040,24019,-10979,-45.71,1217
2021-11-14,9953,18956,-9003,-47.49,1217
2021-11-15,15773,29723,-13950,-46.93,1217
2021-11-16,17271,31548,-14277,-45.25,1217
2021-11-17,17271,31557,-14286,-45.27,1217
2021-11-18,17271,31572,-14301,-45.3,1217
2021-11-19,17835,31445,-13610,-43.28,1217
2021-11-20,13040,23998,-10958,-45.66,1217
2021-11-21,9953,18883,-8930,-47.29,1217
2021-11-22,15773,29601,-13828,-46.71,1217
2021-11-23,17271,31379,-14108,-44.96,1217
2021-11-24,17271,31345,-14074,-44.9,1217
2021-11-25,17271,31323,-14052,-44.86,1217
2021-11-26,17835,31166,-13331,-42.77,1217
2021-11-27,13040,23696,-10656,-44.97,1217
2021-11-28,9953,18568,-8615,-46.4,1217
2021-11-29,15773,29281,-13508,-46.13,1217
2021-11-30,17271,31063,-13792,-44.4,1217
2021-12-01,18274,31042,-12768,-41.13,1217
2021-12-02,18274,31042,-12768,-41.13,1217
2021-12-03,15947,30914,-14967,-48.41,1217
2021-12-04,13374,23480,-10106,-43.04,1217
2021-12-05,10819,18392,-7573,-41.18,1217
2021-12-06,18363,29150,-10787,-37.01,1217
2021-12-07,18274,30978,-12704,-41.01,1217
2021-12-08,18274,31004,-12730,-41.06,1217
2021-12-09,18274,31049,-12775,-41.14,1217
2021-12-10,15947,30962,-15015,-48.49,1217
2021-12-11,13374,23563,-10189,-43.24,1217
2021-12-12,10819,18504,-7685,-41.53,1217
2021-12-13,18363,29281,-10918,-37.29,1217
2021-12-14,18274,31119,-12845,-41.28,1217
2021-12-15,18274,31143,-12869,-41.32,1217
2021-12-16,18274,31174,-12900,-41.38,1217
2021-12-17,15947,31061,-15114,-48.66,1217
2021-12-18,13374,23624,-10250,-43.39,1217
2021-12-19,10819,18515,-7696,-41.57,1217
2021-12-20,18363,29229,-10866,-37.18,1217
2021-12-21,18274,30995,-12721,-41.04,1217
2021-12-22,18274,30937,-12663,-40.93,1217
2021-12-23,18274,30879,-12605,-40.82,1217
2021-12-24,15947,30670,-14723,-48.0,1217
2021-12-25,13374,23134,-9760,-42.19,1217
2021-12-26,10819,17924,-7105,-39.64,1217
2021-12-27,18363,28539,-10176,-35.66,1217
2021-12-28,18274,30209,-11935,-39.51,1217
2021-12-29,18274,30061,-11787,-39.21,1217
2021-12-30,18274,29920,-11646,-38.92,1217
2021-12-31,15947,29639,-13692,-46.2,1217
2022-01-01,14848,22043,-7195,-32.64,1217
2022-01-02,9138,16787,-7649,-45.57,1217
2022-01-03,16456,27370,-10914,-39.88,1217
2022-01-04,17878,29024,-11146,-38.4,1217
2022-01-05,17878,28878,-11000,-38.09,1217
2022-01-06,17878,28754,-10876,-37.82,1217
2022-01-07,17874,28509,-10635,-37.3,1217
2022-01-08,14848,20964,-6116,-29.17,1217
2022-01-09,9138,15773,-6635,-42.07,1217
2022-01-10,16456,26437,-9981,-37.75,1217
2022-01-11,17878,28183,-10305,-36.56,1217
2022-01-12,17878,28139,-10261,-36.47,1217
2022-01-13,17878,28126,-10248,-36.44,1217
2022-01-14,17874,27996,-10122,-36.16,1217
2022-01-15,14848,20569,-5721,-27.81,1217
2022-01-16,9138,15499,-6361,-41.04,1217
2022-01-17,16456,26280,-9824,-37.38,1217
2022-01-18,17878,28139,-10261,-36.47,1217
2022-01-19,17878,28201,-10323,-36.61,1217
2022-01-20,17878,28285,-10407,-36.79,1217
2022-01-21,17874,28242,-10368,-36.71,1217
2022-01-22,14848,20890,-6042,-28.92,1217
2022-01-23,9138,15881,-6743,-42.46,1217
2022-01-24,16456,26709,-10253,-38.39,1217
2022-01-25,17878,28601,-10723,-37.49,1217
2022-01-26,17878,28681,-10803,-37.67,1217
2022-01-27,17878,28769,-10891,-37.86,1217
2022-01-28,17874,28716,-10842,-37.76,1217
2022-01-29,14848,21342,-6494,-30.43,1217
2022-01-30,9138,16299,-7161,-43.94,1217
2020-02-01,56090,55032,1058,1.92,1621
2020-02-02,48020,48531,-511,-1.05,1621
2020-02-03,58485,60318,-1833,-3.04,1621
2020-02-04,61061,62049,-988,-1.59,1621
2020-02-05,61061,62135,-1074,-1.73,1621
2020-02-06,61061,62211,-1150,-1.85,1621
2020-02-07,63032,63683,-651,-1.02,1621
2020-02-08,56090,55775,315,0.56,1621
2020-02-09,48020,49197,-1177,-2.39,1621
2020-02-10,58485,60910,-2425,-3.98,1621
2020-02-11,61061,62572,-1511,-2.41,1621
2020-02-12,61061,62595,-1534,-2.45,1621
2020-02-13,61061,62616,-1555,-2.48,1621
2020-02-14,63032,64042,-1010,-1.58,1621
2020-02-15,56090,56098,-8,-0.01,1621
2020-02-16,48020,49495,-1475,-2.98,1621
2020-02-17,58485,61193,-2708,-4.43,1621
2020-02-18,61061,62851,-1790,-2.85,1621
2020-02-19,61061,62879,-1818,-2.89,1621
2020-02-20,61061,62914,-1853,-2.95,1621
2020-02-21,63032,64363,-1331,-2.07,1621
2020-02-22,56090,56447,-357,-0.63,1621
2020-02-23,48020,49878,-1858,-3.73,1621
2020-02-24,58485,61613,-3128,-5.08,1621
2020-02-25,61061,63308,-2247,-3.55,1621
2020-02-26,61061,63374,-2313,-3.65,1621
2020-02-27,61061,63446,-2385,-3.76,1621
2020-02-28,63032,64926,-1894,-2.92,1621
2020-02-29,56090,57037,-947,-1.66,1621
2020-03-01,35945,50488,-14543,-28.8,1621
2020-03-02,49615,62236,-12621,-20.28,1621
2020-03-03,49260,63936,-14676,-22.95,1621
2020-03-04,49260,63998,-14738,-23.03,1621
2020-03-05,49260,64056,-14796,-23.1,1621
2020-03-06,50843,65514,-14671,-22.39,1621
2020-03-07,39650,57594,-17944,-31.16,1621
2020-03-08,35945,51006,-15061,-29.53,1621
2020-03-09,49615,62708,-13093,-20.88,1621
2020-03-10,49260,64356,-15096,-23.46,1621
2020-03-11,49260,64361,-15101,-23.46,1621
2020-03-12,49260,64360,-15100,-23.46,1621
2020-03-13,50843,65756,-14913,-22.68,1621
2020-03-14,39650,57774,-18124,-31.37,1621
2020-03-15,35945,51126,-15181,-29.69,1621
2020-03-16,49615,62769,-13154,-20.96,1621
2020-03-17,49260,64363,-15103,-23.47,1621
2020-03-18,49260,64320,-15060,-23.41,1621
2020-03-19,49260,64275,-15015,-23.36,1621
2020-03-20,50843,65636,-14793,-22.54,1621
2020-03-21,39650,57626,-17976,-31.19,1621
2020-03-22,35945,50957,-15012,-29.46,1621
2020-03-23,49615,62589,-12974,-20.73,1621
2020-03-24,49260,64179,-14919,-23.25,1621
2020-03-25,49260,64138,-14878,-23.2,1621
2020-03-26,49260,64103,-14843,-23.15,1621
2020-03-27,50843,65479,-14636,-22.35,1621
2020-03-28,39650,57489,-17839,-31.03,1621
2020-03-29,35945,50845,-14900,-29.3,1621
2020-03-30,49615,62503,-12888,-20.62,1621
2020-03-31,49260,64120,-14860,-23.18,1621
2020-04-01,49226,64106,-14880,-23.21,1621
2020-04-02,49226,64098,-14872,-23.2,1621
2020-04-03,46416,65497,-19081,-29.13,1621
2020-04-04,35685,57528,-21843,-37.97,1621
2020-04-05,27812,50899,-23087,-45.36,1621
2020-04-06,48723,62567,-13844,-22.13,1621
2020-04-07,49226,64190,-14964,-23.31,1621
2020-04-08,49226,64175,-14949,-23.29,1621
2020-04-09,49226,64159,-14933,-23.27,1621
2020-04-10,46416,65546,-19130,-29.19,1621
2020-04-11,35685,57558,-21873,-38.0,1621
2020-04-12,27812,50906,-23094,-45.37,1621
2020-04-13,48723,62546,-13823,-22.1,1621
2020-04-14,49226,64137,-14911,-23.25,1621
2020-04-15,49226,64088,-14862,-23.19,1621
2020-04-16,49226,64037,-14811,-23.13,1621
2020-04-17,46416,65387,-18971,-29.01,1621
2020-04-18,35685,57363,-21678,-37.79,1621
2020-04-19,27812,50676,-22864,-45.12,1621
2020-04-20,48723,62285,-13562,-21.77,1621
2020-04-21,49226,63847,-14621,-22.9,1621
2020-04-22,49226,63774,-14548,-22.81,1621
2020-04-23,49226,63702,-14476,-22.72,1621
2020-04-24,46416,65037,-18621,-28.63,1621
2020-04-25,35685,57003,-21318,-37.4,1621
2020-04-26,27812,50311,-22499,-44.72,1621
2020-04-27,48723,61919,-13196,-21.31,1621
2020-04-28,49226,63486,-14260,-22.46,1621
2020-04-29,49226,63420,-14194,-22.38,1621
2020-04-30,49226,63360,-14134,-22.31,1621
2020-05-01,59338,64709,-5371,-8.3,1621
2020-05-02,50459,56691,-6232,-10.99,1621
2020-05-03,43063,50015,-6952,-13.9,1621
2020-05-04,57277,61640,-4363,-7.08,1621
2020-05-05,58925,63222,-4297,-6.8,1621
2020-05-06,58925,63171,-4246,-6.72,1621
2020-05-07,58925,63123,-4198,-6.65,1621
2020-05-08,59338,64482,-5144,-7.98,1621
2020-05-09,50459,56470,-6011,-10.64,1621
2020-05-10,43063,49798,-6735,-13.52,1621
2020-05-11,57277,61424,-4147,-6.75,1621
2020-05-12,58925,63004,-4079,-6.47,1621
2020-05-13,58925,62950,-4025,-6.39,1621
2020-05-14,58925,62896,-3971,-6.31,1621
2020-05-15,59338,64249,-4911,-7.64,1621
2020-05-16,50459,56232,-5773,-10.27,1621
2020-05-17,43063,49555,-6492,-13.1,1621
2020-05-18,57277,61179,-3902,-6.38,1621
2020-05-19,58925,62761,-3836,-6.11,1621
2020-05-20,58925,62712,-3787,-6.04,1621
2020-05-21,58925,62670,-3745,-5.98,1621
2020-05-22,59338,64041,-4703,-7.34,1621
2020-05-23,50459,56049,-5590,-9.97,1621
2020-05-24,43063,49406,-6343,-12.84,1621
2020-05-25,57277,61071,-3794,-6.21,1621
2020-05-26,58925,62701,-3776,-6.02,1621
2020-05-27,58925,62709,-3784,-6.03,1621
2020-05-28,58925,62730,-3805,-6.07,1621
2020-05-29,59338,64171,-4833,-7.53,1621
2020-05-30,50459,56252,-5793,-10.3,1621
2020-05-31,43063,49686,-6623,-13.33,1621
2020-06-01,59164,61429,-2265,-3.69,1621
2020-06-02,60485,63136,-2651,-4.2,1621
2020-06-03,60485,63217,-2732,-4.32,1621
2020-06-04,60485,63306,-2821,-4.46,1621
2020-06-05,60327,64806,-4479,-6.91,1621
2020-06-06,53986,56936,-2950,-5.18,1621
2020-06-07,46305,50405,-4100,-8.13,1621
2020-06-08,59164,62168,-3004,-4.83,1621
2020-06-09,60485,63878,-3393,-5.31,1621
2020-06-10,60485,63942,-3457,-5.41,1621
2020-06-11,60485,63994,-3509,-5.48,1621
2020-06-12,60327,65435,-5108,-7.81,1621
2020-06-13,53986,57485,-3499,-6.09,1621
2020-06-14,46305,50852,-4547,-8.94,1621
2020-06-15,59164,62491,-3327,-5.32,1621
2020-06-16,60485,64058,-3573,-5.58,1621
2020-06-17,60485,63961,-3476,-5.43,1621
2020-06-18,60485,63835,-3350,-5.25,1621
2020-06-19,60327,65085,-4758,-7.31,1621
2020-06-20,53986,56933,-2947,-5.18,1621
2020-06-21,46305,50091,-3786,-7.56,1621
2020-06-22,59164,61518,-2354,-3.83,1621
2020-06-23,60485,62873,-2388,-3.8,1621
2020-06-24,60485,62569,-2084,-3.33,1621
2020-06-25,60485,62246,-1761,-2.83,1621
2020-06-26,60327,63311,-2984,-4.71,1621
2020-06-27,53986,54992,-1006,-1.83,1621
2020-06-28,46305,48003,-1698,-3.54,1621
2020-06-29,59164,59307,-143,-0.24,1621
2020-06-30,60485,60566,-81,-0.13,1621
2020-07-01,59186,60194,-1008,-1.67,1621
2020-07-02,59186,59833,-647,-1.08,1621
2020-07-03,60650,60891,-241,-0.4,1621
2020-07-04,53656,52595,1061,2.02,1621
2020-07-05,49136,45660,3476,7.61,1621
2020-07-06,58184,57048,1136,1.99,1621
2020-07-07,59186,58417,769,1.32,1621
2020-07-08,59186,58180,1006,1.73,1621
2020-07-09,59186,57975,1211,2.09,1621
2020-07-10,60650,59207,1443,2.44,1621
2020-07-11,53656,51098,2558,5.01,1621
2020-07-12,49136,44358,4778,10.77,1621
2020-07-13,58184,55944,2240,4.0,1621
2020-07-14,59186,57509,1677,2.92,1621
2020-07-15,59186,57463,1723,3.0,1621
2020-07-16,59186,57437,1749,3.05,1621
2020-07-17,60650,58831,1819,3.09,1621
2020-07-18,53656,50865,2791,5.49,1621
2020-07-19,49136,44245,4891,11.05,1621
2020-07-20,58184,55924,2260,4.04,1621
2020-07-21,59186,57554,1632,2.84,1621
2020-07-22,59186,57541,1645,2.86,1621
2020-07-23,59186,57517,1669,2.9,1621
2020-07-24,60650,58883,1767,3.0,1621
2020-07-25,53656,50858,2798,5.5,1621
2020-07-26,49136,44150,4986,11.29,1621
2020-07-27,58184,55717,2467,4.43,1621
2020-07-28,59186,57211,1975,3.45,1621
2020-07-29,59186,57046,2140,3.75,1621
2020-07-30,59186,56855,2331,4.1,1621
2020-07-31,60650,58047,2603,4.48,1621
2020-08-01,53273,49845,3428,6.88,1621
2020-08-02,47308,42963,4345,10.11,1621
2020-08-03,56870,54364,2506,4.61,1621
2020-08-04,57007,55708,1299,2.33,1621
2020-08-05,57007,55411,1596,2.88,1621
2020-08-06,57007,55114,1893,3.43,1621
2020-08-07,57350,56229,1121,1.99,1621
2020-08-08,53273,47984,5289,11.02,1621
2020-08-09,47308,41096,6212,15.12,1621
2020-08-10,56870,52530,4340,8.26,1621
2020-08-11,57007,53947,3060,5.67,1621
2020-08-12,57007,53765,3242,6.03,1621
2020-08-13,57007,53624,3383,6.31,1621
2020-08-14,57350,54933,2417,4.4,1621
2020-08-15,53273,46920,6353,13.54,1621
2020-08-16,47308,40297,7011,17.4,1621
2020-08-17,56870,52026,4844,9.31,1621
2020-08-18,57007,53763,3244,6.03,1621
2020-08-19,57007,53919,3088,5.73,1621
2020-08-20,57007,54131,2876,5.31,1621
2020-08-21,57350,55800,1550,2.78,1621
2020-08-22,53273,48147,5126,10.65,1621
2020-08-23,47308,41879,5429,12.96,1621
2020-08-24,56870,53949,2921,5.41,1621
2020-08-25,57007,56009,998,1.78,1621
2020-08-26,57007,56464,543,0.96,1621
2020-08-27,57007,56944,63,0.11,1621
2020-08-28,57350,58847,-1497,-2.54,1621
2020-08-29,53273,51389,1884,3.67,1621
2020-08-30,47308,45274,2034,4.49,1621
2020-08-31,56870,57453,-583,-1.01,1621
2020-09-01,61280,59578,1702,2.86,1621
2020-09-02,61280,60052,1228,2.04,1621
2020-09-03,61280,60506,774,1.28,1621
2020-09-04,62171,62340,-169,-0.27,1621
2020-09-05,57558,54773,2785,5.08,1621
2020-09-06,50052,48512,1540,3.17,1621
2020-09-07,59182,60513,-1331,-2.2,1621
2020-09-08,61280,62431,-1151,-1.84,1621
2020-09-09,61280,62676,-1396,-2.23,1621
2020-09-10,61280,62884,-1604,-2.55,1621
2020-09-11,62171,64460,-2289,-3.55,1621
2020-09-12,57558,56630,928,1.64,1621
2020-09-13,50052,50106,-54,-0.11,1621
2020-09-14,59182,61850,-2668,-4.31,1621
2020-09-15,61280,63522,-2242,-3.53,1621
2020-09-16,61280,63537,-2257,-3.55,1621
2020-09-17,61280,63535,-2255,-3.55,1621
2020-09-18,62171,64926,-2755,-4.24,1621
2020-09-19,57558,56936,622,1.09,1621
2020-09-20,50052,50282,-230,-0.46,1621
2020-09-21,59182,61926,-2744,-4.43,1621
2020-09-22,61280,63527,-2247,-3.54,1621
2020-09-23,61280,63501,-2221,-3.5,1621
2020-09-24,61280,63488,-2208,-3.48,1621
2020-09-25,62171,64893,-2722,-4.19,1621
2020-09-26,57558,56942,616,1.08,1621
2020-09-27,50052,50348,-296,-0.59,1621
2020-09-28,59182,62069,-2887,-4.65,1621
2020-09-29,61280,63761,-2481,-3.89,1621
2020-09-30,61280,63836,-2556,-4.0,1621
2020-10-01,61008,63928,-2920,-4.57,1621
2020-10-02,61972,65440,-3468,-5.3,1621
2020-10-03,55753,57593,-1840,-3.19,1621
2020-10-04,47903,51096,-3193,-6.25,1621
2020-10-05,60240,62903,-2663,-4.23,1621
2020-10-06,61008,64669,-3661,-5.66,1621
2020-10-07,61008,64802,-3794,-5.85,1621
2020-10-08,61008,64933,-3925,-6.04,1621
2020-10-09,61972,66467,-4495,-6.76,1621
2020-10-10,55753,58621,-2868,-4.89,1621
2020-10-11,47903,52106,-4203,-8.07,1621
2020-10-12,60240,63876,-3636,-5.69,1621
2020-10-13,61008,65587,-4579,-6.98,1621
2020-10-14,61008,65649,-4641,-7.07,1621
2020-10-15,61008,65696,-4688,-7.14,1621
2020-10-16,61972,67133,-5161,-7.69,1621
2020-10-17,55753,59184,-3431,-5.8,1621
2020-10-18,47903,52560,-4657,-8.86,1621
2020-10-19,60240,64219,-3979,-6.2,1621
2020-10-20,61008,65821,-4813,-7.31,1621
2020-10-21,61008,65778,-4770,-7.25,1621
2020-10-22,61008,65729,-4721,-7.18,1621
2020-10-23,61972,67080,-5108,-7.61,1621
2020-10-24,55753,59056,-3303,-5.59,1621
2020-10-25,47903,52372,-4469,-8.53,1621
2020-10-26,60240,63988,-3748,-5.86,1621
2020-10-27,61008,65563,-4555,-6.95,1621
2020-10-28,61008,65510,-4502,-6.87,1621
2020-10-29,61008,65467,-4459,-6.81,1621
2020-10-30,61972,66841,-4869,-7.28,1621
2020-10-31,55753,58855,-3102,-5.27,1621
2020-11-01,39553,52222,-12669,-24.26,1621
2020-11-02,55761,63899,-8138,-12.74,1621
2020-11-03,54000,65544,-11544,-17.61,1621
2020-11-04,54000,65567,-11567,-17.64,1621
2020-11-05,54000,65603,-11603,-17.69,1621
2020-11-06,55106,67055,-11949,-17.82,1621
2020-11-07,44426,59145,-14719,-24.89,1621
2020-11-08,39553,52581,-13028,-24.78,1621
2020-11-09,55761,64320,-8559,-13.31,1621
2020-11-10,54000,66014,-12014,-18.2,1621
2020-11-11,54000,66074,-12074,-18.27,1621
2020-11-12,54000,66131,-12131,-18.34,1621
2020-11-13,55106,67589,-12483,-18.47,1621
2020-11-14,44426,59668,-15242,-25.54,1621
2020-11-15,39553,53076,-13523,-25.48,1621
2020-11-16,55761,64770,-9009,-13.91,1621
2020-11-17,54000,66405,-12405,-18.68,1621
2020-11-18,54000,66390,-12390,-18.66,1621
2020-11-19,54000,66361,-12361,-18.63,1621
2020-11-20,55106,67722,-12616,-18.63,1621
2020-11-21,44426,59696,-15270,-25.58,1621
2020-11-22,39553,52994,-13441,-25.36,1621
2020-11-23,55761,64576,-8815,-13.65,1621
2020-11-24,54000,66099,-12099,-18.3,1621
2020-11-25,54000,65977,-11977,-18.15,1621
2020-11-26,54000,65847,-11847,-17.99,1621
2020-11-27,55106,67116,-12010,-17.89,1621
2020-11-28,44426,59010,-14584,-24.71,1621
2020-11-29,39553,52243,-12690,-24.29,1621
2020-11-30,55761,63774,-8013,-12.56,1621
2020-12-01,53598,65264,-11666,-17.88,1621
2020-12-02,53598,65125,-11527,-17.7,1621
2020-12-03,53598,64997,-11399,-17.54,1621
2020-12-04,60017,66285,-6268,-9.46,1621
2020-12-05,48568,58215,-9647,-16.57,1621
2020-12-06,37509,51499,-13990,-27.17,1621
2020-12-07,52195,63096,-10901,-17.28,1621
2020-12-08,53598,64662,-11064,-17.11,1621
2020-12-09,53598,64610,-11012,-17.04,1621
2020-12-10,53598,64574,-10976,-17.0,1621
2020-12-11,60017,65959,-5942,-9.01,1621
2020-12-12,48568,57985,-9417,-16.24,1621
2020-12-13,37509,51363,-13854,-26.97,1621
2020-12-14,52195,63049,-10854,-17.22,1621
2020-12-15,53598,64696,-11098,-17.15,1621
2020-12-16,53598,64713,-11115,-17.18,1621
2020-12-17,53598,64735,-11137,-17.2,1621
2020-12-18,60017,66162,-6145,-9.29,1621
2020-12-19,48568,58215,-9647,-16.57,1621
2020-12-20,37509,51602,-14093,-27.31,1621
2020-12-21,52195,63280,-11085,-17.52,1621
2020-12-22,53598,64902,-11304,-17.42,1621
2020-12-23,53598,64878,-11280,-17.39,1621
2020-12-24,53598,64842,-11244,-17.34,1621
2020-12-25,60017,66198,-6181,-9.34,1621
2020-12-26,48568,58168,-9600,-16.5,1621
2020-12-27,37509,51464,-13955,-27.12,1621
2020-12-28,52195,63043,-10848,-17.21,1621
2020-12-29,53598,64562,-10964,-16.98,1621
2020-12-30,53598,64435,-10837,-16.82,1621
2020-12-31,53598,64298,-10700,-16.64,1621
2021-01-01,63432,65559,-2127,-3.24,1621
2021-01-02,51122,57442,-6320,-11.0,1621
2021-01-03,43294,50662,-7368,-14.54,1621
2021-01-04,60098,62179,-2081,-3.35,1621
2021-01-05,62981,63653,-672,-1.06,1621
2021-01-06,62981,63497,-516,-0.81,1621
2021-01-07,62981,63351,-370,-0.58,1621
2021-01-08,63432,64622,-1190,-1.84,1621
2021-01-09,51122,56536,-5414,-9.58,1621
2021-01-10,43294,49806,-6512,-13.07,1621
2021-01-11,60098,61392,-1294,-2.11,1621
2021-01-12,62981,62953,28,0.04,1621
2021-01-13,62981,62901,80,0.13,1621
2021-01-14,62981,62873,108,0.17,1621
2021-01-15,63432,64273,-841,-1.31,1621
2021-01-16,51122,56326,-5204,-9.24,1621
2021-01-17,43294,49741,-6447,-12.96,1621
2021-01-18,60098,61476,-1378,-2.24,1621
2021-01-19,62981,63185,-204,-0.32,1621
2021-01-20,62981,63279,-298,-0.47,1621
2021-01-21,62981,63391,-410,-0.65,1621
2021-01-22,63432,64923,-1491,-2.3,1621
2021-01-23,51122,57096,-5974,-10.46,1621
2021-01-24,43294,50618,-7324,-14.47,1621
2021-01-25,60098,62445,-2347,-3.76,1621
2021-01-26,62981,64230,-1249,-1.94,1621
2021-01-27,62981,64382,-1401,-2.18,1621
2021-01-28,62981,64534,-1553,-2.41,1621
2021-01-29,63432,66089,-2657,-4.02,1621
2021-01-30,51122,58268,-7146,-12.26,1621
2021-01-31,43294,51779,-8485,-16.39,1621
2021-02-01,66270,63580,2690,4.23,1621
2021-02-02,66167,65325,842,1.29,1621
2021-02-03,66167,65425,742,1.13,1621
2021-02-04,66167,65516,651,0.99,1621
2021-02-05,68080,67002,1078,1.61,1621
2021-02-06,60972,59107,1865,3.16,1621
2021-02-07,52222,52541,-319,-0.61,1621
2021-02-08,66270,64265,2005,3.12,1621
2021-02-09,66167,65935,232,0.35,1621
2021-02-10,66167,65965,202,0.31,1621
2021-02-11,66167,65991,176,0.27,1621
2021-02-12,68080,67420,660,0.98,1621
2021-02-13,60972,59476,1496,2.52,1621
2021-02-14,52222,52872,-650,-1.23,1621
2021-02-15,66270,64568,1702,2.64,1621
2021-02-16,66167,66221,-54,-0.08,1621
2021-02-17,66167,66243,-76,-0.11,1621
2021-02-18,66167,66272,-105,-0.16,1621
2021-02-19,68080,67714,366,0.54,1621
2021-02-20,60972,59790,1182,1.98,1621
2021-02-21,52222,53214,-992,-1.86,1621
2021-02-22,66270,64942,1328,2.04,1621
2021-02-23,66167,66631,-464,-0.7,1621
2021-02-24,66167,66692,-525,-0.79,1621
2021-02-25,66167,66759,-592,-0.89,1621
2021-02-26,68080,68236,-156,-0.23,1621
2021-02-27,60972,60346,626,1.04,1621
2021-02-28,52222,53798,-1576,-2.93,1621
2021-03-01,66074,65548,526,0.8,1621
2021-03-02,66888,67252,-364,-0.54,1621
2021-03-03,66888,67319,-431,-0.64,1621
2021-03-04,66888,67384,-496,-0.74,1621
2021-03-05,69009,68851,158,0.23,1621
2021-03-06,63784,60940,2844,4.67,1621
2021-03-07,53927,54363,-436,-0.8,1621
2021-03-08,66074,66076,-2,-0.0,1621
2021-03-09,66888,67736,-848,-1.25,1621
2021-03-10,66888,67753,-865,-1.28,1621
2021-03-11,66888,67762,-874,-1.29,1621
2021-03-12,69009,69170,-161,-0.23,1621
2021-03-13,63784,61198,2586,4.23,1621
2021-03-14,53927,54559,-632,-1.16,1621
2021-03-15,66074,66211,-137,-0.21,1621
2021-03-16,66888,67811,-923,-1.36,1621
2021-03-17,66888,67773,-885,-1.31,1621
2021-03-18,66888,67732,-844,-1.25,1621
2021-03-19,69009,69095,-86,-0.12,1621
2021-03-20,63784,61086,2698,4.42,1621
2021-03-21,53927,54417,-490,-0.9,1621
2021-03-22,66074,66047,27,0.04,1621
2021-03-23,66888,67633,-745,-1.1,1621
2021-03-24,66888,67588,-700,-1.04,1621
2021-03-25,66888,67549,-661,-0.98,1621
2021-03-26,69009,68920,89,0.13,1621
2021-03-27,63784,60925,2859,4.69,1621
2021-03-28,53927,54275,-348,-0.64,1621
2021-03-29,66074,65928,146,0.22,1621
2021-03-30,66888,67540,-652,-0.97,1621
2021-03-31,66888,67523,-635,-0.94,1621
2021-04-01,65508,67511,-2003,-2.97,1621
2021-04-02,67014,68908,-1894,-2.75,1621
2021-04-03,59399,60938,-1539,-2.53,1621
2021-04-04,50778,54309,-3531,-6.5,1621
2021-04-05,65106,65978,-872,-1.32,1621
2021-04-06,65508,67603,-2095,-3.1,1621
2021-04-07,65508,67592,-2084,-3.08,1621
2021-04-08,65508,67580,-2072,-3.07,1621
2021-04-09,67014,68972,-1958,-2.84,1621
2021-04-10,59399,60990,-1591,-2.61,1621
2021-04-11,50778,54344,-3566,-6.56,1621
2021-04-12,65106,65992,-886,-1.34,1621
2021-04-13,65508,67589,-2081,-3.08,1621
2021-04-14,65508,67547,-2039,-3.02,1621
2021-04-15,65508,67502,-1994,-2.95,1621
2021-04-16,67014,68859,-1845,-2.68,1621
2021-04-17,59399,60840,-1441,-2.37,1621
2021-04-18,50778,54158,-3380,-6.24,1621
2021-04-19,65106,65771,-665,-1.01,1621
2021-04-20,65508,67336,-1828,-2.71,1621
2021-04-21,65508,67264,-1756,-2.61,1621
2021-04-22,65508,67194,-1686,-2.51,1621
2021-04-23,67014,68529,-1515,-2.21,1621
2021-04-24,59399,60494,-1095,-1.81,1621
2021-04-25,50778,53800,-3022,-5.62,1621
2021-04-26,65106,65406,-300,-0.46,1621
2021-04-27,65508,66970,-1462,-2.18,1621
2021-04-28,65508,66901,-1393,-2.08,1621
2021-04-29,65508,66838,-1330,-1.99,1621
2021-04-30,67014,68183,-1169,-1.71,1621
2021-05-01,65416,60162,5254,8.73,1621
2021-05-02,57186,53483,3703,6.92,1621
2021-05-03,65439,65106,333,0.51,1621
2021-05-04,67023,66686,337,0.51,1621
2021-05-05,67023,66634,389,0.58,1621
2021-05-06,67023,66585,438,0.66,1621
2021-05-07,68878,67944,934,1.37,1621
2021-05-08,65416,59932,5484,9.15,1621
2021-05-09,57186,53261,3925,7.37,1621
2021-05-10,65439,64889,550,0.85,1621
2021-05-11,67023,66470,553,0.83,1621
2021-05-12,67023,66417,606,0.91,1621
2021-05-13,67023,66365,658,0.99,1621
2021-05-14,68878,67718,1160,1.71,1621
2021-05-15,65416,59701,5715,9.57,1621
2021-05-16,57186,53024,4162,7.85,1621
2021-05-17,65439,64646,793,1.23,1621
2021-05-18,67023,66225,798,1.2,1621
2021-05-19,67023,66172,851,1.29,1621
2021-05-20,67023,66125,898,1.36,1621
2021-05-21,68878,67489,1389,2.06,1621
2021-05-22,65416,59488,5928,9.97,1621
2021-05-23,57186,52835,4351,8.24,1621
2021-05-24,65439,64488,951,1.47,1621
2021-05-25,67023,66106,917,1.39,1621
2021-05-26,67023,66100,923,1.4,1621
2021-05-27,67023,66107,916,1.39,1621
2021-05-28,68878,67533,1345,1.99,1621
2021-05-29,65416,59600,5816,9.76,1621
2021-05-30,57186,53019,4167,7.86,1621
2021-05-31,65439,64749,690,1.07,1621
2021-06-01,68057,66445,1612,2.43,1621
2021-06-02,68057,66516,1541,2.32,1621
2021-06-03,68057,66598,1459,2.19,1621
2021-06-04,69179,68092,1087,1.6,1621
2021-06-05,67389,60221,7168,11.9,1621
2021-06-06,60134,53692,6442,12.0,1621
2021-06-07,66166,65460,706,1.08,1621
2021-06-08,68057,67180,877,1.31,1621
2021-06-09,68057,67258,799,1.19,1621
2021-06-10,68057,67328,729,1.08,1621
2021-06-11,69179,68791,388,0.56,1621
2021-06-12,67389,60867,6522,10.72,1621
2021-06-13,60134,54263,5871,10.82,1621
2021-06-14,66166,65935,231,0.35,1621
2021-06-15,68057,67537,520,0.77,1621
2021-06-16,68057,67476,581,0.86,1621
2021-06-17,68057,67389,668,0.99,1621
2021-06-18,69179,68678,501,0.73,1621
2021-06-19,67389,60565,6824,11.27,1621
2021-06-20,60134,53762,6372,11.85,1621
2021-06-21,66166,65226,940,1.44,1621
2021-06-22,68057,66616,1441,2.16,1621
2021-06-23,68057,66344,1713,2.58,1621
2021-06-24,68057,66049,2008,3.04,1621
2021-06-25,69179,67138,2041,3.04,1621
2021-06-26,67389,58837,8552,14.54,1621
2021-06-27,60134,51861,8273,15.95,1621
2021-06-28,66166,63173,2993,4.74,1621
2021-06-29,68057,64434,3623,5.62,1621
2021-06-30,68057,64058,3999,6.24,1621
2021-07-01,67114,63687,3427,5.38,1621
2021-07-02,68208,64731,3477,5.37,1621
2021-07-03,60762,56415,4347,7.71,1621
2021-07-04,54041,49456,4585,9.27,1621
2021-07-05,64636,60814,3822,6.28,1621
2021-07-06,67114,62151,4963,7.99,1621
2021-07-07,67114,61880,5234,8.46,1621
2021-07-08,67114,61638,5476,8.88,1621
2021-07-09,68208,62832,5376,8.56,1621
2021-07-10,60762,54686,6076,11.11,1621
2021-07-11,54041,47911,6130,12.79,1621
2021-07-12,64636,59462,5174,8.7,1621
2021-07-13,67114,60997,6117,10.03,1621
2021-07-14,67114,60923,6191,10.16,1621
2021-07-15,67114,60874,6240,10.25,1621
2021-07-16,68208,62251,5957,9.57,1621
2021-07-17,60762,54272,6490,11.96,1621
2021-07-18,54041,47645,6396,13.42,1621
2021-07-19,64636,59322,5314,8.96,1621
2021-07-20,67114,60957,6157,10.1,1621
2021-07-21,67114,60954,6160,10.11,1621
2021-07-22,67114,60946,6168,10.12,1621
2021-07-23,68208,62333,5875,9.43,1621
2021-07-24,60762,54333,6429,11.83,1621
2021-07-25,54041,47654,6387,13.4,1621
2021-07-26,64636,59252,5384,9.09,1621
2021-07-27,67114,60780,6334,10.42,1621
2021-07-28,67114,60648,6466,10.66,1621
2021-07-29,67114,60491,6623,10.95,1621
2021-07-30,68208,61714,6494,10.52,1621
2021-07-31,60762,53541,7221,13.49,1621
2021-08-01,52532,46686,5846,12.52,1621
2021-08-02,62451,58108,4343,7.47,1621
2021-08-03,64628,59467,5161,8.68,1621
2021-08-04,64628,59180,5448,9.21,1621
2021-08-05,64628,58887,5741,9.75,1621
2021-08-06,65042,59997,5045,8.41,1621
2021-08-07,58846,51740,7106,13.73,1621
2021-08-08,52532,44833,7699,17.17,1621
2021-08-09,62451,56239,6212,11.05,1621
2021-08-10,64628,57621,7007,12.16,1621
2021-08-11,64628,57397,7231,12.6,1621
2021-08-12,64628,57208,7420,12.97,1621
2021-08-13,65042,58464,6578,11.25,1621
2021-08-14,58846,50392,8454,16.78,1621
2021-08-15,52532,43707,8825,20.19,1621
2021-08-16,62451,55370,7081,12.79,1621
2021-08-17,64628,57041,7587,13.3,1621
2021-08-18,64628,57131,7497,13.12,1621
2021-08-19,64628,57277,7351,12.83,1621
2021-08-20,65042,58882,6160,10.46,1621
2021-08-21,58846,51169,7677,15.0,1621
2021-08-22,52532,44845,7687,17.14,1621
2021-08-23,62451,56864,5587,9.83,1621
2021-08-24,64628,58880,5748,9.76,1621
2021-08-25,64628,59299,5329,8.99,1621
2021-08-26,64628,59749,4879,8.17,1621
2021-08-27,65042,61631,3411,5.53,1621
2021-08-28,58846,54160,4686,8.65,1621
2021-08-29,52532,48041,4491,9.35,1621
2021-08-30,62451,60225,2226,3.7,1621
2021-08-31,64628,62361,2267,3.64,1621
2021-09-01,68726,62855,5871,9.34,1621
2021-09-02,68726,63336,5390,8.51,1621
2021-09-03,72308,65203,7105,10.9,1621
2021-09-04,68547,57674,10873,18.85,1621
2021-09-05,59044,51456,7588,14.75,1621
2021-09-06,66548,63503,3045,4.8,1621
2021-09-07,68726,65469,3257,4.97,1621
2021-09-08,68726,65763,2963,4.51,1621
2021-09-09,68726,66020,2706,4.1,1621
2021-09-10,72308,67644,4664,6.89,1621
2021-09-11,68547,59860,8687,14.51,1621
2021-09-12,59044,53379,5665,10.61,1621
2021-09-13,66548,65162,1386,2.13,1621
2021-09-14,68726,66869,1857,2.78,1621
2021-09-15,68726,66914,1812,2.71,1621
2021-09-16,68726,66936,1790,2.67,1621
2021-09-17,72308,68346,3962,5.8,1621
2021-09-18,68547,60370,8177,13.54,1621
2021-09-19,59044,53723,5321,9.9,1621
2021-09-20,66548,65368,1180,1.81,1621
2021-09-21,68726,66967,1759,2.63,1621
2021-09-22,68726,66934,1792,2.68,1621
2021-09-23,68726,66908,1818,2.72,1621
2021-09-24,72308,68299,4009,5.87,1621
2021-09-25,68547,60331,8216,13.62,1621
2021-09-26,59044,53717,5327,9.92,1621
2021-09-27,66548,65417,1131,1.73,1621
2021-09-28,68726,67089,1637,2.44,1621
2021-09-29,68726,67144,1582,2.36,1621
2021-09-30,68726,67217,1509,2.24,1621
2021-10-01,69687,68713,974,1.42,1621
2021-10-02,65808,60851,4957,8.15,1621
2021-10-03,57956,54343,3613,6.65,1621
2021-10-04,64236,66142,-1906,-2.88,1621
2021-10-05,66432,67903,-1471,-2.17,1621
2021-10-06,66432,68035,-1603,-2.36,1621
2021-10-07,66432,68170,-1738,-2.55,1621
2021-10-08,69687,69710,-23,-0.03,1621
2021-10-09,65808,61874,3934,6.36,1621
2021-10-10,57956,55372,2584,4.67,1621
2021-10-11,64236,67158,-2922,-4.35,1621
2021-10-12,66432,68887,-2455,-3.56,1621
2021-10-13,66432,68968,-2536,-3.68,1621
2021-10-14,66432,69036,-2604,-3.77,1621
2021-10-15,69687,70494,-807,-1.14,1621
2021-10-16,65808,62566,3242,5.18,1621
2021-10-17,57956,55961,1995,3.56,1621
2021-10-18,64236,67640,-3404,-5.03,1621
2021-10-19,66432,69258,-2826,-4.08,1621
2021-10-20,66432,69229,-2797,-4.04,1621
2021-10-21,66432,69191,-2759,-3.99,1621
2021-10-22,69687,70551,-864,-1.22,1621
2021-10-23,65808,62533,3275,5.24,1621
2021-10-24,57956,55851,2105,3.77,1621
2021-10-25,64236,67465,-3229,-4.79,1621
2021-10-26,66432,69036,-2604,-3.77,1621
2021-10-27,66432,68976,-2544,-3.69,1621
2021-10-28,66432,68924,-2492,-3.62,1621
2021-10-29,69687,70286,-599,-0.85,1621
2021-10-30,65808,62287,3521,5.65,1621
2021-10-31,57956,55639,2317,4.16,1621
2021-11-01,61906,67301,-5395,-8.02,1621
2021-11-02,64417,68931,-4514,-6.55,1621
2021-11-03,64417,68939,-4522,-6.56,1621
2021-11-04,64417,68962,-4545,-6.59,1621
2021-11-05,66827,70402,-3575,-5.08,1621
2021-11-06,62756,62482,274,0.44,1621
2021-11-07,55734,55910,-176,-0.31,1621
2021-11-08,61906,67644,-5738,-8.48,1621
2021-11-09,64417,69337,-4920,-7.1,1621
2021-11-10,64417,69398,-4981,-7.18,1621
2021-11-11,64417,69460,-5043,-7.26,1621
2021-11-12,66827,70926,-4099,-5.78,1621
2021-11-13,62756,63016,-260,-0.41,1621
2021-11-14,55734,56438,-704,-1.25,1621
2021-11-15,61906,68148,-6242,-9.16,1621
2021-11-16,64417,69801,-5384,-7.71,1621
2021-11-17,64417,69805,-5388,-7.72,1621
2021-11-18,64417,69797,-5380,-7.71,1621
2021-11-19,66827,71179,-4352,-6.11,1621
2021-11-20,62756,63174,-418,-0.66,1621
2021-11-21,55734,56492,-758,-1.34,1621
2021-11-22,61906,68093,-6187,-9.09,1621
2021-11-23,64417,69634,-5217,-7.49,1621
2021-11-24,64417,69527,-5110,-7.35,1621
2021-11-25,64417,69410,-4993,-7.19,1621
2021-11-26,66827,70689,-3862,-5.46,1621
2021-11-27,62756,62590,166,0.27,1621
2021-11-28,55734,55825,-91,-0.16,1621
2021-11-29,61906,67357,-5451,-8.09,1621
2021-11-30,64417,68843,-4426,-6.43,1621
2021-12-01,61708,68698,-6990,-10.17,1621
2021-12-02,61708,68560,-6852,-9.99,1621
2021-12-03,60998,69837,-8839,-12.66,1621
2021-12-04,60217,61753,-1536,-2.49,1621
2021-12-05,51295,55020,-3725,-6.77,1621
2021-12-06,60912,66599,-5687,-8.54,1621
2021-12-07,61708,68148,-6440,-9.45,1621
2021-12-08,61708,68077,-6369,-9.36,1621
2021-12-09,61708,68023,-6315,-9.28,1621
2021-12-10,60998,69390,-8392,-12.09,1621
2021-12-11,60217,61401,-1184,-1.93,1621
2021-12-12,51295,54766,-3471,-6.34,1621
2021-12-13,60912,66440,-5528,-8.32,1621
2021-12-14,61708,68079,-6371,-9.36,1621
2021-12-15,61708,68091,-6383,-9.37,1621
2021-12-16,61708,68110,-6402,-9.4,1621
2021-12-17,60998,69538,-8540,-12.28,1621
2021-12-18,60217,61595,-1378,-2.24,1621
2021-12-19,51295,54990,-3695,-6.72,1621
2021-12-20,60912,66678,-5766,-8.65,1621
2021-12-21,61708,68314,-6606,-9.67,1621
2021-12-22,61708,68305,-6597,-9.66,1621
2021-12-23,61708,68286,-6578,-9.63,1621
2021-12-24,60998,69661,-8663,-12.44,1621
2021-12-25,60217,61651,-1434,-2.33,1621
2021-12-26,51295,54966,-3671,-6.68,1621
2021-12-27,60912,66564,-5652,-8.49,1621
2021-12-28,61708,68102,-6394,-9.39,1621
2021-12-29,61708,67991,-6283,-9.24,1621
2021-12-30,61708,67869,-6161,-9.08,1621
2021-12-31,60998,69142,-8144,-11.78,1621
2022-01-01,61086,61035,51,0.08,1621
2022-01-02,49737,54260,-4523,-8.34,1621
2022-01-03,60010,65780,-5770,-8.77,1621
2022-01-04,61978,67252,-5274,-7.84,1621
2022-01-05,61978,67091,-5113,-7.62,1621
2022-01-06,61978,66936,-4958,-7.41,1621
2022-01-07,64661,68195,-3534,-5.18,1621
2022-01-08,61086,60093,993,1.65,1621
2022-01-09,49737,53344,-3607,-6.76,1621
2022-01-10,60010,64909,-4899,-7.55,1621
2022-01-11,61978,66446,-4468,-6.72,1621
2022-01-12,61978,66368,-4390,-6.61,1621
2022-01-13,61978,66313,-4335,-6.54,1621
2022-01-14,64661,67686,-3025,-4.47,1621
2022-01-15,61086,59711,1375,2.3,1621
2022-01-16,49737,53099,-3362,-6.33,1621
2022-01-17,60010,64808,-4798,-7.4,1621
2022-01-18,61978,66493,-4515,-6.79,1621
2022-01-19,61978,66564,-4586,-6.89,1621
2022-01-20,61978,66655,-4677,-7.02,1621
2022-01-21,64661,68170,-3509,-5.15,1621
2022-01-22,61086,60329,757,1.25,1621
2022-01-23,49737,53840,-4103,-7.62,1621
2022-01-24,60010,65659,-5649,-8.6,1621
2022-01-25,61978,67440,-5462,-8.1,1621
2022-01-26,61978,67591,-5613,-8.3,1621
2022-01-27,61978,67745,-5767,-8.51,1621
2022-01-28,64661,69305,-4644,-6.7,1621
2022-01-29,61086,61491,-405,-0.66,1621
2022-01-30,49737,55012,-5275,-9.59,1621
2020-02-01,8343,7542,801,10.62,1184
2020-02-02,6269,5842,427,7.31,1184
2020-02-03,10892,10351,541,5.23,1184
2020-02-04,10990,10559,431,4.08,1184
2020-02-05,10990,10566,424,4.01,1184
2020-02-06,10990,10568,422,3.99,1184
2020-02-07,11342,10831,511,4.72,1184
2020-02-08,8343,7593,750,9.88,1184
2020-02-09,6269,5888,381,6.47,1184
2020-02-10,10892,10395,497,4.78,1184
2020-02-11,10990,10602,388,3.66,1184
2020-02-12,10990,10611,379,3.57,1184
2020-02-13,10990,10616,374,3.52,1184
2020-02-14,11342,10885,457,4.2,1184
2020-02-15,8343,7655,688,8.99,1184
2020-02-16,6269,5959,310,5.2,1184
2020-02-17,10892,10477,415,3.96,1184
2020-02-18,10990,10695,295,2.76,1184
2020-02-19,10990,10716,274,2.56,1184
2020-02-20,10990,10733,257,2.39,1184
2020-02-21,11342,11013,329,2.99,1184
2020-02-22,8343,7793,550,7.06,1184
2020-02-23,6269,6107,162,2.65,1184
2020-02-24,10892,10632,260,2.45,1184
2020-02-25,10990,10856,134,1.23,1184
2020-02-26,10990,10881,109,1.0,1184
2020-02-27,10990,10899,91,0.83,1184
2020-02-28,11342,11179,163,1.46,1184
2020-02-29,8343,7957,386,4.85,1184
2020-03-01,4371,6265,-1894,-30.23,1184
2020-03-02,8214,10783,-2569,-23.82,1184
2020-03-03,8306,10999,-2693,-24.48,1184
2020-03-04,8306,11013,-2707,-24.58,1184
2020-03-05,8306,11020,-2714,-24.63,1184
2020-03-06,8829,11288,-2459,-21.78,1184
2020-03-07,5774,8052,-2278,-28.29,1184
2020-03-08,4371,6348,-1977,-31.14,1184
2020-03-09,8214,10854,-2640,-24.32,1184
2020-03-10,8306,11059,-2753,-24.89,1184
2020-03-11,8306,11064,-2758,-24.93,1184
2020-03-12,8306,11063,-2757,-24.92,1184
2020-03-13,8829,11325,-2496,-22.04,1184
2020-03-14,5774,8086,-2312,-28.59,1184
2020-03-15,4371,6381,-2010,-31.5,1184
2020-03-16,8214,10889,-2675,-24.57,1184
2020-03-17,8306,11098,-2792,-25.16,1184
2020-03-18,8306,11109,-2803,-25.23,1184
2020-03-19,8306,11118,-2812,-25.29,1184
2020-03-20,8829,11391,-2562,-22.49,1184
2020-03-21,5774,8165,-2391,-29.28,1184
2020-03-22,4371,6474,-2103,-32.48,1184
2020-03-23,8214,10998,-2784,-25.31,1184
2020-03-24,8306,11223,-2917,-25.99,1184
2020-03-25,8306,11251,-2945,-26.18,1184
2020-03-26,8306,11275,-2969,-26.33,1184
2020-03-27,8829,11564,-2735,-23.65,1184
2020-03-28,5774,8352,-2578,-30.87,1184
2020-03-29,4371,6674,-2303,-34.51,1184
2020-03-30,8214,11208,-2994,-26.71,1184
2020-03-31,8306,11442,-3136,-27.41,1184
2020-04-01,7878,11475,-3597,-31.35,1184
2020-04-02,7878,11503,-3625,-31.51,1184
2020-04-03,7619,11792,-4173,-35.39,1184
2020-04-04,5570,8578,-3008,-35.07,1184
2020-04-05,3584,6895,-3311,-48.02,1184
2020-04-06,7698,11421,-3723,-32.6,1184
2020-04-07,7878,11645,-3767,-32.35,1184
2020-04-08,7878,11668,-3790,-32.48,1184
2020-04-09,7878,11683,-3805,-32.57,1184
2020-04-10,7619,11958,-4339,-36.29,1184
2020-04-11,5570,8730,-3160,-36.2,1184
2020-04-12,3584,7033,-3449,-49.04,1184
2020-04-13,7698,11547,-3849,-33.33,1184
2020-04-14,7878,11759,-3881,-33.0,1184
2020-04-15,7878,11771,-3893,-33.07,1184
2020-04-16,7878,11778,-3900,-33.11,1184
2020-04-17,7619,12047,-4428,-36.76,1184
2020-04-18,5570,8817,-3247,-36.83,1184
2020-04-19,3584,7120,-3536,-49.66,1184
2020-04-20,7698,11637,-3939,-33.85,1184
2020-04-21,7878,11855,-3977,-33.55,1184
2020-04-22,7878,11877,-3999,-33.67,1184
2020-04-23,7878,11896,-4018,-33.78,1184
2020-04-24,7619,12181,-4562,-37.45,1184
2020-04-25,5570,8967,-3397,-37.88,1184
2020-04-26,3584,7290,-3706,-50.84,1184
2020-04-27,7698,11827,-4129,-34.91,1184
2020-04-28,7878,12067,-4189,-34.71,1184
2020-04-29,7878,12109,-4231,-34.94,1184
2020-04-30,7878,12149,-4271,-35.16,1184
2020-05-01,10854,12453,-1599,-12.84,1184
2020-05-02,8122,9257,-1135,-12.26,1184
2020-05-03,5929,7594,-1665,-21.93,1184
2020-05-04,10355,12143,-1788,-14.72,1184
2020-05-05,10635,12391,-1756,-14.17,1184
2020-05-06,10635,12437,-1802,-14.49,1184
2020-05-07,10635,12477,-1842,-14.76,1184
2020-05-08,10854,12776,-1922,-15.04,1184
2020-05-09,8122,9571,-1449,-15.14,1184
2020-05-10,5929,7894,-1965,-24.89,1184
2020-05-11,10355,12425,-2070,-16.66,1184
2020-05-12,10635,12651,-2016,-15.94,1184
2020-05-13,10635,12672,-2037,-16.07,1184
2020-05-14,10635,12683,-2048,-16.15,1184
2020-05-15,10854,12950,-2096,-16.19,1184
2020-05-16,8122,9712,-1590,-16.37,1184
2020-05-17,5929,8001,-2072,-25.9,1184
2020-05-18,10355,12497,-2142,-17.14,1184
2020-05-19,10635,12688,-2053,-16.18,1184
2020-05-20,10635,12675,-2040,-16.09,1184
2020-05-21,10635,12654,-2019,-15.96,1184
2020-05-22,10854,12893,-2039,-15.81,1184
2020-05-23,8122,9628,-1506,-15.64,1184
2020-05-24,5929,7895,-1966,-24.9,1184
2020-05-25,10355,12372,-2017,-16.3,1184
2020-05-26,10635,12550,-1915,-15.26,1184
2020-05-27,10635,12528,-1893,-15.11,1184
2020-05-28,10635,12503,-1868,-14.94,1184
2020-05-29,10854,12742,-1888,-14.82,1184
2020-05-30,8122,9482,-1360,-14.34,1184
2020-05-31,5929,7758,-1829,-23.58,1184
2020-06-01,11511,12249,-738,-6.02,1184
2020-06-02,11957,12442,-485,-3.9,1184
2020-06-03,11957,12440,-483,-3.88,1184
2020-06-04,11957,12435,-478,-3.84,1184
2020-06-05,11936,12696,-760,-5.99,1184
2020-06-06,8844,9458,-614,-6.49,1184
2020-06-07,6933,7755,-822,-10.6,1184
2020-06-08,11511,12266,-755,-6.16,1184
2020-06-09,11957,12477,-520,-4.17,1184
2020-06-10,11957,12489,-532,-4.26,1184
2020-06-11,11957,12495,-538,-4.31,1184
2020-06-12,11936,12764,-828,-6.49,1184
2020-06-13,8844,9529,-685,-7.19,1184
2020-06-14,6933,7824,-891,-11.39,1184
2020-06-15,11511,12327,-816,-6.62,1184
2020-06-16,11957,12527,-570,-4.55,1184
2020-06-17,11957,12522,-565,-4.51,1184
2020-06-18,11957,12508,-551,-4.41,1184
2020-06-19,11936,12751,-815,-6.39,1184
2020-06-20,8844,9487,-643,-6.78,1184
2020-06-21,6933,7750,-817,-10.54,1184
2020-06-22,11511,12220,-709,-5.8,1184
2020-06-23,11957,12384,-427,-3.45,1184
2020-06-24,11957,12343,-386,-3.13,1184
2020-06-25,11957,12293,-336,-2.73,1184
2020-06-26,11936,12501,-565,-4.52,1184
2020-06-27,8844,9205,-361,-3.92,1184
2020-06-28,6933,7438,-505,-6.79,1184
2020-06-29,11511,11882,-371,-3.12,1184
2020-06-30,11957,12024,-67,-0.56,1184
2020-07-01,12157,11966,191,1.6,1184
2020-07-02,12157,11904,253,2.13,1184
2020-07-03,12226,12106,120,0.99,1184
2020-07-04,8456,8810,-354,-4.02,1184
2020-07-05,7102,7048,54,0.77,1184
2020-07-06,12110,11502,608,5.29,1184
2020-07-07,12157,11660,497,4.26,1184
2020-07-08,12157,11623,534,4.59,1184
2020-07-09,12157,11586,571,4.93,1184
2020-07-10,12226,11816,410,3.47,1184
2020-07-11,8456,8550,-94,-1.1,1184
2020-07-12,7102,6822,280,4.1,1184
2020-07-13,12110,11310,800,7.07,1184
2020-07-14,12157,11502,655,5.69,1184
2020-07-15,12157,11498,659,5.73,1184
2020-07-16,12157,11492,665,5.79,1184
2020-07-17,12226,11752,474,4.03,1184
2020-07-18,8456,8511,-55,-0.65,1184
2020-07-19,7102,6805,297,4.36,1184
2020-07-20,12110,11310,800,7.07,1184
2020-07-21,12157,11515,642,5.58,1184
2020-07-22,12157,11519,638,5.54,1184
2020-07-23,12157,11515,642,5.58,1184
2020-07-24,12226,11772,454,3.86,1184
2020-07-25,8456,8524,-68,-0.8,1184
2020-07-26,7102,6805,297,4.36,1184
2020-07-27,12110,11294,816,7.23,1184
2020-07-28,12157,11478,679,5.92,1184
2020-07-29,12157,11459,698,6.09,1184
2020-07-30,12157,11430,727,6.36,1184
2020-07-31,12226,11660,566,4.85,1184
2020-08-01,8490,8386,104,1.24,1184
2020-08-02,6825,6641,184,2.77,1184
2020-08-03,11159,11105,54,0.49,1184
2020-08-04,11324,11266,58,0.51,1184
2020-08-05,11324,11227,97,0.86,1184
2020-08-06,11324,11183,141,1.26,1184
2020-08-07,11503,11402,101,0.89,1184
2020-08-08,8490,8120,370,4.56,1184
2020-08-09,6825,6374,451,7.08,1184
2020-08-10,11159,10842,317,2.92,1184
2020-08-11,11324,11013,311,2.82,1184
2020-08-12,11324,10988,336,3.06,1184
2020-08-13,11324,10963,361,3.29,1184
2020-08-14,11503,11206,297,2.65,1184
2020-08-15,8490,7953,537,6.75,1184
2020-08-16,6825,6238,587,9.41,1184
2020-08-17,11159,10741,418,3.89,1184
2020-08-18,11324,10948,376,3.43,1184
2020-08-19,11324,10961,363,3.31,1184
2020-08-20,11324,10974,350,3.19,1184
2020-08-21,11503,11254,249,2.21,1184
2020-08-22,8490,8037,453,5.64,1184
2020-08-23,6825,6355,470,7.4,1184
2020-08-24,11159,10887,272,2.5,1184
2020-08-25,11324,11121,203,1.83,1184
2020-08-26,11324,11155,169,1.52,1184
2020-08-27,11324,11185,139,1.24,1184
2020-08-28,11503,11476,27,0.24,1184
2020-08-29,8490,8265,225,2.72,1184
2020-08-30,6825,6584,241,3.66,1184
2020-08-31,11159,11112,47,0.42,1184
2020-09-01,11712,11337,375,3.31,1184
2020-09-02,11712,11358,354,3.12,1184
2020-09-03,11712,11371,341,3.0,1184
2020-09-04,11598,11642,-44,-0.38,1184
2020-09-05,8727,8407,320,3.81,1184
2020-09-06,6745,6702,43,0.64,1184
2020-09-07,11390,11205,185,1.65,1184
2020-09-08,11712,11405,307,2.69,1184
2020-09-09,11712,11402,310,2.72,1184
2020-09-10,11712,11392,320,2.81,1184
2020-09-11,11598,11643,-45,-0.39,1184
2020-09-12,8727,8393,334,3.98,1184
2020-09-13,6745,6675,70,1.05,1184
2020-09-14,11390,11170,220,1.97,1184
2020-09-15,11712,11366,346,3.04,1184
2020-09-16,11712,11364,348,3.06,1184
2020-09-17,11712,11361,351,3.09,1184
2020-09-18,11598,11624,-26,-0.22,1184
2020-09-19,8727,8390,337,4.02,1184
2020-09-20,6745,6693,52,0.78,1184
2020-09-21,11390,11212,178,1.59,1184
2020-09-22,11712,11436,276,2.41,1184
2020-09-23,11712,11465,247,2.15,1184
2020-09-24,11712,11494,218,1.9,1184
2020-09-25,11598,11789,-191,-1.62,1184
2020-09-26,8727,8588,139,1.62,1184
2020-09-27,6745,6923,-178,-2.57,1184
2020-09-28,11390,11472,-82,-0.71,1184
2020-09-29,11712,11723,-11,-0.09,1184
2020-09-30,11712,11776,-64,-0.54,1184
2020-10-01,11514,11825,-311,-2.63,1184
2020-10-02,11616,12136,-520,-4.28,1184
2020-10-03,8562,8945,-383,-4.28,1184
2020-10-04,6424,7284,-860,-11.81,1184
2020-10-05,11327,11833,-506,-4.28,1184
2020-10-06,11514,12077,-563,-4.66,1184
2020-10-07,11514,12117,-603,-4.98,1184
2020-10-08,11514,12148,-634,-5.22,1184
2020-10-09,11616,12436,-820,-6.59,1184
2020-10-10,8562,9217,-655,-7.11,1184
2020-10-11,6424,7525,-1101,-14.63,1184
2020-10-12,11327,12039,-712,-5.91,1184
2020-10-13,11514,12246,-732,-5.98,1184
2020-10-14,11514,12247,-733,-5.99,1184
2020-10-15,11514,12239,-725,-5.92,1184
2020-10-16,11616,12487,-871,-6.98,1184
2020-10-17,8562,9229,-667,-7.23,1184
2020-10-18,6424,7500,-1076,-14.35,1184
2020-10-19,11327,11979,-652,-5.44,1184
2020-10-20,11514,12155,-641,-5.27,1184
2020-10-21,11514,12129,-615,-5.07,1184
2020-10-22,11514,12096,-582,-4.81,1184
2020-10-23,11616,12325,-709,-5.75,1184
2020-10-24,8562,9053,-491,-5.42,1184
2020-10-25,6424,7314,-890,-12.17,1184
2020-10-26,11327,11788,-461,-3.91,1184
2020-10-27,11514,11964,-450,-3.76,1184
2020-10-28,11514,11941,-427,-3.58,1184
2020-10-29,11514,11917,-403,-3.38,1184
2020-10-30,11616,12157,-541,-4.45,1184
2020-10-31,8562,8899,-337,-3.79,1184
2020-11-01,5145,7176,-2031,-28.3,1184
2020-11-02,10090,11667,-1577,-13.52,1184
2020-11-03,9342,11861,-2519,-21.24,1184
2020-11-04,9342,11856,-2514,-21.2,1184
2020-11-05,9342,11849,-2507,-21.16,1184
2020-11-06,9925,12106,-2181,-18.02,1184
2020-11-07,6923,8862,-1939,-21.88,1184
2020-11-08,5145,7151,-2006,-28.05,1184
2020-11-09,10090,11652,-1562,-13.41,1184
2020-11-10,9342,11852,-2510,-21.18,1184
2020-11-11,9342,11851,-2509,-21.17,1184
2020-11-12,9342,11844,-2502,-21.12,1184
2020-11-13,9925,12098,-2173,-17.96,1184
2020-11-14,6923,8848,-1925,-21.76,1184
2020-11-15,5145,7129,-1984,-27.83,1184
2020-11-16,10090,11618,-1528,-13.15,1184
2020-11-17,9342,11805,-2463,-20.86,1184
2020-11-18,9342,11789,-2447,-20.76,1184
2020-11-19,9342,11767,-2425,-20.61,1184
2020-11-20,9925,12004,-2079,-17.32,1184
2020-11-21,6923,8738,-1815,-20.77,1184
2020-11-22,5145,7003,-1858,-26.53,1184
2020-11-23,10090,11479,-1389,-12.1,1184
2020-11-24,9342,11653,-2311,-19.83,1184
2020-11-25,9342,11627,-2285,-19.65,1184
2020-11-26,9342,11597,-2255,-19.44,1184
2020-11-27,9925,11829,-1904,-16.1,1184
2020-11-28,6923,8562,-1639,-19.14,1184
2020-11-29,5145,6828,-1683,-24.65,1184
2020-11-30,10090,11308,-1218,-10.77,1184
2020-12-01,9404,11490,-2086,-18.15,1184
2020-12-02,9404,11474,-2070,-18.04,1184
2020-12-03,9404,11456,-2052,-17.91,1184
2020-12-04,10438,11703,-1265,-10.81,1184
2020-12-05,7342,8451,-1109,-13.12,1184
2020-12-06,5069,6734,-1665,-24.73,1184
2020-12-07,9638,11231,-1593,-14.18,1184
2020-12-08,9404,11430,-2026,-17.73,1184
2020-12-09,9404,11430,-2026,-17.73,1184
2020-12-10,9404,11426,-2022,-17.7,1184
2020-12-11,10438,11686,-1248,-10.68,1184
2020-12-12,7342,8444,-1102,-13.05,1184
2020-12-13,5069,6734,-1665,-24.73,1184
2020-12-14,9638,11235,-1597,-14.21,1184
2020-12-15,9404,11434,-2030,-17.75,1184
2020-12-16,9404,11430,-2026,-17.73,1184
2020-12-17,9404,11419,-2015,-17.65,1184
2020-12-18,10438,11667,-1229,-10.53,1184
2020-12-19,7342,8411,-1069,-12.71,1184
2020-12-20,5069,6683,-1614,-24.15,1184
2020-12-21,9638,11162,-1524,-13.65,1184
2020-12-22,9404,11337,-1933,-17.05,1184
2020-12-23,9404,11308,-1904,-16.84,1184
2020-12-24,9404,11270,-1866,-16.56,1184
2020-12-25,10438,11491,-1053,-9.16,1184
2020-12-26,7342,8207,-865,-10.54,1184
2020-12-27,5069,6452,-1383,-21.44,1184
2020-12-28,9638,10906,-1268,-11.63,1184
2020-12-29,9404,11058,-1654,-14.96,1184
2020-12-30,9404,11009,-1605,-14.58,1184
2020-12-31,9404,10954,-1550,-14.15,1184
2021-01-01,9066,11162,-2096,-18.78,1184
2021-01-02,5988,7868,-1880,-23.89,1184
2021-01-03,4330,6109,-1779,-29.12,1184
2021-01-04,8589,10564,-1975,-18.7,1184
2021-01-05,8863,10720,-1857,-17.32,1184
2021-01-06,8863,10681,-1818,-17.02,1184
2021-01-07,8863,10640,-1777,-16.7,1184
2021-01-08,9066,10865,-1799,-16.56,1184
2021-01-09,5988,7594,-1606,-21.15,1184
2021-01-10,4330,5861,-1531,-26.12,1184
2021-01-11,8589,10344,-1755,-16.97,1184
2021-01-12,8863,10531,-1668,-15.84,1184
2021-01-13,8863,10524,-1661,-15.78,1184
2021-01-14,8863,10516,-1653,-15.72,1184
2021-01-15,9066,10775,-1709,-15.86,1184
2021-01-16,5988,7538,-1550,-20.56,1184
2021-01-17,4330,5836,-1506,-25.81,1184
2021-01-18,8589,10349,-1760,-17.01,1184
2021-01-19,8863,10565,-1702,-16.11,1184
2021-01-20,8863,10583,-1720,-16.25,1184
2021-01-21,8863,10597,-1734,-16.36,1184
2021-01-22,9066,10875,-1809,-16.63,1184
2021-01-23,5988,7653,-1665,-21.76,1184
2021-01-24,4330,5963,-1633,-27.39,1184
2021-01-25,8589,10484,-1895,-18.08,1184
2021-01-26,8863,10704,-1841,-17.2,1184
2021-01-27,8863,10723,-1860,-17.35,1184
2021-01-28,8863,10736,-1873,-17.45,1184
2021-01-29,9066,11010,-1944,-17.66,1184
2021-01-30,5988,7780,-1792,-23.03,1184
2021-01-31,4330,6082,-1752,-28.81,1184
2021-02-01,9787,10593,-806,-7.61,1184
2021-02-02,10011,10803,-792,-7.33,1184
2021-02-03,10011,10811,-800,-7.4,1184
2021-02-04,10011,10814,-803,-7.43,1184
2021-02-05,10443,11077,-634,-5.72,1184
2021-02-06,7322,7840,-518,-6.61,1184
2021-02-07,5208,6134,-926,-15.1,1184
2021-02-08,9787,10640,-853,-8.02,1184
2021-02-09,10011,10847,-836,-7.71,1184
2021-02-10,10011,10854,-843,-7.77,1184
2021-02-11,10011,10858,-847,-7.8,1184
2021-02-12,10443,11125,-682,-6.13,1184
2021-02-13,7322,7892,-570,-7.22,1184
2021-02-14,5208,6194,-986,-15.92,1184
2021-02-15,9787,10709,-922,-8.61,1184
2021-02-16,10011,10926,-915,-8.37,1184
2021-02-17,10011,10944,-933,-8.53,1184
2021-02-18,10011,10960,-949,-8.66,1184
2021-02-19,10443,11239,-796,-7.08,1184
2021-02-20,7322,8018,-696,-8.68,1184
2021-02-21,5208,6330,-1122,-17.73,1184
2021-02-22,9787,10855,-1068,-9.84,1184
2021-02-23,10011,11079,-1068,-9.64,1184
2021-02-24,10011,11104,-1093,-9.84,1184
2021-02-25,10011,11124,-1113,-10.01,1184
2021-02-26,10443,11405,-962,-8.43,1184
2021-02-27,7322,8184,-862,-10.53,1184
2021-02-28,5208,6494,-1286,-19.8,1184
2021-03-01,10366,11014,-648,-5.88,1184
2021-03-02,10669,11232,-563,-5.01,1184
2021-03-03,10669,11249,-580,-5.16,1184
2021-03-04,10669,11259,-590,-5.24,1184
2021-03-05,10668,11529,-861,-7.47,1184
2021-03-06,7958,8295,-337,-4.06,1184
2021-03-07,5511,6593,-1082,-16.41,1184
2021-03-08,10366,11101,-735,-6.62,1184
2021-03-09,10669,11307,-638,-5.64,1184
2021-03-10,10669,11312,-643,-5.68,1184
2021-03-11,10669,11312,-643,-5.68,1184
2021-03-12,10668,11574,-906,-7.83,1184
2021-03-13,7958,8334,-376,-4.51,1184
2021-03-14,5511,6628,-1117,-16.85,1184
2021-03-15,10366,11134,-768,-6.9,1184
2021-03-16,10669,11341,-672,-5.93,1184
2021-03-17,10669,11350,-681,-6.0,1184
2021-03-18,10669,11355,-686,-6.04,1184
2021-03-19,10668,11626,-958,-8.24,1184
2021-03-20,7958,8397,-439,-5.23,1184
2021-03-21,5511,6703,-1192,-17.78,1184
2021-03-22,10366,11223,-857,-7.64,1184
2021-03-23,10669,11446,-777,-6.79,1184
2021-03-24,10669,11471,-802,-6.99,1184
2021-03-25,10669,11493,-824,-7.17,1184
2021-03-26,10668,11779,-1111,-9.43,1184
2021-03-27,7958,8566,-608,-7.1,1184
2021-03-28,5511,6887,-1376,-19.98,1184
2021-03-29,10366,11420,-1054,-9.23,1184
2021-03-30,10669,11654,-985,-8.45,1184
2021-03-31,10669,11688,-1019,-8.72,1184
2021-04-01,10117,11716,-1599,-13.65,1184
2021-04-02,10633,12006,-1373,-11.44,1184
2021-04-03,7642,8794,-1152,-13.1,1184
2021-04-04,5613,7113,-1500,-21.09,1184
2021-04-05,10239,11642,-1403,-12.05,1184
2021-04-06,10117,11869,-1752,-14.76,1184
2021-04-07,10117,11894,-1777,-14.94,1184
2021-04-08,10117,11911,-1794,-15.06,1184
2021-04-09,10633,12189,-1556,-12.77,1184
2021-04-10,7642,8964,-1322,-14.75,1184
2021-04-11,5613,7269,-1656,-22.78,1184
2021-04-12,10239,11784,-1545,-13.11,1184
2021-04-13,10117,11997,-1880,-15.67,1184
2021-04-14,10117,12010,-1893,-15.76,1184
2021-04-15,10117,12017,-1900,-15.81,1184
2021-04-16,10633,12286,-1653,-13.45,1184
2021-04-17,7642,9054,-1412,-15.6,1184
2021-04-18,5613,7356,-1743,-23.69,1184
2021-04-19,10239,11870,-1631,-13.74,1184
2021-04-20,10117,12086,-1969,-16.29,1184
2021-04-21,10117,12104,-1987,-16.42,1184
2021-04-22,10117,12120,-2003,-16.53,1184
2021-04-23,10633,12401,-1768,-14.26,1184
2021-04-24,7642,9184,-1542,-16.79,1184
2021-04-25,5613,7502,-1889,-25.18,1184
2021-04-26,10239,12035,-1796,-14.92,1184
2021-04-27,10117,12271,-2154,-17.55,1184
2021-04-28,10117,12311,-2194,-17.82,1184
2021-04-29,10117,12347,-2230,-18.06,1184
2021-04-30,10633,12649,-2016,-15.94,1184
2021-05-01,8795,9451,-656,-6.94,1184
2021-05-02,6231,7788,-1557,-19.99,1184
2021-05-03,11603,12336,-733,-5.94,1184
2021-05-04,11783,12585,-802,-6.37,1184
2021-05-05,11783,12633,-850,-6.73,1184
2021-05-06,11783,12675,-892,-7.04,1184
2021-05-07,11746,12977,-1231,-9.49,1184
2021-05-08,8795,9776,-981,-10.03,1184
2021-05-09,6231,8104,-1873,-23.11,1184
2021-05-10,11603,12640,-1037,-8.2,1184
2021-05-11,11783,12872,-1089,-8.46,1184
2021-05-12,11783,12899,-1116,-8.65,1184
2021-05-13,11783,12916,-1133,-8.77,1184
2021-05-14,11746,13191,-1445,-10.95,1184
2021-05-15,8795,9959,-1164,-11.69,1184
2021-05-16,6231,8254,-2023,-24.51,1184
2021-05-17,11603,12755,-1152,-9.03,1184
2021-05-18,11783,12952,-1169,-9.03,1184
2021-05-19,11783,12944,-1161,-8.97,1184
2021-05-20,11783,12928,-1145,-8.86,1184
2021-05-21,11746,13170,-1424,-10.81,1184
2021-05-22,8795,9908,-1113,-11.23,1184
2021-05-23,6231,8176,-1945,-23.79,1184
2021-05-24,11603,12654,-1051,-8.31,1184
2021-05-25,11783,12832,-1049,-8.17,1184
2021-05-26,11783,12809,-1026,-8.01,1184
2021-05-27,11783,12782,-999,-7.82,1184
2021-05-28,11746,13019,-1273,-9.78,1184
2021-05-29,8795,9757,-962,-9.86,1184
2021-05-30,6231,8029,-1798,-22.39,1184
2021-05-31,11603,12516,-913,-7.29,1184
2021-06-01,12368,12705,-337,-2.65,1184
2021-06-02,12368,12698,-330,-2.6,1184
2021-06-03,12368,12689,-321,-2.53,1184
2021-06-04,12258,12946,-688,-5.31,1184
2021-06-05,9173,9705,-532,-5.48,1184
2021-06-06,7503,7999,-496,-6.2,1184
2021-06-07,12040,12507,-467,-3.73,1184
2021-06-08,12368,12717,-349,-2.74,1184
2021-06-09,12368,12728,-360,-2.83,1184
2021-06-10,12368,12735,-367,-2.88,1184
2021-06-11,12258,13004,-746,-5.74,1184
2021-06-12,9173,9771,-598,-6.12,1184
2021-06-13,7503,8069,-566,-7.01,1184
2021-06-14,12040,12577,-537,-4.27,1184
2021-06-15,12368,12781,-413,-3.23,1184
2021-06-16,12368,12781,-413,-3.23,1184
2021-06-17,12368,12773,-405,-3.17,1184
2021-06-18,12258,13022,-764,-5.87,1184
2021-06-19,9173,9765,-592,-6.06,1184
2021-06-20,7503,8035,-532,-6.62,1184
2021-06-21,12040,12511,-471,-3.76,1184
2021-06-22,12368,12682,-314,-2.48,1184
2021-06-23,12368,12647,-279,-2.21,1184
2021-06-24,12368,12603,-235,-1.86,1184
2021-06-25,12258,12816,-558,-4.35,1184
2021-06-26,9173,9524,-351,-3.69,1184
2021-06-27,7503,7761,-258,-3.32,1184
2021-06-28,12040,12207,-167,-1.37,1184
2021-06-29,12368,12350,18,0.15,1184
2021-06-30,12368,12293,75,0.61,1184
2021-07-01,11320,12230,-910,-7.44,1184
2021-07-02,11352,12430,-1078,-8.67,1184
2021-07-03,8030,9130,-1100,-12.05,1184
2021-07-04,6402,7365,-963,-13.08,1184
2021-07-05,11022,11815,-793,-6.71,1184
2021-07-06,11320,11968,-648,-5.41,1184
2021-07-07,11320,11925,-605,-5.07,1184
2021-07-08,11320,11881,-561,-4.72,1184
2021-07-09,11352,12105,-753,-6.22,1184
2021-07-10,8030,8833,-803,-9.09,1184
2021-07-11,6402,7098,-696,-9.81,1184
2021-07-12,11022,11580,-558,-4.82,1184
2021-07-13,11320,11767,-447,-3.8,1184
2021-07-14,11320,11758,-438,-3.73,1184
2021-07-15,11320,11748,-428,-3.64,1184
2021-07-16,11352,12004,-652,-5.43,1184
2021-07-17,8030,8761,-731,-8.34,1184
2021-07-18,6402,7053,-651,-9.23,1184
2021-07-19,11022,11558,-536,-4.64,1184
2021-07-20,11320,11763,-443,-3.77,1184
2021-07-21,11320,11768,-448,-3.81,1184
2021-07-22,11320,11767,-447,-3.8,1184
2021-07-23,11352,12027,-675,-5.61,1184
2021-07-24,8030,8782,-752,-8.56,1184
2021-07-25,6402,7068,-666,-9.42,1184
2021-07-26,11022,11561,-539,-4.66,1184
2021-07-27,11320,11751,-431,-3.67,1184
2021-07-28,11320,11737,-417,-3.55,1184
2021-07-29,11320,11713,-393,-3.36,1184
2021-07-30,11352,11948,-596,-4.99,1184
2021-07-31,8030,8678,-648,-7.47,1184
2021-08-01,6056,6936,-880,-12.69,1184
2021-08-02,10279,11404,-1125,-9.86,1184
2021-08-03,10434,11568,-1134,-9.8,1184
2021-08-04,10434,11530,-1096,-9.51,1184
2021-08-05,10434,11486,-1052,-9.16,1184
2021-08-06,10474,11704,-1230,-10.51,1184
2021-08-07,7749,8421,-672,-7.98,1184
2021-08-08,6056,6672,-616,-9.23,1184
2021-08-09,10279,11137,-858,-7.7,1184
2021-08-10,10434,11303,-869,-7.69,1184
2021-08-11,10434,11273,-839,-7.44,1184
2021-08-12,10434,11243,-809,-7.2,1184
2021-08-13,10474,11479,-1005,-8.76,1184
2021-08-14,7749,8219,-470,-5.72,1184
2021-08-15,6056,6498,-442,-6.8,1184
2021-08-16,10279,10993,-714,-6.5,1184
2021-08-17,10434,11194,-760,-6.79,1184
2021-08-18,10434,11200,-766,-6.84,1184
2021-08-19,10434,11207,-773,-6.9,1184
2021-08-20,10474,11481,-1007,-8.77,1184
2021-08-21,7749,8258,-509,-6.16,1184
2021-08-22,6056,6572,-516,-7.85,1184
2021-08-23,10279,11101,-822,-7.4,1184
2021-08-24,10434,11333,-899,-7.93,1184
2021-08-25,10434,11366,-932,-8.2,1184
2021-08-26,10434,11396,-962,-8.44,1184
2021-08-27,10474,11688,-1214,-10.39,1184
2021-08-28,7749,8478,-729,-8.6,1184
2021-08-29,6056,6800,-744,-10.94,1184
2021-08-30,10279,11331,-1052,-9.28,1184
2021-08-31,10434,11560,-1126,-9.74,1184
2021-09-01,11762,11585,177,1.53,1184
2021-09-02,11762,11602,160,1.38,1184
2021-09-03,11840,11878,-38,-0.32,1184
2021-09-04,8829,8649,180,2.08,1184
2021-09-05,7221,6948,273,3.93,1184
2021-09-06,11470,11455,15,0.13,1184
2021-09-07,11762,11659,103,0.88,1184
2021-09-08,11762,11659,103,0.88,1184
2021-09-09,11762,11652,110,0.94,1184
2021-09-10,11840,11905,-65,-0.55,1184
2021-09-11,8829,8655,174,2.01,1184
2021-09-12,7221,6937,284,4.09,1184
2021-09-13,11470,11431,39,0.34,1184
2021-09-14,11762,11625,137,1.18,1184
2021-09-15,11762,11621,141,1.21,1184
2021-09-16,11762,11614,148,1.27,1184
2021-09-17,11840,11872,-32,-0.27,1184
2021-09-18,8829,8633,196,2.27,1184
2021-09-19,7221,6930,291,4.2,1184
2021-09-20,11470,11443,27,0.24,1184
2021-09-21,11762,11661,101,0.87,1184
2021-09-22,11762,11683,79,0.68,1184
2021-09-23,11762,11706,56,0.48,1184
2021-09-24,11840,11996,-156,-1.3,1184
2021-09-25,8829,8789,40,0.46,1184
2021-09-26,7221,7120,101,1.42,1184
2021-09-27,11470,11665,-195,-1.67,1184
2021-09-28,11762,11913,-151,-1.27,1184
2021-09-29,11762,11964,-202,-1.69,1184
2021-09-30,11762,12012,-250,-2.08,1184
2021-10-01,12062,12323,-261,-2.12,1184
2021-10-02,8782,9133,-351,-3.84,1184
2021-10-03,6555,7475,-920,-12.31,1184
2021-10-04,11128,12026,-898,-7.47,1184
2021-10-05,11496,12275,-779,-6.35,1184
2021-10-06,11496,12320,-824,-6.69,1184
2021-10-07,11496,12357,-861,-6.97,1184
2021-10-08,12062,12651,-589,-4.66,1184
2021-10-09,8782,9439,-657,-6.96,1184
2021-10-10,6555,7754,-1199,-15.46,1184
2021-10-11,11128,12275,-1147,-9.34,1184
2021-10-12,11496,12490,-994,-7.96,1184
2021-10-13,11496,12499,-1003,-8.02,1184
2021-10-14,11496,12497,-1001,-8.01,1184
2021-10-15,12062,12752,-690,-5.41,1184
2021-10-16,8782,9500,-718,-7.56,1184
2021-10-17,6555,7776,-1221,-15.7,1184
2021-10-18,11128,12259,-1131,-9.23,1184
2021-10-19,11496,12439,-943,-7.58,1184
2021-10-20,11496,12415,-919,-7.4,1184
2021-10-21,11496,12384,-888,-7.17,1184
2021-10-22,12062,12614,-552,-4.38,1184
2021-10-23,8782,9342,-560,-5.99,1184
2021-10-24,6555,7603,-1048,-13.78,1184
2021-10-25,11128,12075,-947,-7.84,1184
2021-10-26,11496,12249,-753,-6.15,1184
2021-10-27,11496,12224,-728,-5.96,1184
2021-10-28,11496,12196,-700,-5.74,1184
2021-10-29,12062,12433,-371,-2.98,1184
2021-10-30,8782,9171,-389,-4.24,1184
2021-10-31,6555,7445,-890,-11.95,1184
2021-11-01,10412,11933,-1521,-12.75,1184
2021-11-02,10930,12123,-1193,-9.84,1184
2021-11-03,10930,12116,-1186,-9.79,1184
2021-11-04,10930,12106,-1176,-9.71,1184
2021-11-05,11553,12361,-808,-6.54,1184
2021-11-06,8293,9116,-823,-9.03,1184
2021-11-07,6217,7405,-1188,-16.04,1184
2021-11-08,10412,11905,-1493,-12.54,1184
2021-11-09,10930,12106,-1176,-9.71,1184
2021-11-10,10930,12106,-1176,-9.71,1184
2021-11-11,10930,12101,-1171,-9.68,1184
2021-11-12,11553,12357,-804,-6.51,1184
2021-11-13,8293,9109,-816,-8.96,1184
2021-11-14,6217,7393,-1176,-15.91,1184
2021-11-15,10412,11885,-1473,-12.39,1184
2021-11-16,10930,12075,-1145,-9.48,1184
2021-11-17,10930,12063,-1133,-9.39,1184
2021-11-18,10930,12043,-1113,-9.24,1184
2021-11-19,11553,12283,-730,-5.94,1184
2021-11-20,8293,9019,-726,-8.05,1184
2021-11-21,6217,7286,-1069,-14.67,1184
2021-11-22,10412,11763,-1351,-11.49,1184
2021-11-23,10930,11939,-1009,-8.45,1184
2021-11-24,10930,11914,-984,-8.26,1184
2021-11-25,10930,11883,-953,-8.02,1184
2021-11-26,11553,12115,-562,-4.64,1184
2021-11-27,8293,8846,-553,-6.25,1184
2021-11-28,6217,7110,-893,-12.56,1184
2021-11-29,10412,11588,-1176,-10.15,1184
2021-11-30,10930,11767,-837,-7.11,1184
2021-12-01,10041,11748,-1707,-14.53,1184
2021-12-02,10041,11727,-1686,-14.38,1184
2021-12-03,9714,11970,-2256,-18.85,1184
2021-12-04,7639,8715,-1076,-12.35,1184
2021-12-05,5557,6995,-1438,-20.56,1184
2021-12-06,10178,11490,-1312,-11.42,1184
2021-12-07,10041,11686,-1645,-14.08,1184
2021-12-08,10041,11684,-1643,-14.06,1184
2021-12-09,10041,11679,-1638,-14.03,1184
2021-12-10,9714,11937,-2223,-18.62,1184
2021-12-11,7639,8695,-1056,-12.14,1184
2021-12-12,5557,6986,-1429,-20.46,1184
2021-12-13,10178,11488,-1310,-11.4,1184
2021-12-14,10041,11689,-1648,-14.1,1184
2021-12-15,10041,11688,-1647,-14.09,1184
2021-12-16,10041,11680,-1639,-14.03,1184
2021-12-17,9714,11932,-2218,-18.59,1184
2021-12-18,7639,8680,-1041,-11.99,1184
2021-12-19,5557,6957,-1400,-20.12,1184
2021-12-20,10178,11441,-1263,-11.04,1184
2021-12-21,10041,11622,-1581,-13.6,1184
2021-12-22,10041,11598,-1557,-13.42,1184
2021-12-23,10041,11565,-1524,-13.18,1184
2021-12-24,9714,11790,-2076,-17.61,1184
2021-12-25,7639,8511,-872,-10.25,1184
2021-12-26,5557,6760,-1203,-17.8,1184
2021-12-27,10178,11217,-1039,-9.26,1184
2021-12-28,10041,11372,-1331,-11.7,1184
2021-12-29,10041,11325,-1284,-11.34,1184
2021-12-30,10041,11271,-1230,-10.91,1184
2021-12-31,9714,11478,-1764,-15.37,1184
2022-01-01,7426,8184,-758,-9.26,1184
2022-01-02,5211,6423,-1212,-18.87,1184
2022-01-03,9829,10875,-1046,-9.62,1184
2022-01-04,9882,11029,-1147,-10.4,1184
2022-01-05,9882,10985,-1103,-10.04,1184
2022-01-06,9882,10939,-1057,-9.66,1184
2022-01-07,10106,11160,-1054,-9.44,1184
2022-01-08,7426,7883,-457,-5.8,1184
2022-01-09,5211,6144,-933,-15.19,1184
2022-01-10,9829,10620,-791,-7.45,1184
2022-01-11,9882,10802,-920,-8.52,1184
2022-01-12,9882,10788,-906,-8.4,1184
2022-01-13,9882,10774,-892,-8.28,1184
2022-01-14,10106,11028,-922,-8.36,1184
2022-01-15,7426,7785,-359,-4.61,1184
2022-01-16,5211,6078,-867,-14.26,1184
2022-01-17,9829,10587,-758,-7.16,1184
2022-01-18,9882,10800,-918,-8.5,1184
2022-01-19,9882,10815,-933,-8.63,1184
2022-01-20,9882,10827,-945,-8.73,1184
2022-01-21,10106,11104,-998,-8.99,1184
2022-01-22,7426,7880,-454,-5.76,1184
2022-01-23,5211,6190,-979,-15.82,1184
2022-01-24,9829,10712,-883,-8.24,1184
2022-01-25,9882,10933,-1051,-9.61,1184
2022-01-26,9882,10953,-1071,-9.78,1184
2022-01-27,9882,10968,-1086,-9.9,1184
2022-01-28,10106,11243,-1137,-10.11,1184
2022-01-29,7426,8016,-590,-7.36,1184
2022-01-30,5211,6320,-1109,-17.55,1184
2020-02-01,6410,5558,852,15.33,1218
2020-02-02,5313,4597,716,15.58,1218
2020-02-03,9122,9074,48,0.53,1218
2020-02-04,9356,9433,-77,-0.82,1218
2020-02-05,9356,9471,-115,-1.21,1218
2020-02-06,9356,9493,-137,-1.44,1218
2020-02-07,9399,9424,-25,-0.27,1218
2020-02-08,6410,5648,762,13.49,1218
2020-02-09,5313,4660,653,14.01,1218
2020-02-10,9122,9113,9,0.1,1218
2020-02-11,9356,9455,-99,-1.05,1218
2020-02-12,9356,9481,-125,-1.32,1218
2020-02-13,9356,9498,-142,-1.5,1218
2020-02-14,9399,9431,-32,-0.34,1218
2020-02-15,6410,5664,746,13.17,1218
2020-02-16,5313,4691,622,13.26,1218
2020-02-17,9122,9167,-45,-0.49,1218
2020-02-18,9356,9538,-182,-1.91,1218
2020-02-19,9356,9598,-242,-2.52,1218
2020-02-20,9356,9654,-298,-3.09,1218
2020-02-21,9399,9630,-231,-2.4,1218
2020-02-22,6410,5908,502,8.5,1218
2020-02-23,5313,4982,331,6.64,1218
2020-02-24,9122,9504,-382,-4.02,1218
2020-02-25,9356,9920,-564,-5.69,1218
2020-02-26,9356,10022,-666,-6.65,1218
2020-02-27,9356,10116,-760,-7.51,1218
2020-02-28,9399,10125,-726,-7.17,1218
2020-02-29,6410,6430,-20,-0.31,1218
2020-03-01,3569,5524,-1955,-35.39,1218
2020-03-02,6460,10059,-3599,-35.78,1218
2020-03-03,6528,10480,-3952,-37.71,1218
2020-03-04,6528,10579,-4051,-38.29,1218
2020-03-05,6528,10662,-4134,-38.77,1218
2020-03-06,6724,10652,-3928,-36.88,1218
2020-03-07,4151,6930,-2779,-40.1,1218
2020-03-08,3569,5992,-2423,-40.44,1218
2020-03-09,6460,10489,-4029,-38.41,1218
2020-03-10,6528,10866,-4338,-39.92,1218
2020-03-11,6528,10919,-4391,-40.21,1218
2020-03-12,6528,10954,-4426,-40.41,1218
2020-03-13,6724,10896,-4172,-38.29,1218
2020-03-14,4151,7127,-2976,-41.76,1218
2020-03-15,3569,6144,-2575,-41.91,1218
2020-03-16,6460,10600,-4140,-39.06,1218
2020-03-17,6528,10942,-4414,-40.34,1218
2020-03-18,6528,10966,-4438,-40.47,1218
2020-03-19,6528,10979,-4451,-40.54,1218
2020-03-20,6724,10907,-4183,-38.35,1218
2020-03-21,4151,7134,-2983,-41.81,1218
2020-03-22,3569,6155,-2586,-42.01,1218
2020-03-23,6460,10625,-4165,-39.2,1218
2020-03-24,6528,10989,-4461,-40.6,1218
2020-03-25,6528,11045,-4517,-40.9,1218
2020-03-26,6528,11096,-4568,-41.17,1218
2020-03-27,6724,11070,-4346,-39.26,1218
2020-03-28,4151,7348,-3197,-43.51,1218
2020-03-29,3569,6425,-2856,-44.45,1218
2020-03-30,6460,10953,-4493,-41.02,1218
2020-03-31,6528,11376,-4848,-42.62,1218
2020-04-01,5317,11489,-6172,-53.72,1218
2020-04-02,5317,11597,-6280,-54.15,1218
2020-04-03,5079,11621,-6542,-56.29,1218
2020-04-04,3718,7944,-4226,-53.2,1218
2020-04-05,2632,7057,-4425,-62.7,1218
2020-04-06,5279,11612,-6333,-54.54,1218
2020-04-07,5317,12052,-6735,-55.88,1218
2020-04-08,5317,12170,-6853,-56.31,1218
2020-04-09,5317,12269,-6952,-56.66,1218
2020-04-10,5079,12272,-7193,-58.61,1218
2020-04-11,3718,8560,-4842,-56.57,1218
2020-04-12,2632,7625,-4993,-65.48,1218
2020-04-13,5279,12119,-6840,-56.44,1218
2020-04-14,5317,12485,-7168,-57.41,1218
2020-04-15,5317,12518,-7201,-57.53,1218
2020-04-16,5317,12522,-7205,-57.54,1218
2020-04-17,5079,12422,-7343,-59.11,1218
2020-04-18,3718,8600,-4882,-56.77,1218
2020-04-19,2632,7549,-4917,-65.13,1218
2020-04-20,5279,11924,-6645,-55.73,1218
2020-04-21,5317,12171,-6854,-56.31,1218
2020-04-22,5317,12085,-6768,-56.0,1218
2020-04-23,5317,11974,-6657,-55.6,1218
2020-04-24,5079,11764,-6685,-56.83,1218
2020-04-25,3718,7839,-4121,-52.57,1218
2020-04-26,2632,6695,-4063,-60.69,1218
2020-04-27,5279,10987,-5708,-51.95,1218
2020-04-28,5317,11163,-5846,-52.37,1218
2020-04-29,5317,11020,-5703,-51.75,1218
2020-04-30,5317,10865,-5548,-51.06,1218
2020-05-01,7852,10626,-2774,-26.11,1218
2020-05-02,5586,6687,-1101,-16.46,1218
2020-05-03,4467,5544,-1077,-19.43,1218
2020-05-04,7760,9851,-2091,-21.23,1218
2020-05-05,8090,10057,-1967,-19.56,1218
2020-05-06,8090,9957,-1867,-18.75,1218
2020-05-07,8090,9857,-1767,-17.93,1218
2020-05-08,7852,9684,-1832,-18.92,1218
2020-05-09,5586,5820,-234,-4.02,1218
2020-05-10,4467,4761,-294,-6.18,1218
2020-05-11,7760,9157,-1397,-15.26,1218
2020-05-12,8090,9456,-1366,-14.45,1218
2020-05-13,8090,9452,-1362,-14.41,1218
2020-05-14,8090,9449,-1359,-14.38,1218
2020-05-15,7852,9371,-1519,-16.21,1218
2020-05-16,5586,5601,-15,-0.27,1218
2020-05-17,4467,4630,-163,-3.52,1218
2020-05-18,7760,9111,-1351,-14.83,1218
2020-05-19,8090,9488,-1398,-14.73,1218
2020-05-20,8090,9554,-1464,-15.32,1218
2020-05-21,8090,9614,-1524,-15.85,1218
2020-05-22,7852,9592,-1740,-18.14,1218
2020-05-23,5586,5867,-281,-4.79,1218
2020-05-24,4467,4934,-467,-9.46,1218
2020-05-25,7760,9444,-1684,-17.83,1218
2020-05-26,8090,9841,-1751,-17.79,1218
2020-05-27,8090,9921,-1831,-18.46,1218
2020-05-28,8090,9987,-1897,-18.99,1218
2020-05-29,7852,9963,-2111,-21.19,1218
2020-05-30,5586,6233,-647,-10.38,1218
2020-05-31,4467,5288,-821,-15.53,1218
2020-06-01,9246,9783,-537,-5.49,1218
2020-06-02,9557,10163,-606,-5.96,1218
2020-06-03,9557,10222,-665,-6.51,1218
2020-06-04,9557,10266,-709,-6.91,1218
2020-06-05,9128,10221,-1093,-10.69,1218
2020-06-06,6428,6467,-39,-0.6,1218
2020-06-07,5458,5501,-43,-0.78,1218
2020-06-08,9246,9974,-728,-7.3,1218
2020-06-09,9557,10334,-777,-7.52,1218
2020-06-10,9557,10374,-817,-7.88,1218
2020-06-11,9557,10400,-843,-8.11,1218
2020-06-12,9128,10338,-1210,-11.7,1218
2020-06-13,6428,6569,-141,-2.15,1218
2020-06-14,5458,5588,-130,-2.33,1218
2020-06-15,9246,10048,-802,-7.98,1218
2020-06-16,9557,10394,-837,-8.05,1218
2020-06-17,9557,10421,-864,-8.29,1218
2020-06-18,9557,10434,-877,-8.41,1218
2020-06-19,9128,10357,-1229,-11.87,1218
2020-06-20,6428,6574,-146,-2.22,1218
2020-06-21,5458,5577,-119,-2.13,1218
2020-06-22,9246,10019,-773,-7.72,1218
2020-06-23,9557,10347,-790,-7.64,1218
2020-06-24,9557,10354,-797,-7.7,1218
2020-06-25,9557,10347,-790,-7.64,1218
2020-06-26,9128,10249,-1121,-10.94,1218
2020-06-27,6428,6443,-15,-0.23,1218
2020-06-28,5458,5424,34,0.63,1218
2020-06-29,9246,9844,-598,-6.07,1218
2020-06-30,9557,10150,-593,-5.84,1218
2020-07-01,9858,10136,-278,-2.74,1218
2020-07-02,9858,10109,-251,-2.48,1218
2020-07-03,9607,9995,-388,-3.88,1218
2020-07-04,6441,6174,267,4.32,1218
2020-07-05,5896,5144,752,14.62,1218
2020-07-06,9498,9556,-58,-0.61,1218
2020-07-07,9858,9858,0,0.0,1218
2020-07-08,9858,9845,13,0.13,1218
2020-07-09,9858,9823,35,0.36,1218
2020-07-10,9607,9718,-111,-1.14,1218
2020-07-11,6441,5911,530,8.97,1218
2020-07-12,5896,4898,998,20.38,1218
2020-07-13,9498,9332,166,1.78,1218
2020-07-14,9858,9659,199,2.06,1218
2020-07-15,9858,9674,184,1.9,1218
2020-07-16,9858,9682,176,1.82,1218
2020-07-17,9607,9609,-2,-0.02,1218
2020-07-18,6441,5835,606,10.39,1218
2020-07-19,5896,4855,1041,21.44,1218
2020-07-20,9498,9322,176,1.89,1218
2020-07-21,9858,9680,178,1.84,1218
2020-07-22,9858,9724,134,1.38,1218
2020-07-23,9858,9758,100,1.02,1218
2020-07-24,9607,9707,-100,-1.03,1218
2020-07-25,6441,5951,490,8.23,1218
2020-07-26,5896,4986,910,18.25,1218
2020-07-27,9498,9462,36,0.38,1218
2020-07-28,9858,9824,34,0.35,1218
2020-07-29,9858,9867,-9,-0.09,1218
2020-07-30,9858,9896,-38,-0.38,1218
2020-07-31,9607,9834,-227,-2.31,1218
2020-08-01,7350,6065,1285,21.19,1218
2020-08-02,6628,5081,1547,30.45,1218
2020-08-03,10405,9535,870,9.12,1218
2020-08-04,11167,9874,1293,13.09,1218
2020-08-05,11167,9893,1274,12.88,1218
2020-08-06,11167,9895,1272,12.85,1218
2020-08-07,10895,9809,1086,11.07,1218
2020-08-08,7350,6015,1335,22.19,1218
2020-08-09,6628,5009,1619,32.32,1218
2020-08-10,10405,9444,961,10.18,1218
2020-08-11,11167,9767,1400,14.33,1218
2020-08-12,11167,9774,1393,14.25,1218
2020-08-13,11167,9770,1397,14.3,1218
2020-08-14,10895,9682,1213,12.53,1218
2020-08-15,7350,5893,1457,24.72,1218
2020-08-16,6628,4897,1731,35.35,1218
2020-08-17,10405,9347,1058,11.32,1218
2020-08-18,11167,9692,1475,15.22,1218
2020-08-19,11167,9725,1442,14.83,1218
2020-08-20,11167,9752,1415,14.51,1218
2020-08-21,10895,9698,1197,12.34,1218
2020-08-22,7350,5947,1403,23.59,1218
2020-08-23,6628,4991,1637,32.8,1218
2020-08-24,10405,9483,922,9.72,1218
2020-08-25,11167,9870,1297,13.14,1218
2020-08-26,11167,9944,1223,12.3,1218
2020-08-27,11167,10011,1156,11.55,1218
2020-08-28,10895,9995,900,9.0,1218
2020-08-29,7350,6277,1073,17.09,1218
2020-08-30,6628,5351,1277,23.86,1218
2020-08-31,10405,9869,536,5.43,1218
2020-09-01,10466,10275,191,1.86,1218
2020-09-02,10466,10362,104,1.0,1218
2020-09-03,10466,10437,29,0.28,1218
2020-09-04,10085,10422,-337,-3.23,1218
2020-09-05,7302,6699,603,9.0,1218
2020-09-06,6186,5761,425,7.38,1218
2020-09-07,9964,10261,-297,-2.89,1218
2020-09-08,10466,10644,-178,-1.67,1218
2020-09-09,10466,10705,-239,-2.23,1218
2020-09-10,10466,10749,-283,-2.63,1218
2020-09-11,10085,10700,-615,-5.75,1218
2020-09-12,7302,6941,361,5.2,1218
2020-09-13,6186,5966,220,3.69,1218
2020-09-14,9964,10429,-465,-4.46,1218
2020-09-15,10466,10775,-309,-2.87,1218
2020-09-16,10466,10801,-335,-3.1,1218
2020-09-17,10466,10812,-346,-3.2,1218
2020-09-18,10085,10735,-650,-6.05,1218
2020-09-19,7302,6950,352,5.06,1218
2020-09-20,6186,5955,231,3.88,1218
2020-09-21,9964,10402,-438,-4.21,1218
2020-09-22,10466,10738,-272,-2.53,1218
2020-09-23,10466,10758,-292,-2.71,1218
2020-09-24,10466,10769,-303,-2.81,1218
2020-09-25,10085,10695,-610,-5.7,1218
2020-09-26,7302,6919,383,5.54,1218
2020-09-27,6186,5937,249,4.19,1218
2020-09-28,9964,10400,-436,-4.19,1218
2020-09-29,10466,10754,-288,-2.68,1218
2020-09-30,10466,10795,-329,-3.05,1218
2020-10-01,9603,10827,-1224,-11.31,1218
2020-10-02,9463,10776,-1313,-12.18,1218
2020-10-03,6660,7022,-362,-5.16,1218
2020-10-04,5433,6059,-626,-10.33,1218
2020-10-05,9363,10541,-1178,-11.18,1218
2020-10-06,9603,10911,-1308,-11.99,1218
2020-10-07,9603,10964,-1361,-12.41,1218
2020-10-08,9603,11005,-1402,-12.74,1218
2020-10-09,9463,10957,-1494,-13.64,1218
2020-10-10,6660,7203,-543,-7.54,1218
2020-10-11,5433,6237,-804,-12.89,1218
2020-10-12,9363,10710,-1347,-12.58,1218
2020-10-13,9603,11068,-1465,-13.24,1218
2020-10-14,9603,11105,-1502,-13.53,1218
2020-10-15,9603,11127,-1524,-13.7,1218
2020-10-16,9463,11058,-1595,-14.42,1218
2020-10-17,6660,7281,-621,-8.53,1218
2020-10-18,5433,6290,-857,-13.62,1218
2020-10-19,9363,10738,-1375,-12.8,1218
2020-10-20,9603,11071,-1468,-13.26,1218
2020-10-21,9603,11085,-1482,-13.37,1218
2020-10-22,9603,11085,-1482,-13.37,1218
2020-10-23,9463,10997,-1534,-13.95,1218
2020-10-24,6660,7204,-544,-7.55,1218
2020-10-25,5433,6200,-767,-12.37,1218
2020-10-26,9363,10639,-1276,-11.99,1218
2020-10-27,9603,10968,-1365,-12.45,1218
2020-10-28,9603,10981,-1378,-12.55,1218
2020-10-29,9603,10984,-1381,-12.57,1218
2020-10-30,9463,10904,-1441,-13.22,1218
2020-10-31,6660,7121,-461,-6.47,1218
2020-11-01,4216,6132,-1916,-31.25,1218
2020-11-02,7809,10587,-2778,-26.24,1218
2020-11-03,7227,10935,-3708,-33.91,1218
2020-11-04,7227,10968,-3741,-34.11,1218
2020-11-05,7227,10992,-3765,-34.25,1218
2020-11-06,7824,10932,-3108,-28.43,1218
2020-11-07,5035,7169,-2134,-29.77,1218
2020-11-08,4216,6197,-1981,-31.97,1218
2020-11-09,7809,10668,-2859,-26.8,1218
2020-11-10,7227,11027,-3800,-34.46,1218
2020-11-11,7227,11068,-3841,-34.7,1218
2020-11-12,7227,11097,-3870,-34.87,1218
2020-11-13,7824,11036,-3212,-29.1,1218
2020-11-14,5035,7268,-2233,-30.72,1218
2020-11-15,4216,6287,-2071,-32.94,1218
2020-11-16,7809,10744,-2935,-27.32,1218
2020-11-17,7227,11085,-3858,-34.8,1218
2020-11-18,7227,11105,-3878,-34.92,1218
2020-11-19,7227,11107,-3880,-34.93,1218
2020-11-20,7824,11019,-3195,-29.0,1218
2020-11-21,5035,7221,-2186,-30.27,1218
2020-11-22,4216,6208,-1992,-32.09,1218
2020-11-23,7809,10633,-2824,-26.56,1218
2020-11-24,7227,10943,-3716,-33.96,1218
2020-11-25,7227,10933,-3706,-33.9,1218
2020-11-26,7227,10908,-3681,-33.75,1218
2020-11-27,7824,10795,-2971,-27.52,1218
2020-11-28,5035,6975,-1940,-27.81,1218
2020-11-29,4216,5946,-1730,-29.1,1218
2020-11-30,7809,10359,-2550,-24.62,1218
2020-12-01,7095,10661,-3566,-33.45,1218
2020-12-02,7095,10648,-3553,-33.37,1218
2020-12-03,7095,10626,-3531,-33.23,1218
2020-12-04,8253,10520,-2267,-21.55,1218
2020-12-05,5366,6714,-1348,-20.08,1218
2020-12-06,3813,5700,-1887,-33.11,1218
2020-12-07,7002,10133,-3131,-30.9,1218
2020-12-08,7095,10459,-3364,-32.16,1218
2020-12-09,7095,10471,-3376,-32.24,1218
2020-12-10,7095,10476,-3381,-32.27,1218
2020-12-11,8253,10397,-2144,-20.62,1218
2020-12-12,5366,6616,-1250,-18.89,1218
2020-12-13,3813,5627,-1814,-32.24,1218
2020-12-14,7002,10082,-3080,-30.55,1218
2020-12-15,7095,10426,-3331,-31.95,1218
2020-12-16,7095,10453,-3358,-32.12,1218
2020-12-17,7095,10467,-3372,-32.22,1218
2020-12-18,8253,10393,-2140,-20.59,1218
2020-12-19,5366,6611,-1245,-18.83,1218
2020-12-20,3813,5616,-1803,-32.1,1218
2020-12-21,7002,10058,-3056,-30.38,1218
2020-12-22,7095,10384,-3289,-31.67,1218
2020-12-23,7095,10388,-3293,-31.7,1218
2020-12-24,7095,10374,-3279,-31.61,1218
2020-12-25,8253,10268,-2015,-19.62,1218
2020-12-26,5366,6452,-1086,-16.83,1218
2020-12-27,3813,5419,-1606,-29.64,1218
2020-12-28,7002,9824,-2822,-28.73,1218
2020-12-29,7095,10112,-3017,-29.84,1218
2020-12-30,7095,10079,-2984,-29.61,1218
2020-12-31,7095,10030,-2935,-29.26,1218
2021-01-01,7236,9893,-2657,-26.86,1218
2021-01-02,4895,6050,-1155,-19.09,1218
2021-01-03,3906,4996,-1090,-21.82,1218
2021-01-04,6721,9385,-2664,-28.39,1218
2021-01-05,7227,9664,-2437,-25.22,1218
2021-01-06,7227,9630,-2403,-24.95,1218
2021-01-07,7227,9588,-2361,-24.62,1218
2021-01-08,7236,9465,-2229,-23.55,1218
2021-01-09,4895,5644,-749,-13.27,1218
2021-01-10,3906,4619,-713,-15.44,1218
2021-01-11,6721,9044,-2323,-25.69,1218
2021-01-12,7227,9366,-2139,-22.84,1218
2021-01-13,7227,9380,-2153,-22.95,1218
2021-01-14,7227,9390,-2163,-23.04,1218
2021-01-15,7236,9323,-2087,-22.39,1218
2021-01-16,4895,5559,-664,-11.94,1218
2021-01-17,3906,4592,-686,-14.94,1218
2021-01-18,6721,9076,-2355,-25.95,1218
2021-01-19,7227,9454,-2227,-23.56,1218
2021-01-20,7227,9521,-2294,-24.09,1218
2021-01-21,7227,9580,-2353,-24.56,1218
2021-01-22,7236,9557,-2321,-24.29,1218
2021-01-23,4895,5831,-936,-16.05,1218
2021-01-24,3906,4896,-990,-20.22,1218
2021-01-25,6721,9403,-2682,-28.52,1218
2021-01-26,7227,9798,-2571,-26.24,1218
2021-01-27,7227,9873,-2646,-26.8,1218
2021-01-28,7227,9934,-2707,-27.25,1218
2021-01-29,7236,9904,-2668,-26.94,1218
2021-01-30,4895,6165,-1270,-20.6,1218
2021-01-31,3906,5211,-1305,-25.04,1218
2021-02-01,8076,9694,-1618,-16.69,1218
2021-02-02,8481,10060,-1579,-15.7,1218
2021-02-03,8481,10104,-1623,-16.06,1218
2021-02-04,8481,10131,-1650,-16.29,1218
2021-02-05,8507,10068,-1561,-15.5,1218
2021-02-06,5792,6295,-503,-7.99,1218
2021-02-07,4595,5309,-714,-13.45,1218
2021-02-08,8076,9764,-1688,-17.29,1218
2021-02-09,8481,10106,-1625,-16.08,1218
2021-02-10,8481,10130,-1649,-16.28,1218
2021-02-11,8481,10144,-1663,-16.39,1218
2021-02-12,8507,10073,-1566,-15.55,1218
2021-02-13,5792,6300,-508,-8.06,1218
2021-02-14,4595,5322,-727,-13.66,1218
2021-02-15,8076,9791,-1715,-17.52,1218
2021-02-16,8481,10153,-1672,-16.47,1218
2021-02-17,8481,10205,-1724,-16.89,1218
2021-02-18,8481,10252,-1771,-17.27,1218
2021-02-19,8507,10219,-1712,-16.75,1218
2021-02-20,5792,6489,-697,-10.74,1218
2021-02-21,4595,5555,-960,-17.28,1218
2021-02-22,8076,10069,-1993,-19.79,1218
2021-02-23,8481,10478,-1997,-19.06,1218
2021-02-24,8481,10576,-2095,-19.81,1218
2021-02-25,8481,10665,-2184,-20.48,1218
2021-02-26,8507,10672,-2165,-20.29,1218
2021-02-27,5792,6976,-1184,-16.97,1218
2021-02-28,4595,6071,-1476,-24.31,1218
2021-03-01,8604,10607,-2003,-18.88,1218
2021-03-02,8916,11031,-2115,-19.17,1218
2021-03-03,8916,11135,-2219,-19.93,1218
2021-03-04,8916,11224,-2308,-20.56,1218
2021-03-05,8712,11221,-2509,-22.36,1218
2021-03-06,6304,7508,-1204,-16.04,1218
2021-03-07,4729,6578,-1849,-28.11,1218
2021-03-08,8604,11084,-2480,-22.37,1218
2021-03-09,8916,11471,-2555,-22.27,1218
2021-03-10,8916,11533,-2617,-22.69,1218
2021-03-11,8916,11576,-2660,-22.98,1218
2021-03-12,8712,11526,-2814,-24.41,1218
2021-03-13,6304,7764,-1460,-18.8,1218
2021-03-14,4729,6787,-2058,-30.32,1218
2021-03-15,8604,11247,-2643,-23.5,1218
2021-03-16,8916,11592,-2676,-23.08,1218
2021-03-17,8916,11617,-2701,-23.25,1218
2021-03-18,8916,11629,-2713,-23.33,1218
2021-03-19,8712,11555,-2843,-24.6,1218
2021-03-20,6304,7778,-1474,-18.95,1218
2021-03-21,4729,6794,-2065,-30.39,1218
2021-03-22,8604,11256,-2652,-23.56,1218
2021-03-23,8916,11612,-2696,-23.22,1218
2021-03-24,8916,11658,-2742,-23.52,1218
2021-03-25,8916,11699,-2783,-23.79,1218
2021-03-26,8712,11662,-2950,-25.3,1218
2021-03-27,6304,7929,-1625,-20.49,1218
2021-03-28,4729,6995,-2266,-32.39,1218
2021-03-29,8604,11512,-2908,-25.26,1218
2021-03-30,8916,11925,-3009,-25.23,1218
2021-03-31,8916,12030,-3114,-25.89,1218
2021-04-01,8086,12130,-4044,-33.34,1218
2021-04-02,8194,12149,-3955,-32.55,1218
2021-04-03,5754,8468,-2714,-32.05,1218
2021-04-04,4711,7580,-2869,-37.85,1218
2021-04-05,8087,12135,-4048,-33.36,1218
2021-04-06,8086,12579,-4493,-35.72,1218
2021-04-07,8086,12703,-4617,-36.35,1218
2021-04-08,8086,12810,-4724,-36.88,1218
2021-04-09,8194,12824,-4630,-36.1,1218
2021-04-10,5754,9125,-3371,-36.94,1218
2021-04-11,4711,8206,-3495,-42.59,1218
2021-04-12,8087,12717,-4630,-36.41,1218
2021-04-13,8086,13102,-5016,-38.28,1218
2021-04-14,8086,13155,-5069,-38.53,1218
2021-04-15,8086,13181,-5095,-38.65,1218
2021-04-16,8194,13103,-4909,-37.46,1218
2021-04-17,5754,9302,-3548,-38.14,1218
2021-04-18,4711,8274,-3563,-43.06,1218
2021-04-19,8087,12670,-4583,-36.17,1218
2021-04-20,8086,12937,-4851,-37.5,1218
2021-04-21,8086,12871,-4785,-37.18,1218
2021-04-22,8086,12777,-4691,-36.71,1218
2021-04-23,8194,12583,-4389,-34.88,1218
2021-04-24,5754,8671,-2917,-33.64,1218
2021-04-25,4711,7538,-2827,-37.5,1218
2021-04-26,8087,11838,-3751,-31.69,1218
2021-04-27,8086,12020,-3934,-32.73,1218
2021-04-28,8086,11879,-3793,-31.93,1218
2021-04-29,8086,11725,-3639,-31.04,1218
2021-04-30,8194,11483,-3289,-28.64,1218
2021-05-01,6686,7539,-853,-11.31,1218
2021-05-02,5182,6388,-1206,-18.88,1218
2021-05-03,9342,10686,-1344,-12.58,1218
2021-05-04,9753,10879,-1126,-10.35,1218
2021-05-05,9753,10765,-1012,-9.4,1218
2021-05-06,9753,10650,-897,-8.42,1218
2021-05-07,9497,10461,-964,-9.22,1218
2021-05-08,6686,6580,106,1.61,1218
2021-05-09,5182,5502,-320,-5.82,1218
2021-05-10,9342,9881,-539,-5.45,1218
2021-05-11,9753,10162,-409,-4.02,1218
2021-05-12,9753,10140,-387,-3.82,1218
2021-05-13,9753,10121,-368,-3.64,1218
2021-05-14,9497,10028,-531,-5.3,1218
2021-05-15,6686,6243,443,7.1,1218
2021-05-16,5182,5259,-77,-1.46,1218
2021-05-17,9342,9728,-386,-3.97,1218
2021-05-18,9753,10095,-342,-3.39,1218
2021-05-19,9753,10154,-401,-3.95,1218
2021-05-20,9753,10207,-454,-4.45,1218
2021-05-21,9497,10179,-682,-6.7,1218
2021-05-22,6686,6450,236,3.66,1218
2021-05-23,5182,5515,-333,-6.04,1218
2021-05-24,9342,10024,-682,-6.8,1218
2021-05-25,9753,10422,-669,-6.42,1218
2021-05-26,9753,10502,-749,-7.13,1218
2021-05-27,9753,10570,-817,-7.73,1218
2021-05-28,9497,10550,-1053,-9.98,1218
2021-05-29,6686,6823,-137,-2.01,1218
2021-05-30,5182,5882,-700,-11.9,1218
2021-05-31,9342,10381,-1039,-10.01,1218
2021-06-01,10483,10765,-282,-2.62,1218
2021-06-02,10483,10829,-346,-3.2,1218
2021-06-03,10483,10877,-394,-3.62,1218
2021-06-04,10011,10835,-824,-7.6,1218
2021-06-05,7280,7086,194,2.74,1218
2021-06-06,6509,6123,386,6.3,1218
2021-06-07,10398,10599,-201,-1.9,1218
2021-06-08,10483,10962,-479,-4.37,1218
2021-06-09,10483,11005,-522,-4.74,1218
2021-06-10,10483,11033,-550,-4.99,1218
2021-06-11,10011,10974,-963,-8.78,1218
2021-06-12,7280,7207,73,1.01,1218
2021-06-13,6509,6229,280,4.5,1218
2021-06-14,10398,10690,-292,-2.73,1218
2021-06-15,10483,11039,-556,-5.04,1218
2021-06-16,10483,11068,-585,-5.29,1218
2021-06-17,10483,11084,-601,-5.42,1218
2021-06-18,10011,11010,-999,-9.07,1218
2021-06-19,7280,7230,50,0.69,1218
2021-06-20,6509,6237,272,4.36,1218
2021-06-21,10398,10683,-285,-2.67,1218
2021-06-22,10483,11015,-532,-4.83,1218
2021-06-23,10483,11026,-543,-4.92,1218
2021-06-24,10483,11022,-539,-4.89,1218
2021-06-25,10011,10929,-918,-8.4,1218
2021-06-26,7280,7127,153,2.15,1218
2021-06-27,6509,6112,397,6.5,1218
2021-06-28,10398,10535,-137,-1.3,1218
2021-06-29,10483,10845,-362,-3.34,1218
2021-06-30,10483,10834,-351,-3.24,1218
2021-07-01,9904,10809,-905,-8.37,1218
2021-07-02,9829,10696,-867,-8.11,1218
2021-07-03,6684,6877,-193,-2.81,1218
2021-07-04,5800,5846,-46,-0.79,1218
2021-07-05,9384,10258,-874,-8.52,1218
2021-07-06,9904,10559,-655,-6.2,1218
2021-07-07,9904,10543,-639,-6.06,1218
2021-07-08,9904,10518,-614,-5.84,1218
2021-07-09,9829,10408,-579,-5.56,1218
2021-07-10,6684,6597,87,1.32,1218
2021-07-11,5800,5579,221,3.96,1218
2021-07-12,9384,10007,-623,-6.23,1218
2021-07-13,9904,10329,-425,-4.11,1218
2021-07-14,9904,10337,-433,-4.19,1218
2021-07-15,9904,10339,-435,-4.21,1218
2021-07-16,9829,10259,-430,-4.19,1218
2021-07-17,6684,6480,204,3.15,1218
2021-07-18,5800,5495,305,5.55,1218
2021-07-19,9384,9956,-572,-5.75,1218
2021-07-20,9904,10310,-406,-3.94,1218
2021-07-21,9904,10350,-446,-4.31,1218
2021-07-22,9904,10382,-478,-4.6,1218
2021-07-23,9829,10329,-500,-4.84,1218
2021-07-24,6684,6573,111,1.69,1218
2021-07-25,5800,5607,193,3.44,1218
2021-07-26,9384,10084,-700,-6.94,1218
2021-07-27,9904,10448,-544,-5.21,1218
2021-07-28,9904,10494,-590,-5.62,1218
2021-07-29,9904,10526,-622,-5.91,1218
2021-07-30,9829,10469,-640,-6.11,1218
2021-07-31,6684,6703,-19,-0.28,1218
2021-08-01,6051,5724,327,5.71,1218
2021-08-02,8912,10184,-1272,-12.49,1218
2021-08-03,9144,10528,-1384,-13.15,1218
2021-08-04,9144,10551,-1407,-13.34,1218
2021-08-05,9144,10558,-1414,-13.39,1218
2021-08-06,8963,10475,-1512,-14.43,1218
2021-08-07,6755,6684,71,1.06,1218
2021-08-08,6051,5680,371,6.53,1218
2021-08-09,8912,10117,-1205,-11.91,1218
2021-08-10,9144,10441,-1297,-12.42,1218
2021-08-11,9144,10447,-1303,-12.47,1218
2021-08-12,9144,10441,-1297,-12.42,1218
2021-08-13,8963,10351,-1388,-13.41,1218
2021-08-14,6755,6557,198,3.02,1218
2021-08-15,6051,5557,494,8.89,1218
2021-08-16,8912,10002,-1090,-10.9,1218
2021-08-17,9144,10340,-1196,-11.57,1218
2021-08-18,9144,10366,-1222,-11.79,1218
2021-08-19,9144,10385,-1241,-11.95,1218
2021-08-20,8963,10324,-1361,-13.18,1218
2021-08-21,6755,6564,191,2.91,1218
2021-08-22,6051,5601,450,8.03,1218
2021-08-23,8912,10086,-1174,-11.64,1218
2021-08-24,9144,10465,-1321,-12.62,1218
2021-08-25,9144,10533,-1389,-13.19,1218
2021-08-26,9144,10594,-1450,-13.69,1218
2021-08-27,8963,10574,-1611,-15.24,1218
2021-08-28,6755,6852,-97,-1.42,1218
2021-08-29,6051,5923,128,2.16,1218
2021-08-30,8912,10439,-1527,-14.63,1218
2021-08-31,9144,10845,-1701,-15.68,1218
2021-09-01,9884,10934,-1050,-9.6,1218
2021-09-02,9884,11010,-1126,-10.23,1218
2021-09-03,9724,10998,-1274,-11.58,1218
2021-09-04,7441,7279,162,2.23,1218
2021-09-05,6634,6347,287,4.52,1218
2021-09-06,9602,10852,-1250,-11.52,1218
2021-09-07,9884,11242,-1358,-12.08,1218
2021-09-08,9884,11310,-1426,-12.61,1218
2021-09-09,9884,11360,-1476,-12.99,1218
2021-09-10,9724,11318,-1594,-14.08,1218
2021-09-11,7441,7566,-125,-1.65,1218
2021-09-12,6634,6598,36,0.55,1218
2021-09-13,9602,11067,-1465,-13.24,1218
2021-09-14,9884,11419,-1535,-13.44,1218
2021-09-15,9884,11450,-1566,-13.68,1218
2021-09-16,9884,11465,-1581,-13.79,1218
2021-09-17,9724,11390,-1666,-14.63,1218
2021-09-18,7441,7608,-167,-2.2,1218
2021-09-19,6634,6613,21,0.32,1218
2021-09-20,9602,11060,-1458,-13.18,1218
2021-09-21,9884,11396,-1512,-13.27,1218
2021-09-22,9884,11414,-1530,-13.4,1218
2021-09-23,9884,11422,-1538,-13.47,1218
2021-09-24,9724,11345,-1621,-14.29,1218
2021-09-25,7441,7566,-125,-1.65,1218
2021-09-26,6634,6580,54,0.82,1218
2021-09-27,9602,11039,-1437,-13.02,1218
2021-09-28,9884,11389,-1505,-13.21,1218
2021-09-29,9884,11426,-1542,-13.5,1218
2021-09-30,9884,11454,-1570,-13.71,1218
2021-10-01,9841,11399,-1558,-13.67,1218
2021-10-02,7118,7642,-524,-6.86,1218
2021-10-03,5814,6677,-863,-12.92,1218
2021-10-04,8892,11156,-2264,-20.29,1218
2021-10-05,9611,11526,-1915,-16.61,1218
2021-10-06,9611,11579,-1968,-17.0,1218
2021-10-07,9611,11620,-2009,-17.29,1218
2021-10-08,9841,11574,-1733,-14.97,1218
2021-10-09,7118,7823,-705,-9.01,1218
2021-10-10,5814,6859,-1045,-15.24,1218
2021-10-11,8892,11335,-2443,-21.55,1218
2021-10-12,9611,11697,-2086,-17.83,1218
2021-10-13,9611,11739,-2128,-18.13,1218
2021-10-14,9611,11766,-2155,-18.32,1218
2021-10-15,9841,11702,-1861,-15.9,1218
2021-10-16,7118,7929,-811,-10.23,1218
2021-10-17,5814,6943,-1129,-16.26,1218
2021-10-18,8892,11395,-2503,-21.97,1218
2021-10-19,9611,11732,-2121,-18.08,1218
2021-10-20,9611,11749,-2138,-18.2,1218
2021-10-21,9611,11751,-2140,-18.21,1218
2021-10-22,9841,11665,-1824,-15.64,1218
2021-10-23,7118,7873,-755,-9.59,1218
2021-10-24,5814,6869,-1055,-15.36,1218
2021-10-25,8892,11308,-2416,-21.37,1218
2021-10-26,9611,11635,-2024,-17.4,1218
2021-10-27,9611,11646,-2035,-17.47,1218
2021-10-28,9611,11647,-2036,-17.48,1218
2021-10-29,9841,11563,-1722,-14.89,1218
2021-10-30,7118,7777,-659,-8.47,1218
2021-10-31,5814,6783,-969,-14.29,1218
2021-11-01,8037,11235,-3198,-28.46,1218
2021-11-02,8690,11579,-2889,-24.95,1218
2021-11-03,8690,11608,-2918,-25.14,1218
2021-11-04,8690,11629,-2939,-25.27,1218
2021-11-05,8980,11565,-2585,-22.35,1218
2021-11-06,6381,7800,-1419,-18.19,1218
2021-11-07,5135,6826,-1691,-24.77,1218
2021-11-08,8037,11296,-3259,-28.85,1218
2021-11-09,8690,11655,-2965,-25.44,1218
2021-11-10,8690,11698,-3008,-25.71,1218
2021-11-11,8690,11727,-3037,-25.9,1218
2021-11-12,8980,11670,-2690,-23.05,1218
2021-11-13,6381,7905,-1524,-19.28,1218
2021-11-14,5135,6928,-1793,-25.88,1218
2021-11-15,8037,11389,-3352,-29.43,1218
2021-11-16,8690,11736,-3046,-25.95,1218
2021-11-17,8690,11761,-3071,-26.11,1218
2021-11-18,8690,11769,-3079,-26.16,1218
2021-11-19,8980,11687,-2707,-23.16,1218
2021-11-20,6381,7895,-1514,-19.18,1218
2021-11-21,5135,6888,-1753,-25.45,1218
2021-11-22,8037,11318,-3281,-28.99,1218
2021-11-23,8690,11633,-2943,-25.3,1218
2021-11-24,8690,11627,-2937,-25.26,1218
2021-11-25,8690,11605,-2915,-25.12,1218
2021-11-26,8980,11494,-2514,-21.87,1218
2021-11-27,6381,7676,-1295,-16.87,1218
2021-11-28,5135,6647,-1512,-22.75,1218
2021-11-29,8037,11060,-3023,-27.33,1218
2021-11-30,8690,11361,-2671,-23.51,1218
2021-12-01,7411,11346,-3935,-34.68,1218
2021-12-02,7411,11320,-3909,-34.53,1218
2021-12-03,6849,11211,-4362,-38.91,1218
2021-12-04,4986,7400,-2414,-32.62,1218
2021-12-05,4298,6382,-2084,-32.65,1218
2021-12-06,7564,10810,-3246,-30.03,1218
2021-12-07,7411,11130,-3719,-33.41,1218
2021-12-08,7411,11138,-3727,-33.46,1218
2021-12-09,7411,11137,-3726,-33.46,1218
2021-12-10,6849,11054,-4205,-38.04,1218
2021-12-11,4986,7269,-2283,-31.41,1218
2021-12-12,4298,6278,-1980,-31.54,1218
2021-12-13,7564,10731,-3167,-29.51,1218
2021-12-14,7411,11074,-3663,-33.08,1218
2021-12-15,7411,11101,-3690,-33.24,1218
2021-12-16,7411,11116,-3705,-33.33,1218
2021-12-17,6849,11044,-4195,-37.98,1218
2021-12-18,4986,7265,-2279,-31.37,1218
2021-12-19,4298,6274,-1976,-31.5,1218
2021-12-20,7564,10721,-3157,-29.45,1218
2021-12-21,7411,11053,-3642,-32.95,1218
2021-12-22,7411,11064,-3653,-33.02,1218
2021-12-23,7411,11057,-3646,-32.97,1218
2021-12-24,6849,10958,-4109,-37.5,1218
2021-12-25,4986,7149,-2163,-30.26,1218
2021-12-26,4298,6123,-1825,-29.81,1218
2021-12-27,7564,10534,-2970,-28.19,1218
2021-12-28,7411,10829,-3418,-31.56,1218
2021-12-29,7411,10801,-3390,-31.39,1218
2021-12-30,7411,10757,-3346,-31.11,1218
2021-12-31,6849,10622,-3773,-35.52,1218
2022-01-01,5560,6781,-1221,-18.01,1218
2022-01-02,4229,5727,-1498,-26.16,1218
2022-01-03,6897,10116,-3219,-31.82,1218
2022-01-04,7691,10393,-2702,-26.0,1218
2022-01-05,7691,10355,-2664,-25.73,1218
2022-01-06,7691,10308,-2617,-25.39,1218
2022-01-07,7655,10178,-2523,-24.79,1218
2022-01-08,5560,6349,-789,-12.43,1218
2022-01-09,4229,5315,-1086,-20.43,1218
2022-01-10,6897,9731,-2834,-29.12,1218
2022-01-11,7691,10043,-2352,-23.42,1218
2022-01-12,7691,10046,-2355,-23.44,1218
2022-01-13,7691,10045,-2354,-23.43,1218
2022-01-14,7655,9967,-2312,-23.2,1218
2022-01-15,5560,6192,-632,-10.21,1218
2022-01-16,4229,5216,-987,-18.92,1218
2022-01-17,6897,9690,-2793,-28.82,1218
2022-01-18,7691,10060,-2369,-23.55,1218
2022-01-19,7691,10119,-2428,-23.99,1218
2022-01-20,7691,10173,-2482,-24.4,1218
2022-01-21,7655,10145,-2490,-24.54,1218
2022-01-22,5560,6416,-856,-13.34,1218
2022-01-23,4229,5479,-1250,-22.81,1218
2022-01-24,6897,9986,-3089,-30.93,1218
2022-01-25,7691,10382,-2691,-25.92,1218
2022-01-26,7691,10460,-2769,-26.47,1218
2022-01-27,7691,10524,-2833,-26.92,1218
2022-01-28,7655,10499,-2844,-27.09,1218
2022-01-29,5560,6765,-1205,-17.81,1218
2022-01-30,4229,5817,-1588,-27.3,1218
2020-02-01,28541,26666,1875,7.03,1221
2020-02-02,24742,23629,1113,4.71,1221
2020-02-03,30274,30307,-33,-0.11,1221
2020-02-04,30778,30728,50,0.16,1221
2020-02-05,30778,30752,26,0.08,1221
2020-02-06,30778,30770,8,0.03,1221
2020-02-07,32472,31885,587,1.84,1221
2020-02-08,28541,26998,1543,5.72,1221
2020-02-09,24742,23933,809,3.38,1221
2020-02-10,30274,30584,-310,-1.01,1221
2020-02-11,30778,30981,-203,-0.66,1221
2020-02-12,30778,30985,-207,-0.67,1221
2020-02-13,30778,30986,-208,-0.67,1221
2020-02-14,32472,32090,382,1.19,1221
2020-02-15,28541,27195,1346,4.95,1221
2020-02-16,24742,24128,614,2.54,1221
2020-02-17,30274,30782,-508,-1.65,1221
2020-02-18,30778,31187,-409,-1.31,1221
2020-02-19,30778,31203,-425,-1.36,1221
2020-02-20,30778,31220,-442,-1.42,1221
2020-02-21,32472,32343,129,0.4,1221
2020-02-22,28541,27471,1070,3.9,1221
2020-02-23,24742,24428,314,1.29,1221
2020-02-24,30274,31107,-833,-2.68,1221
2020-02-25,30778,31537,-759,-2.41,1221
2020-02-26,30778,31577,-799,-2.53,1221
2020-02-27,30778,31617,-839,-2.65,1221
2020-02-28,32472,32760,-288,-0.88,1221
2020-02-29,28541,27905,636,2.28,1221
2020-03-01,17697,24875,-7178,-28.86,1221
2020-03-02,23625,31563,-7938,-25.15,1221
2020-03-03,23595,31997,-8402,-26.26,1221
2020-03-04,23595,32037,-8442,-26.35,1221
2020-03-05,23595,32071,-8476,-26.43,1221
2020-03-06,25454,33203,-7749,-23.34,1221
2020-03-07,19540,28333,-8793,-31.03,1221
2020-03-08,17697,25282,-7585,-30.0,1221
2020-03-09,23625,31946,-8321,-26.05,1221
2020-03-10,23595,32352,-8757,-27.07,1221
2020-03-11,23595,32360,-8765,-27.09,1221
2020-03-12,23595,32360,-8765,-27.09,1221
2020-03-13,25454,33457,-8003,-23.92,1221
2020-03-14,19540,28549,-9009,-31.56,1221
2020-03-15,17697,25461,-7764,-30.49,1221
2020-03-16,23625,32088,-8463,-26.37,1221
2020-03-17,23595,32458,-8863,-27.31,1221
2020-03-18,23595,32431,-8836,-27.25,1221
2020-03-19,23595,32400,-8805,-27.18,1221
2020-03-20,25454,33467,-8013,-23.94,1221
2020-03-21,19540,28533,-8993,-31.52,1221
2020-03-22,17697,25422,-7725,-30.39,1221
2020-03-23,23625,32029,-8404,-26.24,1221
2020-03-24,23595,32384,-8789,-27.14,1221
2020-03-25,23595,32345,-8750,-27.05,1221
2020-03-26,23595,32305,-8710,-26.96,1221
2020-03-27,25454,33366,-7912,-23.71,1221
2020-03-28,19540,28430,-8890,-31.27,1221
2020-03-29,17697,25319,-7622,-30.1,1221
2020-03-30,23625,31929,-8304,-26.01,1221
2020-03-31,23595,32287,-8692,-26.92,1221
2020-04-01,23453,32254,-8801,-27.29,1221
2020-04-02,23453,32220,-8767,-27.21,1221
2020-04-03,22769,33288,-10519,-31.6,1221
2020-04-04,18291,28359,-10068,-35.5,1221
2020-04-05,14239,25255,-11016,-43.62,1221
2020-04-06,23577,31870,-8293,-26.02,1221
2020-04-07,23453,32234,-8781,-27.24,1221
2020-04-08,23453,32205,-8752,-27.18,1221
2020-04-09,23453,32174,-8721,-27.11,1221
2020-04-10,22769,33245,-10476,-31.51,1221
2020-04-11,18291,28316,-10025,-35.4,1221
2020-04-12,14239,25213,-10974,-43.53,1221
2020-04-13,23577,31827,-8250,-25.92,1221
2020-04-14,23453,32190,-8737,-27.14,1221
2020-04-15,23453,32160,-8707,-27.07,1221
2020-04-16,23453,32127,-8674,-27.0,1221
2020-04-17,22769,33196,-10427,-31.41,1221
2020-04-18,18291,28267,-9976,-35.29,1221
2020-04-19,14239,25162,-10923,-43.41,1221
2020-04-20,23577,31777,-8200,-25.8,1221
2020-04-21,23453,32140,-8687,-27.03,1221
2020-04-22,23453,32112,-8659,-26.96,1221
2020-04-23,23453,32082,-8629,-26.9,1221
2020-04-24,22769,33154,-10385,-31.32,1221
2020-04-25,18291,28229,-9938,-35.2,1221
2020-04-26,14239,25129,-10890,-43.34,1221
2020-04-27,23577,31749,-8172,-25.74,1221
2020-04-28,23453,32118,-8665,-26.98,1221
2020-04-29,23453,32095,-8642,-26.93,1221
2020-04-30,23453,32070,-8617,-26.87,1221
2020-05-01,29522,33147,-3625,-10.94,1221
2020-05-02,25424,28225,-2801,-9.92,1221
2020-05-03,21283,25128,-3845,-15.3,1221
2020-05-04,28764,31749,-2985,-9.4,1221
2020-05-05,28372,32117,-3745,-11.66,1221
2020-05-06,28372,32092,-3720,-11.59,1221
2020-05-07,28372,32063,-3691,-11.51,1221
2020-05-08,29522,33134,-3612,-10.9,1221
2020-05-09,25424,28206,-2782,-9.86,1221
2020-05-10,21283,25100,-3817,-15.21,1221
2020-05-11,28764,31713,-2949,-9.3,1221
2020-05-12,28372,32072,-3700,-11.54,1221
2020-05-13,28372,32038,-3666,-11.44,1221
2020-05-14,28372,32000,-3628,-11.34,1221
2020-05-15,29522,33065,-3543,-10.72,1221
2020-05-16,25424,28131,-2707,-9.62,1221
2020-05-17,21283,25023,-3740,-14.95,1221
2020-05-18,28764,31636,-2872,-9.08,1221
2020-05-19,28372,32000,-3628,-11.34,1221
2020-05-20,28372,31974,-3602,-11.27,1221
2020-05-21,28372,31950,-3578,-11.2,1221
2020-05-22,29522,33033,-3511,-10.63,1221
2020-05-23,25424,28123,-2699,-9.6,1221
2020-05-24,21283,25044,-3761,-15.02,1221
2020-05-25,28764,31690,-2926,-9.23,1221
2020-05-26,28372,32092,-3720,-11.59,1221
2020-05-27,28372,32109,-3737,-11.64,1221
2020-05-28,28372,32132,-3760,-11.7,1221
2020-05-29,29522,33264,-3742,-11.25,1221
2020-05-30,25424,28404,-2980,-10.49,1221
2020-05-31,21283,25377,-4094,-16.13,1221
2020-06-01,29933,32074,-2141,-6.68,1221
2020-06-02,30296,32524,-2228,-6.85,1221
2020-06-03,30296,32586,-2290,-7.03,1221
2020-06-04,30296,32649,-2353,-7.21,1221
2020-06-05,30766,33814,-3048,-9.01,1221
2020-06-06,27117,28980,-1863,-6.43,1221
2020-06-07,23103,25968,-2865,-11.03,1221
2020-06-08,29933,32671,-2738,-8.38,1221
2020-06-09,30296,33116,-2820,-8.52,1221
2020-06-10,30296,33159,-2863,-8.63,1221
2020-06-11,30296,33190,-2894,-8.72,1221
2020-06-12,30766,34311,-3545,-10.33,1221
2020-06-13,27117,29419,-2302,-7.82,1221
2020-06-14,23103,26336,-3233,-12.28,1221
2020-06-15,29933,32954,-3021,-9.17,1221
2020-06-16,30296,33303,-3007,-9.03,1221
2020-06-17,30296,33240,-2944,-8.86,1221
2020-06-18,30296,33155,-2859,-8.62,1221
2020-06-19,30766,34152,-3386,-9.91,1221
2020-06-20,27117,29131,-2014,-6.91,1221
2020-06-21,23103,25916,-2813,-10.85,1221
2020-06-22,29933,32401,-2468,-7.62,1221
2020-06-23,30296,32617,-2321,-7.12,1221
2020-06-24,30296,32426,-2130,-6.57,1221
2020-06-25,30296,32218,-1922,-5.97,1221
2020-06-26,30766,33101,-2335,-7.05,1221
2020-06-27,27117,27976,-859,-3.07,1221
2020-06-28,23103,24670,-1567,-6.35,1221
2020-06-29,29933,31078,-1145,-3.68,1221
2020-06-30,30296,31234,-938,-3.0,1221
2020-07-01,29755,30999,-1244,-4.01,1221
2020-07-02,29755,30766,-1011,-3.29,1221
2020-07-03,30970,31642,-672,-2.12,1221
2020-07-04,27374,26528,846,3.19,1221
2020-07-05,25585,23252,2333,10.03,1221
2020-07-06,29578,29708,-130,-0.44,1221
2020-07-07,29755,29928,-173,-0.58,1221
2020-07-08,29755,29771,-16,-0.05,1221
2020-07-09,29755,29631,124,0.42,1221
2020-07-10,30970,30610,360,1.18,1221
2020-07-11,27374,25608,1766,6.9,1221
2020-07-12,25585,22449,3136,13.97,1221
2020-07-13,29578,29026,552,1.9,1221
2020-07-14,29755,29367,388,1.32,1221
2020-07-15,29755,29330,425,1.45,1221
2020-07-16,29755,29303,452,1.54,1221
2020-07-17,30970,30389,581,1.91,1221
2020-07-18,27374,25484,1890,7.42,1221
2020-07-19,25585,22409,3176,14.17,1221
2020-07-20,29578,29057,521,1.79,1221
2020-07-21,29755,29452,303,1.03,1221
2020-07-22,29755,29454,301,1.02,1221
2020-07-23,29755,29449,306,1.04,1221
2020-07-24,30970,30538,432,1.41,1221
2020-07-25,27374,25621,1753,6.84,1221
2020-07-26,25585,22517,3068,13.63,1221
2020-07-27,29578,29121,457,1.57,1221
2020-07-28,29755,29460,295,1.0,1221
2020-07-29,29755,29393,362,1.23,1221
2020-07-30,29755,29310,445,1.52,1221
2020-07-31,30970,30316,654,2.16,1221
2020-08-01,25978,25310,668,2.64,1221
2020-08-02,23220,22118,1102,4.98,1221
2020-08-03,27905,28635,-730,-2.55,1221
2020-08-04,27656,28891,-1235,-4.27,1221
2020-08-05,27656,28750,-1094,-3.81,1221
2020-08-06,27656,28604,-948,-3.31,1221
2020-08-07,28681,29558,-877,-2.97,1221
2020-08-08,25978,24516,1462,5.96,1221
2020-08-09,23220,21305,1915,8.99,1221
2020-08-10,27905,27821,84,0.3,1221
2020-08-11,27656,28097,-441,-1.57,1221
2020-08-12,27656,27994,-338,-1.21,1221
2020-08-13,27656,27905,-249,-0.89,1221
2020-08-14,28681,28937,-256,-0.88,1221
2020-08-15,25978,23992,1986,8.28,1221
2020-08-16,23220,20893,2327,11.14,1221
2020-08-17,27905,27538,367,1.33,1221
2020-08-18,27656,27954,-298,-1.07,1221
2020-08-19,27656,28003,-347,-1.24,1221
2020-08-20,27656,28074,-418,-1.49,1221
2020-08-21,28681,29270,-589,-2.01,1221
2020-08-22,25978,24490,1488,6.08,1221
2020-08-23,23220,21556,1664,7.72,1221
2020-08-24,27905,28359,-454,-1.6,1221
2020-08-25,27656,28927,-1271,-4.39,1221
2020-08-26,27656,29117,-1461,-5.02,1221
2020-08-27,27656,29315,-1659,-5.66,1221
2020-08-28,28681,30623,-1942,-6.34,1221
2020-08-29,25978,25936,42,0.16,1221
2020-08-30,23220,23076,144,0.62,1221
2020-08-31,27905,29933,-2028,-6.78,1221
2020-09-01,28339,30533,-2194,-7.19,1221
2020-09-02,28339,30733,-2394,-7.79,1221
2020-09-03,28339,30920,-2581,-8.35,1221
2020-09-04,30222,32196,-1974,-6.13,1221
2020-09-05,27435,27458,-23,-0.08,1221
2020-09-06,24082,24528,-446,-1.82,1221
2020-09-07,28204,31299,-3095,-9.89,1221
2020-09-08,28339,31798,-3459,-10.88,1221
2020-09-09,28339,31886,-3547,-11.12,1221
2020-09-10,28339,31952,-3613,-11.31,1221
2020-09-11,30222,33101,-2879,-8.7,1221
2020-09-12,27435,28232,-797,-2.82,1221
2020-09-13,24082,25171,-1089,-4.33,1221
2020-09-14,28204,31812,-3608,-11.34,1221
2020-09-15,28339,32188,-3849,-11.96,1221
2020-09-16,28339,32158,-3819,-11.88,1221
2020-09-17,28339,32116,-3777,-11.76,1221
2020-09-18,30222,33167,-2945,-8.88,1221
2020-09-19,27435,28213,-778,-2.76,1221
2020-09-20,24082,25081,-999,-3.98,1221
2020-09-21,28204,31666,-3462,-10.93,1221
2020-09-22,28339,31999,-3660,-11.44,1221
2020-09-23,28339,31942,-3603,-11.28,1221
2020-09-24,28339,31886,-3547,-11.12,1221
2020-09-25,30222,32938,-2716,-8.25,1221
2020-09-26,27435,27996,-561,-2.0,1221
2020-09-27,24082,24887,-805,-3.23,1221
2020-09-28,28204,31505,-3301,-10.48,1221
2020-09-29,28339,31878,-3539,-11.1,1221
2020-09-30,28339,31866,-3527,-11.07,1221
2020-10-01,28277,31859,-3582,-11.24,1221
2020-10-02,29795,32961,-3166,-9.61,1221
2020-10-03,26556,28070,-1514,-5.39,1221
2020-10-04,22910,25009,-2099,-8.39,1221
2020-10-05,28412,31670,-3258,-10.29,1221
2020-10-06,28277,32081,-3804,-11.86,1221
2020-10-07,28277,32101,-3824,-11.91,1221
2020-10-08,28277,32118,-3841,-11.96,1221
2020-10-09,29795,33235,-3440,-10.35,1221
2020-10-10,26556,28349,-1793,-6.32,1221
2020-10-11,22910,25285,-2375,-9.39,1221
2020-10-12,28412,31933,-3521,-11.03,1221
2020-10-13,28277,32323,-4046,-12.52,1221
2020-10-14,28277,32313,-4036,-12.49,1221
2020-10-15,28277,32294,-4017,-12.44,1221
2020-10-16,29795,33368,-3573,-10.71,1221
2020-10-17,26556,28436,-1880,-6.61,1221
2020-10-18,22910,25321,-2411,-9.52,1221
2020-10-19,28412,31918,-3506,-10.98,1221
2020-10-20,28277,32255,-3978,-12.33,1221
2020-10-21,28277,32195,-3918,-12.17,1221
2020-10-22,28277,32127,-3850,-11.98,1221
2020-10-23,29795,33157,-3362,-10.14,1221
2020-10-24,26556,28186,-1630,-5.78,1221
2020-10-25,22910,25037,-2127,-8.5,1221
2020-10-26,28412,31608,-3196,-10.11,1221
2020-10-27,28277,31927,-3650,-11.43,1221
2020-10-28,28277,31855,-3578,-11.23,1221
2020-10-29,28277,31784,-3507,-11.03,1221
2020-10-30,29795,32818,-3023,-9.21,1221
2020-10-31,26556,27858,-1302,-4.67,1221
2020-11-01,19296,24728,-5432,-21.97,1221
2020-11-02,26916,31322,-4406,-14.07,1221
2020-11-03,25100,31669,-6569,-20.74,1221
2020-11-04,25100,31629,-6529,-20.64,1221
2020-11-05,25100,31593,-6493,-20.55,1221
2020-11-06,26604,32662,-6058,-18.55,1221
2020-11-07,22248,27737,-5489,-19.79,1221
2020-11-08,19296,24641,-5345,-21.69,1221
2020-11-09,26916,31266,-4350,-13.91,1221
2020-11-10,25100,31640,-6540,-20.67,1221
2020-11-11,25100,31623,-6523,-20.63,1221
2020-11-12,25100,31603,-6503,-20.58,1221
2020-11-13,26604,32684,-6080,-18.6,1221
2020-11-14,22248,27763,-5515,-19.86,1221
2020-11-15,19296,24664,-5368,-21.76,1221
2020-11-16,26916,31279,-4363,-13.95,1221
2020-11-17,25100,31638,-6538,-20.67,1221
2020-11-18,25100,31598,-6498,-20.56,1221
2020-11-19,25100,31551,-6451,-20.45,1221
2020-11-20,26604,32599,-5995,-18.39,1221
2020-11-21,22248,27642,-5394,-19.51,1221
2020-11-22,19296,24504,-5208,-21.25,1221
2020-11-23,26916,31080,-4164,-13.4,1221
2020-11-24,25100,31398,-6298,-20.06,1221
2020-11-25,25100,31320,-6220,-19.86,1221
2020-11-26,25100,31235,-6135,-19.64,1221
2020-11-27,26604,32249,-5645,-17.5,1221
2020-11-28,22248,27263,-5015,-18.39,1221
2020-11-29,19296,24101,-4805,-19.94,1221
2020-11-30,26916,30658,-3742,-12.21,1221
2020-12-01,25920,30964,-5044,-16.29,1221
2020-12-02,25920,30880,-4960,-16.06,1221
2020-12-03,25920,30797,-4877,-15.84,1221
2020-12-04,28638,31820,-3182,-10.0,1221
2020-12-05,23503,26848,-3345,-12.46,1221
2020-12-06,18624,23706,-5082,-21.44,1221
2020-12-07,26194,30289,-4095,-13.52,1221
2020-12-08,25920,30625,-4705,-15.36,1221
2020-12-09,25920,30575,-4655,-15.22,1221
2020-12-10,25920,30527,-4607,-15.09,1221
2020-12-11,28638,31587,-2949,-9.34,1221
2020-12-12,23503,26652,-3149,-11.82,1221
2020-12-13,18624,23546,-4922,-20.9,1221
2020-12-14,26194,30162,-3968,-13.16,1221
2020-12-15,25920,30527,-4607,-15.09,1221
2020-12-16,25920,30502,-4582,-15.02,1221
2020-12-17,25920,30474,-4554,-14.94,1221
2020-12-18,28638,31546,-2908,-9.22,1221
2020-12-19,23503,26618,-3115,-11.7,1221
2020-12-20,18624,23512,-4888,-20.79,1221
2020-12-21,26194,30120,-3926,-13.03,1221
2020-12-22,25920,30471,-4551,-14.94,1221
2020-12-23,25920,30425,-4505,-14.81,1221
2020-12-24,25920,30370,-4450,-14.65,1221
2020-12-25,28638,31411,-2773,-8.83,1221
2020-12-26,23503,26446,-2943,-11.13,1221
2020-12-27,18624,23299,-4675,-20.07,1221
2020-12-28,26194,29866,-3672,-12.29,1221
2020-12-29,25920,30174,-4254,-14.1,1221
2020-12-30,25920,30085,-4165,-13.84,1221
2020-12-31,25920,29990,-4070,-13.57,1221
2021-01-01,26098,30993,-4895,-15.79,1221
2021-01-02,20280,25995,-5715,-21.98,1221
2021-01-03,16638,22821,-6183,-27.09,1221
2021-01-04,24478,29366,-4888,-16.65,1221
2021-01-05,25086,29660,-4574,-15.42,1221
2021-01-06,25086,29565,-4479,-15.15,1221
2021-01-07,25086,29472,-4386,-14.88,1221
2021-01-08,26098,30487,-4389,-14.4,1221
2021-01-09,20280,25509,-5229,-20.5,1221
2021-01-10,16638,22363,-5725,-25.6,1221
2021-01-11,24478,28945,-4467,-15.43,1221
2021-01-12,25086,29285,-4199,-14.34,1221
2021-01-13,25086,29241,-4155,-14.21,1221
2021-01-14,25086,29206,-4120,-14.11,1221
2021-01-15,26098,30282,-4184,-13.82,1221
2021-01-16,20280,25370,-5090,-20.06,1221
2021-01-17,16638,22292,-5654,-25.36,1221
2021-01-18,24478,28944,-4466,-15.43,1221
2021-01-19,25086,29351,-4265,-14.53,1221
2021-01-20,25086,29375,-4289,-14.6,1221
2021-01-21,25086,29403,-4317,-14.68,1221
2021-01-22,26098,30539,-4441,-14.54,1221
2021-01-23,20280,25681,-5401,-21.03,1221
2021-01-24,16638,22652,-6014,-26.55,1221
2021-01-25,24478,29345,-4867,-16.59,1221
2021-01-26,25086,29787,-4701,-15.78,1221
2021-01-27,25086,29837,-4751,-15.92,1221
2021-01-28,25086,29884,-4798,-16.06,1221
2021-01-29,26098,31031,-4933,-15.9,1221
2021-01-30,20280,26177,-5897,-22.53,1221
2021-01-31,16638,23145,-6507,-28.11,1221
2021-02-01,27099,29828,-2729,-9.15,1221
2021-02-02,27441,30254,-2813,-9.3,1221
2021-02-03,27441,30284,-2843,-9.39,1221
2021-02-04,27441,30307,-2866,-9.46,1221
2021-02-05,28927,31428,-2501,-7.96,1221
2021-02-06,24111,26545,-2434,-9.17,1221
2021-02-07,20080,23484,-3404,-14.49,1221
2021-02-08,27099,30138,-3039,-10.08,1221
2021-02-09,27441,30538,-3097,-10.14,1221
2021-02-10,27441,30543,-3102,-10.16,1221
2021-02-11,27441,30545,-3104,-10.16,1221
2021-02-12,28927,31648,-2721,-8.6,1221
2021-02-13,24111,26752,-2641,-9.87,1221
2021-02-14,20080,23683,-3603,-15.21,1221
2021-02-15,27099,30334,-3235,-10.66,1221
2021-02-16,27441,30735,-3294,-10.72,1221
2021-02-17,27441,30747,-3306,-10.75,1221
2021-02-18,27441,30760,-3319,-10.79,1221
2021-02-19,28927,31878,-2951,-9.26,1221
2021-02-20,24111,27001,-2890,-10.7,1221
2021-02-21,20080,23953,-3873,-16.17,1221
2021-02-22,27099,30628,-3529,-11.52,1221
2021-02-23,27441,31053,-3612,-11.63,1221
2021-02-24,27441,31090,-3649,-11.74,1221
2021-02-25,27441,31127,-3686,-11.84,1221
2021-02-26,28927,32269,-3342,-10.36,1221
2021-02-27,24111,27413,-3302,-12.05,1221
2021-02-28,20080,24383,-4303,-17.65,1221
2021-03-01,28282,31072,-2790,-8.98,1221
2021-03-02,28542,31508,-2966,-9.41,1221
2021-03-03,28542,31550,-3008,-9.53,1221
2021-03-04,28542,31588,-3046,-9.64,1221
2021-03-05,29515,32725,-3210,-9.81,1221
2021-03-06,26420,27859,-1439,-5.17,1221
2021-03-07,21180,24815,-3635,-14.65,1221
2021-03-08,28282,31485,-3203,-10.17,1221
2021-03-09,28542,31897,-3355,-10.52,1221
2021-03-10,28542,31912,-3370,-10.56,1221
2021-03-11,28542,31919,-3377,-10.58,1221
2021-03-12,29515,33023,-3508,-10.62,1221
2021-03-13,26420,28122,-1702,-6.05,1221
2021-03-14,21180,25040,-3860,-15.42,1221
2021-03-15,28282,31673,-3391,-10.71,1221
2021-03-16,28542,32048,-3506,-10.94,1221
2021-03-17,28542,32027,-3485,-10.88,1221
2021-03-18,28542,31999,-3457,-10.8,1221
2021-03-19,29515,33070,-3555,-10.75,1221
2021-03-20,26420,28139,-1719,-6.11,1221
2021-03-21,21180,25031,-3851,-15.38,1221
2021-03-22,28282,31639,-3357,-10.61,1221
2021-03-23,28542,31994,-3452,-10.79,1221
2021-03-24,28542,31956,-3414,-10.68,1221
2021-03-25,28542,31916,-3374,-10.57,1221
2021-03-26,29515,32977,-3462,-10.5,1221
2021-03-27,26420,28040,-1620,-5.78,1221
2021-03-28,21180,24928,-3748,-15.04,1221
2021-03-29,28282,31536,-3254,-10.32,1221
2021-03-30,28542,31893,-3351,-10.51,1221
2021-03-31,28542,31859,-3317,-10.41,1221
2021-04-01,27105,31823,-4718,-14.83,1221
2021-04-02,28666,32890,-4224,-12.84,1221
2021-04-03,24023,27960,-3937,-14.08,1221
2021-04-04,20312,24855,-4543,-18.28,1221
2021-04-05,27480,31470,-3990,-12.68,1221
2021-04-06,27105,31833,-4728,-14.85,1221
2021-04-07,27105,31804,-4699,-14.77,1221
2021-04-08,27105,31773,-4668,-14.69,1221
2021-04-09,28666,32844,-4178,-12.72,1221
2021-04-10,24023,27916,-3893,-13.95,1221
2021-04-11,20312,24812,-4500,-18.14,1221
2021-04-12,27480,31428,-3948,-12.56,1221
2021-04-13,27105,31791,-4686,-14.74,1221
2021-04-14,27105,31761,-4656,-14.66,1221
2021-04-15,27105,31728,-4623,-14.57,1221
2021-04-16,28666,32797,-4131,-12.6,1221
2021-04-17,24023,27868,-3845,-13.8,1221
2021-04-18,20312,24763,-4451,-17.97,1221
2021-04-19,27480,31378,-3898,-12.42,1221
2021-04-20,27105,31740,-4635,-14.6,1221
2021-04-21,27105,31711,-4606,-14.52,1221
2021-04-22,27105,31680,-4575,-14.44,1221
2021-04-23,28666,32751,-4085,-12.47,1221
2021-04-24,24023,27825,-3802,-13.66,1221
2021-04-25,20312,24724,-4412,-17.85,1221
2021-04-26,27480,31343,-3863,-12.32,1221
2021-04-27,27105,31711,-4606,-14.52,1221
2021-04-28,27105,31687,-4582,-14.46,1221
2021-04-29,27105,31662,-4557,-14.39,1221
2021-04-30,28666,32738,-4072,-12.44,1221
2021-05-01,27189,27816,-627,-2.25,1221
2021-05-02,22718,24719,-2001,-8.09,1221
2021-05-03,29075,31341,-2266,-7.23,1221
2021-05-04,29633,31710,-2077,-6.55,1221
2021-05-05,29633,31686,-2053,-6.48,1221
2021-05-06,29633,31659,-2026,-6.4,1221
2021-05-07,30480,32732,-2252,-6.88,1221
2021-05-08,27189,27805,-616,-2.22,1221
2021-05-09,22718,24702,-1984,-8.03,1221
2021-05-10,29075,31316,-2241,-7.16,1221
2021-05-11,29633,31677,-2044,-6.45,1221
2021-05-12,29633,31644,-2011,-6.36,1221
2021-05-13,29633,31607,-1974,-6.25,1221
2021-05-14,30480,32672,-2192,-6.71,1221
2021-05-15,27189,27738,-549,-1.98,1221
2021-05-16,22718,24629,-1911,-7.76,1221
2021-05-17,29075,31239,-2164,-6.93,1221
2021-05-18,29633,31600,-1967,-6.22,1221
2021-05-19,29633,31570,-1937,-6.14,1221
2021-05-20,29633,31541,-1908,-6.05,1221
2021-05-21,30480,32618,-2138,-6.55,1221
2021-05-22,27189,27701,-512,-1.85,1221
2021-05-23,22718,24614,-1896,-7.7,1221
2021-05-24,29075,31252,-2177,-6.97,1221
2021-05-25,29633,31645,-2012,-6.36,1221
2021-05-26,29633,31652,-2019,-6.38,1221
2021-05-27,29633,31665,-2032,-6.42,1221
2021-05-28,30480,32788,-2308,-7.04,1221
2021-05-29,27189,27919,-730,-2.61,1221
2021-05-30,22718,24883,-2165,-8.7,1221
2021-05-31,29075,31572,-2497,-7.91,1221
2021-06-01,29231,32016,-2785,-8.7,1221
2021-06-02,29231,32073,-2842,-8.86,1221
2021-06-03,29231,32132,-2901,-9.03,1221
2021-06-04,29844,33295,-3451,-10.36,1221
2021-06-05,27419,28462,-1043,-3.66,1221
2021-06-06,24999,25453,-454,-1.78,1221
2021-06-07,28536,32161,-3625,-11.27,1221
2021-06-08,29231,32613,-3382,-10.37,1221
2021-06-09,29231,32667,-3436,-10.52,1221
2021-06-10,29231,32710,-3479,-10.64,1221
2021-06-11,29844,33846,-4002,-11.82,1221
2021-06-12,27419,28971,-1552,-5.36,1221
2021-06-13,24999,25907,-908,-3.5,1221
2021-06-14,28536,32547,-4011,-12.32,1221
2021-06-15,29231,32918,-3687,-11.2,1221
2021-06-16,29231,32879,-3648,-11.1,1221
2021-06-17,29231,32819,-3588,-10.93,1221
2021-06-18,29844,33841,-3997,-11.81,1221
2021-06-19,27419,28844,-1425,-4.94,1221
2021-06-20,24999,25652,-653,-2.55,1221
2021-06-21,28536,32161,-3625,-11.27,1221
2021-06-22,29231,32398,-3167,-9.78,1221
2021-06-23,29231,32226,-2995,-9.29,1221
2021-06-24,29231,32036,-2805,-8.76,1221
2021-06-25,29844,32934,-3090,-9.38,1221
2021-06-26,27419,27820,-401,-1.44,1221
2021-06-27,24999,24522,477,1.95,1221
2021-06-28,28536,30936,-2400,-7.76,1221
2021-06-29,29231,31093,-1862,-5.99,1221
2021-06-30,29231,30856,-1625,-5.27,1221
2021-07-01,26745,30618,-3873,-12.65,1221
2021-07-02,27643,31486,-3843,-12.21,1221
2021-07-03,23943,26361,-2418,-9.17,1221
2021-07-04,21815,23070,-1255,-5.44,1221
2021-07-05,26207,29509,-3302,-11.19,1221
2021-07-06,26745,29710,-2965,-9.98,1221
2021-07-07,26745,29533,-2788,-9.44,1221
2021-07-08,26745,29370,-2625,-8.94,1221
2021-07-09,27643,30326,-2683,-8.85,1221
2021-07-10,23943,25302,-1359,-5.37,1221
2021-07-11,21815,22121,-306,-1.38,1221
2021-07-12,26207,28677,-2470,-8.61,1221
2021-07-13,26745,28997,-2252,-7.77,1221
2021-07-14,26745,28942,-2197,-7.59,1221
2021-07-15,26745,28899,-2154,-7.45,1221
2021-07-16,27643,29971,-2328,-7.77,1221
2021-07-17,23943,25055,-1112,-4.44,1221
2021-07-18,21815,21973,-158,-0.72,1221
2021-07-19,26207,28617,-2410,-8.42,1221
2021-07-20,26745,29011,-2266,-7.81,1221
2021-07-21,26745,29015,-2270,-7.82,1221
2021-07-22,26745,29015,-2270,-7.82,1221
2021-07-23,27643,30113,-2470,-8.2,1221
2021-07-24,23943,25205,-1262,-5.01,1221
2021-07-25,21815,22115,-300,-1.36,1221
2021-07-26,26207,28734,-2527,-8.79,1221
2021-07-27,26745,29088,-2343,-8.05,1221
2021-07-28,26745,29038,-2293,-7.9,1221
2021-07-29,26745,28972,-2227,-7.69,1221
2021-07-30,27643,29994,-2351,-7.84,1221
2021-07-31,23943,25004,-1061,-4.24,1221
2021-08-01,20410,21827,-1417,-6.49,1221
2021-08-02,25319,28356,-3037,-10.71,1221
2021-08-03,25353,28623,-3270,-11.42,1221
2021-08-04,25353,28489,-3136,-11.01,1221
2021-08-05,25353,28347,-2994,-10.56,1221
2021-08-06,25977,29302,-3325,-11.35,1221
2021-08-07,23101,24258,-1157,-4.77,1221
2021-08-08,20410,21041,-631,-3.0,1221
2021-08-09,25319,27547,-2228,-8.09,1221
2021-08-10,25353,27808,-2455,-8.83,1221
2021-08-11,25353,27688,-2335,-8.43,1221
2021-08-12,25353,27579,-2226,-8.07,1221
2021-08-13,25977,28588,-2611,-9.13,1221
2021-08-14,23101,23616,-515,-2.18,1221
2021-08-15,20410,20490,-80,-0.39,1221
2021-08-16,25319,27105,-1786,-6.59,1221
2021-08-17,25353,27491,-2138,-7.78,1221
2021-08-18,25353,27509,-2156,-7.84,1221
2021-08-19,25353,27549,-2196,-7.97,1221
2021-08-20,25977,28716,-2739,-9.54,1221
2021-08-21,23101,23908,-807,-3.38,1221
2021-08-22,20410,20947,-537,-2.56,1221
2021-08-23,25319,27727,-2408,-8.68,1221
2021-08-24,25353,28274,-2921,-10.33,1221
2021-08-25,25353,28445,-3092,-10.87,1221
2021-08-26,25353,28629,-3276,-11.44,1221
2021-08-27,25977,29927,-3950,-13.2,1221
2021-08-28,23101,25234,-2133,-8.45,1221
2021-08-29,20410,22372,-1962,-8.77,1221
2021-08-30,25319,29231,-3912,-13.38,1221
2021-08-31,25353,29836,-4483,-15.03,1221
2021-09-01,29277,30045,-768,-2.56,1221
2021-09-02,29277,30245,-968,-3.2,1221
2021-09-03,30560,31537,-977,-3.1,1221
2021-09-04,27799,26817,982,3.66,1221
2021-09-05,24960,23908,1052,4.4,1221
2021-09-06,28772,30701,-1929,-6.28,1221
2021-09-07,29277,31225,-1948,-6.24,1221
2021-09-08,29277,31337,-2060,-6.57,1221
2021-09-09,29277,31427,-2150,-6.84,1221
2021-09-10,30560,32600,-2040,-6.26,1221
2021-09-11,27799,27754,45,0.16,1221
2021-09-12,24960,24715,245,0.99,1221
2021-09-13,28772,31377,-2605,-8.3,1221
2021-09-14,29277,31770,-2493,-7.85,1221
2021-09-15,29277,31756,-2479,-7.81,1221
2021-09-16,29277,31727,-2450,-7.72,1221
2021-09-17,30560,32789,-2229,-6.8,1221
2021-09-18,27799,27844,-45,-0.16,1221
2021-09-19,24960,24716,244,0.99,1221
2021-09-20,28772,31304,-2532,-8.09,1221
2021-09-21,29277,31637,-2360,-7.46,1221
2021-09-22,29277,31577,-2300,-7.28,1221
2021-09-23,29277,31517,-2240,-7.11,1221
2021-09-24,30560,32562,-2002,-6.15,1221
2021-09-25,27799,27613,186,0.67,1221
2021-09-26,24960,24495,465,1.9,1221
2021-09-27,28772,31103,-2331,-7.49,1221
2021-09-28,29277,31466,-2189,-6.96,1221
2021-09-29,29277,31445,-2168,-6.89,1221
2021-09-30,29277,31429,-2152,-6.85,1221
2021-10-01,31071,32523,-1452,-4.46,1221
2021-10-02,27729,27624,105,0.38,1221
2021-10-03,23709,24557,-848,-3.45,1221
2021-10-04,28947,31213,-2266,-7.26,1221
2021-10-05,29430,31621,-2191,-6.93,1221
2021-10-06,29430,31640,-2210,-6.98,1221
2021-10-07,29430,31657,-2227,-7.03,1221
2021-10-08,31071,32776,-1705,-5.2,1221
2021-10-09,27729,27895,-166,-0.6,1221
2021-10-10,23709,24835,-1126,-4.53,1221
2021-10-11,28947,31491,-2544,-8.08,1221
2021-10-12,29430,31888,-2458,-7.71,1221
2021-10-13,29430,31888,-2458,-7.71,1221
2021-10-14,29430,31878,-2448,-7.68,1221
2021-10-15,31071,32962,-1891,-5.74,1221
2021-10-16,27729,28039,-310,-1.11,1221
2021-10-17,23709,24934,-1225,-4.91,1221
2021-10-18,28947,31540,-2593,-8.22,1221
2021-10-19,29430,31886,-2456,-7.7,1221
2021-10-20,29430,31833,-2403,-7.55,1221
2021-10-21,29430,31772,-2342,-7.37,1221
2021-10-22,31071,32807,-1736,-5.29,1221
2021-10-23,27729,27839,-110,-0.4,1221
2021-10-24,23709,24693,-984,-3.98,1221
2021-10-25,28947,31264,-2317,-7.41,1221
2021-10-26,29430,31582,-2152,-6.81,1221
2021-10-27,29430,31508,-2078,-6.6,1221
2021-10-28,29430,31434,-2004,-6.38,1221
2021-10-29,31071,32463,-1392,-4.29,1221
2021-10-30,27729,27498,231,0.84,1221
2021-10-31,23709,24362,-653,-2.68,1221
2021-11-01,26983,30949,-3966,-12.81,1221
2021-11-02,28021,31289,-3268,-10.44,1221
2021-11-03,28021,31243,-3222,-10.31,1221
2021-11-04,28021,31200,-3179,-10.19,1221
2021-11-05,29195,32263,-3068,-9.51,1221
2021-11-06,25498,27333,-1835,-6.71,1221
2021-11-07,22083,24232,-2149,-8.87,1221
2021-11-08,26983,30854,-3871,-12.55,1221
2021-11-09,28021,31226,-3205,-10.26,1221
2021-11-10,28021,31208,-3187,-10.21,1221
2021-11-11,28021,31189,-3168,-10.16,1221
2021-11-12,29195,32271,-3076,-9.53,1221
2021-11-13,25498,27353,-1855,-6.78,1221
2021-11-14,22083,24257,-2174,-8.96,1221
2021-11-15,26983,30878,-3895,-12.61,1221
2021-11-16,28021,31243,-3222,-10.31,1221
2021-11-17,28021,31210,-3189,-10.22,1221
2021-11-18,28021,31170,-3149,-10.1,1221
2021-11-19,29195,32225,-3030,-9.4,1221
2021-11-20,25498,27276,-1778,-6.52,1221
2021-11-21,22083,24146,-2063,-8.54,1221
2021-11-22,26983,30729,-3746,-12.19,1221
2021-11-23,28021,31053,-3032,-9.76,1221
2021-11-24,28021,30980,-2959,-9.55,1221
2021-11-25,28021,30901,-2880,-9.32,1221
2021-11-26,29195,31919,-2724,-8.53,1221
2021-11-27,25498,26935,-1437,-5.34,1221
2021-11-28,22083,23774,-1691,-7.11,1221
2021-11-29,26983,30331,-3348,-11.04,1221
2021-11-30,28021,30636,-2615,-8.54,1221
2021-12-01,26543,30549,-4006,-13.11,1221
2021-12-02,26543,30462,-3919,-12.87,1221
2021-12-03,27006,31480,-4474,-14.21,1221
2021-12-04,23769,26502,-2733,-10.31,1221
2021-12-05,20091,23355,-3264,-13.98,1221
2021-12-06,26905,29931,-3026,-10.11,1221
2021-12-07,26543,30260,-3717,-12.28,1221
2021-12-08,26543,30202,-3659,-12.12,1221
2021-12-09,26543,30148,-3605,-11.96,1221
2021-12-10,27006,31201,-4195,-13.45,1221
2021-12-11,23769,26260,-2491,-9.49,1221
2021-12-12,20091,23149,-3058,-13.21,1221
2021-12-13,26905,29761,-2856,-9.6,1221
2021-12-14,26543,30124,-3581,-11.89,1221
2021-12-15,26543,30097,-3554,-11.81,1221
2021-12-16,26543,30069,-3526,-11.73,1221
2021-12-17,27006,31143,-4137,-13.28,1221
2021-12-18,23769,26217,-2448,-9.34,1221
2021-12-19,20091,23114,-3023,-13.08,1221
2021-12-20,26905,29728,-2823,-9.5,1221
2021-12-21,26543,30085,-3542,-11.77,1221
2021-12-22,26543,30045,-3502,-11.66,1221
2021-12-23,26543,29998,-3455,-11.52,1221
2021-12-24,27006,31047,-4041,-13.02,1221
2021-12-25,23769,26090,-2321,-8.9,1221
2021-12-26,20091,22952,-2861,-12.47,1221
2021-12-27,26905,29526,-2621,-8.88,1221
2021-12-28,26543,29842,-3299,-11.05,1221
2021-12-29,26543,29759,-3216,-10.81,1221
2021-12-30,26543,29669,-3126,-10.54,1221
2021-12-31,27006,30676,-3670,-11.96,1221
2022-01-01,23445,25681,-2236,-8.71,1221
2022-01-02,19133,22509,-3376,-15.0,1221
2022-01-03,25820,29054,-3234,-11.13,1221
2022-01-04,25984,29346,-3362,-11.46,1221
2022-01-05,25984,29248,-3264,-11.16,1221
2022-01-06,25984,29150,-3166,-10.86,1221
2022-01-07,27026,30157,-3131,-10.38,1221
2022-01-08,23445,25171,-1726,-6.86,1221
2022-01-09,19133,22017,-2884,-13.1,1221
2022-01-10,25820,28588,-2768,-9.68,1221
2022-01-11,25984,28916,-2932,-10.14,1221
2022-01-12,25984,28860,-2876,-9.97,1221
2022-01-13,25984,28812,-2828,-9.82,1221
2022-01-14,27026,29876,-2850,-9.54,1221
2022-01-15,23445,24951,-1506,-6.04,1221
2022-01-16,19133,21861,-2728,-12.48,1221
2022-01-17,25820,28500,-2680,-9.4,1221
2022-01-18,25984,28897,-2913,-10.08,1221
2022-01-19,25984,28910,-2926,-10.12,1221
2022-01-20,25984,28929,-2945,-10.18,1221
2022-01-21,27026,30057,-3031,-10.08,1221
2022-01-22,23445,25193,-1748,-6.94,1221
2022-01-23,19133,22159,-3026,-13.66,1221
2022-01-24,25820,28849,-3029,-10.5,1221
2022-01-25,25984,29289,-3305,-11.28,1221
2022-01-26,25984,29338,-3354,-11.43,1221
2022-01-27,25984,29386,-3402,-11.58,1221
2022-01-28,27026,30535,-3509,-11.49,1221
2022-01-29,23445,25684,-2239,-8.72,1221
2022-01-30,19133,22655,-3522,-15.55,1221
2020-02-01,7472,5874,1598,27.2,1622
2020-02-02,5520,3965,1555,39.22,1622
2020-02-03,11308,10481,827,7.89,1622
2020-02-04,11259,10627,632,5.95,1622
2020-02-05,11259,10642,617,5.8,1622
2020-02-06,11259,10647,612,5.75,1622
2020-02-07,11258,10411,847,8.14,1622
2020-02-08,7472,5936,1536,25.88,1622
2020-02-09,5520,4007,1513,37.76,1622
2020-02-10,11308,10504,804,7.65,1622
2020-02-11,11259,10634,625,5.88,1622
2020-02-12,11259,10637,622,5.85,1622
2020-02-13,11259,10634,625,5.88,1622
2020-02-14,11258,10394,864,8.31,1622
2020-02-15,7472,5920,1552,26.22,1622
2020-02-16,5520,3996,1524,38.14,1622
2020-02-17,11308,10502,806,7.67,1622
2020-02-18,11259,10646,613,5.76,1622
2020-02-19,11259,10667,592,5.55,1622
2020-02-20,11259,10684,575,5.38,1622
2020-02-21,11258,10468,790,7.55,1622
2020-02-22,7472,6018,1454,24.16,1622
2020-02-23,5520,4120,1400,33.98,1622
2020-02-24,11308,10653,655,6.15,1622
2020-02-25,11259,10822,437,4.04,1622
2020-02-26,11259,10867,392,3.61,1622
2020-02-27,11259,10907,352,3.23,1622
2020-02-28,11258,10710,548,5.12,1622
2020-02-29,7472,6278,1194,19.02,1622
2020-03-01,3948,4392,-444,-10.11,1622
2020-03-02,8604,10933,-2329,-21.3,1622
2020-03-03,8557,11106,-2549,-22.95,1622
2020-03-04,8557,11150,-2593,-23.26,1622
2020-03-05,8557,11185,-2628,-23.5,1622
2020-03-06,8742,10979,-2237,-20.38,1622
2020-03-07,5243,6532,-1289,-19.73,1622
2020-03-08,3948,4629,-681,-14.71,1622
2020-03-09,8604,11149,-2545,-22.83,1622
2020-03-10,8557,11299,-2742,-24.27,1622
2020-03-11,8557,11318,-2761,-24.39,1622
2020-03-12,8557,11326,-2769,-24.45,1622
2020-03-13,8742,11094,-2352,-21.2,1622
2020-03-14,5243,6621,-1378,-20.81,1622
2020-03-15,3948,4693,-745,-15.87,1622
2020-03-16,8604,11190,-2586,-23.11,1622
2020-03-17,8557,11320,-2763,-24.41,1622
2020-03-18,8557,11322,-2765,-24.42,1622
2020-03-19,8557,11317,-2760,-24.39,1622
2020-03-20,8742,11075,-2333,-21.07,1622
2020-03-21,5243,6597,-1354,-20.52,1622
2020-03-22,3948,4669,-721,-15.44,1622
2020-03-23,8604,11170,-2566,-22.97,1622
2020-03-24,8557,11309,-2752,-24.33,1622
2020-03-25,8557,11323,-2766,-24.43,1622
2020-03-26,8557,11334,-2777,-24.5,1622
2020-03-27,8742,11111,-2369,-21.32,1622
2020-03-28,5243,6655,-1412,-21.22,1622
2020-03-29,3948,4750,-802,-16.88,1622
2020-03-30,8604,11277,-2673,-23.7,1622
2020-03-31,8557,11440,-2883,-25.2,1622
2020-04-01,8018,11479,-3461,-30.15,1622
2020-04-02,8018,11513,-3495,-30.36,1622
2020-04-03,7431,11312,-3881,-34.31,1622
2020-04-04,4876,6874,-1998,-29.07,1622
2020-04-05,3158,4985,-1827,-36.65,1622
2020-04-06,8020,11523,-3503,-30.4,1622
2020-04-07,8018,11693,-3675,-31.43,1622
2020-04-08,8018,11735,-3717,-31.67,1622
2020-04-09,8018,11767,-3749,-31.86,1622
2020-04-10,7431,11559,-4128,-35.71,1622
2020-04-11,4876,7110,-2234,-31.42,1622
2020-04-12,3158,5204,-2046,-39.32,1622
2020-04-13,8020,11722,-3702,-31.58,1622
2020-04-14,8018,11870,-3852,-32.45,1622
2020-04-15,8018,11884,-3866,-32.53,1622
2020-04-16,8018,11888,-3870,-32.55,1622
2020-04-17,7431,11649,-4218,-36.21,1622
2020-04-18,4876,7168,-2292,-31.98,1622
2020-04-19,3158,5231,-2073,-39.63,1622
2020-04-20,8020,11717,-3697,-31.55,1622
2020-04-21,8018,11835,-3817,-32.25,1622
2020-04-22,8018,11822,-3804,-32.18,1622
2020-04-23,8018,11799,-3781,-32.05,1622
2020-04-24,7431,11538,-4107,-35.6,1622
2020-04-25,4876,7039,-2163,-30.73,1622
2020-04-26,3158,5087,-1929,-37.92,1622
2020-04-27,8020,11564,-3544,-30.65,1622
2020-04-28,8018,11675,-3657,-31.32,1622
2020-04-29,8018,11660,-3642,-31.23,1622
2020-04-30,8018,11640,-3622,-31.12,1622
2020-05-01,10848,11386,-538,-4.73,1622
2020-05-02,7267,6897,370,5.36,1622
2020-05-03,5114,4958,156,3.15,1622
2020-05-04,10498,11450,-952,-8.31,1622
2020-05-05,10908,11579,-671,-5.79,1622
2020-05-06,10908,11583,-675,-5.83,1622
2020-05-07,10908,11583,-675,-5.83,1622
2020-05-08,10848,11348,-500,-4.41,1622
2020-05-09,7267,6878,389,5.66,1622
2020-05-10,5114,4957,157,3.17,1622
2020-05-11,10498,11465,-967,-8.43,1622
2020-05-12,10908,11607,-699,-6.02,1622
2020-05-13,10908,11623,-715,-6.15,1622
2020-05-14,10908,11631,-723,-6.22,1622
2020-05-15,10848,11401,-553,-4.85,1622
2020-05-16,7267,6932,335,4.83,1622
2020-05-17,5114,5010,104,2.08,1622
2020-05-18,10498,11513,-1015,-8.82,1622
2020-05-19,10908,11648,-740,-6.35,1622
2020-05-20,10908,11653,-745,-6.39,1622
2020-05-21,10908,11649,-741,-6.36,1622
2020-05-22,10848,11405,-557,-4.88,1622
2020-05-23,7267,6921,346,5.0,1622
2020-05-24,5114,4983,131,2.63,1622
2020-05-25,10498,11470,-972,-8.47,1622
2020-05-26,10908,11590,-682,-5.88,1622
2020-05-27,10908,11581,-673,-5.81,1622
2020-05-28,10908,11564,-656,-5.67,1622
2020-05-29,10848,11309,-461,-4.08,1622
2020-05-30,7267,6817,450,6.6,1622
2020-05-31,5114,4873,241,4.95,1622
2020-06-01,11492,11357,135,1.19,1622
2020-06-02,12311,11477,834,7.27,1622
2020-06-03,12311,11470,841,7.33,1622
2020-06-04,12311,11458,853,7.44,1622
2020-06-05,11742,11212,530,4.73,1622
2020-06-06,8541,6730,1811,26.91,1622
2020-06-07,5980,4797,1183,24.66,1622
2020-06-08,11492,11294,198,1.75,1622
2020-06-09,12311,11428,883,7.73,1622
2020-06-10,12311,11435,876,7.66,1622
2020-06-11,12311,11437,874,7.64,1622
2020-06-12,11742,11203,539,4.81,1622
2020-06-13,8541,6732,1809,26.87,1622
2020-06-14,5980,4809,1171,24.35,1622
2020-06-15,11492,11313,179,1.58,1622
2020-06-16,12311,11451,860,7.51,1622
2020-06-17,12311,11459,852,7.44,1622
2020-06-18,12311,11459,852,7.44,1622
2020-06-19,11742,11220,522,4.65,1622
2020-06-20,8541,6741,1800,26.7,1622
2020-06-21,5980,4806,1174,24.43,1622
2020-06-22,11492,11296,196,1.74,1622
2020-06-23,12311,11416,895,7.84,1622
2020-06-24,12311,11405,906,7.94,1622
2020-06-25,12311,11384,927,8.14,1622
2020-06-26,11742,11123,619,5.57,1622
2020-06-27,8541,6621,1920,29.0,1622
2020-06-28,5980,4664,1316,28.22,1622
2020-06-29,11492,11133,359,3.22,1622
2020-06-30,12311,11234,1077,9.59,1622
2020-07-01,11268,11206,62,0.55,1622
2020-07-02,11268,11170,98,0.88,1622
2020-07-03,11279,10898,381,3.5,1622
2020-07-04,7064,6389,675,10.57,1622
2020-07-05,5766,4428,1338,30.22,1622
2020-07-06,11014,10897,117,1.07,1622
2020-07-07,11268,11002,266,2.42,1622
2020-07-08,11268,10983,285,2.59,1622
2020-07-09,11268,10960,308,2.81,1622
2020-07-10,11279,10704,575,5.37,1622
2020-07-11,7064,6214,850,13.68,1622
2020-07-12,5766,4275,1491,34.88,1622
2020-07-13,11014,10768,246,2.28,1622
2020-07-14,11268,10898,370,3.4,1622
2020-07-15,11268,10905,363,3.33,1622
2020-07-16,11268,10907,361,3.31,1622
2020-07-17,11279,10675,604,5.66,1622
2020-07-18,7064,6208,856,13.79,1622
2020-07-19,5766,4290,1476,34.41,1622
2020-07-20,11014,10800,214,1.98,1622
2020-07-21,11268,10944,324,2.96,1622
2020-07-22,11268,10959,309,2.82,1622
2020-07-23,11268,10967,301,2.74,1622
2020-07-24,11279,10735,544,5.07,1622
2020-07-25,7064,6263,801,12.79,1622
2020-07-26,5766,4335,1431,33.01,1622
2020-07-27,11014,10830,184,1.7,1622
2020-07-28,11268,10956,312,2.85,1622
2020-07-29,11268,10950,318,2.9,1622
2020-07-30,11268,10932,336,3.07,1622
2020-07-31,11279,10672,607,5.69,1622
2020-08-01,6006,6171,-165,-2.67,1622
2020-08-02,4508,4214,294,6.98,1622
2020-08-03,9557,10680,-1123,-10.51,1622
2020-08-04,8363,10778,-2415,-22.41,1622
2020-08-05,8363,10746,-2383,-22.18,1622
2020-08-06,8363,10705,-2342,-21.88,1622
2020-08-07,7967,10427,-2460,-23.59,1622
2020-08-08,6006,5913,93,1.57,1622
2020-08-09,4508,3946,562,14.24,1622
2020-08-10,9557,10411,-854,-8.2,1622
2020-08-11,8363,10512,-2149,-20.44,1622
2020-08-12,8363,10491,-2128,-20.28,1622
2020-08-13,8363,10467,-2104,-20.1,1622
2020-08-14,7967,10213,-2246,-21.99,1622
2020-08-15,6006,5728,278,4.85,1622
2020-08-16,4508,3797,711,18.73,1622
2020-08-17,9557,10302,-745,-7.23,1622
2020-08-18,8363,10449,-2086,-19.96,1622
2020-08-19,8363,10476,-2113,-20.17,1622
2020-08-20,8363,10504,-2141,-20.38,1622
2020-08-21,7967,10303,-2336,-22.67,1622
2020-08-22,6006,5871,135,2.3,1622
2020-08-23,4508,3993,515,12.9,1622
2020-08-24,9557,10549,-992,-9.4,1622
2020-08-25,8363,10744,-2381,-22.16,1622
2020-08-26,8363,10815,-2452,-22.67,1622
2020-08-27,8363,10882,-2519,-23.15,1622
2020-08-28,7967,10715,-2748,-25.65,1622
2020-08-29,6006,6311,-305,-4.83,1622
2020-08-30,4508,4453,55,1.24,1622
2020-08-31,9557,11023,-1466,-13.3,1622
2020-09-01,10789,11224,-435,-3.88,1622
2020-09-02,10789,11294,-505,-4.47,1622
2020-09-03,10789,11354,-565,-4.98,1622
2020-09-04,10659,11171,-512,-4.58,1622
2020-09-05,7056,6746,310,4.6,1622
2020-09-06,5750,4863,887,18.24,1622
2020-09-07,10764,11401,-637,-5.59,1622
2020-09-08,10789,11567,-778,-6.73,1622
2020-09-09,10789,11600,-811,-6.99,1622
2020-09-10,10789,11620,-831,-7.15,1622
2020-09-11,10659,11397,-738,-6.48,1622
2020-09-12,7056,6931,125,1.8,1622
2020-09-13,5750,5009,741,14.79,1622
2020-09-14,10764,11510,-746,-6.48,1622
2020-09-15,10789,11643,-854,-7.33,1622
2020-09-16,10789,11645,-856,-7.35,1622
2020-09-17,10789,11640,-851,-7.31,1622
2020-09-18,10659,11396,-737,-6.47,1622
2020-09-19,7056,6915,141,2.04,1622
2020-09-20,5750,4983,767,15.39,1622
2020-09-21,10764,11480,-716,-6.24,1622
2020-09-22,10789,11612,-823,-7.09,1622
2020-09-23,10789,11620,-831,-7.15,1622
2020-09-24,10789,11624,-835,-7.18,1622
2020-09-25,10659,11394,-735,-6.45,1622
2020-09-26,7056,6930,126,1.82,1622
2020-09-27,5750,5017,733,14.61,1622
2020-09-28,10764,11534,-770,-6.68,1622
2020-09-29,10789,11688,-899,-7.69,1622
2020-09-30,10789,11718,-929,-7.93,1622
2020-10-01,10830,11741,-911,-7.76,1622
2020-10-02,10414,11530,-1116,-9.68,1622
2020-10-03,6826,7081,-255,-3.6,1622
2020-10-04,4971,5180,-209,-4.03,1622
2020-10-05,10730,11707,-977,-8.35,1622
2020-10-06,10830,11865,-1035,-8.72,1622
2020-10-07,10830,11895,-1065,-8.95,1622
2020-10-08,10830,11914,-1084,-9.1,1622
2020-10-09,10414,11694,-1280,-10.95,1622
2020-10-10,6826,7233,-407,-5.63,1622
2020-10-11,4971,5316,-345,-6.49,1622
2020-10-12,10730,11822,-1092,-9.24,1622
2020-10-13,10830,11958,-1128,-9.43,1622
2020-10-14,10830,11962,-1132,-9.46,1622
2020-10-15,10830,11956,-1126,-9.42,1622
2020-10-16,10414,11709,-1295,-11.06,1622
2020-10-17,6826,7222,-396,-5.48,1622
2020-10-18,4971,5279,-308,-5.83,1622
2020-10-19,10730,11762,-1032,-8.77,1622
2020-10-20,10830,11878,-1048,-8.82,1622
2020-10-21,10830,11866,-1036,-8.73,1622
2020-10-22,10830,11846,-1016,-8.58,1622
2020-10-23,10414,11590,-1176,-10.15,1622
2020-10-24,6826,7099,-273,-3.85,1622
2020-10-25,4971,5157,-186,-3.61,1622
2020-10-26,10730,11646,-916,-7.87,1622
2020-10-27,10830,11772,-942,-8.0,1622
2020-10-28,10830,11774,-944,-8.02,1622
2020-10-29,10830,11773,-943,-8.01,1622
2020-10-30,10414,11539,-1125,-9.75,1622
2020-10-31,6826,7072,-246,-3.48,1622
2020-11-01,4083,5156,-1073,-20.81,1622
2020-11-02,9649,11671,-2022,-17.32,1622
2020-11-03,9092,11824,-2732,-23.11,1622
2020-11-04,9092,11852,-2760,-23.29,1622
2020-11-05,9092,11874,-2782,-23.43,1622
2020-11-06,9114,11661,-2547,-21.84,1622
2020-11-07,5575,7211,-1636,-22.69,1622
2020-11-08,4083,5307,-1224,-23.06,1622
2020-11-09,9649,11829,-2180,-18.43,1622
2020-11-10,9092,11982,-2890,-24.12,1622
2020-11-11,9092,12004,-2912,-24.26,1622
2020-11-12,9092,12015,-2923,-24.33,1622
2020-11-13,9114,11782,-2668,-22.64,1622
2020-11-14,5575,7307,-1732,-23.7,1622
2020-11-15,4083,5371,-1288,-23.98,1622
2020-11-16,9649,11856,-2207,-18.62,1622
2020-11-17,9092,11967,-2875,-24.02,1622
2020-11-18,9092,11942,-2850,-23.87,1622
2020-11-19,9092,11902,-2810,-23.61,1622
2020-11-20,9114,11617,-2503,-21.55,1622
2020-11-21,5575,7087,-1512,-21.33,1622
2020-11-22,4083,5098,-1015,-19.91,1622
2020-11-23,9649,11530,-1881,-16.31,1622
2020-11-24,9092,11589,-2497,-21.55,1622
2020-11-25,9092,11517,-2425,-21.06,1622
2020-11-26,9092,11434,-2342,-20.48,1622
2020-11-27,9114,11111,-1997,-17.97,1622
2020-11-28,5575,6549,-974,-14.87,1622
2020-11-29,4083,4533,-450,-9.93,1622
2020-11-30,9649,10947,-1298,-11.86,1622
2020-12-01,8625,10996,-2371,-21.56,1622
2020-12-02,8625,10920,-2295,-21.02,1622
2020-12-03,8625,10841,-2216,-20.44,1622
2020-12-04,9629,10529,-900,-8.55,1622
2020-12-05,5962,5985,-23,-0.38,1622
2020-12-06,4179,3995,184,4.61,1622
2020-12-07,8896,10438,-1542,-14.77,1622
2020-12-08,8625,10521,-1896,-18.02,1622
2020-12-09,8625,10483,-1858,-17.72,1622
2020-12-10,8625,10444,-1819,-17.42,1622
2020-12-11,9629,10174,-545,-5.36,1622
2020-12-12,5962,5672,290,5.11,1622
2020-12-13,4179,3722,457,12.28,1622
2020-12-14,8896,10204,-1308,-12.82,1622
2020-12-15,8625,10323,-1698,-16.45,1622
2020-12-16,8625,10317,-1692,-16.4,1622
2020-12-17,8625,10305,-1680,-16.3,1622
2020-12-18,9629,10057,-428,-4.26,1622
2020-12-19,5962,5570,392,7.04,1622
2020-12-20,4179,3630,549,15.12,1622
2020-12-21,8896,10115,-1219,-12.05,1622
2020-12-22,8625,10230,-1605,-15.69,1622
2020-12-23,8625,10215,-1590,-15.57,1622
2020-12-24,8625,10188,-1563,-15.34,1622
2020-12-25,9629,9919,-290,-2.92,1622
2020-12-26,5962,5409,553,10.22,1622
2020-12-27,4179,3441,738,21.45,1622
2020-12-28,8896,9896,-1000,-10.11,1622
2020-12-29,8625,9980,-1355,-13.58,1622
2020-12-30,8625,9933,-1308,-13.17,1622
2020-12-31,8625,9875,-1250,-12.66,1622
2021-01-01,8589,9577,-988,-10.32,1622
2021-01-02,4725,5040,-315,-6.25,1622
2021-01-03,3521,3049,472,15.48,1622
2021-01-04,8254,9486,-1232,-12.99,1622
2021-01-05,8444,9557,-1113,-11.65,1622
2021-01-06,8444,9503,-1059,-11.14,1622
2021-01-07,8444,9445,-1001,-10.6,1622
2021-01-08,8589,9153,-564,-6.16,1622
2021-01-09,4725,4628,97,2.1,1622
2021-01-10,3521,2656,865,32.57,1622
2021-01-11,8254,9117,-863,-9.47,1622
2021-01-12,8444,9219,-775,-8.41,1622
2021-01-13,8444,9200,-756,-8.22,1622
2021-01-14,8444,9181,-737,-8.03,1622
2021-01-15,8589,8932,-343,-3.84,1622
2021-01-16,4725,4452,273,6.13,1622
2021-01-17,3521,2527,994,39.34,1622
2021-01-18,8254,9036,-782,-8.65,1622
2021-01-19,8444,9184,-740,-8.06,1622
2021-01-20,8444,9210,-766,-8.32,1622
2021-01-21,8444,9234,-790,-8.56,1622
2021-01-22,8589,9024,-435,-4.82,1622
2021-01-23,4725,4579,146,3.19,1622
2021-01-24,3521,2684,837,31.18,1622
2021-01-25,8254,9217,-963,-10.45,1622
2021-01-26,8444,9385,-941,-10.03,1622
2021-01-27,8444,9424,-980,-10.4,1622
2021-01-28,8444,9455,-1011,-10.69,1622
2021-01-29,8589,9247,-658,-7.12,1622
2021-01-30,4725,4798,-73,-1.52,1622
2021-01-31,3521,2894,627,21.67,1622
2021-02-01,9356,9415,-59,-0.63,1622
2021-02-02,9499,9565,-66,-0.69,1622
2021-02-03,9499,9584,-85,-0.89,1622
2021-02-04,9499,9593,-94,-0.98,1622
2021-02-05,9520,9362,158,1.69,1622
2021-02-06,5887,4890,997,20.39,1622
2021-02-07,4206,2963,1243,41.95,1622
2021-02-08,9356,9461,-105,-1.11,1622
2021-02-09,9499,9592,-93,-0.97,1622
2021-02-10,9499,9595,-96,-1.0,1622
2021-02-11,9499,9591,-92,-0.96,1622
2021-02-12,9520,9350,170,1.82,1622
2021-02-13,5887,4874,1013,20.78,1622
2021-02-14,4206,2946,1260,42.77,1622
2021-02-15,9356,9449,-93,-0.98,1622
2021-02-16,9499,9588,-89,-0.93,1622
2021-02-17,9499,9604,-105,-1.09,1622
2021-02-18,9499,9616,-117,-1.22,1622
2021-02-19,9520,9395,125,1.33,1622
2021-02-20,5887,4941,946,19.15,1622
2021-02-21,4206,3038,1168,38.45,1622
2021-02-22,9356,9566,-210,-2.2,1622
2021-02-23,9499,9732,-233,-2.39,1622
2021-02-24,9499,9774,-275,-2.81,1622
2021-02-25,9499,9811,-312,-3.18,1622
2021-02-26,9520,9613,-93,-0.97,1622
2021-02-27,5887,5179,708,13.67,1622
2021-02-28,4206,3293,913,27.73,1622
2021-03-01,10052,9835,217,2.21,1622
2021-03-02,10225,10010,215,2.15,1622
2021-03-03,10225,10057,168,1.67,1622
2021-03-04,10225,10094,131,1.3,1622
2021-03-05,9904,9892,12,0.12,1622
2021-03-06,6430,5450,980,17.98,1622
2021-03-07,4465,3551,914,25.74,1622
2021-03-08,10052,10077,-25,-0.25,1622
2021-03-09,10225,10232,-7,-0.07,1622
2021-03-10,10225,10256,-31,-0.3,1622
2021-03-11,10225,10269,-44,-0.43,1622
2021-03-12,9904,10041,-137,-1.36,1622
2021-03-13,6430,5572,858,15.4,1622
2021-03-14,4465,3647,818,22.43,1622
2021-03-15,10052,10147,-95,-0.94,1622
2021-03-16,10225,10279,-54,-0.53,1622
2021-03-17,10225,10282,-57,-0.55,1622
2021-03-18,10225,10276,-51,-0.5,1622
2021-03-19,9904,10034,-130,-1.3,1622
2021-03-20,6430,5555,875,15.75,1622
2021-03-21,4465,3624,841,23.21,1622
2021-03-22,10052,10122,-70,-0.69,1622
2021-03-23,10225,10257,-32,-0.31,1622
2021-03-24,10225,10267,-42,-0.41,1622
2021-03-25,10225,10274,-49,-0.48,1622
2021-03-26,9904,10046,-142,-1.41,1622
2021-03-27,6430,5586,844,15.11,1622
2021-03-28,4465,3676,789,21.46,1622
2021-03-29,10052,10198,-146,-1.43,1622
2021-03-30,10225,10357,-132,-1.27,1622
2021-03-31,10225,10393,-168,-1.62,1622
2021-04-01,9731,10424,-693,-6.65,1622
2021-04-02,9538,10220,-682,-6.67,1622
2021-04-03,5956,5781,175,3.03,1622
2021-04-04,4458,3891,567,14.57,1622
2021-04-05,9844,10429,-585,-5.61,1622
2021-04-06,9731,10601,-870,-8.21,1622
2021-04-07,9731,10644,-913,-8.58,1622
2021-04-08,9731,10679,-948,-8.88,1622
2021-04-09,9538,10475,-937,-8.95,1622
2021-04-10,5956,6031,-75,-1.24,1622
2021-04-11,4458,4130,328,7.94,1622
2021-04-12,9844,10653,-809,-7.59,1622
2021-04-13,9731,10806,-1075,-9.95,1622
2021-04-14,9731,10827,-1096,-10.12,1622
2021-04-15,9731,10836,-1105,-10.2,1622
2021-04-16,9538,10603,-1065,-10.04,1622
2021-04-17,5956,6128,-172,-2.81,1622
2021-04-18,4458,4196,262,6.24,1622
2021-04-19,9844,10688,-844,-7.9,1622
2021-04-20,9731,10809,-1078,-9.97,1622
2021-04-21,9731,10799,-1068,-9.89,1622
2021-04-22,9731,10780,-1049,-9.73,1622
2021-04-23,9538,10521,-983,-9.34,1622
2021-04-24,5956,6023,-67,-1.11,1622
2021-04-25,4458,4071,387,9.51,1622
2021-04-26,9844,10547,-703,-6.67,1622
2021-04-27,9731,10657,-926,-8.69,1622
2021-04-28,9731,10641,-910,-8.55,1622
2021-04-29,9731,10618,-887,-8.35,1622
2021-04-30,9538,10361,-823,-7.94,1622
2021-05-01,7067,5869,1198,20.41,1622
2021-05-02,5012,3926,1086,27.66,1622
2021-05-03,11077,10415,662,6.36,1622
2021-05-04,11007,10540,467,4.43,1622
2021-05-05,11007,10540,467,4.43,1622
2021-05-06,11007,10537,470,4.46,1622
2021-05-07,10576,10299,277,2.69,1622
2021-05-08,7067,5826,1241,21.3,1622
2021-05-09,5012,3903,1109,28.41,1622
2021-05-10,11077,10409,668,6.42,1622
2021-05-11,11007,10551,456,4.32,1622
2021-05-12,11007,10566,441,4.17,1622
2021-05-13,11007,10574,433,4.09,1622
2021-05-14,10576,10345,231,2.23,1622
2021-05-15,7067,5878,1189,20.23,1622
2021-05-16,5012,3957,1055,26.66,1622
2021-05-17,11077,10462,615,5.88,1622
2021-05-18,11007,10600,407,3.84,1622
2021-05-19,11007,10608,399,3.76,1622
2021-05-20,11007,10607,400,3.77,1622
2021-05-21,10576,10366,210,2.03,1622
2021-05-22,7067,5885,1182,20.08,1622
2021-05-23,5012,3950,1062,26.89,1622
2021-05-24,11077,10440,637,6.1,1622
2021-05-25,11007,10561,446,4.22,1622
2021-05-26,11007,10554,453,4.29,1622
2021-05-27,11007,10538,469,4.45,1622
2021-05-28,10576,10284,292,2.84,1622
2021-05-29,7067,5792,1275,22.01,1622
2021-05-30,5012,3847,1165,30.28,1622
2021-05-31,11077,10331,746,7.22,1622
2021-06-01,11383,10449,934,8.94,1622
2021-06-02,11383,10441,942,9.02,1622
2021-06-03,11383,10427,956,9.17,1622
2021-06-04,10693,10177,516,5.07,1622
2021-06-05,7319,5693,1626,28.56,1622
2021-06-06,6031,3757,2274,60.53,1622
2021-06-07,11080,10252,828,8.08,1622
2021-06-08,11383,10383,1000,9.63,1622
2021-06-09,11383,10388,995,9.58,1622
2021-06-10,11383,10388,995,9.58,1622
2021-06-11,10693,10152,541,5.33,1622
2021-06-12,7319,5681,1638,28.83,1622
2021-06-13,6031,3757,2274,60.53,1622
2021-06-14,11080,10262,818,7.97,1622
2021-06-15,11383,10400,983,9.45,1622
2021-06-16,11383,10410,973,9.35,1622
2021-06-17,11383,10412,971,9.33,1622
2021-06-18,10693,10175,518,5.09,1622
2021-06-19,7319,5699,1620,28.43,1622
2021-06-20,6031,3768,2263,60.06,1622
2021-06-21,11080,10262,818,7.97,1622
2021-06-22,11383,10386,997,9.6,1622
2021-06-23,11383,10380,1003,9.66,1622
2021-06-24,11383,10363,1020,9.84,1622
2021-06-25,10693,10106,587,5.81,1622
2021-06-26,7319,5608,1711,30.51,1622
2021-06-27,6031,3654,2377,65.05,1622
2021-06-28,11080,10126,954,9.42,1622
2021-06-29,11383,10229,1154,11.28,1622
2021-06-30,11383,10203,1180,11.57,1622
2021-07-01,9957,10168,-211,-2.08,1622
2021-07-02,9562,9895,-333,-3.37,1622
2021-07-03,6339,5385,954,17.72,1622
2021-07-04,5324,3423,1901,55.54,1622
2021-07-05,10232,9890,342,3.46,1622
2021-07-06,9957,9992,-35,-0.35,1622
2021-07-07,9957,9970,-13,-0.13,1622
2021-07-08,9957,9942,15,0.15,1622
2021-07-09,9562,9681,-119,-1.23,1622
2021-07-10,6339,5187,1152,22.21,1622
2021-07-11,5324,3243,2081,64.17,1622
2021-07-12,10232,9731,501,5.15,1622
2021-07-13,9957,9857,100,1.01,1622
2021-07-14,9957,9859,98,0.99,1622
2021-07-15,9957,9858,99,1.0,1622
2021-07-16,9562,9622,-60,-0.62,1622
2021-07-17,6339,5153,1186,23.02,1622
2021-07-18,5324,3232,2092,64.73,1622
2021-07-19,10232,9741,491,5.04,1622
2021-07-20,9957,9885,72,0.73,1622
2021-07-21,9957,9902,55,0.56,1622
2021-07-22,9957,9910,47,0.47,1622
2021-07-23,9562,9681,-119,-1.23,1622
2021-07-24,6339,5212,1127,21.62,1622
2021-07-25,5324,3288,2036,61.92,1622
2021-07-26,10232,9789,443,4.53,1622
2021-07-27,9957,9920,37,0.37,1622
2021-07-28,9957,9919,38,0.38,1622
2021-07-29,9957,9906,51,0.51,1622
2021-07-30,9562,9653,-91,-0.94,1622
2021-07-31,6339,5157,1182,22.92,1622
2021-08-01,4476,3204,1272,39.7,1622
2021-08-02,8600,9675,-1075,-11.11,1622
2021-08-03,8839,9777,-938,-9.59,1622
2021-08-04,8839,9747,-908,-9.32,1622
2021-08-05,8839,9709,-870,-8.96,1622
2021-08-06,8398,9431,-1033,-10.95,1622
2021-08-07,5736,4916,820,16.68,1622
2021-08-08,4476,2948,1528,51.83,1622
2021-08-09,8600,9410,-810,-8.61,1622
2021-08-10,8839,9507,-668,-7.03,1622
2021-08-11,8839,9480,-641,-6.76,1622
2021-08-12,8839,9450,-611,-6.47,1622
2021-08-13,8398,9188,-790,-8.6,1622
2021-08-14,5736,4695,1041,22.17,1622
2021-08-15,4476,2756,1720,62.41,1622
2021-08-16,8600,9251,-651,-7.04,1622
2021-08-17,8839,9388,-549,-5.85,1622
2021-08-18,8839,9405,-566,-6.02,1622
2021-08-19,8839,9424,-585,-6.21,1622
2021-08-20,8398,9212,-814,-8.84,1622
2021-08-21,5736,4772,964,20.2,1622
2021-08-22,4476,2886,1590,55.09,1622
2021-08-23,8600,9434,-834,-8.84,1622
2021-08-24,8839,9622,-783,-8.14,1622
2021-08-25,8839,9689,-850,-8.77,1622
2021-08-26,8839,9752,-913,-9.36,1622
2021-08-27,8398,9581,-1183,-12.35,1622
2021-08-28,5736,5176,560,10.82,1622
2021-08-29,4476,3319,1157,34.86,1622
2021-08-30,8600,9890,-1290,-13.04,1622
2021-08-31,8839,10093,-1254,-12.42,1622
2021-09-01,11890,10168,1722,16.94,1622
2021-09-02,11890,10232,1658,16.2,1622
2021-09-03,11744,10055,1689,16.8,1622
2021-09-04,8005,5637,2368,42.01,1622
2021-09-05,6395,3760,2635,70.08,1622
2021-09-06,11717,10306,1411,13.69,1622
2021-09-07,11890,10480,1410,13.45,1622
2021-09-08,11890,10520,1370,13.02,1622
2021-09-09,11890,10547,1343,12.73,1622
2021-09-10,11744,10331,1413,13.68,1622
2021-09-11,8005,5872,2133,36.32,1622
2021-09-12,6395,3955,2440,61.69,1622
2021-09-13,11717,10462,1255,12.0,1622
2021-09-14,11890,10598,1292,12.19,1622
2021-09-15,11890,10604,1286,12.13,1622
2021-09-16,11890,10600,1290,12.17,1622
2021-09-17,11744,10357,1387,13.39,1622
2021-09-18,8005,5876,2129,36.23,1622
2021-09-19,6395,3943,2452,62.19,1622
2021-09-20,11717,10438,1279,12.25,1622
2021-09-21,11890,10568,1322,12.51,1622
2021-09-22,11890,10573,1317,12.46,1622
2021-09-23,11890,10573,1317,12.46,1622
2021-09-24,11744,10339,1405,13.59,1622
2021-09-25,8005,5871,2134,36.35,1622
2021-09-26,6395,3953,2442,61.78,1622
2021-09-27,11717,10467,1250,11.94,1622
2021-09-28,11890,10617,1273,11.99,1622
2021-09-29,11890,10643,1247,11.72,1622
2021-09-30,11890,10665,1225,11.49,1622
2021-10-01,11854,10451,1403,13.42,1622
2021-10-02,7848,6002,1846,30.76,1622
2021-10-03,5765,4101,1664,40.58,1622
2021-10-04,11414,10628,786,7.4,1622
2021-10-05,11731,10788,943,8.74,1622
2021-10-06,11731,10820,911,8.42,1622
2021-10-07,11731,10842,889,8.2,1622
2021-10-08,11854,10626,1228,11.56,1622
2021-10-09,7848,6169,1679,27.22,1622
2021-10-10,5765,4256,1509,35.46,1622
2021-10-11,11414,10767,647,6.01,1622
2021-10-12,11731,10908,823,7.54,1622
2021-10-13,11731,10918,813,7.45,1622
2021-10-14,11731,10916,815,7.47,1622
2021-10-15,11854,10674,1180,11.05,1622
2021-10-16,7848,6191,1657,26.76,1622
2021-10-17,5765,4251,1514,35.62,1622
2021-10-18,11414,10737,677,6.31,1622
2021-10-19,11731,10854,877,8.08,1622
2021-10-20,11731,10843,888,8.19,1622
2021-10-21,11731,10823,908,8.39,1622
2021-10-22,11854,10567,1287,12.18,1622
2021-10-23,7848,6074,1774,29.21,1622
2021-10-24,5765,4129,1636,39.62,1622
2021-10-25,11414,10614,800,7.54,1622
2021-10-26,11731,10736,995,9.27,1622
2021-10-27,11731,10733,998,9.3,1622
2021-10-28,11731,10728,1003,9.35,1622
2021-10-29,11854,10488,1366,13.02,1622
2021-10-30,7848,6016,1832,30.45,1622
2021-10-31,5765,4095,1670,40.78,1622
2021-11-01,10618,10606,12,0.11,1622
2021-11-02,11244,10755,489,4.55,1622
2021-11-03,11244,10779,465,4.31,1622
2021-11-04,11244,10799,445,4.12,1622
2021-11-05,10878,10584,294,2.78,1622
2021-11-06,7224,6134,1090,17.77,1622
2021-11-07,5213,4231,982,23.21,1622
2021-11-08,10618,10755,-137,-1.27,1622
2021-11-09,11244,10911,333,3.05,1622
2021-11-10,11244,10938,306,2.8,1622
2021-11-11,11244,10954,290,2.65,1622
2021-11-12,10878,10728,150,1.4,1622
2021-11-13,7224,6260,964,15.4,1622
2021-11-14,5213,4333,880,20.31,1622
2021-11-15,10618,10828,-210,-1.94,1622
2021-11-16,11244,10948,296,2.7,1622
2021-11-17,11244,10933,311,2.84,1622
2021-11-18,11244,10904,340,3.12,1622
2021-11-19,10878,10629,249,2.34,1622
2021-11-20,7224,6109,1115,18.25,1622
2021-11-21,5213,4128,1085,26.28,1622
2021-11-22,10618,10568,50,0.47,1622
2021-11-23,11244,10635,609,5.73,1622
2021-11-24,11244,10569,675,6.39,1622
2021-11-25,11244,10490,754,7.19,1622
2021-11-26,10878,10171,707,6.95,1622
2021-11-27,7224,5611,1613,28.75,1622
2021-11-28,5213,3597,1616,44.93,1622
2021-11-29,10618,10009,609,6.08,1622
2021-11-30,11244,10056,1188,11.81,1622
2021-12-01,9676,9977,-301,-3.02,1622
2021-12-02,9676,9893,-217,-2.19,1622
2021-12-03,8999,9576,-577,-6.03,1622
2021-12-04,6573,5026,1547,30.78,1622
2021-12-05,4690,3028,1662,54.89,1622
2021-12-06,10355,9464,891,9.41,1622
2021-12-07,9676,9539,137,1.44,1622
2021-12-08,9676,9493,183,1.93,1622
2021-12-09,9676,9447,229,2.42,1622
2021-12-10,8999,9169,-170,-1.85,1622
2021-12-11,6573,4661,1912,41.02,1622
2021-12-12,4690,2705,1985,73.38,1622
2021-12-13,10355,9182,1173,12.77,1622
2021-12-14,9676,9296,380,4.09,1622
2021-12-15,9676,9287,389,4.19,1622
2021-12-16,9676,9273,403,4.35,1622
2021-12-17,8999,9024,-25,-0.28,1622
2021-12-18,6573,4538,2035,44.84,1622
2021-12-19,4690,2599,2091,80.45,1622
2021-12-20,10355,9087,1268,13.95,1622
2021-12-21,9676,9206,470,5.11,1622
2021-12-22,9676,9195,481,5.23,1622
2021-12-23,9676,9174,502,5.47,1622
2021-12-24,8999,8911,88,0.99,1622
2021-12-25,6573,4407,2166,49.15,1622
2021-12-26,4690,2444,2246,91.9,1622
2021-12-27,10355,8905,1450,16.28,1622
2021-12-28,9676,8995,681,7.57,1622
2021-12-29,9676,8953,723,8.08,1622
2021-12-30,9676,8900,776,8.72,1622
2021-12-31,8999,8605,394,4.58,1622
2022-01-01,6386,4071,2315,56.87,1622
2022-01-02,4314,2082,2232,107.2,1622
2022-01-03,9722,8519,1203,14.12,1622
2022-01-04,9780,8590,1190,13.85,1622
2022-01-05,9780,8533,1247,14.61,1622
2022-01-06,9780,8471,1309,15.45,1622
2022-01-07,9570,8175,1395,17.06,1622
2022-01-08,6386,3645,2741,75.2,1622
2022-01-09,4314,1666,2648,158.94,1622
2022-01-10,9722,8120,1602,19.73,1622
2022-01-11,9780,8214,1566,19.07,1622
2022-01-12,9780,8186,1594,19.47,1622
2022-01-13,9780,8159,1621,19.87,1622
2022-01-14,9570,7901,1669,21.12,1622
2022-01-15,6386,3413,2973,87.11,1622
2022-01-16,4314,1479,2835,191.68,1622
2022-01-17,9722,7980,1742,21.83,1622
2022-01-18,9780,8121,1659,20.43,1622
2022-01-19,9780,8140,1640,20.15,1622
2022-01-20,9780,8158,1622,19.88,1622
2022-01-21,9570,7943,1627,20.48,1622
2022-01-22,6386,3495,2891,82.72,1622
2022-01-23,4314,1597,2717,170.13,1622
2022-01-24,9722,8130,1592,19.58,1622
2022-01-25,9780,8297,1483,17.87,1622
2022-01-26,9780,8337,1443,17.31,1622
2022-01-27,9780,8369,1411,16.86,1622
2022-01-28,9570,8163,1407,17.24,1622
2022-01-29,6386,3718,2668,71.76,1622
2022-01-30,4314,1818,2496,137.29,1622
2020-02-01,18740,17652,1088,6.16,1626
2020-02-02,16854,16145,709,4.39,1626
2020-02-03,19753,20001,-248,-1.24,1626
2020-02-04,20241,20504,-263,-1.28,1626
2020-02-05,20241,20563,-322,-1.57,1626
2020-02-06,20241,20638,-397,-1.92,1626
2020-02-07,21282,21308,-26,-0.12,1626
2020-02-08,18740,18037,703,3.9,1626
2020-02-09,16854,16495,359,2.18,1626
2020-02-10,19753,20317,-564,-2.78,1626
2020-02-11,20241,20786,-545,-2.62,1626
2020-02-12,20241,20813,-572,-2.75,1626
2020-02-13,20241,20858,-617,-2.96,1626
2020-02-14,21282,21502,-220,-1.02,1626
2020-02-15,18740,18208,532,2.92,1626
2020-02-16,16854,16648,206,1.24,1626
2020-02-17,19753,20456,-703,-3.44,1626
2020-02-18,20241,20916,-675,-3.23,1626
2020-02-19,20241,20938,-697,-3.33,1626
2020-02-20,20241,20984,-743,-3.54,1626
2020-02-21,21282,21632,-350,-1.62,1626
2020-02-22,18740,18346,394,2.15,1626
2020-02-23,16854,16797,57,0.34,1626
2020-02-24,19753,20619,-866,-4.2,1626
2020-02-25,20241,21095,-854,-4.05,1626
2020-02-26,20241,21134,-893,-4.23,1626
2020-02-27,20241,21196,-955,-4.51,1626
2020-02-28,21282,21861,-579,-2.65,1626
2020-02-29,18740,18590,150,0.81,1626
2020-03-01,11433,17055,-5622,-32.96,1626
2020-03-02,15474,20888,-5414,-25.92,1626
2020-03-03,15264,21372,-6108,-28.58,1626
2020-03-04,15264,21416,-6152,-28.73,1626
2020-03-05,15264,21479,-6215,-28.94,1626
2020-03-06,16306,22141,-5835,-26.35,1626
2020-03-07,12487,18863,-6376,-33.8,1626
2020-03-08,11433,17318,-5885,-33.98,1626
2020-03-09,15474,21136,-5662,-26.79,1626
2020-03-10,15264,21602,-6338,-29.34,1626
2020-03-11,15264,21624,-6360,-29.41,1626
2020-03-12,15264,21664,-6400,-29.54,1626
2020-03-13,16306,22301,-5995,-26.88,1626
2020-03-14,12487,18996,-6509,-34.27,1626
2020-03-15,11433,17423,-5990,-34.38,1626
2020-03-16,15474,21214,-5740,-27.06,1626
2020-03-17,15264,21654,-6390,-29.51,1626
2020-03-18,15264,21651,-6387,-29.5,1626
2020-03-19,15264,21668,-6404,-29.56,1626
2020-03-20,16306,22284,-5978,-26.83,1626
2020-03-21,12487,18962,-6475,-34.15,1626
2020-03-22,11433,17374,-5941,-34.19,1626
2020-03-23,15474,21154,-5680,-26.85,1626
2020-03-24,15264,21586,-6322,-29.29,1626
2020-03-25,15264,21579,-6315,-29.26,1626
2020-03-26,15264,21595,-6331,-29.32,1626
2020-03-27,16306,22214,-5908,-26.6,1626
2020-03-28,12487,18897,-6410,-33.92,1626
2020-03-29,11433,17318,-5885,-33.98,1626
2020-03-30,15474,21108,-5634,-26.69,1626
2020-03-31,15264,21552,-6288,-29.18,1626
2020-04-01,15189,21558,-6369,-29.54,1626
2020-04-02,15189,21588,-6399,-29.64,1626
2020-04-03,14472,22220,-7748,-34.87,1626
2020-04-04,11532,18916,-7384,-39.04,1626
2020-04-05,9434,17348,-7914,-45.62,1626
2020-04-06,15113,21148,-6035,-28.54,1626
2020-04-07,15189,21600,-6411,-29.68,1626
2020-04-08,15189,21612,-6423,-29.72,1626
2020-04-09,15189,21644,-6455,-29.82,1626
2020-04-10,14472,22276,-7804,-35.03,1626
2020-04-11,11532,18969,-7437,-39.21,1626
2020-04-12,9434,17395,-7961,-45.77,1626
2020-04-13,15113,21186,-6073,-28.67,1626
2020-04-14,15189,21627,-6438,-29.77,1626
2020-04-15,15189,21626,-6437,-29.77,1626
2020-04-16,15189,21643,-6454,-29.82,1626
2020-04-17,14472,22259,-7787,-34.98,1626
2020-04-18,11532,18935,-7403,-39.1,1626
2020-04-19,9434,17344,-7910,-45.61,1626
2020-04-20,15113,21118,-6005,-28.44,1626
2020-04-21,15189,21543,-6354,-29.49,1626
2020-04-22,15189,21527,-6338,-29.44,1626
2020-04-23,15189,21531,-6342,-29.46,1626
2020-04-24,14472,22135,-7663,-34.62,1626
2020-04-25,11532,18802,-7270,-38.67,1626
2020-04-26,9434,17204,-7770,-45.16,1626
2020-04-27,15113,20975,-5862,-27.95,1626
2020-04-28,15189,21398,-6209,-29.02,1626
2020-04-29,15189,21383,-6194,-28.97,1626
2020-04-30,15189,21391,-6202,-28.99,1626
2020-05-01,19613,22001,-2388,-10.85,1626
2020-05-02,16716,18676,-1960,-10.49,1626
2020-05-03,14409,17088,-2679,-15.68,1626
2020-05-04,18968,20869,-1901,-9.11,1626
2020-05-05,19172,21303,-2131,-10.0,1626
2020-05-06,19172,21300,-2128,-9.99,1626
2020-05-07,19172,21319,-2147,-10.07,1626
2020-05-08,19613,21940,-2327,-10.61,1626
2020-05-09,16716,18624,-1908,-10.24,1626
2020-05-10,14409,17044,-2635,-15.46,1626
2020-05-11,18968,20830,-1862,-8.94,1626
2020-05-12,19172,21268,-2096,-9.86,1626
2020-05-13,19172,21266,-2094,-9.85,1626
2020-05-14,19172,21284,-2112,-9.92,1626
2020-05-15,19613,21901,-2288,-10.45,1626
2020-05-16,16716,18579,-1863,-10.03,1626
2020-05-17,14409,16991,-2582,-15.2,1626
2020-05-18,18968,20768,-1800,-8.67,1626
2020-05-19,19172,21194,-2022,-9.54,1626
2020-05-20,19172,21179,-2007,-9.48,1626
2020-05-21,19172,21184,-2012,-9.5,1626
2020-05-22,19613,21788,-2175,-9.98,1626
2020-05-23,16716,18453,-1737,-9.41,1626
2020-05-24,14409,16853,-2444,-14.5,1626
2020-05-25,18968,20619,-1651,-8.01,1626
2020-05-26,19172,21037,-1865,-8.87,1626
2020-05-27,19172,21016,-1844,-8.77,1626
2020-05-28,19172,21017,-1845,-8.78,1626
2020-05-29,19613,21620,-2007,-9.28,1626
2020-05-30,16716,18287,-1571,-8.59,1626
2020-05-31,14409,16692,-2283,-13.68,1626
2020-06-01,20005,20467,-462,-2.26,1626
2020-06-02,20460,20895,-435,-2.08,1626
2020-06-03,20460,20887,-427,-2.04,1626
2020-06-04,20460,20903,-443,-2.12,1626
2020-06-05,20474,21523,-1049,-4.87,1626
2020-06-06,18044,18208,-164,-0.9,1626
2020-06-07,15794,16630,-836,-5.03,1626
2020-06-08,20005,20421,-416,-2.04,1626
2020-06-09,20460,20865,-405,-1.94,1626
2020-06-10,20460,20870,-410,-1.96,1626
2020-06-11,20460,20896,-436,-2.09,1626
2020-06-12,20474,21522,-1048,-4.87,1626
2020-06-13,18044,18209,-165,-0.91,1626
2020-06-14,15794,16628,-834,-5.02,1626
2020-06-15,20005,20411,-406,-1.99,1626
2020-06-16,20460,20842,-382,-1.83,1626
2020-06-17,20460,20828,-368,-1.77,1626
2020-06-18,20460,20829,-369,-1.77,1626
2020-06-19,20474,21424,-950,-4.43,1626
2020-06-20,18044,18075,-31,-0.17,1626
2020-06-21,15794,16454,-660,-4.01,1626
2020-06-22,20005,20192,-187,-0.93,1626
2020-06-23,20460,20575,-115,-0.56,1626
2020-06-24,20460,20510,-50,-0.24,1626
2020-06-25,20460,20460,0,0.0,1626
2020-06-26,20474,21003,-529,-2.52,1626
2020-06-27,18044,17603,441,2.51,1626
2020-06-28,15794,15934,-140,-0.88,1626
2020-06-29,20005,19626,379,1.93,1626
2020-06-30,20460,19968,492,2.46,1626
2020-07-01,19894,19868,26,0.13,1626
2020-07-02,19894,19788,106,0.54,1626
2020-07-03,20562,20310,252,1.24,1626
2020-07-04,17190,16897,293,1.73,1626
2020-07-05,16409,15222,1187,7.8,1626
2020-07-06,19258,18919,339,1.79,1626
2020-07-07,19894,19273,621,3.22,1626
2020-07-08,19894,19195,699,3.64,1626
2020-07-09,19894,19146,748,3.91,1626
2020-07-10,20562,19707,855,4.34,1626
2020-07-11,17190,16340,850,5.2,1626
2020-07-12,16409,14718,1691,11.49,1626
2020-07-13,19258,18473,785,4.25,1626
2020-07-14,19894,18890,1004,5.31,1626
2020-07-15,19894,18878,1016,5.38,1626
2020-07-16,19894,18897,997,5.28,1626
2020-07-17,20562,19525,1037,5.31,1626
2020-07-18,17190,16225,965,5.95,1626
2020-07-19,16409,14667,1742,11.88,1626
2020-07-20,19258,18482,776,4.2,1626
2020-07-21,19894,18955,939,4.95,1626
2020-07-22,19894,18991,903,4.75,1626
2020-07-23,19894,19052,842,4.42,1626
2020-07-24,20562,19714,848,4.3,1626
2020-07-25,17190,16439,751,4.57,1626
2020-07-26,16409,14898,1511,10.14,1626
2020-07-27,19258,18721,537,2.87,1626
2020-07-28,19894,19193,701,3.65,1626
2020-07-29,19894,19221,673,3.5,1626
2020-07-30,19894,19264,630,3.27,1626
2020-07-31,20562,19903,659,3.31,1626
2020-08-01,17698,16598,1100,6.63,1626
2020-08-02,16178,15023,1155,7.69,1626
2020-08-03,19482,18809,673,3.58,1626
2020-08-04,19963,19240,723,3.76,1626
2020-08-05,19963,19227,736,3.83,1626
2020-08-06,19963,19231,732,3.81,1626
2020-08-07,20298,19832,466,2.35,1626
2020-08-08,17698,16493,1205,7.31,1626
2020-08-09,16178,14889,1289,8.66,1626
2020-08-10,19482,18651,831,4.46,1626
2020-08-11,19963,19066,897,4.7,1626
2020-08-12,19963,19044,919,4.83,1626
2020-08-13,19963,19048,915,4.8,1626
2020-08-14,20298,19657,641,3.26,1626
2020-08-15,17698,16335,1363,8.34,1626
2020-08-16,16178,14755,1423,9.64,1626
2020-08-17,19482,18551,931,5.02,1626
2020-08-18,19963,19007,956,5.03,1626
2020-08-19,19963,19033,930,4.89,1626
2020-08-20,19963,19090,873,4.57,1626
2020-08-21,20298,19758,540,2.73,1626
2020-08-22,17698,16497,1201,7.28,1626
2020-08-23,16178,14981,1197,7.99,1626
2020-08-24,19482,18841,641,3.4,1626
2020-08-25,19963,19360,603,3.11,1626
2020-08-26,19963,19447,516,2.65,1626
2020-08-27,19963,19560,403,2.06,1626
2020-08-28,20298,20279,19,0.09,1626
2020-08-29,17698,17064,634,3.72,1626
2020-08-30,16178,15585,593,3.8,1626
2020-08-31,19482,19474,8,0.04,1626
2020-09-01,20305,20014,291,1.45,1626
2020-09-02,20305,20111,194,0.96,1626
2020-09-03,20305,20226,79,0.39,1626
2020-09-04,21419,20937,482,2.3,1626
2020-09-05,19126,17705,1421,8.03,1626
2020-09-06,17486,16200,1286,7.94,1626
2020-09-07,19896,20056,-160,-0.8,1626
2020-09-08,20305,20554,-249,-1.21,1626
2020-09-09,20305,20605,-300,-1.46,1626
2020-09-10,20305,20669,-364,-1.76,1626
2020-09-11,21419,21325,94,0.44,1626
2020-09-12,19126,18035,1091,6.05,1626
2020-09-13,17486,16473,1013,6.15,1626
2020-09-14,19896,20271,-375,-1.85,1626
2020-09-15,20305,20715,-410,-1.98,1626
2020-09-16,20305,20714,-409,-1.97,1626
2020-09-17,20305,20730,-425,-2.05,1626
2020-09-18,21419,21344,75,0.35,1626
2020-09-19,19126,18019,1107,6.14,1626
2020-09-20,17486,16428,1058,6.44,1626
2020-09-21,19896,20204,-308,-1.52,1626
2020-09-22,20305,20633,-328,-1.59,1626
2020-09-23,20305,20626,-321,-1.56,1626
2020-09-24,20305,20643,-338,-1.64,1626
2020-09-25,21419,21264,155,0.73,1626
2020-09-26,19126,17952,1174,6.54,1626
2020-09-27,17486,16380,1106,6.75,1626
2020-09-28,19896,20180,-284,-1.41,1626
2020-09-29,20305,20637,-332,-1.61,1626
2020-09-30,20305,20659,-354,-1.71,1626
2020-10-01,20597,20707,-110,-0.53,1626
2020-10-02,21368,21359,9,0.04,1626
2020-10-03,18898,18078,820,4.54,1626
2020-10-04,16807,16534,273,1.65,1626
2020-10-05,21372,20360,1012,4.97,1626
2020-10-06,20597,20838,-241,-1.16,1626
2020-10-07,20597,20876,-279,-1.34,1626
2020-10-08,20597,20935,-338,-1.61,1626
2020-10-09,21368,21593,-225,-1.04,1626
2020-10-10,18898,18311,587,3.21,1626
2020-10-11,16807,16761,46,0.27,1626
2020-10-12,21372,20575,797,3.87,1626
2020-10-13,20597,21035,-438,-2.08,1626
2020-10-14,20597,21051,-454,-2.16,1626
2020-10-15,20597,21083,-486,-2.31,1626
2020-10-16,21368,21710,-342,-1.58,1626
2020-10-17,18898,18394,504,2.74,1626
2020-10-18,16807,16809,-2,-0.01,1626
2020-10-19,21372,20586,786,3.82,1626
2020-10-20,20597,21010,-413,-1.97,1626
2020-10-21,20597,20991,-394,-1.88,1626
2020-10-22,20597,20990,-393,-1.87,1626
2020-10-23,21368,21587,-219,-1.01,1626
2020-10-24,18898,18246,652,3.57,1626
2020-10-25,16807,16639,168,1.01,1626
2020-10-26,21372,20399,973,4.77,1626
2020-10-27,20597,20812,-215,-1.03,1626
2020-10-28,20597,20788,-191,-0.92,1626
2020-10-29,20597,20787,-190,-0.91,1626
2020-10-30,21368,21389,-21,-0.1,1626
2020-10-31,18898,18058,840,4.65,1626
2020-11-01,13567,16466,-2899,-17.61,1626
2020-11-02,18648,20245,-1597,-7.89,1626
2020-11-03,17647,20679,-3032,-14.66,1626
2020-11-04,17647,20679,-3032,-14.66,1626
2020-11-05,17647,20703,-3056,-14.76,1626
2020-11-06,18722,21331,-2609,-12.23,1626
2020-11-07,15464,18025,-2561,-14.21,1626
2020-11-08,13567,16456,-2889,-17.56,1626
2020-11-09,18648,20256,-1608,-7.94,1626
2020-11-10,17647,20709,-3062,-14.79,1626
2020-11-11,17647,20722,-3075,-14.84,1626
2020-11-12,17647,20755,-3108,-14.97,1626
2020-11-13,18722,21387,-2665,-12.46,1626
2020-11-14,15464,18079,-2615,-14.46,1626
2020-11-15,13567,16504,-2937,-17.8,1626
2020-11-16,18648,20291,-1643,-8.1,1626
2020-11-17,17647,20725,-3078,-14.85,1626
2020-11-18,17647,20716,-3069,-14.81,1626
2020-11-19,17647,20722,-3075,-14.84,1626
2020-11-20,18722,21323,-2601,-12.2,1626
2020-11-21,15464,17982,-2518,-14.0,1626
2020-11-22,13567,16370,-2803,-17.12,1626
2020-11-23,18648,20121,-1473,-7.32,1626
2020-11-24,17647,20519,-2872,-14.0,1626
2020-11-25,17647,20473,-2826,-13.8,1626
2020-11-26,17647,20446,-2799,-13.69,1626
2020-11-27,18722,21016,-2294,-10.92,1626
2020-11-28,15464,17648,-2184,-12.38,1626
2020-11-29,13567,16014,-2447,-15.28,1626
2020-11-30,18648,19748,-1100,-5.57,1626
2020-12-01,18010,20134,-2124,-10.55,1626
2020-12-02,18010,20083,-2073,-10.32,1626
2020-12-03,18010,20057,-2047,-10.21,1626
2020-12-04,19824,20634,-810,-3.93,1626
2020-12-05,16175,17279,-1104,-6.39,1626
2020-12-06,13080,15664,-2584,-16.5,1626
2020-12-07,17773,19421,-1648,-8.49,1626
2020-12-08,18010,19835,-1825,-9.2,1626
2020-12-09,18010,19815,-1805,-9.11,1626
2020-12-10,18010,19822,-1812,-9.14,1626
2020-12-11,19824,20435,-611,-2.99,1626
2020-12-12,16175,17115,-940,-5.49,1626
2020-12-13,13080,15535,-2455,-15.8,1626
2020-12-14,17773,19325,-1552,-8.03,1626
2020-12-15,18010,19769,-1759,-8.9,1626
2020-12-16,18010,19776,-1766,-8.93,1626
2020-12-17,18010,19805,-1795,-9.06,1626
2020-12-18,19824,20434,-610,-2.99,1626
2020-12-19,16175,17124,-949,-5.54,1626
2020-12-20,13080,15547,-2467,-15.87,1626
2020-12-21,17773,19335,-1562,-8.08,1626
2020-12-22,18010,19770,-1760,-8.9,1626
2020-12-23,18010,19760,-1750,-8.86,1626
2020-12-24,18010,19767,-1757,-8.89,1626
2020-12-25,19824,20368,-544,-2.67,1626
2020-12-26,16175,17026,-851,-5.0,1626
2020-12-27,13080,15412,-2332,-15.13,1626
2020-12-28,17773,19160,-1387,-7.24,1626
2020-12-29,18010,19553,-1543,-7.89,1626
2020-12-30,18010,19502,-1492,-7.65,1626
2020-12-31,18010,19467,-1457,-7.48,1626
2021-01-01,18163,20029,-1866,-9.32,1626
2021-01-02,14070,16650,-2580,-15.5,1626
2021-01-03,11885,15004,-3119,-20.79,1626
2021-01-04,16708,18725,-2017,-10.77,1626
2021-01-05,17477,19098,-1621,-8.49,1626
2021-01-06,17477,19033,-1556,-8.18,1626
2021-01-07,17477,18992,-1515,-7.98,1626
2021-01-08,18163,19556,-1393,-7.12,1626
2021-01-09,14070,16188,-2118,-13.08,1626
2021-01-10,11885,14562,-2677,-18.38,1626
2021-01-11,16708,18311,-1603,-8.75,1626
2021-01-12,17477,18719,-1242,-6.63,1626
2021-01-13,17477,18698,-1221,-6.53,1626
2021-01-14,17477,18707,-1230,-6.58,1626
2021-01-15,18163,19327,-1164,-6.02,1626
2021-01-16,14070,16020,-1950,-12.17,1626
2021-01-17,11885,14459,-2574,-17.8,1626
2021-01-18,16708,18274,-1566,-8.57,1626
2021-01-19,17477,18751,-1274,-6.79,1626
2021-01-20,17477,18798,-1321,-7.03,1626
2021-01-21,17477,18873,-1396,-7.4,1626
2021-01-22,18163,19557,-1394,-7.13,1626
2021-01-23,14070,16310,-2240,-13.73,1626
2021-01-24,11885,14804,-2919,-19.72,1626
2021-01-25,16708,18668,-1960,-10.5,1626
2021-01-26,17477,19188,-1711,-8.92,1626
2021-01-27,17477,19270,-1793,-9.3,1626
2021-01-28,17477,19373,-1896,-9.79,1626
2021-01-29,18163,20077,-1914,-9.53,1626
2021-01-30,14070,16841,-2771,-16.45,1626
2021-01-31,11885,15339,-3454,-22.52,1626
2021-02-01,18713,19200,-487,-2.54,1626
2021-02-02,19077,19709,-632,-3.21,1626
2021-02-03,19077,19775,-698,-3.53,1626
2021-02-04,19077,19856,-779,-3.92,1626
2021-02-05,19802,20533,-731,-3.56,1626
2021-02-06,16412,17268,-856,-4.96,1626
2021-02-07,14080,15732,-1652,-10.5,1626
2021-02-08,18713,19560,-847,-4.33,1626
2021-02-09,19077,20034,-957,-4.78,1626
2021-02-10,19077,20065,-988,-4.92,1626
2021-02-11,19077,20114,-1037,-5.16,1626
2021-02-12,19802,20760,-958,-4.61,1626
2021-02-13,16412,17467,-1055,-6.04,1626
2021-02-14,14080,15909,-1829,-11.5,1626
2021-02-15,18713,19716,-1003,-5.09,1626
2021-02-16,19077,20176,-1099,-5.45,1626
2021-02-17,19077,20196,-1119,-5.54,1626
2021-02-18,19077,20240,-1163,-5.75,1626
2021-02-19,19802,20885,-1083,-5.19,1626
2021-02-20,16412,17596,-1184,-6.73,1626
2021-02-21,14080,16044,-1964,-12.24,1626
2021-02-22,18713,19862,-1149,-5.78,1626
2021-02-23,19077,20335,-1258,-6.19,1626
2021-02-24,19077,20371,-1294,-6.35,1626
2021-02-25,19077,20431,-1354,-6.63,1626
2021-02-26,19802,21094,-1292,-6.12,1626
2021-02-27,16412,17821,-1409,-7.91,1626
2021-02-28,14080,16285,-2205,-13.54,1626
2021-03-01,19293,20118,-825,-4.1,1626
2021-03-02,19355,20602,-1247,-6.05,1626
2021-03-03,19355,20647,-1292,-6.26,1626
2021-03-04,19355,20712,-1357,-6.55,1626
2021-03-05,20041,21377,-1336,-6.25,1626
2021-03-06,17860,18102,-242,-1.34,1626
2021-03-07,14506,16560,-2054,-12.4,1626
2021-03-08,19293,20383,-1090,-5.35,1626
2021-03-09,19355,20853,-1498,-7.18,1626
2021-03-10,19355,20881,-1526,-7.31,1626
2021-03-11,19355,20926,-1571,-7.51,1626
2021-03-12,20041,21568,-1527,-7.08,1626
2021-03-13,17860,18268,-408,-2.23,1626
2021-03-14,14506,16700,-2194,-13.14,1626
2021-03-15,19293,20495,-1202,-5.86,1626
2021-03-16,19355,20939,-1584,-7.56,1626
2021-03-17,19355,20940,-1585,-7.57,1626
2021-03-18,19355,20959,-1604,-7.65,1626
2021-03-19,20041,21577,-1536,-7.12,1626
2021-03-20,17860,18256,-396,-2.17,1626
2021-03-21,14506,16670,-2164,-12.98,1626
2021-03-22,19293,20449,-1156,-5.65,1626
2021-03-23,19355,20881,-1526,-7.31,1626
2021-03-24,19355,20873,-1518,-7.27,1626
2021-03-25,19355,20888,-1533,-7.34,1626
2021-03-26,20041,21504,-1463,-6.8,1626
2021-03-27,17860,18185,-325,-1.79,1626
2021-03-28,14506,16604,-2098,-12.64,1626
2021-03-29,19293,20391,-1098,-5.38,1626
2021-03-30,19355,20832,-1477,-7.09,1626
2021-03-31,19355,20836,-1481,-7.11,1626
2021-04-01,18656,20864,-2208,-10.58,1626
2021-04-02,19381,21494,-2113,-9.83,1626
2021-04-03,16236,18188,-1952,-10.73,1626
2021-04-04,14414,16619,-2205,-13.27,1626
2021-04-05,18975,20419,-1444,-7.07,1626
2021-04-06,18656,20870,-2214,-10.61,1626
2021-04-07,18656,20883,-2227,-10.66,1626
2021-04-08,18656,20916,-2260,-10.81,1626
2021-04-09,19381,21549,-2168,-10.06,1626
2021-04-10,16236,18244,-2008,-11.01,1626
2021-04-11,14414,16673,-2259,-13.55,1626
2021-04-12,18975,20467,-1492,-7.29,1626
2021-04-13,18656,20911,-2255,-10.78,1626
2021-04-14,18656,20913,-2257,-10.79,1626
2021-04-15,18656,20933,-2277,-10.88,1626
2021-04-16,19381,21552,-2171,-10.07,1626
2021-04-17,16236,18231,-1995,-10.94,1626
2021-04-18,14414,16643,-2229,-13.39,1626
2021-04-19,18975,20420,-1445,-7.08,1626
2021-04-20,18656,20847,-2191,-10.51,1626
2021-04-21,18656,20833,-2177,-10.45,1626
2021-04-22,18656,20838,-2182,-10.47,1626
2021-04-23,19381,21443,-2062,-9.62,1626
2021-04-24,16236,18110,-1874,-10.35,1626
2021-04-25,14414,16513,-2099,-12.71,1626
2021-04-26,18975,20282,-1307,-6.44,1626
2021-04-27,18656,20704,-2048,-9.89,1626
2021-04-28,18656,20688,-2032,-9.82,1626
2021-04-29,18656,20694,-2038,-9.85,1626
2021-04-30,19381,21302,-1921,-9.02,1626
2021-05-01,18849,17975,874,4.86,1626
2021-05-02,15760,16384,-624,-3.81,1626
2021-05-03,20123,20163,-40,-0.2,1626
2021-05-04,20711,20595,116,0.56,1626
2021-05-05,20711,20590,121,0.59,1626
2021-05-06,20711,20608,103,0.5,1626
2021-05-07,21132,21227,-95,-0.45,1626
2021-05-08,18849,17911,938,5.24,1626
2021-05-09,15760,16330,-570,-3.49,1626
2021-05-10,20123,20117,6,0.03,1626
2021-05-11,20711,20556,155,0.75,1626
2021-05-12,20711,20555,156,0.76,1626
2021-05-13,20711,20574,137,0.67,1626
2021-05-14,21132,21193,-61,-0.29,1626
2021-05-15,18849,17873,976,5.46,1626
2021-05-16,15760,16287,-527,-3.24,1626
2021-05-17,20123,20067,56,0.28,1626
2021-05-18,20711,20496,215,1.05,1626
2021-05-19,20711,20483,228,1.11,1626
2021-05-20,20711,20490,221,1.08,1626
2021-05-21,21132,21096,36,0.17,1626
2021-05-22,18849,17763,1086,6.11,1626
2021-05-23,15760,16164,-404,-2.5,1626
2021-05-24,20123,19931,192,0.96,1626
2021-05-25,20711,20349,362,1.78,1626
2021-05-26,20711,20328,383,1.88,1626
2021-05-27,20711,20328,383,1.88,1626
2021-05-28,21132,20930,202,0.97,1626
2021-05-29,18849,17595,1254,7.13,1626
2021-05-30,15760,15998,-238,-1.49,1626
2021-05-31,20123,19769,354,1.79,1626
2021-06-01,20215,20195,20,0.1,1626
2021-06-02,20215,20184,31,0.15,1626
2021-06-03,20215,20196,19,0.09,1626
2021-06-04,20734,20812,-78,-0.37,1626
2021-06-05,18906,17494,1412,8.07,1626
2021-06-06,17381,15914,1467,9.22,1626
2021-06-07,19595,19703,-108,-0.55,1626
2021-06-08,20215,20145,70,0.35,1626
2021-06-09,20215,20150,65,0.32,1626
2021-06-10,20215,20176,39,0.19,1626
2021-06-11,20734,20803,-69,-0.33,1626
2021-06-12,18906,17492,1414,8.08,1626
2021-06-13,17381,15915,1466,9.21,1626
2021-06-14,19595,19702,-107,-0.54,1626
2021-06-15,20215,20138,77,0.38,1626
2021-06-16,20215,20130,85,0.42,1626
2021-06-17,20215,20139,76,0.38,1626
2021-06-18,20734,20742,-8,-0.04,1626
2021-06-19,18906,17402,1504,8.64,1626
2021-06-20,17381,15790,1591,10.08,1626
2021-06-21,19595,19538,57,0.29,1626
2021-06-22,20215,19930,285,1.43,1626
2021-06-23,20215,19876,339,1.71,1626
2021-06-24,20215,19834,381,1.92,1626
2021-06-25,20734,20386,348,1.71,1626
2021-06-26,18906,16994,1912,11.25,1626
2021-06-27,17381,15331,2050,13.37,1626
2021-06-28,19595,19030,565,2.97,1626
2021-06-29,20215,19376,839,4.33,1626
2021-06-30,20215,19278,937,4.86,1626
2021-07-01,19354,19200,154,0.8,1626
2021-07-02,19521,19722,-201,-1.02,1626
2021-07-03,16781,16306,475,2.91,1626
2021-07-04,15265,14627,638,4.36,1626
2021-07-05,18230,18319,-89,-0.49,1626
2021-07-06,19354,18666,688,3.69,1626
2021-07-07,19354,18580,774,4.17,1626
2021-07-08,19354,18521,833,4.5,1626
2021-07-09,19521,19071,450,2.36,1626
2021-07-10,16781,15692,1089,6.94,1626
2021-07-11,15265,14058,1207,8.59,1626
2021-07-12,18230,17801,429,2.41,1626
2021-07-13,19354,18205,1149,6.31,1626
2021-07-14,19354,18181,1173,6.45,1626
2021-07-15,19354,18187,1167,6.42,1626
2021-07-16,19521,18805,716,3.81,1626
2021-07-17,16781,15494,1287,8.31,1626
2021-07-18,15265,13927,1338,9.61,1626
2021-07-19,18230,17734,496,2.8,1626
2021-07-20,19354,18200,1154,6.34,1626
2021-07-21,19354,18232,1122,6.15,1626
2021-07-22,19354,18289,1065,5.82,1626
2021-07-23,19521,18950,571,3.01,1626
2021-07-24,16781,15675,1106,7.06,1626
2021-07-25,15265,14135,1130,7.99,1626
2021-07-26,18230,17962,268,1.49,1626
2021-07-27,19354,18438,916,4.97,1626
2021-07-28,19354,18471,883,4.78,1626
2021-07-29,19354,18521,833,4.5,1626
2021-07-30,19521,19167,354,1.85,1626
2021-07-31,16781,15870,911,5.74,1626
2021-08-01,15583,14303,1280,8.95,1626
2021-08-02,18562,18096,466,2.58,1626
2021-08-03,18720,18535,185,1.0,1626
2021-08-04,18720,18528,192,1.04,1626
2021-08-05,18720,18538,182,0.98,1626
2021-08-06,18733,19144,-411,-2.15,1626
2021-08-07,16756,15808,948,6.0,1626
2021-08-08,15583,14206,1377,9.69,1626
2021-08-09,18562,17968,594,3.31,1626
2021-08-10,18720,18382,338,1.84,1626
2021-08-11,18720,18358,362,1.97,1626
2021-08-12,18720,18357,363,1.98,1626
2021-08-13,18733,18960,-227,-1.2,1626
2021-08-14,16756,15630,1126,7.2,1626
2021-08-15,15583,14042,1541,10.97,1626
2021-08-16,18562,17828,734,4.12,1626
2021-08-17,18720,18273,447,2.45,1626
2021-08-18,18720,18288,432,2.36,1626
2021-08-19,18720,18333,387,2.11,1626
2021-08-20,18733,18988,-255,-1.34,1626
2021-08-21,16756,15716,1040,6.62,1626
2021-08-22,15583,14189,1394,9.82,1626
2021-08-23,18562,18038,524,2.9,1626
2021-08-24,18720,18547,173,0.93,1626
2021-08-25,18720,18625,95,0.51,1626
2021-08-26,18720,18732,-12,-0.06,1626
2021-08-27,18733,19445,-712,-3.66,1626
2021-08-28,16756,16225,531,3.27,1626
2021-08-29,15583,14745,838,5.68,1626
2021-08-30,18562,18633,-71,-0.38,1626
2021-08-31,18720,19174,-454,-2.37,1626
2021-09-01,21767,19275,2492,12.93,1626
2021-09-02,21767,19394,2373,12.24,1626
2021-09-03,22855,20111,2744,13.64,1626
2021-09-04,21024,16886,4138,24.51,1626
2021-09-05,19278,15391,3887,25.26,1626
2021-09-06,21227,19255,1972,10.24,1626
2021-09-07,21767,19764,2003,10.13,1626
2021-09-08,21767,19826,1941,9.79,1626
2021-09-09,21767,19900,1867,9.38,1626
2021-09-10,22855,20567,2288,11.12,1626
2021-09-11,21024,17288,3736,21.61,1626
2021-09-12,19278,15735,3543,22.52,1626
2021-09-13,21227,19543,1684,8.62,1626
2021-09-14,21767,19994,1773,8.87,1626
2021-09-15,21767,20000,1767,8.83,1626
2021-09-16,21767,20022,1745,8.72,1626
2021-09-17,22855,20640,2215,10.73,1626
2021-09-18,21024,17317,3707,21.41,1626
2021-09-19,19278,15727,3551,22.58,1626
2021-09-20,21227,19504,1723,8.83,1626
2021-09-21,21767,19932,1835,9.21,1626
2021-09-22,21767,19922,1845,9.26,1626
2021-09-23,21767,19935,1832,9.19,1626
2021-09-24,22855,20551,2304,11.21,1626
2021-09-25,21024,17234,3790,21.99,1626
2021-09-26,19278,15657,3621,23.13,1626
2021-09-27,21227,19451,1776,9.13,1626
2021-09-28,21767,19902,1865,9.37,1626
2021-09-29,21767,19918,1849,9.28,1626
2021-09-30,21767,19960,1807,9.05,1626
2021-10-01,22622,20608,2014,9.77,1626
2021-10-02,21159,17322,3837,22.15,1626
2021-10-03,18442,15775,2667,16.91,1626
2021-10-04,20999,19598,1401,7.15,1626
2021-10-05,21557,20075,1482,7.38,1626
2021-10-06,21557,20114,1443,7.17,1626
2021-10-07,21557,20174,1383,6.86,1626
2021-10-08,22622,20834,1788,8.58,1626
2021-10-09,21159,17555,3604,20.53,1626
2021-10-10,18442,16010,2432,15.19,1626
2021-10-11,20999,19828,1171,5.91,1626
2021-10-12,21557,20294,1263,6.22,1626
2021-10-13,21557,20316,1241,6.11,1626
2021-10-14,21557,20354,1203,5.91,1626
2021-10-15,22622,20988,1634,7.79,1626
2021-10-16,21159,17680,3479,19.68,1626
2021-10-17,18442,16101,2341,14.54,1626
2021-10-18,20999,19884,1115,5.61,1626
2021-10-19,21557,20314,1243,6.12,1626
2021-10-20,21557,20300,1257,6.19,1626
2021-10-21,21557,20303,1254,6.18,1626
2021-10-22,22622,20904,1718,8.22,1626
2021-10-23,21159,17565,3594,20.46,1626
2021-10-24,18442,15959,2483,15.56,1626
2021-10-25,20999,19719,1280,6.49,1626
2021-10-26,21557,20131,1426,7.08,1626
2021-10-27,21557,20105,1452,7.22,1626
2021-10-28,21557,20101,1456,7.24,1626
2021-10-29,22622,20700,1922,9.29,1626
2021-10-30,21159,17365,3794,21.85,1626
2021-10-31,18442,15768,2674,16.96,1626
2021-11-01,19563,19542,21,0.11,1626
2021-11-02,20569,19972,597,2.99,1626
2021-11-03,20569,19966,603,3.02,1626
2021-11-04,20569,19986,583,2.92,1626
2021-11-05,20691,20610,81,0.39,1626
2021-11-06,19107,17300,1807,10.45,1626
2021-11-07,16738,15729,1009,6.41,1626
2021-11-08,19563,19527,36,0.18,1626
2021-11-09,20569,19978,591,2.96,1626
2021-11-10,20569,19991,578,2.89,1626
2021-11-11,20569,20026,543,2.71,1626
2021-11-12,20691,20660,31,0.15,1626
2021-11-13,19107,17355,1752,10.1,1626
2021-11-14,16738,15784,954,6.04,1626
2021-11-15,19563,19576,-13,-0.07,1626
2021-11-16,20569,20017,552,2.76,1626
2021-11-17,20569,20013,556,2.78,1626
2021-11-18,20569,20026,543,2.71,1626
2021-11-19,20691,20634,57,0.28,1626
2021-11-20,19107,17300,1807,10.45,1626
2021-11-21,16738,15695,1043,6.65,1626
2021-11-22,19563,19452,111,0.57,1626
2021-11-23,20569,19856,713,3.59,1626
2021-11-24,20569,19816,753,3.8,1626
2021-11-25,20569,19792,777,3.93,1626
2021-11-26,20691,20366,325,1.6,1626
2021-11-27,19107,17000,2107,12.39,1626
2021-11-28,16738,15368,1370,8.91,1626
2021-11-29,19563,19101,462,2.42,1626
2021-11-30,20569,19486,1083,5.56,1626
2021-12-01,19336,19433,-97,-0.5,1626
2021-12-02,19336,19403,-67,-0.35,1626
2021-12-03,19816,19976,-160,-0.8,1626
2021-12-04,17480,16616,864,5.2,1626
2021-12-05,15308,14995,313,2.09,1626
2021-12-06,19752,18745,1007,5.37,1626
2021-12-07,19336,19153,183,0.96,1626
2021-12-08,19336,19127,209,1.09,1626
2021-12-09,19336,19127,209,1.09,1626
2021-12-10,19816,19733,83,0.42,1626
2021-12-11,17480,16408,1072,6.53,1626
2021-12-12,15308,14822,486,3.28,1626
2021-12-13,19752,18608,1144,6.15,1626
2021-12-14,19336,19049,287,1.51,1626
2021-12-15,19336,19054,282,1.48,1626
2021-12-16,19336,19081,255,1.34,1626
2021-12-17,19816,19711,105,0.53,1626
2021-12-18,17480,16403,1077,6.57,1626
2021-12-19,15308,14829,479,3.23,1626
2021-12-20,19752,18620,1132,6.08,1626
2021-12-21,19336,19060,276,1.45,1626
2021-12-22,19336,19057,279,1.46,1626
2021-12-23,19336,19070,266,1.39,1626
2021-12-24,19816,19679,137,0.7,1626
2021-12-25,17480,16345,1135,6.94,1626
2021-12-26,15308,14739,569,3.86,1626
2021-12-27,19752,18495,1257,6.8,1626
2021-12-28,19336,18896,440,2.33,1626
2021-12-29,19336,18851,485,2.57,1626
2021-12-30,19336,18823,513,2.73,1626
2021-12-31,19816,19390,426,2.2,1626
2022-01-01,17565,16015,1550,9.68,1626
2022-01-02,14833,14372,461,3.21,1626
2022-01-03,19100,18094,1006,5.56,1626
2022-01-04,19459,18467,992,5.37,1626
2022-01-05,19459,18400,1059,5.76,1626
2022-01-06,19459,18356,1103,6.01,1626
2022-01-07,20242,18915,1327,7.02,1626
2022-01-08,17565,15541,2024,13.02,1626
2022-01-09,14833,13907,926,6.66,1626
2022-01-10,19100,17647,1453,8.23,1626
2022-01-11,19459,18045,1414,7.84,1626
2022-01-12,19459,18012,1447,8.03,1626
2022-01-13,19459,18010,1449,8.05,1626
2022-01-14,20242,18617,1625,8.73,1626
2022-01-15,17565,15298,2267,14.82,1626
2022-01-16,14833,13724,1109,8.08,1626
2022-01-17,19100,17527,1573,8.97,1626
2022-01-18,19459,17992,1467,8.15,1626
2022-01-19,19459,18027,1432,7.94,1626
2022-01-20,19459,18092,1367,7.56,1626
2022-01-21,20242,18767,1475,7.86,1626
2022-01-22,17565,15512,2053,13.23,1626
2022-01-23,14833,13999,834,5.96,1626
2022-01-24,19100,17858,1242,6.95,1626
2022-01-25,19459,18374,1085,5.91,1626
2022-01-26,19459,18454,1005,5.45,1626
2022-01-27,19459,18556,903,4.87,1626
2022-01-28,20242,19260,982,5.1,1626
2022-01-29,17565,16027,1538,9.6,1626
2022-01-30,14833,14528,305,2.1,1626
2020-02-01,15746,14611,1135,7.77,1182
2020-02-02,11493,10781,712,6.6,1182
2020-02-03,18630,18292,338,1.85,1182
2020-02-04,18613,18428,185,1.0,1182
2020-02-05,18613,18462,151,0.82,1182
2020-02-06,18613,18490,123,0.67,1182
2020-02-07,19899,19355,544,2.81,1182
2020-02-08,15746,14826,920,6.21,1182
2020-02-09,11493,10970,523,4.77,1182
2020-02-10,18630,18459,171,0.93,1182
2020-02-11,18613,18577,36,0.19,1182
2020-02-12,18613,18598,15,0.08,1182
2020-02-13,18613,18618,-5,-0.03,1182
2020-02-14,19899,19482,417,2.14,1182
2020-02-15,15746,14956,790,5.28,1182
2020-02-16,11493,11110,383,3.45,1182
2020-02-17,18630,18612,18,0.1,1182
2020-02-18,18613,18749,-136,-0.73,1182
2020-02-19,18613,18792,-179,-0.95,1182
2020-02-20,18613,18837,-224,-1.19,1182
2020-02-21,19899,19727,172,0.87,1182
2020-02-22,15746,15228,518,3.4,1182
2020-02-23,11493,11409,84,0.74,1182
2020-02-24,18630,18937,-307,-1.62,1182
2020-02-25,18613,19097,-484,-2.53,1182
2020-02-26,18613,19161,-548,-2.86,1182
2020-02-27,18613,19223,-610,-3.17,1182
2020-02-28,19899,20126,-227,-1.13,1182
2020-02-29,15746,15636,110,0.7,1182
2020-03-01,7940,11819,-3879,-32.82,1182
2020-03-02,14308,19344,-5036,-26.03,1182
2020-03-03,14350,19497,-5147,-26.4,1182
2020-03-04,14350,19548,-5198,-26.59,1182
2020-03-05,14350,19592,-5242,-26.76,1182
2020-03-06,15786,20473,-4687,-22.89,1182
2020-03-07,10767,15958,-5191,-32.53,1182
2020-03-08,7940,12113,-4173,-34.45,1182
2020-03-09,14308,19609,-5301,-27.03,1182
2020-03-10,14350,19731,-5381,-27.27,1182
2020-03-11,14350,19753,-5403,-27.35,1182
2020-03-12,14350,19769,-5419,-27.41,1182
2020-03-13,15786,20623,-4837,-23.45,1182
2020-03-14,10767,16085,-5318,-33.06,1182
2020-03-15,7940,12222,-4282,-35.04,1182
2020-03-16,14308,19704,-5396,-27.39,1182
2020-03-17,14350,19818,-5468,-27.59,1182
2020-03-18,14350,19837,-5487,-27.66,1182
2020-03-19,14350,19856,-5506,-27.73,1182
2020-03-20,15786,20721,-4935,-23.82,1182
2020-03-21,10767,16199,-5432,-33.53,1182
2020-03-22,7940,12357,-4417,-35.74,1182
2020-03-23,14308,19866,-5558,-27.98,1182
2020-03-24,14350,20011,-5661,-28.29,1182
2020-03-25,14350,20065,-5715,-28.48,1182
2020-03-26,14350,20122,-5772,-28.69,1182
2020-03-27,15786,21027,-5241,-24.93,1182
2020-03-28,10767,16545,-5778,-34.92,1182
2020-03-29,7940,12742,-4802,-37.69,1182
2020-03-30,14308,20290,-5982,-29.48,1182
2020-03-31,14350,20471,-6121,-29.9,1182
2020-04-01,13819,20556,-6737,-32.77,1182
2020-04-02,13819,20640,-6821,-33.05,1182
2020-04-03,13452,21565,-8113,-37.62,1182
2020-04-04,10434,17097,-6663,-38.97,1182
2020-04-05,6097,13303,-7206,-54.17,1182
2020-04-06,14023,20851,-6828,-32.75,1182
2020-04-07,13819,21024,-7205,-34.27,1182
2020-04-08,13819,21095,-7276,-34.49,1182
2020-04-09,13819,21157,-7338,-34.68,1182
2020-04-10,13452,22054,-8602,-39.0,1182
2020-04-11,10434,17552,-7118,-40.55,1182
2020-04-12,6097,13718,-7621,-55.55,1182
2020-04-13,14023,21222,-7199,-33.92,1182
2020-04-14,13819,21348,-7529,-35.27,1182
2020-04-15,13819,21369,-7550,-35.33,1182
2020-04-16,13819,21381,-7562,-35.37,1182
2020-04-17,13452,22227,-8775,-39.48,1182
2020-04-18,10434,17676,-7242,-40.97,1182
2020-04-19,6097,13795,-7698,-55.8,1182
2020-04-20,14023,21255,-7232,-34.02,1182
2020-04-21,13819,21342,-7523,-35.25,1182
2020-04-22,13819,21329,-7510,-35.21,1182
2020-04-23,13819,21312,-7493,-35.16,1182
2020-04-24,13452,22137,-8685,-39.23,1182
2020-04-25,10434,17570,-7136,-40.61,1182
2020-04-26,6097,13681,-7584,-55.43,1182
2020-04-27,14023,21139,-7116,-33.66,1182
2020-04-28,13819,21230,-7411,-34.91,1182
2020-04-29,13819,21227,-7408,-34.9,1182
2020-04-30,13819,21225,-7406,-34.89,1182
2020-05-01,18944,22069,-3125,-14.16,1182
2020-05-02,15023,17525,-2502,-14.28,1182
2020-05-03,9379,13660,-4281,-31.34,1182
2020-05-04,18080,21145,-3065,-14.5,1182
2020-05-05,18186,21263,-3077,-14.47,1182
2020-05-06,18186,21286,-3100,-14.56,1182
2020-05-07,18186,21308,-3122,-14.65,1182
2020-05-08,18944,22173,-3229,-14.56,1182
2020-05-09,15023,17647,-2624,-14.87,1182
2020-05-10,9379,13796,-4417,-32.02,1182
2020-05-11,18080,21289,-3209,-15.07,1182
2020-05-12,18186,21410,-3224,-15.06,1182
2020-05-13,18186,21431,-3245,-15.14,1182
2020-05-14,18186,21445,-3259,-15.2,1182
2020-05-15,18944,22297,-3353,-15.04,1182
2020-05-16,15023,17752,-2729,-15.37,1182
2020-05-17,9379,13877,-4498,-32.41,1182
2020-05-18,18080,21343,-3263,-15.29,1182
2020-05-19,18186,21434,-3248,-15.15,1182
2020-05-20,18186,21422,-3236,-15.11,1182
2020-05-21,18186,21402,-3216,-15.03,1182
2020-05-22,18944,22219,-3275,-14.74,1182
2020-05-23,15023,17640,-2617,-14.84,1182
2020-05-24,9379,13733,-4354,-31.7,1182
2020-05-25,18080,21168,-3088,-14.59,1182
2020-05-26,18186,21232,-3046,-14.35,1182
2020-05-27,18186,21198,-3012,-14.21,1182
2020-05-28,18186,21160,-2974,-14.05,1182
2020-05-29,18944,21964,-3020,-13.75,1182
2020-05-30,15023,17378,-2355,-13.55,1182
2020-05-31,9379,13470,-4091,-30.37,1182
2020-06-01,19168,20910,-1742,-8.33,1182
2020-06-02,19594,20984,-1390,-6.62,1182
2020-06-03,19594,20964,-1370,-6.54,1182
2020-06-04,19594,20945,-1351,-6.45,1182
2020-06-05,19014,21772,-2758,-12.67,1182
2020-06-06,15342,17211,-1869,-10.86,1182
2020-06-07,11099,13329,-2230,-16.73,1182
2020-06-08,19168,20797,-1629,-7.83,1182
2020-06-09,19594,20897,-1303,-6.24,1182
2020-06-10,19594,20902,-1308,-6.26,1182
2020-06-11,19594,20906,-1312,-6.28,1182
2020-06-12,19014,21752,-2738,-12.59,1182
2020-06-13,15342,17206,-1864,-10.83,1182
2020-06-14,11099,13333,-2234,-16.76,1182
2020-06-15,19168,20804,-1636,-7.86,1182
2020-06-16,19594,20900,-1306,-6.25,1182
2020-06-17,19594,20895,-1301,-6.23,1182
2020-06-18,19594,20882,-1288,-6.17,1182
2020-06-19,19014,21705,-2691,-12.4,1182
2020-06-20,15342,17128,-1786,-10.43,1182
2020-06-21,11099,13220,-2121,-16.04,1182
2020-06-22,19168,20650,-1482,-7.18,1182
2020-06-23,19594,20702,-1108,-5.35,1182
2020-06-24,19594,20649,-1055,-5.11,1182
2020-06-25,19594,20586,-992,-4.82,1182
2020-06-26,19014,21358,-2344,-10.97,1182
2020-06-27,15342,16732,-1390,-8.31,1182
2020-06-28,11099,12776,-1677,-13.13,1182
2020-06-29,19168,20161,-993,-4.93,1182
2020-06-30,19594,20174,-580,-2.87,1182
2020-07-01,19421,20087,-666,-3.32,1182
2020-07-02,19421,19996,-575,-2.88,1182
2020-07-03,20113,20748,-635,-3.06,1182
2020-07-04,15079,16110,-1031,-6.4,1182
2020-07-05,11626,12151,-525,-4.32,1182
2020-07-06,19280,19542,-262,-1.34,1182
2020-07-07,19421,19568,-147,-0.75,1182
2020-07-08,19421,19504,-83,-0.43,1182
2020-07-09,19421,19444,-23,-0.12,1182
2020-07-10,20113,20233,-120,-0.59,1182
2020-07-11,15079,15639,-560,-3.58,1182
2020-07-12,11626,11729,-103,-0.88,1182
2020-07-13,19280,19173,107,0.56,1182
2020-07-14,19421,19255,166,0.86,1182
2020-07-15,19421,19247,174,0.9,1182
2020-07-16,19421,19244,177,0.92,1182
2020-07-17,20113,20088,25,0.12,1182
2020-07-18,15079,15546,-467,-3.0,1182
2020-07-19,11626,11682,-56,-0.48,1182
2020-07-20,19280,19168,112,0.58,1182
2020-07-21,19421,19285,136,0.71,1182
2020-07-22,19421,19304,117,0.61,1182
2020-07-23,19421,19320,101,0.52,1182
2020-07-24,20113,20175,-62,-0.31,1182
2020-07-25,15079,15635,-556,-3.56,1182
2020-07-26,11626,11765,-139,-1.18,1182
2020-07-27,19280,19236,44,0.23,1182
2020-07-28,19421,19330,91,0.47,1182
2020-07-29,19421,19320,101,0.52,1182
2020-07-30,19421,19301,120,0.62,1182
2020-07-31,20113,20116,-3,-0.01,1182
2020-08-01,15644,15533,111,0.71,1182
2020-08-02,11814,11619,195,1.68,1182
2020-08-03,18916,19045,-129,-0.68,1182
2020-08-04,18999,19095,-96,-0.5,1182
2020-08-05,18999,19045,-46,-0.24,1182
2020-08-06,18999,18989,10,0.05,1182
2020-08-07,20018,19774,244,1.23,1182
2020-08-08,15644,15166,478,3.15,1182
2020-08-09,11814,11236,578,5.14,1182
2020-08-10,18916,18654,262,1.4,1182
2020-08-11,18999,18707,292,1.56,1182
2020-08-12,18999,18668,331,1.77,1182
2020-08-13,18999,18634,365,1.96,1182
2020-08-14,20018,19449,569,2.93,1182
2020-08-15,15644,14882,762,5.12,1182
2020-08-16,11814,11000,814,7.4,1182
2020-08-17,18916,18474,442,2.39,1182
2020-08-18,18999,18589,410,2.21,1182
2020-08-19,18999,18617,382,2.05,1182
2020-08-20,18999,18653,346,1.85,1182
2020-08-21,20018,19541,477,2.44,1182
2020-08-22,15644,15047,597,3.97,1182
2020-08-23,11814,11237,577,5.13,1182
2020-08-24,18916,18780,136,0.72,1182
2020-08-25,18999,18960,39,0.21,1182
2020-08-26,18999,19047,-48,-0.25,1182
2020-08-27,18999,19136,-137,-0.72,1182
2020-08-28,20018,20067,-49,-0.24,1182
2020-08-29,15644,15608,36,0.23,1182
2020-08-30,11814,11823,-9,-0.08,1182
2020-08-31,18916,19381,-465,-2.4,1182
2020-09-01,19524,19566,-42,-0.21,1182
2020-09-02,19524,19648,-124,-0.63,1182
2020-09-03,19524,19721,-197,-1.0,1182
2020-09-04,19965,20629,-664,-3.22,1182
2020-09-05,15842,16137,-295,-1.83,1182
2020-09-06,11848,12313,-465,-3.78,1182
2020-09-07,19131,19826,-695,-3.51,1182
2020-09-08,19524,19961,-437,-2.19,1182
2020-09-09,19524,19990,-466,-2.33,1182
2020-09-10,19524,20009,-485,-2.42,1182
2020-09-11,19965,20862,-897,-4.3,1182
2020-09-12,15842,16318,-476,-2.92,1182
2020-09-13,11848,12443,-595,-4.78,1182
2020-09-14,19131,19910,-779,-3.91,1182
2020-09-15,19524,20004,-480,-2.4,1182
2020-09-16,19524,19999,-475,-2.38,1182
2020-09-17,19524,19991,-467,-2.34,1182
2020-09-18,19965,20825,-860,-4.13,1182
2020-09-19,15842,16269,-427,-2.62,1182
2020-09-20,11848,12391,-543,-4.38,1182
2020-09-21,19131,19862,-731,-3.68,1182
2020-09-22,19524,19968,-444,-2.22,1182
2020-09-23,19524,19982,-458,-2.29,1182
2020-09-24,19524,19998,-474,-2.37,1182
2020-09-25,19965,20862,-897,-4.3,1182
2020-09-26,15842,16340,-498,-3.05,1182
2020-09-27,11848,12499,-651,-5.21,1182
2020-09-28,19131,20008,-877,-4.38,1182
2020-09-29,19524,20152,-628,-3.12,1182
2020-09-30,19524,20203,-679,-3.36,1182
2020-10-01,19480,20254,-774,-3.82,1182
2020-10-02,20567,21149,-582,-2.75,1182
2020-10-03,15934,16653,-719,-4.32,1182
2020-10-04,11380,12833,-1453,-11.32,1182
2020-10-05,19170,20356,-1186,-5.83,1182
2020-10-06,19480,20508,-1028,-5.01,1182
2020-10-07,19480,20558,-1078,-5.24,1182
2020-10-08,19480,20602,-1122,-5.45,1182
2020-10-09,20567,21482,-915,-4.26,1182
2020-10-10,15934,16964,-1030,-6.07,1182
2020-10-11,11380,13114,-1734,-13.22,1182
2020-10-12,19170,20604,-1434,-6.96,1182
2020-10-13,19480,20716,-1236,-5.97,1182
2020-10-14,19480,20723,-1243,-6.0,1182
2020-10-15,19480,20721,-1241,-5.99,1182
2020-10-16,20567,21552,-985,-4.57,1182
2020-10-17,15934,16986,-1052,-6.19,1182
2020-10-18,11380,13089,-1709,-13.06,1182
2020-10-19,19170,20533,-1363,-6.64,1182
2020-10-20,19480,20602,-1122,-5.45,1182
2020-10-21,19480,20571,-1091,-5.3,1182
2020-10-22,19480,20535,-1055,-5.14,1182
2020-10-23,20567,21339,-772,-3.62,1182
2020-10-24,15934,16750,-816,-4.87,1182
2020-10-25,11380,12838,-1458,-11.36,1182
2020-10-26,19170,20273,-1103,-5.44,1182
2020-10-27,19480,20340,-860,-4.23,1182
2020-10-28,19480,20314,-834,-4.11,1182
2020-10-29,19480,20288,-808,-3.98,1182
2020-10-30,20567,21107,-540,-2.56,1182
2020-10-31,15934,16539,-605,-3.66,1182
2020-11-01,9050,12651,-3601,-28.46,1182
2020-11-02,17576,20113,-2537,-12.61,1182
2020-11-03,15672,20208,-4536,-22.45,1182
2020-11-04,15672,20210,-4538,-22.45,1182
2020-11-05,15672,20213,-4541,-22.47,1182
2020-11-06,17082,21059,-3977,-18.89,1182
2020-11-07,13142,16515,-3373,-20.42,1182
2020-11-08,9050,12648,-3598,-28.45,1182
2020-11-09,17576,20126,-2550,-12.67,1182
2020-11-10,15672,20234,-4562,-22.55,1182
2020-11-11,15672,20242,-4570,-22.58,1182
2020-11-12,15672,20246,-4574,-22.59,1182
2020-11-13,17082,21088,-4006,-19.0,1182
2020-11-14,13142,16535,-3393,-20.52,1182
2020-11-15,9050,12653,-3603,-28.48,1182
2020-11-16,17576,20112,-2536,-12.61,1182
2020-11-17,15672,20197,-4525,-22.4,1182
2020-11-18,15672,20180,-4508,-22.34,1182
2020-11-19,15672,20155,-4483,-22.24,1182
2020-11-20,17082,20967,-3885,-18.53,1182
2020-11-21,13142,16384,-3242,-19.79,1182
2020-11-22,9050,12473,-3423,-27.44,1182
2020-11-23,17576,19905,-2329,-11.7,1182
2020-11-24,15672,19965,-4293,-21.5,1182
2020-11-25,15672,19926,-4254,-21.35,1182
2020-11-26,15672,19885,-4213,-21.19,1182
2020-11-27,17082,20686,-3604,-17.42,1182
2020-11-28,13142,16096,-2954,-18.35,1182
2020-11-29,9050,12185,-3135,-25.73,1182
2020-11-30,17576,19622,-2046,-10.43,1182
2020-12-01,16302,19693,-3391,-17.22,1182
2020-12-02,16302,19670,-3368,-17.12,1182
2020-12-03,16302,19650,-3348,-17.04,1182
2020-12-04,18408,20476,-2068,-10.1,1182
2020-12-05,13759,15916,-2157,-13.55,1182
2020-12-06,8644,12035,-3391,-28.18,1182
2020-12-07,17045,19504,-2459,-12.61,1182
2020-12-08,16302,19607,-3305,-16.86,1182
2020-12-09,16302,19616,-3314,-16.89,1182
2020-12-10,16302,19625,-3323,-16.93,1182
2020-12-11,18408,20476,-2068,-10.1,1182
2020-12-12,13759,15935,-2176,-13.66,1182
2020-12-13,8644,12069,-3425,-28.38,1182
2020-12-14,17045,19547,-2502,-12.8,1182
2020-12-15,16302,19651,-3349,-17.04,1182
2020-12-16,16302,19653,-3351,-17.05,1182
2020-12-17,16302,19647,-3345,-17.03,1182
2020-12-18,18408,20475,-2067,-10.1,1182
2020-12-19,13759,15903,-2144,-13.48,1182
2020-12-20,8644,11999,-3355,-27.96,1182
2020-12-21,17045,19430,-2385,-12.27,1182
2020-12-22,16302,19482,-3180,-16.32,1182
2020-12-23,16302,19428,-3126,-16.09,1182
2020-12-24,16302,19360,-3058,-15.8,1182
2020-12-25,18408,20125,-1717,-8.53,1182
2020-12-26,13759,15489,-1730,-11.17,1182
2020-12-27,8644,11520,-2876,-24.97,1182
2020-12-28,17045,18889,-1844,-9.76,1182
2020-12-29,16302,18882,-2580,-13.66,1182
2020-12-30,16302,18774,-2472,-13.17,1182
2020-12-31,16302,18659,-2357,-12.63,1182
2021-01-01,15751,19384,-3633,-18.74,1182
2021-01-02,11079,14717,-3638,-24.72,1182
2021-01-03,7365,10727,-3362,-31.34,1182
2021-01-04,14636,18087,-3451,-19.08,1182
2021-01-05,14919,18080,-3161,-17.48,1182
2021-01-06,14919,17983,-3064,-17.04,1182
2021-01-07,14919,17892,-2973,-16.62,1182
2021-01-08,15751,18650,-2899,-15.54,1182
2021-01-09,11079,14028,-2949,-21.02,1182
2021-01-10,7365,10091,-2726,-27.01,1182
2021-01-11,14636,17513,-2877,-16.43,1182
2021-01-12,14919,17576,-2657,-15.12,1182
2021-01-13,14919,17555,-2636,-15.02,1182
2021-01-14,14919,17543,-2624,-14.96,1182
2021-01-15,15751,18385,-2634,-14.33,1182
2021-01-16,11079,13846,-2767,-19.98,1182
2021-01-17,7365,9994,-2629,-26.31,1182
2021-01-18,14636,17497,-2861,-16.35,1182
2021-01-19,14919,17639,-2720,-15.42,1182
2021-01-20,14919,17691,-2772,-15.67,1182
2021-01-21,14919,17747,-2828,-15.94,1182
2021-01-22,15751,18649,-2898,-15.54,1182
2021-01-23,11079,14163,-3084,-21.78,1182
2021-01-24,7365,10355,-2990,-28.87,1182
2021-01-25,14636,17893,-3257,-18.2,1182
2021-01-26,14919,18060,-3141,-17.39,1182
2021-01-27,14919,18129,-3210,-17.71,1182
2021-01-28,14919,18193,-3274,-18.0,1182
2021-01-29,15751,19094,-3343,-17.51,1182
2021-01-30,11079,14600,-3521,-24.12,1182
2021-01-31,7365,10776,-3411,-31.65,1182
2021-02-01,16949,18293,-1344,-7.35,1182
2021-02-02,16734,18435,-1701,-9.23,1182
2021-02-03,16734,18475,-1741,-9.42,1182
2021-02-04,16734,18508,-1774,-9.59,1182
2021-02-05,18110,19377,-1267,-6.54,1182
2021-02-06,13478,14852,-1374,-9.25,1182
2021-02-07,9091,10998,-1907,-17.34,1182
2021-02-08,16949,18489,-1540,-8.33,1182
2021-02-09,16734,18607,-1873,-10.07,1182
2021-02-10,16734,18628,-1894,-10.17,1182
2021-02-11,16734,18646,-1912,-10.25,1182
2021-02-12,18110,19507,-1397,-7.16,1182
2021-02-13,13478,14978,-1500,-10.01,1182
2021-02-14,9091,11128,-2037,-18.31,1182
2021-02-15,16949,18625,-1676,-9.0,1182
2021-02-16,16734,18757,-2023,-10.79,1182
2021-02-17,16734,18795,-2061,-10.97,1182
2021-02-18,16734,18834,-2100,-11.15,1182
2021-02-19,18110,19719,-1609,-8.16,1182
2021-02-20,13478,15216,-1738,-11.42,1182
2021-02-21,9091,11392,-2301,-20.2,1182
2021-02-22,16949,18918,-1969,-10.41,1182
2021-02-23,16734,19075,-2341,-12.27,1182
2021-02-24,16734,19138,-2404,-12.56,1182
2021-02-25,16734,19199,-2465,-12.84,1182
2021-02-26,18110,20102,-1992,-9.91,1182
2021-02-27,13478,15613,-2135,-13.67,1182
2021-02-28,9091,11798,-2707,-22.94,1182
2021-03-01,18003,19327,-1324,-6.85,1182
2021-03-02,17955,19484,-1529,-7.85,1182
2021-03-03,17955,19540,-1585,-8.11,1182
2021-03-04,17955,19589,-1634,-8.34,1182
2021-03-05,18836,20476,-1640,-8.01,1182
2021-03-06,14926,15966,-1040,-6.51,1182
2021-03-07,9382,12127,-2745,-22.64,1182
2021-03-08,18003,19629,-1626,-8.28,1182
2021-03-09,17955,19756,-1801,-9.12,1182
2021-03-10,17955,19782,-1827,-9.24,1182
2021-03-11,17955,19801,-1846,-9.32,1182
2021-03-12,18836,20659,-1823,-8.82,1182
2021-03-13,14926,16122,-1196,-7.42,1182
2021-03-14,9382,12260,-2878,-23.47,1182
2021-03-15,18003,19742,-1739,-8.81,1182
2021-03-16,17955,19854,-1899,-9.56,1182
2021-03-17,17955,19870,-1915,-9.64,1182
2021-03-18,17955,19886,-1931,-9.71,1182
2021-03-19,18836,20745,-1909,-9.2,1182
2021-03-20,14926,16217,-1291,-7.96,1182
2021-03-21,9382,12369,-2987,-24.15,1182
2021-03-22,18003,19871,-1868,-9.4,1182
2021-03-23,17955,20009,-2054,-10.27,1182
2021-03-24,17955,20055,-2100,-10.47,1182
2021-03-25,17955,20105,-2150,-10.69,1182
2021-03-26,18836,21002,-2166,-10.31,1182
2021-03-27,14926,16513,-1587,-9.61,1182
2021-03-28,9382,12705,-3323,-26.16,1182
2021-03-29,18003,20247,-2244,-11.08,1182
2021-03-30,17955,20423,-2468,-12.08,1182
2021-03-31,17955,20506,-2551,-12.44,1182
2021-04-01,16620,20588,-3968,-19.27,1182
2021-04-02,17848,21513,-3665,-17.04,1182
2021-04-03,12673,17046,-4373,-25.65,1182
2021-04-04,9094,13254,-4160,-31.39,1182
2021-04-05,16918,20806,-3888,-18.69,1182
2021-04-06,16620,20985,-4365,-20.8,1182
2021-04-07,16620,21062,-4442,-21.09,1182
2021-04-08,16620,21131,-4511,-21.35,1182
2021-04-09,17848,22037,-4189,-19.01,1182
2021-04-10,12673,17543,-4870,-27.76,1182
2021-04-11,9094,13718,-4624,-33.71,1182
2021-04-12,16918,21232,-4314,-20.32,1182
2021-04-13,16620,21367,-4747,-22.22,1182
2021-04-14,16620,21398,-4778,-22.33,1182
2021-04-15,16620,21418,-4798,-22.4,1182
2021-04-16,17848,22273,-4425,-19.87,1182
2021-04-17,12673,17729,-5056,-28.52,1182
2021-04-18,9094,13854,-4760,-34.36,1182
2021-04-19,16918,21320,-4402,-20.65,1182
2021-04-20,16620,21411,-4791,-22.38,1182
2021-04-21,16620,21401,-4781,-22.34,1182
2021-04-22,16620,21386,-4766,-22.29,1182
2021-04-23,17848,22211,-4363,-19.64,1182
2021-04-24,12673,17643,-4970,-28.17,1182
2021-04-25,9094,13752,-4658,-33.87,1182
2021-04-26,16918,21207,-4289,-20.22,1182
2021-04-27,16620,21295,-4675,-21.95,1182
2021-04-28,16620,21287,-4667,-21.92,1182
2021-04-29,16620,21281,-4661,-21.9,1182
2021-04-30,17848,22120,-4272,-19.31,1182
2021-05-01,16305,17570,-1265,-7.2,1182
2021-05-02,10576,13701,-3125,-22.81,1182
2021-05-03,19898,21181,-1283,-6.06,1182
2021-05-04,19805,21294,-1489,-6.99,1182
2021-05-05,19805,21314,-1509,-7.08,1182
2021-05-06,19805,21333,-1528,-7.16,1182
2021-05-07,20680,22197,-1517,-6.83,1182
2021-05-08,16305,17670,-1365,-7.72,1182
2021-05-09,10576,13819,-3243,-23.47,1182
2021-05-10,19898,21313,-1415,-6.64,1182
2021-05-11,19805,21436,-1631,-7.61,1182
2021-05-12,19805,21460,-1655,-7.71,1182
2021-05-13,19805,21479,-1674,-7.79,1182
2021-05-14,20680,22336,-1656,-7.41,1182
2021-05-15,16305,17797,-1492,-8.38,1182
2021-05-16,10576,13929,-3353,-24.07,1182
2021-05-17,19898,21401,-1503,-7.02,1182
2021-05-18,19805,21498,-1693,-7.88,1182
2021-05-19,19805,21492,-1687,-7.85,1182
2021-05-20,19805,21479,-1674,-7.79,1182
2021-05-21,20680,22301,-1621,-7.27,1182
2021-05-22,16305,17727,-1422,-8.02,1182
2021-05-23,10576,13825,-3249,-23.5,1182
2021-05-24,19898,21264,-1366,-6.42,1182
2021-05-25,19805,21330,-1525,-7.15,1182
2021-05-26,19805,21297,-1492,-7.01,1182
2021-05-27,19805,21260,-1455,-6.84,1182
2021-05-28,20680,22064,-1384,-6.27,1182
2021-05-29,16305,17476,-1171,-6.7,1182
2021-05-30,10576,13565,-2989,-22.03,1182
2021-05-31,19898,21001,-1103,-5.25,1182
2021-06-01,20445,21070,-625,-2.97,1182
2021-06-02,20445,21046,-601,-2.86,1182
2021-06-03,20445,21022,-577,-2.74,1182
2021-06-04,21036,21843,-807,-3.69,1182
2021-06-05,16509,17277,-768,-4.45,1182
2021-06-06,12489,13391,-902,-6.74,1182
2021-06-07,20393,20854,-461,-2.21,1182
2021-06-08,20445,20950,-505,-2.41,1182
2021-06-09,20445,20953,-508,-2.42,1182
2021-06-10,20445,20954,-509,-2.43,1182
2021-06-11,21036,21799,-763,-3.5,1182
2021-06-12,16509,17253,-744,-4.31,1182
2021-06-13,12489,13382,-893,-6.67,1182
2021-06-14,20393,20856,-463,-2.22,1182
2021-06-15,20445,20957,-512,-2.44,1182
2021-06-16,20445,20957,-512,-2.44,1182
2021-06-17,20445,20951,-506,-2.42,1182
2021-06-18,21036,21780,-744,-3.42,1182
2021-06-19,16509,17212,-703,-4.08,1182
2021-06-20,12489,13313,-824,-6.19,1182
2021-06-21,20393,20752,-359,-1.73,1182
2021-06-22,20445,20813,-368,-1.77,1182
2021-06-23,20445,20770,-325,-1.56,1182
2021-06-24,20445,20716,-271,-1.31,1182
2021-06-25,21036,21496,-460,-2.14,1182
2021-06-26,16509,16878,-369,-2.19,1182
2021-06-27,12489,12929,-440,-3.4,1182
2021-06-28,20393,20320,73,0.36,1182
2021-06-29,20445,20336,109,0.54,1182
2021-06-30,20445,20251,194,0.96,1182
2021-07-01,18800,20162,-1362,-6.76,1182
2021-07-02,19787,20913,-1126,-5.38,1182
2021-07-03,14899,16273,-1374,-8.44,1182
2021-07-04,11143,12310,-1167,-9.48,1182
2021-07-05,18481,19695,-1214,-6.16,1182
2021-07-06,18800,19714,-914,-4.64,1182
2021-07-07,18800,19642,-842,-4.29,1182
2021-07-08,18800,19573,-773,-3.95,1182
2021-07-09,19787,20352,-565,-2.78,1182
2021-07-10,14899,15748,-849,-5.39,1182
2021-07-11,11143,11827,-684,-5.78,1182
2021-07-12,18481,19260,-779,-4.04,1182
2021-07-13,18800,19332,-532,-2.75,1182
2021-07-14,18800,19314,-514,-2.66,1182
2021-07-15,18800,19302,-502,-2.6,1182
2021-07-16,19787,20138,-351,-1.74,1182
2021-07-17,14899,15589,-690,-4.43,1182
2021-07-18,11143,11721,-578,-4.93,1182
2021-07-19,18481,19202,-721,-3.75,1182
2021-07-20,18800,19317,-517,-2.68,1182
2021-07-21,18800,19336,-536,-2.77,1182
2021-07-22,18800,19353,-553,-2.86,1182
2021-07-23,19787,20211,-424,-2.1,1182
2021-07-24,14899,15674,-775,-4.94,1182
2021-07-25,11143,11810,-667,-5.65,1182
2021-07-26,18481,19287,-806,-4.18,1182
2021-07-27,18800,19389,-589,-3.04,1182
2021-07-28,18800,19388,-588,-3.03,1182
2021-07-29,18800,19377,-577,-2.98,1182
2021-07-30,19787,20201,-414,-2.05,1182
2021-07-31,14899,15626,-727,-4.65,1182
2021-08-01,10826,11719,-893,-7.62,1182
2021-08-02,17801,19152,-1351,-7.05,1182
2021-08-03,17826,19209,-1383,-7.2,1182
2021-08-04,17826,19164,-1338,-6.98,1182
2021-08-05,17826,19111,-1285,-6.72,1182
2021-08-06,18564,19898,-1334,-6.7,1182
2021-08-07,14678,15290,-612,-4.0,1182
2021-08-08,10826,11358,-532,-4.68,1182
2021-08-09,17801,18773,-972,-5.18,1182
2021-08-10,17826,18820,-994,-5.28,1182
2021-08-11,17826,18774,-948,-5.05,1182
2021-08-12,17826,18731,-905,-4.83,1182
2021-08-13,18564,19536,-972,-4.98,1182
2021-08-14,14678,14957,-279,-1.87,1182
2021-08-15,10826,11063,-237,-2.14,1182
2021-08-16,17801,18524,-723,-3.9,1182
2021-08-17,17826,18625,-799,-4.29,1182
2021-08-18,17826,18640,-814,-4.37,1182
2021-08-19,17826,18662,-836,-4.48,1182
2021-08-20,18564,19538,-974,-4.99,1182
2021-08-21,14678,15031,-353,-2.35,1182
2021-08-22,10826,11210,-384,-3.43,1182
2021-08-23,17801,18743,-942,-5.03,1182
2021-08-24,17826,18914,-1088,-5.75,1182
2021-08-25,17826,18995,-1169,-6.15,1182
2021-08-26,17826,19079,-1253,-6.57,1182
2021-08-27,18564,20007,-1443,-7.21,1182
2021-08-28,14678,15547,-869,-5.59,1182
2021-08-29,10826,11763,-937,-7.97,1182
2021-08-30,17801,19324,-1523,-7.88,1182
2021-08-31,17826,19512,-1686,-8.64,1182
2021-09-01,20026,19601,425,2.17,1182
2021-09-02,20026,19681,345,1.75,1182
2021-09-03,20744,20598,146,0.71,1182
2021-09-04,16372,16115,257,1.59,1182
2021-09-05,12697,12301,396,3.22,1182
2021-09-06,19473,19824,-351,-1.77,1182
2021-09-07,20026,19969,57,0.29,1182
2021-09-08,20026,20008,18,0.09,1182
2021-09-09,20026,20037,-11,-0.05,1182
2021-09-10,20744,20899,-155,-0.74,1182
2021-09-11,16372,16362,10,0.06,1182
2021-09-12,12697,12494,203,1.62,1182
2021-09-13,19473,19967,-494,-2.47,1182
2021-09-14,20026,20065,-39,-0.19,1182
2021-09-15,20026,20062,-36,-0.18,1182
2021-09-16,20026,20054,-28,-0.14,1182
2021-09-17,20744,20887,-143,-0.68,1182
2021-09-18,16372,16329,43,0.26,1182
2021-09-19,12697,12447,250,2.01,1182
2021-09-20,19473,19914,-441,-2.21,1182
2021-09-21,20026,20014,12,0.06,1182
2021-09-22,20026,20022,4,0.02,1182
2021-09-23,20026,20031,-5,-0.02,1182
2021-09-24,20744,20888,-144,-0.69,1182
2021-09-25,16372,16358,14,0.09,1182
2021-09-26,12697,12510,187,1.49,1182
2021-09-27,19473,20013,-540,-2.7,1182
2021-09-28,20026,20151,-125,-0.62,1182
2021-09-29,20026,20197,-171,-0.85,1182
2021-09-30,20026,20244,-218,-1.08,1182
2021-10-01,21278,21136,142,0.67,1182
2021-10-02,16537,16638,-101,-0.61,1182
2021-10-03,11990,12817,-827,-6.45,1182
2021-10-04,19206,20342,-1136,-5.58,1182
2021-10-05,20121,20496,-375,-1.83,1182
2021-10-06,20121,20551,-430,-2.09,1182
2021-10-07,20121,20600,-479,-2.33,1182
2021-10-08,21278,21486,-208,-0.97,1182
2021-10-09,16537,16975,-438,-2.58,1182
2021-10-10,11990,13134,-1144,-8.71,1182
2021-10-11,19206,20632,-1426,-6.91,1182
2021-10-12,20121,20753,-632,-3.05,1182
2021-10-13,20121,20769,-648,-3.12,1182
2021-10-14,20121,20776,-655,-3.15,1182
2021-10-15,21278,21616,-338,-1.56,1182
2021-10-16,16537,17058,-521,-3.05,1182
2021-10-17,11990,13168,-1178,-8.95,1182
2021-10-18,19206,20618,-1412,-6.85,1182
2021-10-19,20121,20693,-572,-2.76,1182
2021-10-20,20121,20666,-545,-2.64,1182
2021-10-21,20121,20632,-511,-2.48,1182
2021-10-22,21278,21438,-160,-0.75,1182
2021-10-23,16537,16850,-313,-1.86,1182
2021-10-24,11990,12937,-947,-7.32,1182
2021-10-25,19206,20370,-1164,-5.71,1182
2021-10-26,20121,20435,-314,-1.54,1182
2021-10-27,20121,20404,-283,-1.39,1182
2021-10-28,20121,20374,-253,-1.24,1182
2021-10-29,21278,21188,90,0.42,1182
2021-10-30,16537,16615,-78,-0.47,1182
2021-10-31,11990,12721,-731,-5.75,1182
2021-11-01,17788,20177,-2389,-11.84,1182
2021-11-02,18835,20267,-1432,-7.07,1182
2021-11-03,18835,20265,-1430,-7.06,1182
2021-11-04,18835,20263,-1428,-7.05,1182
2021-11-05,20180,21106,-926,-4.39,1182
2021-11-06,15537,16560,-1023,-6.18,1182
2021-11-07,10987,12691,-1704,-13.43,1182
2021-11-08,17788,20169,-2381,-11.81,1182
2021-11-09,18835,20277,-1442,-7.11,1182
2021-11-10,18835,20288,-1453,-7.16,1182
2021-11-11,18835,20294,-1459,-7.19,1182
2021-11-12,20180,21140,-960,-4.54,1182
2021-11-13,15537,16591,-1054,-6.35,1182
2021-11-14,10987,12714,-1727,-13.58,1182
2021-11-15,17788,20178,-2390,-11.84,1182
2021-11-16,18835,20269,-1434,-7.07,1182
2021-11-17,18835,20257,-1422,-7.02,1182
2021-11-18,18835,20238,-1403,-6.93,1182
2021-11-19,20180,21056,-876,-4.16,1182
2021-11-20,15537,16477,-940,-5.7,1182
2021-11-21,10987,12570,-1583,-12.59,1182
2021-11-22,17788,20005,-2217,-11.08,1182
2021-11-23,18835,20068,-1233,-6.14,1182
2021-11-24,18835,20031,-1196,-5.97,1182
2021-11-25,18835,19990,-1155,-5.78,1182
2021-11-26,20180,20789,-609,-2.93,1182
2021-11-27,15537,16198,-661,-4.08,1182
2021-11-28,10987,12283,-1296,-10.55,1182
2021-11-29,17788,19717,-1929,-9.78,1182
2021-11-30,18835,19783,-948,-4.79,1182
2021-12-01,17442,19755,-2313,-11.71,1182
2021-12-02,17442,19729,-2287,-11.59,1182
2021-12-03,17240,20549,-3309,-16.1,1182
2021-12-04,14085,15982,-1897,-11.87,1182
2021-12-05,9755,12095,-2340,-19.35,1182
2021-12-06,17631,19559,-1928,-9.86,1182
2021-12-07,17442,19657,-2215,-11.27,1182
2021-12-08,17442,19662,-2220,-11.29,1182
2021-12-09,17442,19667,-2225,-11.31,1182
2021-12-10,17240,20516,-3276,-15.97,1182
2021-12-11,14085,15976,-1891,-11.84,1182
2021-12-12,9755,12110,-2355,-19.45,1182
2021-12-13,17631,19590,-1959,-10.0,1182
2021-12-14,17442,19698,-2256,-11.45,1182
2021-12-15,17442,19706,-2264,-11.49,1182
2021-12-16,17442,19707,-2265,-11.49,1182
2021-12-17,17240,20543,-3303,-16.08,1182
2021-12-18,14085,15981,-1896,-11.86,1182
2021-12-19,9755,12087,-2332,-19.29,1182
2021-12-20,17631,19530,-1899,-9.72,1182
2021-12-21,17442,19594,-2152,-10.98,1182
2021-12-22,17442,19551,-2109,-10.79,1182
2021-12-23,17442,19496,-2054,-10.54,1182
2021-12-24,17240,20272,-3032,-14.96,1182
2021-12-25,14085,15647,-1562,-9.98,1182
2021-12-26,9755,11688,-1933,-16.54,1182
2021-12-27,17631,19067,-1436,-7.53,1182
2021-12-28,17442,19068,-1626,-8.53,1182
2021-12-29,17442,18965,-1523,-8.03,1182
2021-12-30,17442,18855,-1413,-7.49,1182
2021-12-31,17240,19582,-2342,-11.96,1182
2022-01-01,12966,14916,-1950,-13.07,1182
2022-01-02,8746,10924,-2178,-19.94,1182
2022-01-03,15425,18279,-2854,-15.61,1182
2022-01-04,16078,18267,-2189,-11.98,1182
2022-01-05,16078,18162,-2084,-11.47,1182
2022-01-06,16078,18060,-1982,-10.97,1182
2022-01-07,17027,18808,-1781,-9.47,1182
2022-01-08,12966,14172,-1206,-8.51,1182
2022-01-09,8746,10222,-1476,-14.44,1182
2022-01-10,15425,17629,-2204,-12.5,1182
2022-01-11,16078,17677,-1599,-9.05,1182
2022-01-12,16078,17640,-1562,-8.85,1182
2022-01-13,16078,17612,-1534,-8.71,1182
2022-01-14,17027,18439,-1412,-7.66,1182
2022-01-15,12966,13886,-920,-6.63,1182
2022-01-16,8746,10020,-1274,-12.71,1182
2022-01-17,15425,17510,-2085,-11.91,1182
2022-01-18,16078,17641,-1563,-8.86,1182
2022-01-19,16078,17683,-1605,-9.08,1182
2022-01-20,16078,17731,-1653,-9.32,1182
2022-01-21,17027,18627,-1600,-8.59,1182
2022-01-22,12966,14136,-1170,-8.28,1182
2022-01-23,8746,10325,-1579,-15.29,1182
2022-01-24,15425,17861,-2436,-13.64,1182
2022-01-25,16078,18029,-1951,-10.82,1182
2022-01-26,16078,18099,-2021,-11.17,1182
2022-01-27,16078,18166,-2088,-11.49,1182
2022-01-28,17027,19071,-2044,-10.72,1182
2022-01-29,12966,14582,-1616,-11.08,1182
2022-01-30,8746,10764,-2018,-18.75,1182
2020-02-01,13280,11220,2060,18.36,1611
2020-02-02,11170,9940,1230,12.37,1611
2020-02-03,14002,13032,970,7.44,1611
2020-02-04,14374,13160,1214,9.22,1611
2020-02-05,14374,13170,1204,9.14,1611
2020-02-06,14374,13172,1202,9.13,1611
2020-02-07,15538,14088,1450,10.29,1611
2020-02-08,13280,11261,2019,17.93,1611
2020-02-09,11170,9964,1206,12.1,1611
2020-02-10,14002,13041,961,7.37,1611
2020-02-11,14374,13160,1214,9.22,1611
2020-02-12,14374,13164,1210,9.19,1611
2020-02-13,14374,13166,1208,9.18,1611
2020-02-14,15538,14085,1453,10.32,1611
2020-02-15,13280,11267,2013,17.87,1611
2020-02-16,11170,9983,1187,11.89,1611
2020-02-17,14002,13077,925,7.07,1611
2020-02-18,14374,13216,1158,8.76,1611
2020-02-19,14374,13242,1132,8.55,1611
2020-02-20,14374,13269,1105,8.33,1611
2020-02-21,15538,14214,1324,9.31,1611
2020-02-22,13280,11423,1857,16.26,1611
2020-02-23,11170,10164,1006,9.9,1611
2020-02-24,14002,13283,719,5.41,1611
2020-02-25,14374,13444,930,6.92,1611
2020-02-26,14374,13490,884,6.55,1611
2020-02-27,14374,13533,841,6.21,1611
2020-02-28,15538,14491,1047,7.23,1611
2020-02-29,13280,11707,1573,13.44,1611
2020-03-01,7717,10452,-2735,-26.17,1611
2020-03-02,10862,13570,-2708,-19.96,1611
2020-03-03,11272,13725,-2453,-17.87,1611
2020-03-04,11272,13762,-2490,-18.09,1611
2020-03-05,11272,13791,-2519,-18.27,1611
2020-03-06,11856,14730,-2874,-19.51,1611
2020-03-07,8769,11926,-3157,-26.47,1611
2020-03-08,7717,10648,-2931,-27.53,1611
2020-03-09,10862,13741,-2879,-20.95,1611
2020-03-10,11272,13871,-2599,-18.74,1611
2020-03-11,11272,13881,-2609,-18.8,1611
2020-03-12,11272,13885,-2613,-18.82,1611
2020-03-13,11856,14801,-2945,-19.9,1611
2020-03-14,8769,11976,-3207,-26.78,1611
2020-03-15,7717,10679,-2962,-27.74,1611
2020-03-16,10862,13757,-2895,-21.04,1611
2020-03-17,11272,13875,-2603,-18.76,1611
2020-03-18,11272,13879,-2607,-18.78,1611
2020-03-19,11272,13881,-2609,-18.8,1611
2020-03-20,11856,14799,-2943,-19.89,1611
2020-03-21,8769,11980,-3211,-26.8,1611
2020-03-22,7717,10694,-2977,-27.84,1611
2020-03-23,10862,13787,-2925,-21.22,1611
2020-03-24,11272,13924,-2652,-19.05,1611
2020-03-25,11272,13948,-2676,-19.19,1611
2020-03-26,11272,13973,-2701,-19.33,1611
2020-03-27,11856,14917,-3061,-20.52,1611
2020-03-28,8769,12123,-3354,-27.67,1611
2020-03-29,7717,10863,-3146,-28.96,1611
2020-03-30,10862,13980,-3118,-22.3,1611
2020-03-31,11272,14140,-2868,-20.28,1611
2020-04-01,10720,14186,-3466,-24.43,1611
2020-04-02,10720,14228,-3508,-24.66,1611
2020-04-03,10542,15185,-4643,-30.58,1611
2020-04-04,8309,12402,-4093,-33.0,1611
2020-04-05,6142,11146,-5004,-44.9,1611
2020-04-06,10490,14264,-3774,-26.46,1611
2020-04-07,10720,14420,-3700,-25.66,1611
2020-04-08,10720,14456,-3736,-25.84,1611
2020-04-09,10720,14485,-3765,-25.99,1611
2020-04-10,10542,15424,-4882,-31.65,1611
2020-04-11,8309,12618,-4309,-34.15,1611
2020-04-12,6142,11338,-5196,-45.83,1611
2020-04-13,10490,14428,-3938,-27.29,1611
2020-04-14,10720,14554,-3834,-26.34,1611
2020-04-15,10720,14559,-3839,-26.37,1611
2020-04-16,10720,14556,-3836,-26.35,1611
2020-04-17,10542,15464,-4922,-31.83,1611
2020-04-18,8309,12629,-4320,-34.21,1611
2020-04-19,6142,11320,-5178,-45.74,1611
2020-04-20,10490,14385,-3895,-27.08,1611
2020-04-21,10720,14488,-3768,-26.01,1611
2020-04-22,10720,14474,-3754,-25.94,1611
2020-04-23,10720,14456,-3736,-25.84,1611
2020-04-24,10542,15353,-4811,-31.34,1611
2020-04-25,8309,12511,-4202,-33.59,1611
2020-04-26,6142,11200,-5058,-45.16,1611
2020-04-27,10490,14266,-3776,-26.47,1611
2020-04-28,10720,14375,-3655,-25.43,1611
2020-04-29,10720,14370,-3650,-25.4,1611
2020-04-30,10720,14364,-3644,-25.37,1611
2020-05-01,14183,15275,-1092,-7.15,1611
2020-05-02,12091,12449,-358,-2.88,1611
2020-05-03,9398,11154,-1756,-15.74,1611
2020-05-04,13094,14237,-1143,-8.03,1611
2020-05-05,13588,14362,-774,-5.39,1611
2020-05-06,13588,14372,-784,-5.46,1611
2020-05-07,13588,14380,-792,-5.51,1611
2020-05-08,14183,15302,-1119,-7.31,1611
2020-05-09,12091,12484,-393,-3.15,1611
2020-05-10,9398,11194,-1796,-16.04,1611
2020-05-11,13094,14279,-1185,-8.3,1611
2020-05-12,13588,14402,-814,-5.65,1611
2020-05-13,13588,14406,-818,-5.68,1611
2020-05-14,13588,14404,-816,-5.67,1611
2020-05-15,14183,15314,-1131,-7.39,1611
2020-05-16,12091,12480,-389,-3.12,1611
2020-05-17,9398,11172,-1774,-15.88,1611
2020-05-18,13094,14237,-1143,-8.03,1611
2020-05-19,13588,14338,-750,-5.23,1611
2020-05-20,13588,14320,-732,-5.11,1611
2020-05-21,13588,14296,-708,-4.95,1611
2020-05-22,14183,15185,-1002,-6.6,1611
2020-05-23,12091,12331,-240,-1.95,1611
2020-05-24,9398,11006,-1608,-14.61,1611
2020-05-25,13094,14056,-962,-6.84,1611
2020-05-26,13588,14146,-558,-3.94,1611
2020-05-27,13588,14120,-532,-3.77,1611
2020-05-28,13588,14092,-504,-3.58,1611
2020-05-29,14183,14981,-798,-5.33,1611
2020-05-30,12091,12132,-41,-0.34,1611
2020-05-31,9398,10815,-1417,-13.1,1611
2020-06-01,13990,13877,113,0.81,1611
2020-06-02,14689,13982,707,5.06,1611
2020-06-03,14689,13974,715,5.12,1611
2020-06-04,14689,13967,722,5.17,1611
2020-06-05,14632,14876,-244,-1.64,1611
2020-06-06,12286,12049,237,1.97,1611
2020-06-07,10388,10754,-366,-3.4,1611
2020-06-08,13990,13835,155,1.12,1611
2020-06-09,14689,13959,730,5.23,1611
2020-06-10,14689,13966,723,5.18,1611
2020-06-11,14689,13969,720,5.15,1611
2020-06-12,14632,14885,-253,-1.7,1611
2020-06-13,12286,12059,227,1.88,1611
2020-06-14,10388,10759,-371,-3.45,1611
2020-06-15,13990,13830,160,1.16,1611
2020-06-16,14689,13936,753,5.4,1611
2020-06-17,14689,13920,769,5.52,1611
2020-06-18,14689,13894,795,5.72,1611
2020-06-19,14632,14775,-143,-0.97,1611
2020-06-20,12286,11909,377,3.17,1611
2020-06-21,10388,10564,-176,-1.67,1611
2020-06-22,13990,13587,403,2.97,1611
2020-06-23,14689,13642,1047,7.67,1611
2020-06-24,14689,13574,1115,8.21,1611
2020-06-25,14689,13495,1194,8.85,1611
2020-06-26,14632,14324,308,2.15,1611
2020-06-27,12286,11408,878,7.7,1611
2020-06-28,10388,10016,372,3.71,1611
2020-06-29,13990,12997,993,7.64,1611
2020-06-30,14689,13015,1674,12.86,1611
2020-07-01,14656,12916,1740,13.47,1611
2020-07-02,14656,12814,1842,14.37,1611
2020-07-03,14985,13628,1357,9.96,1611
2020-07-04,11990,10705,1285,12.0,1611
2020-07-05,11121,9315,1806,19.39,1611
2020-07-06,14285,12305,1980,16.09,1611
2020-07-07,14656,12342,2314,18.75,1611
2020-07-08,14656,12271,2385,19.44,1611
2020-07-09,14656,12203,2453,20.1,1611
2020-07-10,14985,13058,1927,14.76,1611
2020-07-11,11990,10181,1809,17.77,1611
2020-07-12,11121,8844,2277,25.75,1611
2020-07-13,14285,11889,2396,20.15,1611
2020-07-14,14656,11984,2672,22.3,1611
2020-07-15,14656,11971,2685,22.43,1611
2020-07-16,14656,11961,2695,22.53,1611
2020-07-17,14985,12872,2113,16.42,1611
2020-07-18,11990,10048,1942,19.33,1611
2020-07-19,11121,8759,2362,26.97,1611
2020-07-20,14285,11848,2437,20.57,1611
2020-07-21,14656,11979,2677,22.35,1611
2020-07-22,14656,11995,2661,22.18,1611
2020-07-23,14656,12007,2649,22.06,1611
2020-07-24,14985,12931,2054,15.88,1611
2020-07-25,11990,10113,1877,18.56,1611
2020-07-26,11121,8820,2301,26.09,1611
2020-07-27,14285,11898,2387,20.06,1611
2020-07-28,14656,12010,2646,22.03,1611
2020-07-29,14656,12001,2655,22.12,1611
2020-07-30,14656,11982,2674,22.32,1611
2020-07-31,14985,12871,2114,16.42,1611
2020-08-01,12401,10014,2387,23.84,1611
2020-08-02,10824,8680,2144,24.7,1611
2020-08-03,13227,11717,1510,12.89,1611
2020-08-04,13993,11789,2204,18.7,1611
2020-08-05,13993,11742,2251,19.17,1611
2020-08-06,13993,11688,2305,19.72,1611
2020-08-07,14749,12547,2202,17.55,1611
2020-08-08,12401,9666,2735,28.3,1611
2020-08-09,10824,8316,2508,30.16,1611
2020-08-10,13227,11344,1883,16.6,1611
2020-08-11,13993,11416,2577,22.57,1611
2020-08-12,13993,11377,2616,22.99,1611
2020-08-13,13993,11341,2652,23.38,1611
2020-08-14,14749,12228,2521,20.62,1611
2020-08-15,12401,9383,3018,32.16,1611
2020-08-16,10824,8077,2747,34.01,1611
2020-08-17,13227,11156,2071,18.56,1611
2020-08-18,13993,11286,2707,23.99,1611
2020-08-19,13993,11312,2681,23.7,1611
2020-08-20,13993,11344,2649,23.35,1611
2020-08-21,14749,12301,2448,19.9,1611
2020-08-22,12401,9528,2873,30.15,1611
2020-08-23,10824,8295,2529,30.49,1611
2020-08-24,13227,11445,1782,15.57,1611
2020-08-25,13993,11643,2350,20.18,1611
2020-08-26,13993,11731,2262,19.28,1611
2020-08-27,13993,11821,2172,18.37,1611
2020-08-28,14749,12829,1920,14.97,1611
2020-08-29,12401,10099,2302,22.79,1611
2020-08-30,10824,8899,1925,21.63,1611
2020-08-31,13227,12074,1153,9.55,1611
2020-09-01,14575,12287,2288,18.62,1611
2020-09-02,14575,12380,2195,17.73,1611
2020-09-03,14575,12466,2109,16.92,1611
2020-09-04,14957,13459,1498,11.13,1611
2020-09-05,13080,10707,2373,22.16,1611
2020-09-06,11190,9476,1714,18.09,1611
2020-09-07,13688,12612,1076,8.53,1611
2020-09-08,14575,12781,1794,14.04,1611
2020-09-09,14575,12825,1750,13.65,1611
2020-09-10,14575,12856,1719,13.37,1611
2020-09-11,14957,13794,1163,8.43,1611
2020-09-12,13080,10983,2097,19.09,1611
2020-09-13,11190,9695,1495,15.42,1611
2020-09-14,13688,12775,913,7.15,1611
2020-09-15,14575,12890,1685,13.07,1611
2020-09-16,14575,12883,1692,13.13,1611
2020-09-17,14575,12869,1706,13.26,1611
2020-09-18,14957,13766,1191,8.65,1611
2020-09-19,13080,10921,2159,19.77,1611
2020-09-20,11190,9604,1586,16.51,1611
2020-09-21,13688,12662,1026,8.1,1611
2020-09-22,14575,12762,1813,14.21,1611
2020-09-23,14575,12747,1828,14.34,1611
2020-09-24,14575,12731,1844,14.48,1611
2020-09-25,14957,13632,1325,9.72,1611
2020-09-26,13080,10796,2284,21.16,1611
2020-09-27,11190,9493,1697,17.88,1611
2020-09-28,13688,12569,1119,8.9,1611
2020-09-29,14575,12689,1886,14.86,1611
2020-09-30,14575,12697,1878,14.79,1611
2020-10-01,14338,12704,1634,12.86,1611
2020-10-02,14896,13629,1267,9.3,1611
2020-10-03,12611,10816,1795,16.6,1611
2020-10-04,11187,9535,1652,17.33,1611
2020-10-05,14084,12630,1454,11.51,1611
2020-10-06,14338,12767,1571,12.31,1611
2020-10-07,14338,12788,1550,12.12,1611
2020-10-08,14338,12805,1533,11.97,1611
2020-10-09,14896,13735,1161,8.45,1611
2020-10-10,12611,10923,1688,15.45,1611
2020-10-11,11187,9640,1547,16.05,1611
2020-10-12,14084,12728,1356,10.65,1611
2020-10-13,14338,12855,1483,11.54,1611
2020-10-14,14338,12862,1476,11.48,1611
2020-10-15,14338,12863,1475,11.47,1611
2020-10-16,14896,13775,1121,8.14,1611
2020-10-17,12611,10943,1668,15.24,1611
2020-10-18,11187,9639,1548,16.06,1611
2020-10-19,14084,12706,1378,10.85,1611
2020-10-20,14338,12812,1526,11.91,1611
2020-10-21,14338,12799,1539,12.02,1611
2020-10-22,14338,12782,1556,12.17,1611
2020-10-23,14896,13677,1219,8.91,1611
2020-10-24,12611,10832,1779,16.42,1611
2020-10-25,11187,9516,1671,17.56,1611
2020-10-26,14084,12576,1508,11.99,1611
2020-10-27,14338,12676,1662,13.11,1611
2020-10-28,14338,12662,1676,13.24,1611
2020-10-29,14338,12645,1693,13.39,1611
2020-10-30,14896,13545,1351,9.97,1611
2020-10-31,12611,10706,1905,17.79,1611
2020-11-01,9530,9398,132,1.4,1611
2020-11-02,13028,12467,561,4.5,1611
2020-11-03,12204,12579,-375,-2.98,1611
2020-11-04,12204,12576,-372,-2.96,1611
2020-11-05,12204,12571,-367,-2.92,1611
2020-11-06,13096,13482,-386,-2.86,1611
2020-11-07,10306,10654,-348,-3.27,1611
2020-11-08,9530,9356,174,1.86,1611
2020-11-09,13028,12434,594,4.78,1611
2020-11-10,12204,12552,-348,-2.77,1611
2020-11-11,12204,12554,-350,-2.79,1611
2020-11-12,12204,12552,-348,-2.77,1611
2020-11-13,13096,13463,-367,-2.73,1611
2020-11-14,10306,10634,-328,-3.08,1611
2020-11-15,9530,9333,197,2.11,1611
2020-11-16,13028,12406,622,5.01,1611
2020-11-17,12204,12519,-315,-2.52,1611
2020-11-18,12204,12514,-310,-2.48,1611
2020-11-19,12204,12505,-301,-2.41,1611
2020-11-20,13096,13410,-314,-2.34,1611
2020-11-21,10306,10575,-269,-2.54,1611
2020-11-22,9530,9270,260,2.8,1611
2020-11-23,13028,12340,688,5.58,1611
2020-11-24,12204,12451,-247,-1.98,1611
2020-11-25,12204,12448,-244,-1.96,1611
2020-11-26,12204,12443,-239,-1.92,1611
2020-11-27,13096,13354,-258,-1.93,1611
2020-11-28,10306,10528,-222,-2.11,1611
2020-11-29,9530,9234,296,3.21,1611
2020-11-30,13028,12319,709,5.76,1611
2020-12-01,12148,12447,-299,-2.4,1611
2020-12-02,12148,12462,-314,-2.52,1611
2020-12-03,12148,12476,-328,-2.63,1611
2020-12-04,13481,13408,73,0.54,1611
2020-12-05,10342,10602,-260,-2.45,1611
2020-12-06,8459,9328,-869,-9.32,1611
2020-12-07,12304,12430,-126,-1.01,1611
2020-12-08,12148,12574,-426,-3.39,1611
2020-12-09,12148,12602,-454,-3.6,1611
2020-12-10,12148,12625,-477,-3.78,1611
2020-12-11,13481,13561,-80,-0.59,1611
2020-12-12,10342,10755,-413,-3.84,1611
2020-12-13,8459,9475,-1016,-10.72,1611
2020-12-14,12304,12565,-261,-2.08,1611
2020-12-15,12148,12691,-543,-4.28,1611
2020-12-16,12148,12695,-547,-4.31,1611
2020-12-17,12148,12688,-540,-4.26,1611
2020-12-18,13481,13589,-108,-0.79,1611
2020-12-19,10342,10741,-399,-3.71,1611
2020-12-20,8459,9415,-956,-10.15,1611
2020-12-21,12304,12455,-151,-1.21,1611
2020-12-22,12148,12527,-379,-3.03,1611
2020-12-23,12148,12475,-327,-2.62,1611
2020-12-24,12148,12411,-263,-2.12,1611
2020-12-25,13481,13254,227,1.71,1611
2020-12-26,10342,10350,-8,-0.08,1611
2020-12-27,8459,8970,-511,-5.7,1611
2020-12-28,12304,11959,345,2.88,1611
2020-12-29,12148,11985,163,1.36,1611
2020-12-30,12148,11892,256,2.15,1611
2020-12-31,12148,11793,355,3.01,1611
2021-01-01,11860,12608,-748,-5.93,1611
2021-01-02,8947,9685,-738,-7.62,1611
2021-01-03,7257,8293,-1036,-12.49,1611
2021-01-04,11015,11280,-265,-2.35,1611
2021-01-05,11425,11312,113,1.0,1611
2021-01-06,11425,11234,191,1.7,1611
2021-01-07,11425,11159,266,2.38,1611
2021-01-08,11860,12007,-147,-1.22,1611
2021-01-09,8947,9123,-176,-1.93,1611
2021-01-10,7257,7777,-520,-6.69,1611
2021-01-11,11015,10816,199,1.84,1611
2021-01-12,11425,10904,521,4.78,1611
2021-01-13,11425,10887,538,4.94,1611
2021-01-14,11425,10874,551,5.07,1611
2021-01-15,11860,11785,75,0.64,1611
2021-01-16,8947,8964,-17,-0.19,1611
2021-01-17,7257,7681,-424,-5.52,1611
2021-01-18,11015,10779,236,2.19,1611
2021-01-19,11425,10924,501,4.59,1611
2021-01-20,11425,10957,468,4.27,1611
2021-01-21,11425,10991,434,3.95,1611
2021-01-22,11860,11942,-82,-0.69,1611
2021-01-23,8947,9154,-207,-2.26,1611
2021-01-24,7257,7897,-640,-8.1,1611
2021-01-25,11015,11014,1,0.01,1611
2021-01-26,11425,11171,254,2.27,1611
2021-01-27,11425,11209,216,1.93,1611
2021-01-28,11425,11241,184,1.64,1611
2021-01-29,11860,12184,-324,-2.66,1611
2021-01-30,8947,9384,-437,-4.66,1611
2021-01-31,7257,8109,-852,-10.51,1611
2021-02-01,12461,11206,1255,11.2,1611
2021-02-02,12850,11339,1511,13.33,1611
2021-02-03,12850,11352,1498,13.2,1611
2021-02-04,12850,11359,1491,13.13,1611
2021-02-05,13779,12277,1502,12.23,1611
2021-02-06,11044,9452,1592,16.84,1611
2021-02-07,8987,8156,831,10.19,1611
2021-02-08,12461,11234,1227,10.92,1611
2021-02-09,12850,11352,1498,13.2,1611
2021-02-10,12850,11354,1496,13.18,1611
2021-02-11,12850,11354,1496,13.18,1611
2021-02-12,13779,12270,1509,12.3,1611
2021-02-13,11044,9448,1596,16.89,1611
2021-02-14,8987,8159,828,10.15,1611
2021-02-15,12461,11249,1212,10.77,1611
2021-02-16,12850,11383,1467,12.89,1611
2021-02-17,12850,11404,1446,12.68,1611
2021-02-18,12850,11426,1424,12.46,1611
2021-02-19,13779,12367,1412,11.42,1611
2021-02-20,11044,9571,1473,15.39,1611
2021-02-21,8987,8308,679,8.17,1611
2021-02-22,12461,11424,1037,9.08,1611
2021-02-23,12850,11583,1267,10.94,1611
2021-02-24,12850,11627,1223,10.52,1611
2021-02-25,12850,11670,1180,10.11,1611
2021-02-26,13779,12627,1152,9.12,1611
2021-02-27,11044,9845,1199,12.18,1611
2021-02-28,8987,8591,396,4.61,1611
2021-03-01,12883,11712,1171,10.0,1611
2021-03-02,13354,11870,1484,12.5,1611
2021-03-03,13354,11911,1443,12.11,1611
2021-03-04,13354,11944,1410,11.81,1611
2021-03-05,13763,12889,874,6.78,1611
2021-03-06,12092,10089,2003,19.85,1611
2021-03-07,9152,8816,336,3.81,1611
2021-03-08,12883,11914,969,8.13,1611
2021-03-09,13354,12048,1306,10.84,1611
2021-03-10,13354,12063,1291,10.7,1611
2021-03-11,13354,12070,1284,10.64,1611
2021-03-12,13763,12989,774,5.96,1611
2021-03-13,12092,10166,1926,18.95,1611
2021-03-14,9152,8870,282,3.18,1611
2021-03-15,12883,11949,934,7.82,1611
2021-03-16,13354,12067,1287,10.67,1611
2021-03-17,13354,12070,1284,10.64,1611
2021-03-18,13354,12069,1285,10.65,1611
2021-03-19,13763,12985,778,5.99,1611
2021-03-20,12092,10163,1929,18.98,1611
2021-03-21,9152,8873,279,3.14,1611
2021-03-22,12883,11961,922,7.71,1611
2021-03-23,13354,12093,1261,10.43,1611
2021-03-24,13354,12113,1241,10.25,1611
2021-03-25,13354,12133,1221,10.06,1611
2021-03-26,13763,13072,691,5.29,1611
2021-03-27,12092,10274,1818,17.7,1611
2021-03-28,9152,9009,143,1.59,1611
2021-03-29,12883,12123,760,6.27,1611
2021-03-30,13354,12280,1074,8.75,1611
2021-03-31,13354,12324,1030,8.36,1611
2021-04-01,12170,12365,-195,-1.58,1611
2021-04-02,13147,13322,-175,-1.31,1611
2021-04-03,10438,10539,-101,-0.96,1611
2021-04-04,8762,9286,-524,-5.64,1611
2021-04-05,12089,12406,-317,-2.56,1611
2021-04-06,12170,12565,-395,-3.14,1611
2021-04-07,12170,12605,-435,-3.45,1611
2021-04-08,12170,12639,-469,-3.71,1611
2021-04-09,13147,13583,-436,-3.21,1611
2021-04-10,10438,10783,-345,-3.2,1611
2021-04-11,8762,9508,-746,-7.85,1611
2021-04-12,12089,12604,-515,-4.09,1611
2021-04-13,12170,12736,-566,-4.44,1611
2021-04-14,12170,12747,-577,-4.53,1611
2021-04-15,12170,12749,-579,-4.54,1611
2021-04-16,13147,13662,-515,-3.77,1611
2021-04-17,10438,10831,-393,-3.63,1611
2021-04-18,8762,9526,-764,-8.02,1611
2021-04-19,12089,12593,-504,-4.0,1611
2021-04-20,12170,12698,-528,-4.16,1611
2021-04-21,12170,12686,-516,-4.07,1611
2021-04-22,12170,12669,-499,-3.94,1611
2021-04-23,13147,13566,-419,-3.09,1611
2021-04-24,10438,10722,-284,-2.65,1611
2021-04-25,8762,9410,-648,-6.89,1611
2021-04-26,12089,12473,-384,-3.08,1611
2021-04-27,12170,12579,-409,-3.25,1611
2021-04-28,12170,12571,-401,-3.19,1611
2021-04-29,12170,12562,-392,-3.12,1611
2021-04-30,13147,13470,-323,-2.4,1611
2021-05-01,12200,10640,1560,14.66,1611
2021-05-02,9243,9343,-100,-1.07,1611
2021-05-03,13763,12423,1340,10.79,1611
2021-05-04,13881,12546,1335,10.64,1611
2021-05-05,13881,12555,1326,10.56,1611
2021-05-06,13881,12561,1320,10.51,1611
2021-05-07,14708,13483,1225,9.09,1611
2021-05-08,12200,10665,1535,14.39,1611
2021-05-09,9243,9376,-133,-1.42,1611
2021-05-10,13763,12463,1300,10.43,1611
2021-05-11,13881,12588,1293,10.27,1611
2021-05-12,13881,12595,1286,10.21,1611
2021-05-13,13881,12597,1284,10.19,1611
2021-05-14,14708,13510,1198,8.87,1611
2021-05-15,12200,10680,1520,14.23,1611
2021-05-16,9243,9377,-134,-1.43,1611
2021-05-17,13763,12445,1318,10.59,1611
2021-05-18,13881,12551,1330,10.6,1611
2021-05-19,13881,12537,1344,10.72,1611
2021-05-20,13881,12516,1365,10.91,1611
2021-05-21,14708,13407,1301,9.7,1611
2021-05-22,12200,10556,1644,15.57,1611
2021-05-23,9243,9233,10,0.11,1611
2021-05-24,13763,12283,1480,12.05,1611
2021-05-25,13881,12373,1508,12.19,1611
2021-05-26,13881,12347,1534,12.42,1611
2021-05-27,13881,12318,1563,12.69,1611
2021-05-28,14708,13204,1504,11.39,1611
2021-05-29,12200,10352,1848,17.85,1611
2021-05-30,9243,9032,211,2.34,1611
2021-05-31,13763,12090,1673,13.84,1611
2021-06-01,14375,12191,2184,17.91,1611
2021-06-02,14375,12179,2196,18.03,1611
2021-06-03,14375,12167,2208,18.15,1611
2021-06-04,14770,13073,1697,12.98,1611
2021-06-05,12263,10242,2021,19.73,1611
2021-06-06,10609,8944,1665,18.62,1611
2021-06-07,14254,12023,2231,18.56,1611
2021-06-08,14375,12145,2230,18.36,1611
2021-06-09,14375,12152,2223,18.29,1611
2021-06-10,14375,12155,2220,18.26,1611
2021-06-11,14770,13073,1697,12.98,1611
2021-06-12,12263,10250,2013,19.64,1611
2021-06-13,10609,8954,1655,18.48,1611
2021-06-14,14254,12030,2224,18.49,1611
2021-06-15,14375,12142,2233,18.39,1611
2021-06-16,14375,12134,2241,18.47,1611
2021-06-17,14375,12116,2259,18.64,1611
2021-06-18,14770,13006,1764,13.56,1611
2021-06-19,12263,10149,2114,20.83,1611
2021-06-20,10609,8814,1795,20.37,1611
2021-06-21,14254,11846,2408,20.33,1611
2021-06-22,14375,11911,2464,20.69,1611
2021-06-23,14375,11853,2522,21.28,1611
2021-06-24,14375,11783,2592,22.0,1611
2021-06-25,14770,12620,2150,17.04,1611
2021-06-26,12263,9711,2552,26.28,1611
2021-06-27,10609,8325,2284,27.44,1611
2021-06-28,14254,11310,2944,26.03,1611
2021-06-29,14375,11332,3043,26.85,1611
2021-06-30,14375,11235,3140,27.95,1611
2021-07-01,12740,11132,1608,14.44,1611
2021-07-02,13433,11944,1489,12.47,1611
2021-07-03,10549,9018,1531,16.98,1611
2021-07-04,9050,7623,1427,18.72,1611
2021-07-05,12324,10607,1717,16.19,1611
2021-07-06,12740,10637,2103,19.77,1611
2021-07-07,12740,10557,2183,20.68,1611
2021-07-08,12740,10479,2261,21.58,1611
2021-07-09,13433,11324,2109,18.62,1611
2021-07-10,10549,8437,2112,25.03,1611
2021-07-11,9050,7088,1962,27.68,1611
2021-07-12,12324,10123,2201,21.74,1611
2021-07-13,12740,10207,2533,24.82,1611
2021-07-14,12740,10184,2556,25.1,1611
2021-07-15,12740,10165,2575,25.33,1611
2021-07-16,13433,11067,2366,21.38,1611
2021-07-17,10549,8237,2312,28.07,1611
2021-07-18,9050,6942,2108,30.37,1611
2021-07-19,12324,10027,2297,22.91,1611
2021-07-20,12740,10155,2585,25.46,1611
2021-07-21,12740,10170,2570,25.27,1611
2021-07-22,12740,10182,2558,25.12,1611
2021-07-23,13433,11109,2324,20.92,1611
2021-07-24,10549,8294,2255,27.19,1611
2021-07-25,9050,7006,2044,29.17,1611
2021-07-26,12324,10089,2235,22.15,1611
2021-07-27,12740,10209,2531,24.79,1611
2021-07-28,12740,10207,2533,24.82,1611
2021-07-29,12740,10195,2545,24.96,1611
2021-07-30,13433,11092,2341,21.11,1611
2021-07-31,10549,8243,2306,27.98,1611
2021-08-01,8892,6917,1975,28.55,1611
2021-08-02,11849,9960,1889,18.97,1611
2021-08-03,12157,10038,2119,21.11,1611
2021-08-04,12157,9995,2162,21.63,1611
2021-08-05,12157,9945,2212,22.24,1611
2021-08-06,12817,10806,2011,18.61,1611
2021-08-07,10614,7926,2688,33.91,1611
2021-08-08,8892,6574,2318,35.26,1611
2021-08-09,11849,9599,2250,23.44,1611
2021-08-10,12157,9666,2491,25.77,1611
2021-08-11,12157,9621,2536,26.36,1611
2021-08-12,12157,9577,2580,26.94,1611
2021-08-13,12817,10454,2363,22.6,1611
2021-08-14,10614,7599,3015,39.68,1611
2021-08-15,8892,6281,2611,41.57,1611
2021-08-16,11849,9348,2501,26.75,1611
2021-08-17,12157,9465,2692,28.44,1611
2021-08-18,12157,9477,2680,28.28,1611
2021-08-19,12157,9496,2661,28.02,1611
2021-08-20,12817,10440,2377,22.77,1611
2021-08-21,10614,7654,2960,38.67,1611
2021-08-22,8892,6409,2483,38.74,1611
2021-08-23,11849,9548,2301,24.1,1611
2021-08-24,12157,9736,2421,24.87,1611
2021-08-25,12157,9817,2340,23.84,1611
2021-08-26,12157,9900,2257,22.8,1611
2021-08-27,12817,10903,1914,17.55,1611
2021-08-28,10614,8170,2444,29.91,1611
2021-08-29,8892,6969,1923,27.59,1611
2021-08-30,11849,10145,1704,16.8,1611
2021-08-31,12157,10360,1797,17.35,1611
2021-09-01,14036,10458,3578,34.21,1611
2021-09-02,14036,10549,3487,33.06,1611
2021-09-03,14834,11550,3284,28.43,1611
2021-09-04,12272,8805,3467,39.38,1611
2021-09-05,10696,7584,3112,41.03,1611
2021-09-06,13704,10730,2974,27.72,1611
2021-09-07,14036,10909,3127,28.66,1611
2021-09-08,14036,10963,3073,28.03,1611
2021-09-09,14036,11006,3030,27.53,1611
2021-09-10,14834,11954,2880,24.09,1611
2021-09-11,12272,9153,3119,34.08,1611
2021-09-12,10696,7875,2821,35.82,1611
2021-09-13,13704,10963,2741,25.0,1611
2021-09-14,14036,11085,2951,26.62,1611
2021-09-15,14036,11085,2951,26.62,1611
2021-09-16,14036,11076,2960,26.72,1611
2021-09-17,14834,11977,2857,23.85,1611
2021-09-18,12272,9135,3137,34.34,1611
2021-09-19,10696,7820,2876,36.78,1611
2021-09-20,13704,10879,2825,25.97,1611
2021-09-21,14036,10978,3058,27.86,1611
2021-09-22,14036,10961,3075,28.05,1611
2021-09-23,14036,10942,3094,28.28,1611
2021-09-24,14834,11839,2995,25.3,1611
2021-09-25,12272,9000,3272,36.36,1611
2021-09-26,10696,7692,3004,39.05,1611
2021-09-27,13704,10764,2940,27.31,1611
2021-09-28,14036,10879,3157,29.02,1611
2021-09-29,14036,10883,3153,28.97,1611
2021-09-30,14036,10886,3150,28.94,1611
2021-10-01,15439,11807,3632,30.76,1611
2021-10-02,13057,8991,4066,45.22,1611
2021-10-03,11106,7707,3399,44.1,1611
2021-10-04,14018,10801,3217,29.78,1611
2021-10-05,14172,10936,3236,29.59,1611
2021-10-06,14172,10957,3215,29.34,1611
2021-10-07,14172,10974,3198,29.14,1611
2021-10-08,15439,11905,3534,29.69,1611
2021-10-09,13057,9096,3961,43.55,1611
2021-10-10,11106,7815,3291,42.11,1611
2021-10-11,14018,10906,3112,28.53,1611
2021-10-12,14172,11036,3136,28.42,1611
2021-10-13,14172,11048,3124,28.28,1611
2021-10-14,14172,11052,3120,28.23,1611
2021-10-15,15439,11968,3471,29.0,1611
2021-10-16,13057,9140,3917,42.86,1611
2021-10-17,11106,7839,3267,41.68,1611
2021-10-18,14018,10911,3107,28.48,1611
2021-10-19,14172,11019,3153,28.61,1611
2021-10-20,14172,11010,3162,28.72,1611
2021-10-21,14172,10994,3178,28.91,1611
2021-10-22,15439,11891,3548,29.84,1611
2021-10-23,13057,9047,4010,44.32,1611
2021-10-24,11106,7731,3375,43.66,1611
2021-10-25,14018,10791,3227,29.9,1611
2021-10-26,14172,10891,3281,30.13,1611
2021-10-27,14172,10875,3297,30.32,1611
2021-10-28,14172,10857,3315,30.53,1611
2021-10-29,15439,11754,3685,31.35,1611
2021-10-30,13057,8913,4144,46.49,1611
2021-10-31,11106,7603,3503,46.07,1611
2021-11-01,12880,10670,2210,20.71,1611
2021-11-02,13329,10780,2549,23.65,1611
2021-11-03,13329,10775,2554,23.7,1611
2021-11-04,13329,10768,2561,23.78,1611
2021-11-05,14164,11677,2487,21.3,1611
2021-11-06,11747,8848,2899,32.76,1611
2021-11-07,10077,7549,2528,33.49,1611
2021-11-08,12880,10626,2254,21.21,1611
2021-11-09,13329,10744,2585,24.06,1611
2021-11-10,13329,10747,2582,24.03,1611
2021-11-11,13329,10745,2584,24.05,1611
2021-11-12,14164,11657,2507,21.51,1611
2021-11-13,11747,8829,2918,33.05,1611
2021-11-14,10077,7529,2548,33.84,1611
2021-11-15,12880,10604,2276,21.46,1611
2021-11-16,13329,10718,2611,24.36,1611
2021-11-17,13329,10715,2614,24.4,1611
2021-11-18,13329,10707,2622,24.49,1611
2021-11-19,14164,11612,2552,21.98,1611
2021-11-20,11747,8778,2969,33.82,1611
2021-11-21,10077,7472,2605,34.86,1611
2021-11-22,12880,10541,2339,22.19,1611
2021-11-23,13329,10652,2677,25.13,1611
2021-11-24,13329,10647,2682,25.19,1611
2021-11-25,13329,10640,2689,25.27,1611
2021-11-26,14164,11549,2615,22.64,1611
2021-11-27,11747,8719,3028,34.73,1611
2021-11-28,10077,7422,2655,35.77,1611
2021-11-29,12880,10503,2377,22.63,1611
2021-11-30,13329,10627,2702,25.43,1611
2021-12-01,12706,10638,2068,19.44,1611
2021-12-02,12706,10649,2057,19.32,1611
2021-12-03,12834,11577,1257,10.86,1611
2021-12-04,10574,8768,1806,20.6,1611
2021-12-05,9007,7491,1516,20.24,1611
2021-12-06,12922,10592,2330,22.0,1611
2021-12-07,12706,10734,1972,18.37,1611
2021-12-08,12706,10762,1944,18.06,1611
2021-12-09,12706,10786,1920,17.8,1611
2021-12-10,12834,11724,1110,9.47,1611
2021-12-11,10574,8921,1653,18.53,1611
2021-12-12,9007,7645,1362,17.82,1611
2021-12-13,12922,10741,2181,20.31,1611
2021-12-14,12706,10873,1833,16.86,1611
2021-12-15,12706,10884,1822,16.74,1611
2021-12-16,12706,10886,1820,16.72,1611
2021-12-17,12834,11796,1038,8.8,1611
2021-12-18,10574,8958,1616,18.04,1611
2021-12-19,9007,7642,1365,17.86,1611
2021-12-20,12922,10693,2229,20.85,1611
2021-12-21,12706,10776,1930,17.91,1611
2021-12-22,12706,10734,1972,18.37,1611
2021-12-23,12706,10680,2026,18.97,1611
2021-12-24,12834,11533,1301,11.28,1611
2021-12-25,10574,8638,1936,22.41,1611
2021-12-26,9007,7265,1742,23.98,1611
2021-12-27,12922,10261,2661,25.93,1611
2021-12-28,12706,10292,2414,23.46,1611
2021-12-29,12706,10203,2503,24.53,1611
2021-12-30,12706,10106,2600,25.73,1611
2021-12-31,12834,10923,1911,17.5,1611
2022-01-01,11004,7998,3006,37.58,1611
2022-01-02,8745,6604,2141,32.42,1611
2022-01-03,12421,9586,2835,29.57,1611
2022-01-04,12792,9613,3179,33.07,1611
2022-01-05,12792,9528,3264,34.26,1611
2022-01-06,12792,9444,3348,35.45,1611
2022-01-07,13473,10282,3191,31.03,1611
2022-01-08,11004,7388,3616,48.94,1611
2022-01-09,8745,6031,2714,45.0,1611
2022-01-10,12421,9058,3363,37.13,1611
2022-01-11,12792,9135,3657,40.03,1611
2022-01-12,12792,9105,3687,40.49,1611
2022-01-13,12792,9081,3711,40.87,1611
2022-01-14,13473,9981,3492,34.99,1611
2022-01-15,11004,7150,3854,53.9,1611
2022-01-16,8745,5857,2888,49.31,1611
2022-01-17,12421,8947,3474,38.83,1611
2022-01-18,12792,9084,3708,40.82,1611
2022-01-19,12792,9111,3681,40.4,1611
2022-01-20,12792,9140,3652,39.96,1611
2022-01-21,13473,10087,3386,33.57,1611
2022-01-22,11004,7297,3707,50.8,1611
2022-01-23,8745,6039,2706,44.81,1611
2022-01-24,12421,9157,3264,35.64,1611
2022-01-25,12792,9315,3477,37.33,1611
2022-01-26,12792,9356,3436,36.73,1611
2022-01-27,12792,9391,3401,36.22,1611
2022-01-28,13473,10338,3135,30.33,1611
2022-01-29,11004,7542,3462,45.9,1611
2022-01-30,8745,6272,2473,39.43,1611
2020-02-01,44576,42018,2558,6.09,1207
2020-02-02,37696,35637,2059,5.78,1207
2020-02-03,48503,48237,266,0.55,1207
2020-02-04,50074,49360,714,1.45,1207
2020-02-05,50074,49454,620,1.25,1207
2020-02-06,50074,49557,517,1.04,1207
2020-02-07,51583,50451,1132,2.24,1207
2020-02-08,44576,42576,2000,4.7,1207
2020-02-09,37696,36148,1548,4.28,1207
2020-02-10,48503,48705,-202,-0.41,1207
2020-02-11,50074,49787,287,0.58,1207
2020-02-12,50074,49847,227,0.46,1207
2020-02-13,50074,49921,153,0.31,1207
2020-02-14,51583,50792,791,1.56,1207
2020-02-15,44576,42901,1675,3.9,1207
2020-02-16,37696,36465,1231,3.38,1207
2020-02-17,48503,49020,-517,-1.05,1207
2020-02-18,50074,50107,-33,-0.07,1207
2020-02-19,50074,50178,-104,-0.21,1207
2020-02-20,50074,50268,-194,-0.39,1207
2020-02-21,51583,51161,422,0.82,1207
2020-02-22,44576,43295,1281,2.96,1207
2020-02-23,37696,36886,810,2.2,1207
2020-02-24,48503,49469,-966,-1.95,1207
2020-02-25,50074,50585,-511,-1.01,1207
2020-02-26,50074,50682,-608,-1.2,1207
2020-02-27,50074,50797,-723,-1.42,1207
2020-02-28,51583,51711,-128,-0.25,1207
2020-02-29,44576,43861,715,1.63,1207
2020-03-01,25773,37463,-11690,-31.2,1207
2020-03-02,38191,50053,-11862,-23.7,1207
2020-03-03,38547,51168,-12621,-24.67,1207
2020-03-04,38547,51259,-12712,-24.8,1207
2020-03-05,38547,51362,-12815,-24.95,1207
2020-03-06,39794,52257,-12463,-23.85,1207
2020-03-07,28912,44383,-15471,-34.86,1207
2020-03-08,25773,37957,-12184,-32.1,1207
2020-03-09,38191,50513,-12322,-24.39,1207
2020-03-10,38547,51592,-13045,-25.28,1207
2020-03-11,38547,51645,-13098,-25.36,1207
2020-03-12,38547,51707,-13160,-25.45,1207
2020-03-13,39794,52563,-12769,-24.29,1207
2020-03-14,28912,44650,-15738,-35.25,1207
2020-03-15,25773,38187,-12414,-32.51,1207
2020-03-16,38191,50709,-12518,-24.69,1207
2020-03-17,38547,51759,-13212,-25.53,1207
2020-03-18,38547,51786,-13239,-25.56,1207
2020-03-19,38547,51829,-13282,-25.63,1207
2020-03-20,39794,52671,-12877,-24.45,1207
2020-03-21,28912,44750,-15838,-35.39,1207
2020-03-22,25773,38285,-12512,-32.68,1207
2020-03-23,38191,50811,-12620,-24.84,1207
2020-03-24,38547,51870,-13323,-25.69,1207
2020-03-25,38547,51911,-13364,-25.74,1207
2020-03-26,38547,51973,-13426,-25.83,1207
2020-03-27,39794,52837,-13043,-24.69,1207
2020-03-28,28912,44941,-16029,-35.67,1207
2020-03-29,25773,38502,-12729,-33.06,1207
2020-03-30,38191,51055,-12864,-25.2,1207
2020-03-31,38547,52141,-13594,-26.07,1207
2020-04-01,37879,52208,-14329,-27.45,1207
2020-04-02,37879,52292,-14413,-27.56,1207
2020-04-03,35786,53175,-17389,-32.7,1207
2020-04-04,25620,45295,-19675,-43.44,1207
2020-04-05,18866,38867,-20001,-51.46,1207
2020-04-06,37486,51426,-13940,-27.11,1207
2020-04-07,37879,52512,-14633,-27.87,1207
2020-04-08,37879,52574,-14695,-27.95,1207
2020-04-09,37879,52647,-14768,-28.05,1207
2020-04-10,35786,53514,-17728,-33.13,1207
2020-04-11,25620,45613,-19993,-43.83,1207
2020-04-12,18866,39159,-20293,-51.82,1207
2020-04-13,37486,51689,-14203,-27.48,1207
2020-04-14,37879,52742,-14863,-28.18,1207
2020-04-15,37879,52769,-14890,-28.22,1207
2020-04-16,37879,52807,-14928,-28.27,1207
2020-04-17,35786,53638,-17852,-33.28,1207
2020-04-18,25620,45702,-20082,-43.94,1207
2020-04-19,18866,39214,-20348,-51.89,1207
2020-04-20,37486,51713,-14227,-27.51,1207
2020-04-21,37879,52739,-14860,-28.18,1207
2020-04-22,37879,52743,-14864,-28.18,1207
2020-04-23,37879,52762,-14883,-28.21,1207
2020-04-24,35786,53580,-17794,-33.21,1207
2020-04-25,25620,45635,-20015,-43.86,1207
2020-04-26,18866,39144,-20278,-51.8,1207
2020-04-27,37486,51645,-14159,-27.42,1207
2020-04-28,37879,52677,-14798,-28.09,1207
2020-04-29,37879,52691,-14812,-28.11,1207
2020-04-30,37879,52724,-14845,-28.16,1207
2020-05-01,48570,53557,-4987,-9.31,1207
2020-05-02,40579,45631,-5052,-11.07,1207
2020-05-03,32568,39159,-6591,-16.83,1207
2020-05-04,47275,51679,-4404,-8.52,1207
2020-05-05,48554,52730,-4176,-7.92,1207
2020-05-06,48554,52760,-4206,-7.97,1207
2020-05-07,48554,52808,-4254,-8.06,1207
2020-05-08,48570,53652,-5082,-9.47,1207
2020-05-09,40579,45733,-5154,-11.27,1207
2020-05-10,32568,39265,-6697,-17.06,1207
2020-05-11,47275,51783,-4508,-8.71,1207
2020-05-12,48554,52827,-4273,-8.09,1207
2020-05-13,48554,52847,-4293,-8.12,1207
2020-05-14,48554,52879,-4325,-8.18,1207
2020-05-15,48570,53705,-5135,-9.56,1207
2020-05-16,40579,45764,-5185,-11.33,1207
2020-05-17,32568,39270,-6702,-17.07,1207
2020-05-18,47275,51762,-4487,-8.67,1207
2020-05-19,48554,52779,-4225,-8.01,1207
2020-05-20,48554,52772,-4218,-7.99,1207
2020-05-21,48554,52778,-4224,-8.0,1207
2020-05-22,48570,53581,-5011,-9.35,1207
2020-05-23,40579,45619,-5040,-11.05,1207
2020-05-24,32568,39110,-6542,-16.73,1207
2020-05-25,47275,51590,-4315,-8.36,1207
2020-05-26,48554,52602,-4048,-7.7,1207
2020-05-27,48554,52596,-4042,-7.68,1207
2020-05-28,48554,52609,-4055,-7.71,1207
2020-05-29,48570,53424,-4854,-9.09,1207
2020-05-30,40579,45481,-4902,-10.78,1207
2020-05-31,32568,38997,-6429,-16.49,1207
2020-06-01,50317,51506,-1189,-2.31,1207
2020-06-02,51630,52551,-921,-1.75,1207
2020-06-03,51630,52580,-950,-1.81,1207
2020-06-04,51630,52631,-1001,-1.9,1207
2020-06-05,51078,53483,-2405,-4.5,1207
2020-06-06,44689,45576,-887,-1.95,1207
2020-06-07,37425,39124,-1699,-4.34,1207
2020-06-08,50317,51661,-1344,-2.6,1207
2020-06-09,51630,52727,-1097,-2.08,1207
2020-06-10,51630,52770,-1140,-2.16,1207
2020-06-11,51630,52824,-1194,-2.26,1207
2020-06-12,51078,53671,-2593,-4.83,1207
2020-06-13,44689,45746,-1057,-2.31,1207
2020-06-14,37425,39264,-1839,-4.68,1207
2020-06-15,50317,51760,-1443,-2.79,1207
2020-06-16,51630,52771,-1141,-2.16,1207
2020-06-17,51630,52747,-1117,-2.12,1207
2020-06-18,51630,52723,-1093,-2.07,1207
2020-06-19,51078,53480,-2402,-4.49,1207
2020-06-20,44689,45456,-767,-1.69,1207
2020-06-21,37425,38868,-1443,-3.71,1207
2020-06-22,50317,51250,-933,-1.82,1207
2020-06-23,51630,52144,-514,-0.99,1207
2020-06-24,51630,52001,-371,-0.71,1207
2020-06-25,51630,51858,-228,-0.44,1207
2020-06-26,51078,52499,-1421,-2.71,1207
2020-06-27,44689,44364,325,0.73,1207
2020-06-28,37425,37672,-247,-0.66,1207
2020-06-29,50317,49962,355,0.71,1207
2020-06-30,51630,50776,854,1.68,1207
2020-07-01,52519,50566,1953,3.86,1207
2020-07-02,52519,50373,2146,4.26,1207
2020-07-03,52953,50982,1971,3.87,1207
2020-07-04,45149,42833,2316,5.41,1207
2020-07-05,40913,36146,4767,13.19,1207
2020-07-06,51554,48459,3095,6.39,1207
2020-07-07,52519,49316,3203,6.49,1207
2020-07-08,52519,49167,3352,6.82,1207
2020-07-09,52519,49052,3467,7.07,1207
2020-07-10,52953,49755,3198,6.43,1207
2020-07-11,45149,41714,3435,8.23,1207
2020-07-12,40913,35146,5767,16.41,1207
2020-07-13,51554,47588,3966,8.33,1207
2020-07-14,52519,48581,3938,8.11,1207
2020-07-15,52519,48572,3947,8.13,1207
2020-07-16,52519,48598,3921,8.07,1207
2020-07-17,52953,49439,3514,7.11,1207
2020-07-18,45149,41533,3616,8.71,1207
2020-07-19,40913,35092,5821,16.59,1207
2020-07-20,51554,47652,3902,8.19,1207
2020-07-21,52519,48750,3769,7.73,1207
2020-07-22,52519,48834,3685,7.55,1207
2020-07-23,52519,48937,3582,7.32,1207
2020-07-24,52953,49838,3115,6.25,1207
2020-07-25,45149,41975,3174,7.56,1207
2020-07-26,40913,35561,5352,15.05,1207
2020-07-27,51554,48130,3424,7.11,1207
2020-07-28,52519,49221,3298,6.7,1207
2020-07-29,52519,49281,3238,6.57,1207
2020-07-30,52519,49346,3173,6.43,1207
2020-07-31,52953,50198,2755,5.49,1207
2020-08-01,44917,42275,2642,6.25,1207
2020-08-02,39128,35793,3335,9.32,1207
2020-08-03,49863,48289,1574,3.26,1207
2020-08-04,50825,49303,1522,3.09,1207
2020-08-05,50825,49287,1538,3.12,1207
2020-08-06,50825,49279,1546,3.14,1207
2020-08-07,51170,50063,1107,2.21,1207
2020-08-08,44917,42080,2837,6.74,1207
2020-08-09,39128,35547,3581,10.07,1207
2020-08-10,49863,48003,1860,3.87,1207
2020-08-11,50825,48992,1833,3.74,1207
2020-08-12,50825,48964,1861,3.8,1207
2020-08-13,50825,48959,1866,3.81,1207
2020-08-14,51170,49762,1408,2.83,1207
2020-08-15,44917,41813,3104,7.42,1207
2020-08-16,39128,35329,3799,10.75,1207
2020-08-17,49863,47849,2014,4.21,1207
2020-08-18,50825,48913,1912,3.91,1207
2020-08-19,50825,48973,1852,3.78,1207
2020-08-20,50825,49064,1761,3.59,1207
2020-08-21,51170,49970,1200,2.4,1207
2020-08-22,44917,42129,2788,6.62,1207
2020-08-23,39128,35755,3373,9.43,1207
2020-08-24,49863,48384,1479,3.06,1207
2020-08-25,50825,49555,1270,2.56,1207
2020-08-26,50825,49715,1110,2.23,1207
2020-08-27,50825,49900,925,1.85,1207
2020-08-28,51170,50889,281,0.55,1207
2020-08-29,44917,43119,1798,4.17,1207
2020-08-30,39128,36803,2325,6.32,1207
2020-08-31,49863,49475,388,0.78,1207
2020-09-01,50899,50673,226,0.45,1207
2020-09-02,50899,50845,54,0.11,1207
2020-09-03,50899,51025,-126,-0.25,1207
2020-09-04,52169,51993,176,0.34,1207
2020-09-05,45814,44187,1627,3.68,1207
2020-09-06,39180,37821,1359,3.59,1207
2020-09-07,49350,50431,-1081,-2.14,1207
2020-09-08,50899,51555,-656,-1.27,1207
2020-09-09,50899,51644,-745,-1.44,1207
2020-09-10,50899,51734,-835,-1.61,1207
2020-09-11,52169,52608,-439,-0.83,1207
2020-09-12,45814,44705,1109,2.48,1207
2020-09-13,39180,38241,939,2.46,1207
2020-09-14,49350,50755,-1405,-2.77,1207
2020-09-15,50899,51787,-888,-1.71,1207
2020-09-16,50899,51790,-891,-1.72,1207
2020-09-17,50899,51802,-903,-1.74,1207
2020-09-18,52169,52606,-437,-0.83,1207
2020-09-19,45814,44643,1171,2.62,1207
2020-09-20,39180,38131,1049,2.75,1207
2020-09-21,49350,50607,-1257,-2.48,1207
2020-09-22,50899,51614,-715,-1.39,1207
2020-09-23,50899,51603,-704,-1.36,1207
2020-09-24,50899,51612,-713,-1.38,1207
2020-09-25,52169,52423,-254,-0.48,1207
2020-09-26,45814,44477,1337,3.01,1207
2020-09-27,39180,37989,1191,3.14,1207
2020-09-28,49350,50496,-1146,-2.27,1207
2020-09-29,50899,51540,-641,-1.24,1207
2020-09-30,50899,51568,-669,-1.3,1207
2020-10-01,48791,51617,-2826,-5.47,1207
2020-10-02,51472,52469,-997,-1.9,1207
2020-10-03,43784,44562,-778,-1.75,1207
2020-10-04,37354,38110,-756,-1.98,1207
2020-10-05,47759,50649,-2890,-5.71,1207
2020-10-06,48791,51718,-2927,-5.66,1207
2020-10-07,48791,51766,-2975,-5.75,1207
2020-10-08,48791,51828,-3037,-5.86,1207
2020-10-09,51472,52685,-1213,-2.3,1207
2020-10-10,43784,44775,-991,-2.21,1207
2020-10-11,37354,38314,-960,-2.51,1207
2020-10-12,47759,50835,-3076,-6.05,1207
2020-10-13,48791,51881,-3090,-5.96,1207
2020-10-14,48791,51900,-3109,-5.99,1207
2020-10-15,48791,51928,-3137,-6.04,1207
2020-10-16,51472,52748,-1276,-2.42,1207
2020-10-17,43784,44798,-1014,-2.26,1207
2020-10-18,37354,38297,-943,-2.46,1207
2020-10-19,47759,50779,-3020,-5.95,1207
2020-10-20,48791,51787,-2996,-5.79,1207
2020-10-21,48791,51771,-2980,-5.76,1207
2020-10-22,48791,51768,-2977,-5.75,1207
2020-10-23,51472,52563,-1091,-2.08,1207
2020-10-24,43784,44595,-811,-1.82,1207
2020-10-25,37354,38080,-726,-1.91,1207
2020-10-26,47759,50556,-2797,-5.53,1207
2020-10-27,48791,51565,-2774,-5.38,1207
2020-10-28,48791,51556,-2765,-5.36,1207
2020-10-29,48791,51568,-2777,-5.39,1207
2020-10-30,51472,52382,-910,-1.74,1207
2020-10-31,43784,44438,-654,-1.47,1207
2020-11-01,30453,37952,-7499,-19.76,1207
2020-11-02,45974,50460,-4486,-8.89,1207
2020-11-03,44593,51502,-6909,-13.42,1207
2020-11-04,44593,51527,-6934,-13.46,1207
2020-11-05,44593,51571,-6978,-13.53,1207
2020-11-06,45209,52416,-7207,-13.75,1207
2020-11-07,35057,44498,-9441,-21.22,1207
2020-11-08,30453,38035,-7582,-19.93,1207
2020-11-09,45974,50559,-4585,-9.07,1207
2020-11-10,44593,51611,-7018,-13.6,1207
2020-11-11,44593,51639,-7046,-13.64,1207
2020-11-12,44593,51679,-7086,-13.71,1207
2020-11-13,45209,52512,-7303,-13.91,1207
2020-11-14,35057,44575,-9518,-21.35,1207
2020-11-15,30453,38085,-7632,-20.04,1207
2020-11-16,45974,50576,-4602,-9.1,1207
2020-11-17,44593,51589,-6996,-13.56,1207
2020-11-18,44593,51573,-6980,-13.53,1207
2020-11-19,44593,51566,-6973,-13.52,1207
2020-11-20,45209,52349,-7140,-13.64,1207
2020-11-21,35057,44362,-9305,-20.98,1207
2020-11-22,30453,37821,-7368,-19.48,1207
2020-11-23,45974,50265,-4291,-8.54,1207
2020-11-24,44593,51233,-6640,-12.96,1207
2020-11-25,44593,51177,-6584,-12.87,1207
2020-11-26,44593,51136,-6543,-12.8,1207
2020-11-27,45209,51892,-6683,-12.88,1207
2020-11-28,35057,43885,-8828,-20.12,1207
2020-11-29,30453,37333,-6880,-18.43,1207
2020-11-30,45974,49774,-3800,-7.63,1207
2020-12-01,43881,50749,-6868,-13.53,1207
2020-12-02,43881,50708,-6827,-13.46,1207
2020-12-03,43881,50689,-6808,-13.43,1207
2020-12-04,47680,51476,-3796,-7.37,1207
2020-12-05,38067,43506,-5439,-12.5,1207
2020-12-06,29844,36996,-7152,-19.33,1207
2020-12-07,43880,49483,-5603,-11.32,1207
2020-12-08,43881,50505,-6624,-13.12,1207
2020-12-09,43881,50513,-6632,-13.13,1207
2020-12-10,43881,50542,-6661,-13.18,1207
2020-12-11,47680,51374,-3694,-7.19,1207
2020-12-12,38067,43444,-5377,-12.38,1207
2020-12-13,29844,36970,-7126,-19.28,1207
2020-12-14,43880,49483,-5603,-11.32,1207
2020-12-15,43881,50525,-6644,-13.15,1207
2020-12-16,43881,50542,-6661,-13.18,1207
2020-12-17,43881,50570,-6689,-13.23,1207
2020-12-18,47680,51389,-3709,-7.22,1207
2020-12-19,38067,43437,-5370,-12.36,1207
2020-12-20,29844,36928,-7084,-19.18,1207
2020-12-21,43880,49398,-5518,-11.17,1207
2020-12-22,43881,50385,-6504,-12.91,1207
2020-12-23,43881,50340,-6459,-12.83,1207
2020-12-24,43881,50298,-6417,-12.76,1207
2020-12-25,47680,51043,-3363,-6.59,1207
2020-12-26,38067,43012,-4945,-11.5,1207
2020-12-27,29844,36422,-6578,-18.06,1207
2020-12-28,43880,48811,-4931,-10.1,1207
2020-12-29,43881,49721,-5840,-11.75,1207
2020-12-30,43881,49602,-5721,-11.53,1207
2020-12-31,43881,49493,-5612,-11.34,1207
2021-01-01,43826,50178,-6352,-12.66,1207
2021-01-02,32114,42098,-9984,-23.72,1207
2021-01-03,26503,35471,-8968,-25.28,1207
2021-01-04,41733,47836,-6103,-12.76,1207
2021-01-05,43824,48735,-4911,-10.08,1207
2021-01-06,43824,48620,-4796,-9.86,1207
2021-01-07,43824,48530,-4706,-9.7,1207
2021-01-08,43826,49249,-5423,-11.01,1207
2021-01-09,32114,41218,-9104,-22.09,1207
2021-01-10,26503,34654,-8151,-23.52,1207
2021-01-11,41733,47095,-5362,-11.39,1207
2021-01-12,43824,48081,-4257,-8.85,1207
2021-01-13,43824,48064,-4240,-8.82,1207
2021-01-14,43824,48081,-4257,-8.85,1207
2021-01-15,43826,48913,-5087,-10.4,1207
2021-01-16,32114,40999,-8885,-21.67,1207
2021-01-17,26503,34554,-8051,-23.3,1207
2021-01-18,41733,47114,-5381,-11.42,1207
2021-01-19,43824,48218,-4394,-9.11,1207
2021-01-20,43824,48314,-4490,-9.29,1207
2021-01-21,43824,48437,-4613,-9.52,1207
2021-01-22,43826,49368,-5542,-11.23,1207
2021-01-23,32114,41543,-9429,-22.7,1207
2021-01-24,26503,35177,-8674,-24.66,1207
2021-01-25,41733,47804,-6071,-12.7,1207
2021-01-26,43824,48962,-5138,-10.49,1207
2021-01-27,43824,49099,-5275,-10.74,1207
2021-01-28,43824,49251,-5427,-11.02,1207
2021-01-29,43826,50198,-6372,-12.69,1207
2021-01-30,32114,42377,-10263,-24.22,1207
2021-01-31,26503,36003,-9500,-26.39,1207
2021-02-01,46531,48613,-2082,-4.28,1207
2021-02-02,47128,49744,-2616,-5.26,1207
2021-02-03,47128,49848,-2720,-5.46,1207
2021-02-04,47128,49959,-2831,-5.67,1207
2021-02-05,47878,50862,-2984,-5.87,1207
2021-02-06,39416,42995,-3579,-8.32,1207
2021-02-07,32196,36574,-4378,-11.97,1207
2021-02-08,46531,49136,-2605,-5.3,1207
2021-02-09,47128,50223,-3095,-6.16,1207
2021-02-10,47128,50285,-3157,-6.28,1207
2021-02-11,47128,50360,-3232,-6.42,1207
2021-02-12,47878,51232,-3354,-6.55,1207
2021-02-13,39416,43340,-3924,-9.05,1207
2021-02-14,32196,36902,-4706,-12.75,1207
2021-02-15,46531,49454,-2923,-5.91,1207
2021-02-16,47128,50537,-3409,-6.75,1207
2021-02-17,47128,50603,-3475,-6.87,1207
2021-02-18,47128,50688,-3560,-7.02,1207
2021-02-19,47878,51576,-3698,-7.17,1207
2021-02-20,39416,43704,-4288,-9.81,1207
2021-02-21,32196,37289,-5093,-13.66,1207
2021-02-22,46531,49868,-3337,-6.69,1207
2021-02-23,47128,50979,-3851,-7.55,1207
2021-02-24,47128,51073,-3945,-7.72,1207
2021-02-25,47128,51186,-4058,-7.93,1207
2021-02-26,47878,52098,-4220,-8.1,1207
2021-02-27,39416,44249,-4833,-10.92,1207
2021-02-28,32196,37852,-5656,-14.94,1207
2021-03-01,46885,50443,-3558,-7.05,1207
2021-03-02,48164,51562,-3398,-6.59,1207
2021-03-03,48164,51658,-3494,-6.76,1207
2021-03-04,48164,51765,-3601,-6.96,1207
2021-03-05,48570,52667,-4097,-7.78,1207
2021-03-06,41358,44800,-3442,-7.68,1207
2021-03-07,32409,38381,-5972,-15.56,1207
2021-03-08,46885,50944,-4059,-7.97,1207
2021-03-09,48164,52031,-3867,-7.43,1207
2021-03-10,48164,52091,-3927,-7.54,1207
2021-03-11,48164,52160,-3996,-7.66,1207
2021-03-12,48570,53022,-4452,-8.4,1207
2021-03-13,41358,45116,-3758,-8.33,1207
2021-03-14,32409,38657,-6248,-16.16,1207
2021-03-15,46885,51183,-4298,-8.4,1207
2021-03-16,48164,52236,-4072,-7.8,1207
2021-03-17,48164,52265,-4101,-7.85,1207
2021-03-18,48164,52308,-4144,-7.92,1207
2021-03-19,48570,53149,-4579,-8.62,1207
2021-03-20,41358,45227,-3869,-8.55,1207
2021-03-21,32409,38758,-6349,-16.38,1207
2021-03-22,46885,51281,-4396,-8.57,1207
2021-03-23,48164,52336,-4172,-7.97,1207
2021-03-24,48164,52373,-4209,-8.04,1207
2021-03-25,48164,52429,-4265,-8.13,1207
2021-03-26,48570,53287,-4717,-8.85,1207
2021-03-27,41358,45387,-4029,-8.88,1207
2021-03-28,32409,38943,-6534,-16.78,1207
2021-03-29,46885,51491,-4606,-8.95,1207
2021-03-30,48164,52573,-4409,-8.39,1207
2021-03-31,48164,52637,-4473,-8.5,1207
2021-04-01,46227,52719,-6492,-12.31,1207
2021-04-02,45847,53601,-7754,-14.47,1207
2021-04-03,36094,45721,-9627,-21.06,1207
2021-04-04,30116,39294,-9178,-23.36,1207
2021-04-05,46087,51855,-5768,-11.12,1207
2021-04-06,46227,52943,-6716,-12.69,1207
2021-04-07,46227,53009,-6782,-12.79,1207
2021-04-08,46227,53087,-6860,-12.92,1207
2021-04-09,45847,53960,-8113,-15.04,1207
2021-04-10,36094,46064,-9970,-21.64,1207
2021-04-11,30116,39617,-9501,-23.98,1207
2021-04-12,46087,52153,-6066,-11.63,1207
2021-04-13,46227,53213,-6986,-13.13,1207
2021-04-14,46227,53247,-7020,-13.18,1207
2021-04-15,46227,53291,-7064,-13.26,1207
2021-04-16,45847,54128,-8281,-15.3,1207
2021-04-17,36094,46197,-10103,-21.87,1207
2021-04-18,30116,39714,-9598,-24.17,1207
2021-04-19,46087,52217,-6130,-11.74,1207
2021-04-20,46227,53245,-7018,-13.18,1207
2021-04-21,46227,53251,-7024,-13.19,1207
2021-04-22,46227,53271,-7044,-13.22,1207
2021-04-23,45847,54088,-8241,-15.24,1207
2021-04-24,36094,46142,-10048,-21.78,1207
2021-04-25,30116,39649,-9533,-24.04,1207
2021-04-26,46087,52147,-6060,-11.62,1207
2021-04-27,46227,53176,-6949,-13.07,1207
2021-04-28,46227,53186,-6959,-13.08,1207
2021-04-29,46227,53215,-6988,-13.13,1207
2021-04-30,45847,54045,-8198,-15.17,1207
2021-05-01,44420,46115,-1695,-3.68,1207
2021-05-02,35573,39640,-4067,-10.26,1207
2021-05-03,49290,52157,-2867,-5.5,1207
2021-05-04,50008,53205,-3197,-6.01,1207
2021-05-05,50008,53235,-3227,-6.06,1207
2021-05-06,50008,53281,-3273,-6.14,1207
2021-05-07,50070,54126,-4056,-7.49,1207
2021-05-08,44420,46208,-1788,-3.87,1207
2021-05-09,35573,39741,-4168,-10.49,1207
2021-05-10,49290,52262,-2972,-5.69,1207
2021-05-11,50008,53310,-3302,-6.19,1207
2021-05-12,50008,53334,-3326,-6.24,1207
2021-05-13,50008,53371,-3363,-6.3,1207
2021-05-14,50070,54202,-4132,-7.62,1207
2021-05-15,44420,46266,-1846,-3.99,1207
2021-05-16,35573,39778,-4205,-10.57,1207
2021-05-17,49290,52274,-2984,-5.71,1207
2021-05-18,50008,53296,-3288,-6.17,1207
2021-05-19,50008,53293,-3285,-6.16,1207
2021-05-20,50008,53302,-3294,-6.18,1207
2021-05-21,50070,54107,-4037,-7.46,1207
2021-05-22,44420,46147,-1727,-3.74,1207
2021-05-23,35573,39638,-4065,-10.26,1207
2021-05-24,49290,52117,-2827,-5.42,1207
2021-05-25,50008,53127,-3119,-5.87,1207
2021-05-26,50008,53117,-3109,-5.85,1207
2021-05-27,50008,53125,-3117,-5.87,1207
2021-05-28,50070,53935,-3865,-7.17,1207
2021-05-29,44420,45986,-1566,-3.41,1207
2021-05-30,35573,39495,-3922,-9.93,1207
2021-05-31,49290,51997,-2707,-5.21,1207
2021-06-01,51096,53035,-1939,-3.66,1207
2021-06-02,51096,53057,-1961,-3.7,1207
2021-06-03,51096,53101,-2005,-3.78,1207
2021-06-04,51094,53948,-2854,-5.29,1207
2021-06-05,45888,46036,-148,-0.32,1207
2021-06-06,40949,39581,1368,3.46,1207
2021-06-07,50249,52117,-1868,-3.58,1207
2021-06-08,51096,53183,-2087,-3.92,1207
2021-06-09,51096,53229,-2133,-4.01,1207
2021-06-10,51096,53288,-2192,-4.11,1207
2021-06-11,51094,54142,-3048,-5.63,1207
2021-06-12,45888,46226,-338,-0.73,1207
2021-06-13,40949,39756,1193,3.0,1207
2021-06-14,50249,52266,-2017,-3.86,1207
2021-06-15,51096,53294,-2198,-4.12,1207
2021-06-16,51096,53288,-2192,-4.11,1207
2021-06-17,51096,53283,-2187,-4.1,1207
2021-06-18,51094,54061,-2967,-5.49,1207
2021-06-19,45888,46059,-171,-0.37,1207
2021-06-20,40949,39492,1457,3.69,1207
2021-06-21,50249,51896,-1647,-3.17,1207
2021-06-22,51096,52812,-1716,-3.25,1207
2021-06-23,51096,52690,-1594,-3.03,1207
2021-06-24,51096,52566,-1470,-2.8,1207
2021-06-25,51094,53225,-2131,-4.0,1207
2021-06-26,45888,45106,782,1.73,1207
2021-06-27,40949,38427,2522,6.56,1207
2021-06-28,50249,50726,-477,-0.94,1207
2021-06-29,51096,51547,-451,-0.87,1207
2021-06-30,51096,51341,-245,-0.48,1207
2021-07-01,44640,51147,-6507,-12.72,1207
2021-07-02,44761,51752,-6991,-13.51,1207
2021-07-03,41036,43596,-2560,-5.87,1207
2021-07-04,35080,36898,-1818,-4.93,1207
2021-07-05,42579,49197,-6618,-13.45,1207
2021-07-06,44640,50036,-5396,-10.78,1207
2021-07-07,44640,49868,-5228,-10.48,1207
2021-07-08,44640,49731,-5091,-10.24,1207
2021-07-09,44761,50410,-5649,-11.21,1207
2021-07-10,41036,42344,-1308,-3.09,1207
2021-07-11,35080,35750,-670,-1.87,1207
2021-07-12,42579,48166,-5587,-11.6,1207
2021-07-13,44640,49132,-4492,-9.14,1207
2021-07-14,44640,49099,-4459,-9.08,1207
2021-07-15,44640,49101,-4461,-9.09,1207
2021-07-16,44761,49920,-5159,-10.33,1207
2021-07-17,41036,41993,-957,-2.28,1207
2021-07-18,35080,35536,-456,-1.28,1207
2021-07-19,42579,48081,-5502,-11.44,1207
2021-07-20,44640,49168,-4528,-9.21,1207
2021-07-21,44640,49243,-4603,-9.35,1207
2021-07-22,44640,49341,-4701,-9.53,1207
2021-07-23,44761,50241,-5480,-10.91,1207
2021-07-24,41036,42379,-1343,-3.17,1207
2021-07-25,35080,35970,-890,-2.47,1207
2021-07-26,42579,48545,-5966,-12.29,1207
2021-07-27,44640,49645,-5005,-10.08,1207
2021-07-28,44640,49717,-5077,-10.21,1207
2021-07-29,44640,49795,-5155,-10.35,1207
2021-07-30,44761,50661,-5900,-11.65,1207
2021-07-31,41036,42753,-1717,-4.02,1207
2021-08-01,34029,36285,-2256,-6.22,1207
2021-08-02,40606,48795,-8189,-16.78,1207
2021-08-03,42052,49823,-7771,-15.6,1207
2021-08-04,42052,49819,-7767,-15.59,1207
2021-08-05,42052,49821,-7769,-15.59,1207
2021-08-06,43387,50612,-7225,-14.28,1207
2021-08-07,38935,42634,-3699,-8.68,1207
2021-08-08,34029,36104,-2075,-5.75,1207
2021-08-09,40606,48560,-7954,-16.38,1207
2021-08-10,42052,49546,-7494,-15.13,1207
2021-08-11,42052,49512,-7460,-15.07,1207
2021-08-12,42052,49499,-7447,-15.04,1207
2021-08-13,43387,50290,-6903,-13.73,1207
2021-08-14,38935,42327,-3392,-8.01,1207
2021-08-15,34029,35827,-1798,-5.02,1207
2021-08-16,40606,48329,-7723,-15.98,1207
2021-08-17,42052,49374,-7322,-14.83,1207
2021-08-18,42052,49413,-7361,-14.9,1207
2021-08-19,42052,49485,-7433,-15.02,1207
2021-08-20,43387,50370,-6983,-13.86,1207
2021-08-21,38935,42509,-3574,-8.41,1207
2021-08-22,34029,36116,-2087,-5.78,1207
2021-08-23,40606,48727,-8121,-16.67,1207
2021-08-24,42052,49882,-7830,-15.7,1207
2021-08-25,42052,50029,-7977,-15.94,1207
2021-08-26,42052,50203,-8151,-16.24,1207
2021-08-27,43387,51183,-7796,-15.23,1207
2021-08-28,38935,43408,-4473,-10.3,1207
2021-08-29,34029,37089,-3060,-8.25,1207
2021-08-30,40606,49762,-9156,-18.4,1207
2021-08-31,42052,50964,-8912,-17.49,1207
2021-09-01,49691,51142,-1451,-2.84,1207
2021-09-02,49691,51331,-1640,-3.19,1207
2021-09-03,50626,52311,-1685,-3.22,1207
2021-09-04,45662,44518,1144,2.57,1207
2021-09-05,40172,38168,2004,5.25,1207
2021-09-06,48587,50794,-2207,-4.35,1207
2021-09-07,49691,51936,-2245,-4.32,1207
2021-09-08,49691,52043,-2352,-4.52,1207
2021-09-09,49691,52152,-2461,-4.72,1207
2021-09-10,50626,53043,-2417,-4.56,1207
2021-09-11,45662,45157,505,1.12,1207
2021-09-12,40172,38710,1462,3.78,1207
2021-09-13,48587,51238,-2651,-5.17,1207
2021-09-14,49691,52284,-2593,-4.96,1207
2021-09-15,49691,52298,-2607,-4.98,1207
2021-09-16,49691,52319,-2628,-5.02,1207
2021-09-17,50626,53130,-2504,-4.71,1207
2021-09-18,45662,45172,490,1.08,1207
2021-09-19,40172,38662,1510,3.91,1207
2021-09-20,48587,51139,-2552,-4.99,1207
2021-09-21,49691,52145,-2454,-4.71,1207
2021-09-22,49691,52130,-2439,-4.68,1207
2021-09-23,49691,52134,-2443,-4.69,1207
2021-09-24,50626,52939,-2313,-4.37,1207
2021-09-25,45662,44986,676,1.5,1207
2021-09-26,40172,38491,1681,4.37,1207
2021-09-27,48587,50990,-2403,-4.71,1207
2021-09-28,49691,52026,-2335,-4.49,1207
2021-09-29,49691,52046,-2355,-4.52,1207
2021-09-30,49691,52088,-2397,-4.6,1207
2021-10-01,51109,52934,-1825,-3.45,1207
2021-10-02,45156,45022,134,0.3,1207
2021-10-03,39316,38567,749,1.94,1207
2021-10-04,48194,51103,-2909,-5.69,1207
2021-10-05,49781,52171,-2390,-4.58,1207
2021-10-06,49781,52219,-2438,-4.67,1207
2021-10-07,49781,52283,-2502,-4.79,1207
2021-10-08,51109,53143,-2034,-3.83,1207
2021-10-09,45156,45237,-81,-0.18,1207
2021-10-10,39316,38781,535,1.38,1207
2021-10-11,48194,51310,-3116,-6.07,1207
2021-10-12,49781,52362,-2581,-4.93,1207
2021-10-13,49781,52388,-2607,-4.98,1207
2021-10-14,49781,52424,-2643,-5.04,1207
2021-10-15,51109,53251,-2142,-4.02,1207
2021-10-16,45156,45309,-153,-0.34,1207
2021-10-17,39316,38814,502,1.29,1207
2021-10-18,48194,51303,-3109,-6.06,1207
2021-10-19,49781,52316,-2535,-4.85,1207
2021-10-20,49781,52303,-2522,-4.82,1207
2021-10-21,49781,52303,-2522,-4.82,1207
2021-10-22,51109,53099,-1990,-3.75,1207
2021-10-23,45156,45131,25,0.06,1207
2021-10-24,39316,38615,701,1.82,1207
2021-10-25,48194,51089,-2895,-5.67,1207
2021-10-26,49781,52093,-2312,-4.44,1207
2021-10-27,49781,52080,-2299,-4.41,1207
2021-10-28,49781,52086,-2305,-4.43,1207
2021-10-29,51109,52895,-1786,-3.38,1207
2021-10-30,45156,44944,212,0.47,1207
2021-10-31,39316,38452,864,2.25,1207
2021-11-01,45220,50953,-5733,-11.25,1207
2021-11-02,47068,51989,-4921,-9.47,1207
2021-11-03,47068,52009,-4941,-9.5,1207
2021-11-04,47068,52048,-4980,-9.57,1207
2021-11-05,48227,52890,-4663,-8.82,1207
2021-11-06,41288,44970,-3682,-8.19,1207
2021-11-07,34954,38506,-3552,-9.22,1207
2021-11-08,45220,51031,-5811,-11.39,1207
2021-11-09,47068,52085,-5017,-9.63,1207
2021-11-10,47068,52116,-5048,-9.69,1207
2021-11-11,47068,52161,-5093,-9.76,1207
2021-11-12,48227,53000,-4773,-9.01,1207
2021-11-13,41288,45070,-3782,-8.39,1207
2021-11-14,34954,38588,-3634,-9.42,1207
2021-11-15,45220,51088,-5868,-11.49,1207
2021-11-16,47068,52110,-5042,-9.68,1207
2021-11-17,47068,52104,-5036,-9.67,1207
2021-11-18,47068,52106,-5038,-9.67,1207
2021-11-19,48227,52899,-4672,-8.83,1207
2021-11-20,41288,44920,-3632,-8.09,1207
2021-11-21,34954,38387,-3433,-8.94,1207
2021-11-22,45220,50837,-5617,-11.05,1207
2021-11-23,47068,51811,-4743,-9.15,1207
2021-11-24,47068,51759,-4691,-9.06,1207
2021-11-25,47068,51720,-4652,-8.99,1207
2021-11-26,48227,52476,-4249,-8.1,1207
2021-11-27,41288,44469,-3181,-7.15,1207
2021-11-28,34954,37915,-2961,-7.81,1207
2021-11-29,45220,50351,-5131,-10.19,1207
2021-11-30,47068,51320,-4252,-8.29,1207
2021-12-01,44265,51273,-7008,-13.67,1207
2021-12-02,44265,51246,-6981,-13.62,1207
2021-12-03,42905,52024,-9119,-17.53,1207
2021-12-04,37922,44045,-6123,-13.9,1207
2021-12-05,32764,37526,-4762,-12.69,1207
2021-12-06,44832,50003,-5171,-10.34,1207
2021-12-07,44265,51017,-6752,-13.23,1207
2021-12-08,44265,51017,-6752,-13.23,1207
2021-12-09,44265,51039,-6774,-13.27,1207
2021-12-10,42905,51865,-8960,-17.28,1207
2021-12-11,37922,43932,-6010,-13.68,1207
2021-12-12,32764,37455,-4691,-12.52,1207
2021-12-13,44832,49968,-5136,-10.28,1207
2021-12-14,44265,51012,-6747,-13.23,1207
2021-12-15,44265,51033,-6768,-13.26,1207
2021-12-16,44265,51066,-6801,-13.32,1207
2021-12-17,42905,51894,-8989,-17.32,1207
2021-12-18,37922,43951,-6029,-13.72,1207
2021-12-19,32764,37454,-4690,-12.52,1207
2021-12-20,44832,49936,-5104,-10.22,1207
2021-12-21,44265,50938,-6673,-13.1,1207
2021-12-22,44265,50907,-6642,-13.05,1207
2021-12-23,44265,50881,-6616,-13.0,1207
2021-12-24,42905,51640,-8735,-16.92,1207
2021-12-25,37922,43624,-5702,-13.07,1207
2021-12-26,32764,37049,-4285,-11.57,1207
2021-12-27,44832,49451,-4619,-9.34,1207
2021-12-28,44265,50372,-6107,-12.12,1207
2021-12-29,44265,50262,-5997,-11.93,1207
2021-12-30,44265,50161,-5896,-11.75,1207
2021-12-31,42905,50851,-7946,-15.63,1207
2022-01-01,39230,42773,-3543,-8.28,1207
2022-01-02,30305,36146,-5841,-16.16,1207
2022-01-03,44055,48508,-4453,-9.18,1207
2022-01-04,45379,49401,-4022,-8.14,1207
2022-01-05,45379,49277,-3898,-7.91,1207
2022-01-06,45379,49176,-3797,-7.72,1207
2022-01-07,45786,49882,-4096,-8.21,1207
2022-01-08,39230,41835,-2605,-6.23,1207
2022-01-09,30305,35253,-4948,-14.04,1207
2022-01-10,44055,47674,-3619,-7.59,1207
2022-01-11,45379,48640,-3261,-6.7,1207
2022-01-12,45379,48601,-3222,-6.63,1207
2022-01-13,45379,48595,-3216,-6.62,1207
2022-01-14,45786,49405,-3619,-7.33,1207
2022-01-15,39230,41470,-2240,-5.4,1207
2022-01-16,30305,35004,-4699,-13.42,1207
2022-01-17,44055,47544,-3489,-7.34,1207
2022-01-18,45379,48629,-3250,-6.68,1207
2022-01-19,45379,48709,-3330,-6.84,1207
2022-01-20,45379,48817,-3438,-7.04,1207
2022-01-21,45786,49736,-3950,-7.94,1207
2022-01-22,39230,41901,-2671,-6.37,1207
2022-01-23,30305,35527,-5222,-14.7,1207
2022-01-24,44055,48148,-4093,-8.5,1207
2022-01-25,45379,49303,-3924,-7.96,1207
2022-01-26,45379,49440,-4061,-8.21,1207
2022-01-27,45379,49593,-4214,-8.5,1207
2022-01-28,45786,50544,-4758,-9.41,1207
2022-01-29,39230,42728,-3498,-8.19,1207
2022-01-30,30305,36361,-6056,-16.66,1207
2020-02-01,16171,14210,1961,13.8,1208
2020-02-02,12904,11441,1463,12.79,1208
2020-02-03,23462,22990,472,2.05,1208
2020-02-04,23699,23414,285,1.22,1208
2020-02-05,23699,23465,234,1.0,1208
2020-02-06,23699,23511,188,0.8,1208
2020-02-07,23672,23003,669,2.91,1208
2020-02-08,16171,14462,1709,11.82,1208
2020-02-09,12904,11665,1239,10.62,1208
2020-02-10,23462,23188,274,1.18,1208
2020-02-11,23699,23590,109,0.46,1208
2020-02-12,23699,23624,75,0.32,1208
2020-02-13,23699,23657,42,0.18,1208
2020-02-14,23672,23141,531,2.29,1208
2020-02-15,16171,14597,1574,10.78,1208
2020-02-16,12904,11802,1102,9.34,1208
2020-02-17,23462,23333,129,0.55,1208
2020-02-18,23699,23747,-48,-0.2,1208
2020-02-19,23699,23796,-97,-0.41,1208
2020-02-20,23699,23849,-150,-0.63,1208
2020-02-21,23672,23355,317,1.36,1208
2020-02-22,16171,14835,1336,9.01,1208
2020-02-23,12904,12064,840,6.96,1208
2020-02-24,23462,23620,-158,-0.67,1208
2020-02-25,23699,24057,-358,-1.49,1208
2020-02-26,23699,24128,-429,-1.78,1208
2020-02-27,23699,24200,-501,-2.07,1208
2020-02-28,23672,23722,-50,-0.21,1208
2020-02-29,16171,15213,958,6.3,1208
2020-03-01,9299,12450,-3151,-25.31,1208
2020-03-02,17547,24008,-6461,-26.91,1208
2020-03-03,17592,24443,-6851,-28.03,1208
2020-03-04,17592,24507,-6915,-28.22,1208
2020-03-05,17592,24567,-6975,-28.39,1208
2020-03-06,18117,24072,-5955,-24.74,1208
2020-03-07,11305,15543,-4238,-27.27,1208
2020-03-08,9299,12756,-3457,-27.1,1208
2020-03-09,17547,24287,-6740,-27.75,1208
2020-03-10,17592,24694,-7102,-28.76,1208
2020-03-11,17592,24728,-7136,-28.86,1208
2020-03-12,17592,24757,-7165,-28.94,1208
2020-03-13,18117,24233,-6116,-25.24,1208
2020-03-14,11305,15676,-4371,-27.88,1208
2020-03-15,9299,12863,-3564,-27.71,1208
2020-03-16,17547,24371,-6824,-28.0,1208
2020-03-17,17592,24757,-7165,-28.94,1208
2020-03-18,17592,24776,-7184,-29.0,1208
2020-03-19,17592,24794,-7202,-29.05,1208
2020-03-20,18117,24263,-6146,-25.33,1208
2020-03-21,11305,15704,-4399,-28.01,1208
2020-03-22,9299,12894,-3595,-27.88,1208
2020-03-23,17547,24409,-6862,-28.11,1208
2020-03-24,17592,24807,-7215,-29.08,1208
2020-03-25,17592,24840,-7248,-29.18,1208
2020-03-26,17592,24876,-7284,-29.28,1208
2020-03-27,18117,24366,-6249,-25.65,1208
2020-03-28,11305,15829,-4524,-28.58,1208
2020-03-29,9299,13041,-3742,-28.69,1208
2020-03-30,17547,24579,-7032,-28.61,1208
2020-03-31,17592,24999,-7407,-29.63,1208
2020-04-01,15285,25052,-9767,-38.99,1208
2020-04-02,15285,25106,-9821,-39.12,1208
2020-04-03,14444,24610,-10166,-41.31,1208
2020-04-04,10333,16083,-5750,-35.75,1208
2020-04-05,7213,13302,-6089,-45.78,1208
2020-04-06,15365,24842,-9477,-38.15,1208
2020-04-07,15285,25260,-9975,-39.49,1208
2020-04-08,15285,25306,-10021,-39.6,1208
2020-04-09,15285,25348,-10063,-39.7,1208
2020-04-10,14444,24836,-10392,-41.84,1208
2020-04-11,10333,16290,-5957,-36.57,1208
2020-04-12,7213,13486,-6273,-46.51,1208
2020-04-13,15365,25000,-9635,-38.54,1208
2020-04-14,15285,25390,-10105,-39.8,1208
2020-04-15,15285,25407,-10122,-39.84,1208
2020-04-16,15285,25419,-10134,-39.87,1208
2020-04-17,14444,24878,-10434,-41.94,1208
2020-04-18,10333,16303,-5970,-36.62,1208
2020-04-19,7213,13472,-6259,-46.46,1208
2020-04-20,15365,24962,-9597,-38.45,1208
2020-04-21,15285,25331,-10046,-39.66,1208
2020-04-22,15285,25331,-10046,-39.66,1208
2020-04-23,15285,25330,-10045,-39.66,1208
2020-04-24,14444,24779,-10335,-41.71,1208
2020-04-25,10333,16200,-5867,-36.22,1208
2020-04-26,7213,13369,-6156,-46.05,1208
2020-04-27,15365,24863,-9498,-38.2,1208
2020-04-28,15285,25239,-9954,-39.44,1208
2020-04-29,15285,25250,-9965,-39.47,1208
2020-04-30,15285,25262,-9977,-39.49,1208
2020-05-01,20102,24728,-4626,-18.71,1208
2020-05-02,14614,16166,-1552,-9.6,1208
2020-05-03,11059,13353,-2294,-17.18,1208
2020-05-04,20341,24865,-4524,-18.19,1208
2020-05-05,20768,25259,-4491,-17.78,1208
2020-05-06,20768,25286,-4518,-17.87,1208
2020-05-07,20768,25313,-4545,-17.96,1208
2020-05-08,20102,24789,-4687,-18.91,1208
2020-05-09,14614,16236,-1622,-9.99,1208
2020-05-10,11059,13427,-2368,-17.64,1208
2020-05-11,20341,24940,-4599,-18.44,1208
2020-05-12,20768,25330,-4562,-18.01,1208
2020-05-13,20768,25350,-4582,-18.07,1208
2020-05-14,20768,25365,-4597,-18.12,1208
2020-05-15,20102,24827,-4725,-19.03,1208
2020-05-16,14614,16256,-1642,-10.1,1208
2020-05-17,11059,13428,-2369,-17.64,1208
2020-05-18,20341,24919,-4578,-18.37,1208
2020-05-19,20768,25287,-4519,-17.87,1208
2020-05-20,20768,25284,-4516,-17.86,1208
2020-05-21,20768,25277,-4509,-17.84,1208
2020-05-22,20102,24719,-4617,-18.68,1208
2020-05-23,14614,16130,-1516,-9.4,1208
2020-05-24,11059,13287,-2228,-16.77,1208
2020-05-25,20341,24766,-4425,-17.87,1208
2020-05-26,20768,25127,-4359,-17.35,1208
2020-05-27,20768,25121,-4353,-17.33,1208
2020-05-28,20768,25117,-4349,-17.31,1208
2020-05-29,20102,24565,-4463,-18.17,1208
2020-05-30,14614,15987,-1373,-8.59,1208
2020-05-31,11059,13160,-2101,-15.97,1208
2020-06-01,22961,24659,-1698,-6.89,1208
2020-06-02,23295,25042,-1747,-6.98,1208
2020-06-03,23295,25062,-1767,-7.05,1208
2020-06-04,23295,25084,-1789,-7.13,1208
2020-06-05,21616,24560,-2944,-11.99,1208
2020-06-06,15313,16009,-696,-4.35,1208
2020-06-07,12345,13207,-862,-6.53,1208
2020-06-08,22961,24729,-1768,-7.15,1208
2020-06-09,23295,25130,-1835,-7.3,1208
2020-06-10,23295,25163,-1868,-7.42,1208
2020-06-11,23295,25193,-1898,-7.53,1208
2020-06-12,21616,24670,-3054,-12.38,1208
2020-06-13,15313,16112,-799,-4.96,1208
2020-06-14,12345,13295,-950,-7.15,1208
2020-06-15,22961,24794,-1833,-7.39,1208
2020-06-16,23295,25165,-1870,-7.43,1208
2020-06-17,23295,25158,-1863,-7.41,1208
2020-06-18,23295,25141,-1846,-7.34,1208
2020-06-19,21616,24563,-2947,-12.0,1208
2020-06-20,15313,15944,-631,-3.96,1208
2020-06-21,12345,13061,-716,-5.48,1208
2020-06-22,22961,24490,-1529,-6.24,1208
2020-06-23,23295,24788,-1493,-6.02,1208
2020-06-24,23295,24707,-1412,-5.71,1208
2020-06-25,23295,24616,-1321,-5.37,1208
2020-06-26,21616,23967,-2351,-9.81,1208
2020-06-27,15313,15280,33,0.22,1208
2020-06-28,12345,12335,10,0.08,1208
2020-06-29,22961,23707,-746,-3.15,1208
2020-06-30,23295,23957,-662,-2.76,1208
2020-07-01,23250,23838,-588,-2.47,1208
2020-07-02,23250,23719,-469,-1.98,1208
2020-07-03,22329,23052,-723,-3.14,1208
2020-07-04,15126,14360,766,5.33,1208
2020-07-05,13285,11421,1864,16.32,1208
2020-07-06,22876,22811,65,0.28,1208
2020-07-07,23250,23090,160,0.69,1208
2020-07-08,23250,23011,239,1.04,1208
2020-07-09,23250,22941,309,1.35,1208
2020-07-10,22329,22333,-4,-0.02,1208
2020-07-11,15126,13706,1420,10.36,1208
2020-07-12,13285,10838,2447,22.58,1208
2020-07-13,22876,22303,573,2.57,1208
2020-07-14,23250,22659,591,2.61,1208
2020-07-15,23250,22658,592,2.61,1208
2020-07-16,23250,22664,586,2.59,1208
2020-07-17,22329,22128,201,0.91,1208
2020-07-18,15126,13568,1558,11.48,1208
2020-07-19,13285,10760,2525,23.47,1208
2020-07-20,22876,22277,599,2.69,1208
2020-07-21,23250,22676,574,2.53,1208
2020-07-22,23250,22706,544,2.4,1208
2020-07-23,23250,22733,517,2.27,1208
2020-07-24,22329,22207,122,0.55,1208
2020-07-25,15126,13645,1481,10.85,1208
2020-07-26,13285,10823,2462,22.75,1208
2020-07-27,22876,22316,560,2.51,1208
2020-07-28,23250,22681,569,2.51,1208
2020-07-29,23250,22669,581,2.56,1208
2020-07-30,23250,22647,603,2.66,1208
2020-07-31,22329,22065,264,1.2,1208
2020-08-01,14382,13445,937,6.97,1208
2020-08-02,12254,10563,1691,16.01,1208
2020-08-03,21304,21997,-693,-3.15,1208
2020-08-04,21249,22304,-1055,-4.73,1208
2020-08-05,21249,22239,-990,-4.45,1208
2020-08-06,21249,22170,-921,-4.15,1208
2020-08-07,20323,21550,-1227,-5.69,1208
2020-08-08,14382,12901,1481,11.48,1208
2020-08-09,12254,10002,2252,22.52,1208
2020-08-10,21304,21430,-126,-0.59,1208
2020-08-11,21249,21745,-496,-2.28,1208
2020-08-12,21249,21701,-452,-2.08,1208
2020-08-13,21249,21667,-418,-1.93,1208
2020-08-14,20323,21096,-773,-3.66,1208
2020-08-15,14382,12507,1875,14.99,1208
2020-08-16,12254,9681,2573,26.58,1208
2020-08-17,21304,21193,111,0.52,1208
2020-08-18,21249,21601,-352,-1.63,1208
2020-08-19,21249,21657,-408,-1.88,1208
2020-08-20,21249,21730,-481,-2.21,1208
2020-08-21,20323,21268,-945,-4.44,1208
2020-08-22,14382,12791,1591,12.44,1208
2020-08-23,12254,10075,2179,21.63,1208
2020-08-24,21304,21694,-390,-1.8,1208
2020-08-25,21249,22204,-955,-4.3,1208
2020-08-26,21249,22356,-1107,-4.95,1208
2020-08-27,21249,22514,-1265,-5.62,1208
2020-08-28,20323,22128,-1805,-8.16,1208
2020-08-29,14382,13714,668,4.87,1208
2020-08-30,12254,11048,1206,10.92,1208
2020-08-31,21304,22704,-1400,-6.17,1208
2020-09-01,23267,23235,32,0.14,1208
2020-09-02,23267,23394,-127,-0.54,1208
2020-09-03,23267,23545,-278,-1.18,1208
2020-09-04,22855,23137,-282,-1.22,1208
2020-09-05,16174,14689,1485,10.11,1208
2020-09-06,13448,11976,1472,12.29,1208
2020-09-07,22854,23574,-720,-3.05,1208
2020-09-08,23267,24040,-773,-3.22,1208
2020-09-09,23267,24124,-857,-3.55,1208
2020-09-10,23267,24196,-929,-3.84,1208
2020-09-11,22855,23704,-849,-3.58,1208
2020-09-12,16174,15171,1003,6.61,1208
2020-09-13,13448,12374,1074,8.68,1208
2020-09-14,22854,23889,-1035,-4.33,1208
2020-09-15,23267,24276,-1009,-4.16,1208
2020-09-16,23267,24287,-1020,-4.2,1208
2020-09-17,23267,24291,-1024,-4.22,1208
2020-09-18,22855,23740,-885,-3.73,1208
2020-09-19,16174,15156,1018,6.72,1208
2020-09-20,13448,12318,1130,9.17,1208
2020-09-21,22854,23801,-947,-3.98,1208
2020-09-22,23267,24166,-899,-3.72,1208
2020-09-23,23267,24164,-897,-3.71,1208
2020-09-24,23267,24164,-897,-3.71,1208
2020-09-25,22855,23618,-763,-3.23,1208
2020-09-26,16174,15046,1128,7.5,1208
2020-09-27,13448,12226,1222,10.0,1208
2020-09-28,22854,23733,-879,-3.7,1208
2020-09-29,23267,24124,-857,-3.55,1208
2020-09-30,23267,24152,-885,-3.66,1208
2020-10-01,23054,24183,-1129,-4.67,1208
2020-10-02,22724,23667,-943,-3.98,1208
2020-10-03,15980,15125,855,5.65,1208
2020-10-04,12747,12331,416,3.37,1208
2020-10-05,22852,23860,-1008,-4.22,1208
2020-10-06,23054,24270,-1216,-5.01,1208
2020-10-07,23054,24312,-1258,-5.17,1208
2020-10-08,23054,24351,-1297,-5.33,1208
2020-10-09,22724,23838,-1114,-4.67,1208
2020-10-10,15980,15292,688,4.5,1208
2020-10-11,12747,12490,257,2.06,1208
2020-10-12,22852,24006,-1154,-4.81,1208
2020-10-13,23054,24398,-1344,-5.51,1208
2020-10-14,23054,24418,-1364,-5.59,1208
2020-10-15,23054,24433,-1379,-5.64,1208
2020-10-16,22724,23893,-1169,-4.89,1208
2020-10-17,15980,15321,659,4.3,1208
2020-10-18,12747,12491,256,2.05,1208
2020-10-19,22852,23982,-1130,-4.71,1208
2020-10-20,23054,24352,-1298,-5.33,1208
2020-10-21,23054,24352,-1298,-5.33,1208
2020-10-22,23054,24351,-1297,-5.33,1208
2020-10-23,22724,23801,-1077,-4.53,1208
2020-10-24,15980,15222,758,4.98,1208
2020-10-25,12747,12393,354,2.86,1208
2020-10-26,22852,23889,-1037,-4.34,1208
2020-10-27,23054,24269,-1215,-5.01,1208
2020-10-28,23054,24285,-1231,-5.07,1208
2020-10-29,23054,24305,-1251,-5.15,1208
2020-10-30,22724,23779,-1055,-4.44,1208
2020-10-31,15980,15228,752,4.94,1208
2020-11-01,10432,12429,-1997,-16.07,1208
2020-11-02,20266,23957,-3691,-15.41,1208
2020-11-03,18677,24369,-5692,-23.36,1208
2020-11-04,18677,24415,-5738,-23.5,1208
2020-11-05,18677,24463,-5786,-23.65,1208
2020-11-06,18961,23963,-5002,-20.87,1208
2020-11-07,13065,15433,-2368,-15.34,1208
2020-11-08,10432,12649,-2217,-17.53,1208
2020-11-09,20266,24186,-3920,-16.21,1208
2020-11-10,18677,24600,-5923,-24.08,1208
2020-11-11,18677,24642,-5965,-24.21,1208
2020-11-12,18677,24677,-6000,-24.31,1208
2020-11-13,18961,24157,-5196,-21.51,1208
2020-11-14,13065,15599,-2534,-16.24,1208
2020-11-15,10432,12781,-2349,-18.38,1208
2020-11-16,20266,24277,-4011,-16.52,1208
2020-11-17,18677,24644,-5967,-24.21,1208
2020-11-18,18677,24635,-5958,-24.19,1208
2020-11-19,18677,24616,-5939,-24.13,1208
2020-11-20,18961,24039,-5078,-21.12,1208
2020-11-21,13065,15423,-2358,-15.29,1208
2020-11-22,10432,12547,-2115,-16.86,1208
2020-11-23,20266,23988,-3722,-15.52,1208
2020-11-24,18677,24302,-5625,-23.15,1208
2020-11-25,18677,24244,-5567,-22.96,1208
2020-11-26,18677,24182,-5505,-22.76,1208
2020-11-27,18961,23569,-4608,-19.55,1208
2020-11-28,13065,14924,-1859,-12.46,1208
2020-11-29,10432,12027,-1595,-13.26,1208
2020-11-30,20266,23454,-3188,-13.59,1208
2020-12-01,18712,23765,-5053,-21.26,1208
2020-12-02,18712,23711,-4999,-21.08,1208
2020-12-03,18712,23662,-4950,-20.92,1208
2020-12-04,20550,23068,-2518,-10.92,1208
2020-12-05,14041,14451,-410,-2.84,1208
2020-12-06,9746,11588,-1842,-15.9,1208
2020-12-07,18873,23054,-4181,-18.14,1208
2020-12-08,18712,23407,-4695,-20.06,1208
2020-12-09,18712,23398,-4686,-20.03,1208
2020-12-10,18712,23395,-4683,-20.02,1208
2020-12-11,20550,22848,-2298,-10.06,1208
2020-12-12,14041,14275,-234,-1.64,1208
2020-12-13,9746,11452,-1706,-14.9,1208
2020-12-14,18873,22955,-4082,-17.78,1208
2020-12-15,18712,23339,-4627,-19.83,1208
2020-12-16,18712,23356,-4644,-19.88,1208
2020-12-17,18712,23371,-4659,-19.93,1208
2020-12-18,20550,22833,-2283,-10.0,1208
2020-12-19,14041,14262,-221,-1.55,1208
2020-12-20,9746,11434,-1688,-14.76,1208
2020-12-21,18873,22922,-4049,-17.66,1208
2020-12-22,18712,23285,-4573,-19.64,1208
2020-12-23,18712,23272,-4560,-19.59,1208
2020-12-24,18712,23252,-4540,-19.53,1208
2020-12-25,20550,22674,-2124,-9.37,1208
2020-12-26,14041,14058,-17,-0.12,1208
2020-12-27,9746,11182,-1436,-12.84,1208
2020-12-28,18873,22622,-3749,-16.57,1208
2020-12-29,18712,22935,-4223,-18.41,1208
2020-12-30,18712,22875,-4163,-18.2,1208
2020-12-31,18712,22811,-4099,-17.97,1208
2021-01-01,17544,22193,-4649,-20.95,1208
2021-01-02,10833,13543,-2710,-20.01,1208
2021-01-03,8425,10640,-2215,-20.82,1208
2021-01-04,17295,22060,-4765,-21.6,1208
2021-01-05,17798,22362,-4564,-20.41,1208
2021-01-06,17798,22301,-4503,-20.19,1208
2021-01-07,17798,22244,-4446,-19.99,1208
2021-01-08,17544,21643,-4099,-18.94,1208
2021-01-09,10833,13020,-2187,-16.8,1208
2021-01-10,8425,10152,-1727,-17.01,1208
2021-01-11,17295,21616,-4321,-19.99,1208
2021-01-12,17798,21970,-4172,-18.99,1208
2021-01-13,17798,21967,-4169,-18.98,1208
2021-01-14,17798,21973,-4175,-19.0,1208
2021-01-15,17544,21440,-3896,-18.17,1208
2021-01-16,10833,12886,-2053,-15.93,1208
2021-01-17,8425,10090,-1665,-16.5,1208
2021-01-18,17295,21626,-4331,-20.03,1208
2021-01-19,17798,22049,-4251,-19.28,1208
2021-01-20,17798,22113,-4315,-19.51,1208
2021-01-21,17798,22181,-4383,-19.76,1208
2021-01-22,17544,21705,-4161,-19.17,1208
2021-01-23,10833,13203,-2370,-17.95,1208
2021-01-24,8425,10450,-2025,-19.38,1208
2021-01-25,17295,22022,-4727,-21.46,1208
2021-01-26,17798,22473,-4675,-20.8,1208
2021-01-27,17798,22556,-4758,-21.09,1208
2021-01-28,17798,22636,-4838,-21.37,1208
2021-01-29,17544,22164,-4620,-20.84,1208
2021-01-30,10833,13658,-2825,-20.68,1208
2021-01-31,8425,10894,-2469,-22.66,1208
2021-02-01,20095,22449,-2354,-10.49,1208
2021-02-02,20194,22879,-2685,-11.74,1208
2021-02-03,20194,22936,-2742,-11.96,1208
2021-02-04,20194,22987,-2793,-12.15,1208
2021-02-05,19784,22484,-2700,-12.01,1208
2021-02-06,12932,13947,-1015,-7.28,1208
2021-02-07,10252,11153,-901,-8.08,1208
2021-02-08,20095,22679,-2584,-11.39,1208
2021-02-09,20194,23083,-2889,-12.52,1208
2021-02-10,20194,23117,-2923,-12.64,1208
2021-02-11,20194,23150,-2956,-12.77,1208
2021-02-12,19784,22633,-2849,-12.59,1208
2021-02-13,12932,14086,-1154,-8.19,1208
2021-02-14,10252,11288,-1036,-9.18,1208
2021-02-15,20095,22816,-2721,-11.93,1208
2021-02-16,20194,23225,-3031,-13.05,1208
2021-02-17,20194,23270,-3076,-13.22,1208
2021-02-18,20194,23318,-3124,-13.4,1208
2021-02-19,19784,22820,-3036,-13.3,1208
2021-02-20,12932,14295,-1363,-9.53,1208
2021-02-21,10252,11520,-1268,-11.01,1208
2021-02-22,20095,23072,-2977,-12.9,1208
2021-02-23,20194,23506,-3312,-14.09,1208
2021-02-24,20194,23575,-3381,-14.34,1208
2021-02-25,20194,23645,-3451,-14.6,1208
2021-02-26,19784,23166,-3382,-14.6,1208
2021-02-27,12932,14658,-1726,-11.78,1208
2021-02-28,10252,11896,-1644,-13.82,1208
2021-03-01,20477,23456,-2979,-12.7,1208
2021-03-02,20691,23895,-3204,-13.41,1208
2021-03-03,20691,23962,-3271,-13.65,1208
2021-03-04,20691,24026,-3335,-13.88,1208
2021-03-05,20527,23537,-3010,-12.79,1208
2021-03-06,15458,15013,445,2.96,1208
2021-03-07,11188,12232,-1044,-8.53,1208
2021-03-08,20477,23769,-3292,-13.85,1208
2021-03-09,20691,24181,-3490,-14.43,1208
2021-03-10,20691,24220,-3529,-14.57,1208
2021-03-11,20691,24255,-3564,-14.69,1208
2021-03-12,20527,23735,-3208,-13.52,1208
2021-03-13,15458,15181,277,1.82,1208
2021-03-14,11188,12371,-1183,-9.56,1208
2021-03-15,20477,23881,-3404,-14.25,1208
2021-03-16,20691,24269,-3578,-14.74,1208
2021-03-17,20691,24288,-3597,-14.81,1208
2021-03-18,20691,24306,-3615,-14.87,1208
2021-03-19,20527,23774,-3247,-13.66,1208
2021-03-20,15458,15212,246,1.62,1208
2021-03-21,11188,12399,-1211,-9.77,1208
2021-03-22,20477,23911,-3434,-14.36,1208
2021-03-23,20691,24305,-3614,-14.87,1208
2021-03-24,20691,24335,-3644,-14.97,1208
2021-03-25,20691,24366,-3675,-15.08,1208
2021-03-26,20527,23851,-3324,-13.94,1208
2021-03-27,15458,15310,148,0.97,1208
2021-03-28,11188,12519,-1331,-10.63,1208
2021-03-29,20477,24053,-3576,-14.87,1208
2021-03-30,20691,24470,-3779,-15.44,1208
2021-03-31,20691,24521,-3830,-15.62,1208
2021-04-01,18858,24573,-5715,-23.26,1208
2021-04-02,19138,24077,-4939,-20.51,1208
2021-04-03,12972,15550,-2578,-16.58,1208
2021-04-04,9768,12771,-3003,-23.51,1208
2021-04-05,19058,24313,-5255,-21.61,1208
2021-04-06,18858,24733,-5875,-23.75,1208
2021-04-07,18858,24783,-5925,-23.91,1208
2021-04-08,18858,24830,-5972,-24.05,1208
2021-04-09,19138,24323,-5185,-21.32,1208
2021-04-10,12972,15781,-2809,-17.8,1208
2021-04-11,9768,12983,-3215,-24.76,1208
2021-04-12,19058,24503,-5445,-22.22,1208
2021-04-13,18858,24898,-6040,-24.26,1208
2021-04-14,18858,24920,-6062,-24.33,1208
2021-04-15,18858,24938,-6080,-24.38,1208
2021-04-16,19138,24401,-5263,-21.57,1208
2021-04-17,12972,15830,-2858,-18.05,1208
2021-04-18,9768,13003,-3235,-24.88,1208
2021-04-19,19058,24495,-5437,-22.2,1208
2021-04-20,18858,24866,-6008,-24.16,1208
2021-04-21,18858,24866,-6008,-24.16,1208
2021-04-22,18858,24865,-6007,-24.16,1208
2021-04-23,19138,24314,-5176,-21.29,1208
2021-04-24,12972,15733,-2761,-17.55,1208
2021-04-25,9768,12900,-3132,-24.28,1208
2021-04-26,19058,24391,-5333,-21.86,1208
2021-04-27,18858,24765,-5907,-23.85,1208
2021-04-28,18858,24772,-5914,-23.87,1208
2021-04-29,18858,24781,-5923,-23.9,1208
2021-04-30,19138,24243,-5105,-21.06,1208
2021-05-01,15121,15678,-557,-3.55,1208
2021-05-02,11354,12862,-1508,-11.72,1208
2021-05-03,21874,24371,-2497,-10.25,1208
2021-05-04,22377,24763,-2386,-9.64,1208
2021-05-05,22377,24788,-2411,-9.73,1208
2021-05-06,22377,24814,-2437,-9.82,1208
2021-05-07,21492,24290,-2798,-11.52,1208
2021-05-08,15121,15737,-616,-3.91,1208
2021-05-09,11354,12930,-1576,-12.19,1208
2021-05-10,21874,24445,-2571,-10.52,1208
2021-05-11,22377,24837,-2460,-9.9,1208
2021-05-12,22377,24860,-2483,-9.99,1208
2021-05-13,22377,24880,-2503,-10.06,1208
2021-05-14,21492,24346,-2854,-11.72,1208
2021-05-15,15121,15779,-658,-4.17,1208
2021-05-16,11354,12955,-1601,-12.36,1208
2021-05-17,21874,24450,-2576,-10.54,1208
2021-05-18,22377,24822,-2445,-9.85,1208
2021-05-19,22377,24823,-2446,-9.85,1208
2021-05-20,22377,24819,-2442,-9.84,1208
2021-05-21,21492,24263,-2771,-11.42,1208
2021-05-22,15121,15676,-555,-3.54,1208
2021-05-23,11354,12833,-1479,-11.52,1208
2021-05-24,21874,24313,-2439,-10.03,1208
2021-05-25,22377,24672,-2295,-9.3,1208
2021-05-26,22377,24664,-2287,-9.27,1208
2021-05-27,22377,24657,-2280,-9.25,1208
2021-05-28,21492,24102,-2610,-10.83,1208
2021-05-29,15121,15519,-398,-2.56,1208
2021-05-30,11354,12687,-1333,-10.51,1208
2021-05-31,21874,24181,-2307,-9.54,1208
2021-06-01,22525,24559,-2034,-8.28,1208
2021-06-02,22525,24574,-2049,-8.34,1208
2021-06-03,22525,24591,-2066,-8.4,1208
2021-06-04,21508,24063,-2555,-10.62,1208
2021-06-05,14915,15508,-593,-3.82,1208
2021-06-06,12641,12702,-61,-0.48,1208
2021-06-07,21570,24222,-2652,-10.95,1208
2021-06-08,22525,24624,-2099,-8.52,1208
2021-06-09,22525,24657,-2132,-8.65,1208
2021-06-10,22525,24690,-2165,-8.77,1208
2021-06-11,21508,24171,-2663,-11.02,1208
2021-06-12,14915,15618,-703,-4.5,1208
2021-06-13,12641,12808,-167,-1.3,1208
2021-06-14,21570,24315,-2745,-11.29,1208
2021-06-15,22525,24696,-2171,-8.79,1208
2021-06-16,22525,24700,-2175,-8.81,1208
2021-06-17,22525,24695,-2170,-8.79,1208
2021-06-18,21508,24131,-2623,-10.87,1208
2021-06-19,14915,15525,-610,-3.93,1208
2021-06-20,12641,12656,-15,-0.12,1208
2021-06-21,21570,24098,-2528,-10.49,1208
2021-06-22,22525,24409,-1884,-7.72,1208
2021-06-23,22525,24342,-1817,-7.46,1208
2021-06-24,22525,24263,-1738,-7.16,1208
2021-06-25,21508,23624,-2116,-8.96,1208
2021-06-26,14915,14947,-32,-0.21,1208
2021-06-27,12641,12008,633,5.27,1208
2021-06-28,21570,23387,-1817,-7.77,1208
2021-06-29,22525,23640,-1115,-4.72,1208
2021-06-30,22525,23522,-997,-4.24,1208
2021-07-01,21505,23402,-1897,-8.11,1208
2021-07-02,20831,22733,-1902,-8.37,1208
2021-07-03,13878,14035,-157,-1.12,1208
2021-07-04,11619,11089,530,4.78,1208
2021-07-05,20893,22470,-1577,-7.02,1208
2021-07-06,21505,22738,-1233,-5.42,1208
2021-07-07,21505,22647,-1142,-5.04,1208
2021-07-08,21505,22564,-1059,-4.69,1208
2021-07-09,20831,21942,-1111,-5.06,1208
2021-07-10,13878,13301,577,4.34,1208
2021-07-11,11619,10418,1201,11.53,1208
2021-07-12,20893,21869,-976,-4.46,1208
2021-07-13,21505,22211,-706,-3.18,1208
2021-07-14,21505,22197,-692,-3.12,1208
2021-07-15,21505,22192,-687,-3.1,1208
2021-07-16,20831,21646,-815,-3.77,1208
2021-07-17,13878,13078,800,6.12,1208
2021-07-18,11619,10264,1355,13.2,1208
2021-07-19,20893,21777,-884,-4.06,1208
2021-07-20,21505,22174,-669,-3.02,1208
2021-07-21,21505,22204,-699,-3.15,1208
2021-07-22,21505,22233,-728,-3.27,1208
2021-07-23,20831,21711,-880,-4.05,1208
2021-07-24,13878,13155,723,5.5,1208
2021-07-25,11619,10342,1277,12.35,1208
2021-07-26,20893,21844,-951,-4.35,1208
2021-07-27,21505,22219,-714,-3.21,1208
2021-07-28,21505,22218,-713,-3.21,1208
2021-07-29,21505,22208,-703,-3.17,1208
2021-07-30,20831,21638,-807,-3.73,1208
2021-07-31,13878,13028,850,6.52,1208
2021-08-01,11057,10157,900,8.86,1208
2021-08-02,20100,21599,-1499,-6.94,1208
2021-08-03,20159,21915,-1756,-8.01,1208
2021-08-04,20159,21855,-1696,-7.76,1208
2021-08-05,20159,21790,-1631,-7.49,1208
2021-08-06,18661,21172,-2511,-11.86,1208
2021-08-07,12920,12522,398,3.18,1208
2021-08-08,11057,9619,1438,14.95,1208
2021-08-09,20100,21042,-942,-4.48,1208
2021-08-10,20159,21348,-1189,-5.57,1208
2021-08-11,20159,21293,-1134,-5.33,1208
2021-08-12,20159,21246,-1087,-5.12,1208
2021-08-13,18661,20659,-1998,-9.67,1208
2021-08-14,12920,12054,866,7.18,1208
2021-08-15,11057,9209,1848,20.07,1208
2021-08-16,20100,20701,-601,-2.9,1208
2021-08-17,20159,21089,-930,-4.41,1208
2021-08-18,20159,21125,-966,-4.57,1208
2021-08-19,20159,21176,-1017,-4.8,1208
2021-08-20,18661,20694,-2033,-9.82,1208
2021-08-21,12920,12198,722,5.92,1208
2021-08-22,11057,9464,1593,16.83,1208
2021-08-23,20100,21067,-967,-4.59,1208
2021-08-24,20159,21564,-1405,-6.52,1208
2021-08-25,20159,21703,-1544,-7.11,1208
2021-08-26,20159,21852,-1693,-7.75,1208
2021-08-27,18661,21458,-2797,-13.03,1208
2021-08-28,12920,13040,-120,-0.92,1208
2021-08-29,11057,10373,684,6.59,1208
2021-08-30,20100,22030,-1930,-8.76,1208
2021-08-31,20159,22565,-2406,-10.66,1208
2021-09-01,22235,22730,-495,-2.18,1208
2021-09-02,22235,22890,-655,-2.86,1208
2021-09-03,21392,22492,-1100,-4.89,1208
2021-09-04,15067,14056,1011,7.19,1208
2021-09-05,13127,11358,1769,15.57,1208
2021-09-06,21465,22971,-1506,-6.56,1208
2021-09-07,22235,23451,-1216,-5.19,1208
2021-09-08,22235,23552,-1317,-5.59,1208
2021-09-09,22235,23639,-1404,-5.94,1208
2021-09-10,21392,23163,-1771,-7.65,1208
2021-09-11,15067,14645,422,2.88,1208
2021-09-12,13127,11861,1266,10.67,1208
2021-09-13,21465,23389,-1924,-8.23,1208
2021-09-14,22235,23787,-1552,-6.52,1208
2021-09-15,22235,23807,-1572,-6.6,1208
2021-09-16,22235,23819,-1584,-6.65,1208
2021-09-17,21392,23275,-1883,-8.09,1208
2021-09-18,15067,14695,372,2.53,1208
2021-09-19,13127,11858,1269,10.7,1208
2021-09-20,21465,23343,-1878,-8.05,1208
2021-09-21,22235,23706,-1471,-6.21,1208
2021-09-22,22235,23702,-1467,-6.19,1208
2021-09-23,22235,23699,-1464,-6.18,1208
2021-09-24,21392,23148,-1756,-7.59,1208
2021-09-25,15067,14571,496,3.4,1208
2021-09-26,13127,11745,1382,11.77,1208
2021-09-27,21465,23246,-1781,-7.66,1208
2021-09-28,22235,23631,-1396,-5.91,1208
2021-09-29,22235,23653,-1418,-6.0,1208
2021-09-30,22235,23679,-1444,-6.1,1208
2021-10-01,22289,23159,-870,-3.76,1208
2021-10-02,15528,14613,915,6.26,1208
2021-10-03,12360,11816,544,4.6,1208
2021-10-04,21247,23344,-2097,-8.98,1208
2021-10-05,22571,23753,-1182,-4.98,1208
2021-10-06,22571,23795,-1224,-5.14,1208
2021-10-07,22571,23836,-1265,-5.31,1208
2021-10-08,22289,23326,-1037,-4.45,1208
2021-10-09,15528,14783,745,5.04,1208
2021-10-10,12360,11985,375,3.13,1208
2021-10-11,21247,23506,-2259,-9.61,1208
2021-10-12,22571,23903,-1332,-5.57,1208
2021-10-13,22571,23928,-1357,-5.67,1208
2021-10-14,22571,23948,-1377,-5.75,1208
2021-10-15,22289,23414,-1125,-4.8,1208
2021-10-16,15528,14845,683,4.6,1208
2021-10-17,12360,12020,340,2.83,1208
2021-10-18,21247,23514,-2267,-9.64,1208
2021-10-19,22571,23885,-1314,-5.5,1208
2021-10-20,22571,23887,-1316,-5.51,1208
2021-10-21,22571,23886,-1315,-5.51,1208
2021-10-22,22289,23335,-1046,-4.48,1208
2021-10-23,15528,14755,773,5.24,1208
2021-10-24,12360,11922,438,3.67,1208
2021-10-25,21247,23415,-2168,-9.26,1208
2021-10-26,22571,23790,-1219,-5.12,1208
2021-10-27,22571,23801,-1230,-5.17,1208
2021-10-28,22571,23815,-1244,-5.22,1208
2021-10-29,22289,23283,-994,-4.27,1208
2021-10-30,15528,14727,801,5.44,1208
2021-10-31,12360,11922,438,3.67,1208
2021-11-01,20299,23444,-3145,-13.41,1208
2021-11-02,21206,23850,-2644,-11.09,1208
2021-11-03,21206,23893,-2687,-11.25,1208
2021-11-04,21206,23938,-2732,-11.41,1208
2021-11-05,21561,23436,-1875,-8.0,1208
2021-11-06,14989,14905,84,0.56,1208
2021-11-07,11721,12122,-401,-3.31,1208
2021-11-08,20299,23660,-3361,-14.21,1208
2021-11-09,21206,24078,-2872,-11.93,1208
2021-11-10,21206,24124,-2918,-12.1,1208
2021-11-11,21206,24166,-2960,-12.25,1208
2021-11-12,21561,23653,-2092,-8.84,1208
2021-11-13,14989,15104,-115,-0.76,1208
2021-11-14,11721,12295,-574,-4.67,1208
2021-11-15,20299,23801,-3502,-14.71,1208
2021-11-16,21206,24179,-2973,-12.3,1208
2021-11-17,21206,24181,-2975,-12.3,1208
2021-11-18,21206,24173,-2967,-12.27,1208
2021-11-19,21561,23606,-2045,-8.66,1208
2021-11-20,14989,15000,-11,-0.07,1208
2021-11-21,11721,12134,-413,-3.4,1208
2021-11-22,20299,23582,-3283,-13.92,1208
2021-11-23,21206,23904,-2698,-11.29,1208
2021-11-24,21206,23852,-2646,-11.09,1208
2021-11-25,21206,23794,-2588,-10.88,1208
2021-11-26,21561,23183,-1622,-7.0,1208
2021-11-27,14989,14539,450,3.1,1208
2021-11-28,11721,11641,80,0.69,1208
2021-11-29,20299,23066,-2767,-12.0,1208
2021-11-30,21206,23373,-2167,-9.27,1208
2021-12-01,19680,23314,-3634,-15.59,1208
2021-12-02,19680,23259,-3579,-15.39,1208
2021-12-03,18077,22658,-4581,-20.22,1208
2021-12-04,13974,14033,-59,-0.42,1208
2021-12-05,10527,11161,-634,-5.68,1208
2021-12-06,20159,22618,-2459,-10.87,1208
2021-12-07,19680,22962,-3282,-14.29,1208
2021-12-08,19680,22945,-3265,-14.23,1208
2021-12-09,19680,22934,-3254,-14.19,1208
2021-12-10,18077,22380,-4303,-19.23,1208
2021-12-11,13974,13801,173,1.25,1208
2021-12-12,10527,10973,-446,-4.06,1208
2021-12-13,20159,22473,-2314,-10.3,1208
2021-12-14,19680,22855,-3175,-13.89,1208
2021-12-15,19680,22871,-3191,-13.95,1208
2021-12-16,19680,22887,-3207,-14.01,1208
2021-12-17,18077,22352,-4275,-19.13,1208
2021-12-18,13974,13785,189,1.37,1208
2021-12-19,10527,10961,-434,-3.96,1208
2021-12-20,20159,22457,-2298,-10.23,1208
2021-12-21,19680,22827,-3147,-13.79,1208
2021-12-22,19680,22822,-3142,-13.77,1208
2021-12-23,19680,22811,-3131,-13.73,1208
2021-12-24,18077,22242,-4165,-18.73,1208
2021-12-25,13974,13635,339,2.49,1208
2021-12-26,10527,10768,-241,-2.24,1208
2021-12-27,20159,22217,-2058,-9.26,1208
2021-12-28,19680,22538,-2858,-12.68,1208
2021-12-29,19680,22485,-2805,-12.47,1208
2021-12-30,19680,22425,-2745,-12.24,1208
2021-12-31,18077,21812,-3735,-17.12,1208
2022-01-01,13522,13164,358,2.72,1208
2022-01-02,10029,10261,-232,-2.26,1208
2022-01-03,18826,21680,-2854,-13.16,1208
2022-01-04,19208,21980,-2772,-12.61,1208
2022-01-05,19208,21914,-2706,-12.35,1208
2022-01-06,19208,21850,-2642,-12.09,1208
2022-01-07,18610,21242,-2632,-12.39,1208
2022-01-08,13522,12609,913,7.24,1208
2022-01-09,10029,9731,298,3.06,1208
2022-01-10,18826,21183,-2357,-11.13,1208
2022-01-11,19208,21525,-2317,-10.76,1208
2022-01-12,19208,21508,-2300,-10.69,1208
2022-01-13,19208,21501,-2293,-10.66,1208
2022-01-14,18610,20955,-2345,-11.19,1208
2022-01-15,13522,12388,1134,9.15,1208
2022-01-16,10029,9580,449,4.69,1208
2022-01-17,18826,21103,-2277,-10.79,1208
2022-01-18,19208,21516,-2308,-10.73,1208
2022-01-19,19208,21570,-2362,-10.95,1208
2022-01-20,19208,21631,-2423,-11.2,1208
2022-01-21,18610,21148,-2538,-12.0,1208
2022-01-22,13522,12640,882,6.98,1208
2022-01-23,10029,9884,145,1.47,1208
2022-01-24,18826,21453,-2627,-12.25,1208
2022-01-25,19208,21904,-2696,-12.31,1208
2022-01-26,19208,21988,-2780,-12.64,1208
2022-01-27,19208,22070,-2862,-12.97,1208
2022-01-28,18610,21601,-2991,-13.85,1208
2022-01-29,13522,13099,423,3.23,1208
2022-01-30,10029,10340,-311,-3.01,1208
2020-02-01,15587,14272,1315,9.21,1612
2020-02-02,12696,11863,833,7.02,1612
2020-02-03,18078,19211,-1133,-5.9,1612
2020-02-04,18805,19645,-840,-4.28,1612
2020-02-05,18805,19672,-867,-4.41,1612
2020-02-06,18805,19718,-913,-4.63,1612
2020-02-07,19894,20327,-433,-2.13,1612
2020-02-08,15587,14556,1031,7.08,1612
2020-02-09,12696,12119,577,4.76,1612
2020-02-10,18078,19439,-1361,-7.0,1612
2020-02-11,18805,19847,-1042,-5.25,1612
2020-02-12,18805,19853,-1048,-5.28,1612
2020-02-13,18805,19879,-1074,-5.4,1612
2020-02-14,19894,20472,-578,-2.82,1612
2020-02-15,15587,14691,896,6.1,1612
2020-02-16,12696,12246,450,3.67,1612
2020-02-17,18078,19564,-1486,-7.6,1612
2020-02-18,18805,19973,-1168,-5.85,1612
2020-02-19,18805,19983,-1178,-5.9,1612
2020-02-20,18805,20018,-1213,-6.06,1612
2020-02-21,19894,20622,-728,-3.53,1612
2020-02-22,15587,14854,733,4.93,1612
2020-02-23,12696,12424,272,2.19,1612
2020-02-24,18078,19757,-1679,-8.5,1612
2020-02-25,18805,20181,-1376,-6.82,1612
2020-02-26,18805,20206,-1401,-6.93,1612
2020-02-27,18805,20254,-1449,-7.15,1612
2020-02-28,19894,20869,-975,-4.67,1612
2020-02-29,15587,15110,477,3.16,1612
2020-03-01,9275,12686,-3411,-26.89,1612
2020-03-02,14791,20021,-5230,-26.12,1612
2020-03-03,14721,20445,-5724,-28.0,1612
2020-03-04,14721,20465,-5744,-28.07,1612
2020-03-05,14721,20505,-5784,-28.21,1612
2020-03-06,15643,21109,-5466,-25.89,1612
2020-03-07,11048,15335,-4287,-27.96,1612
2020-03-08,9275,12893,-3618,-28.06,1612
2020-03-09,14791,20209,-5418,-26.81,1612
2020-03-10,14721,20610,-5889,-28.57,1612
2020-03-11,14721,20607,-5886,-28.56,1612
2020-03-12,14721,20624,-5903,-28.62,1612
2020-03-13,15643,21204,-5561,-26.23,1612
2020-03-14,11048,15407,-4359,-28.29,1612
2020-03-15,9275,12944,-3669,-28.35,1612
2020-03-16,14791,20240,-5449,-26.92,1612
2020-03-17,14721,20625,-5904,-28.63,1612
2020-03-18,14721,20608,-5887,-28.57,1612
2020-03-19,14721,20613,-5892,-28.58,1612
2020-03-20,15643,21186,-5543,-26.16,1612
2020-03-21,11048,15385,-4337,-28.19,1612
2020-03-22,9275,12921,-3646,-28.22,1612
2020-03-23,14791,20220,-5429,-26.85,1612
2020-03-24,14721,20611,-5890,-28.58,1612
2020-03-25,14721,20603,-5882,-28.55,1612
2020-03-26,14721,20620,-5899,-28.61,1612
2020-03-27,15643,21207,-5564,-26.24,1612
2020-03-28,11048,15421,-4373,-28.36,1612
2020-03-29,9275,12973,-3698,-28.51,1612
2020-03-30,14791,20288,-5497,-27.09,1612
2020-03-31,14721,20695,-5974,-28.87,1612
2020-04-01,13507,20701,-7194,-34.75,1612
2020-04-02,13507,20731,-7224,-34.85,1612
2020-04-03,13226,21329,-8103,-37.99,1612
2020-04-04,10249,15551,-5302,-34.09,1612
2020-04-05,7102,13109,-6007,-45.82,1612
2020-04-06,13478,20426,-6948,-34.02,1612
2020-04-07,13507,20832,-7325,-35.16,1612
2020-04-08,13507,20835,-7328,-35.17,1612
2020-04-09,13507,20858,-7351,-35.24,1612
2020-04-10,13226,21445,-8219,-38.33,1612
2020-04-11,10249,15655,-5406,-34.53,1612
2020-04-12,7102,13197,-6095,-46.18,1612
2020-04-13,13478,20498,-7020,-34.25,1612
2020-04-14,13507,20886,-7379,-35.33,1612
2020-04-15,13507,20871,-7364,-35.28,1612
2020-04-16,13507,20875,-7368,-35.3,1612
2020-04-17,13226,21444,-8218,-38.32,1612
2020-04-18,10249,15638,-5389,-34.46,1612
2020-04-19,7102,13166,-6064,-46.06,1612
2020-04-20,13478,20454,-6976,-34.11,1612
2020-04-21,13507,20832,-7325,-35.16,1612
2020-04-22,13507,20810,-7303,-35.09,1612
2020-04-23,13507,20811,-7304,-35.1,1612
2020-04-24,13226,21380,-8154,-38.14,1612
2020-04-25,10249,15577,-5328,-34.2,1612
2020-04-26,7102,13112,-6010,-45.84,1612
2020-04-27,13478,20410,-6932,-33.96,1612
2020-04-28,13507,20801,-7294,-35.07,1612
2020-04-29,13507,20794,-7287,-35.04,1612
2020-04-30,13507,20812,-7305,-35.1,1612
2020-05-01,17645,21399,-3754,-17.54,1612
2020-05-02,13809,15615,-1806,-11.57,1612
2020-05-03,10829,13168,-2339,-17.76,1612
2020-05-04,17330,20485,-3155,-15.4,1612
2020-05-05,17538,20892,-3354,-16.05,1612
2020-05-06,17538,20899,-3361,-16.08,1612
2020-05-07,17538,20929,-3391,-16.2,1612
2020-05-08,17645,21525,-3880,-18.03,1612
2020-05-09,13809,15745,-1936,-12.3,1612
2020-05-10,10829,13300,-2471,-18.58,1612
2020-05-11,17330,20613,-3283,-15.93,1612
2020-05-12,17538,21013,-3475,-16.54,1612
2020-05-13,17538,21009,-3471,-16.52,1612
2020-05-14,17538,21023,-3485,-16.58,1612
2020-05-15,17645,21601,-3956,-18.31,1612
2020-05-16,13809,15799,-1990,-12.6,1612
2020-05-17,10829,13329,-2500,-18.76,1612
2020-05-18,17330,20617,-3287,-15.94,1612
2020-05-19,17538,20990,-3452,-16.45,1612
2020-05-20,17538,20958,-3420,-16.32,1612
2020-05-21,17538,20945,-3407,-16.27,1612
2020-05-22,17645,21496,-3851,-17.91,1612
2020-05-23,13809,15671,-1862,-11.88,1612
2020-05-24,10829,13180,-2351,-17.84,1612
2020-05-25,17330,20449,-3119,-15.25,1612
2020-05-26,17538,20808,-3270,-15.72,1612
2020-05-27,17538,20766,-3228,-15.54,1612
2020-05-28,17538,20749,-3211,-15.48,1612
2020-05-29,17645,21299,-3654,-17.16,1612
2020-05-30,13809,15478,-1669,-10.78,1612
2020-05-31,10829,12995,-2166,-16.67,1612
2020-06-01,19758,20277,-519,-2.56,1612
2020-06-02,20401,20652,-251,-1.22,1612
2020-06-03,20401,20630,-229,-1.11,1612
2020-06-04,20401,20634,-233,-1.13,1612
2020-06-05,19796,21208,-1412,-6.66,1612
2020-06-06,14987,15410,-423,-2.74,1612
2020-06-07,12282,12951,-669,-5.17,1612
2020-06-08,19758,20255,-497,-2.45,1612
2020-06-09,20401,20650,-249,-1.21,1612
2020-06-10,20401,20644,-243,-1.18,1612
2020-06-11,20401,20661,-260,-1.26,1612
2020-06-12,19796,21242,-1446,-6.81,1612
2020-06-13,14987,15447,-460,-2.98,1612
2020-06-14,12282,12984,-702,-5.41,1612
2020-06-15,19758,20278,-520,-2.56,1612
2020-06-16,20401,20656,-255,-1.23,1612
2020-06-17,20401,20627,-226,-1.1,1612
2020-06-18,20401,20614,-213,-1.03,1612
2020-06-19,19796,21160,-1364,-6.45,1612
2020-06-20,14987,15325,-338,-2.21,1612
2020-06-21,12282,12817,-535,-4.17,1612
2020-06-22,19758,20063,-305,-1.52,1612
2020-06-23,20401,20391,10,0.05,1612
2020-06-24,20401,20310,91,0.45,1612
2020-06-25,20401,20245,156,0.77,1612
2020-06-26,19796,20742,-946,-4.56,1612
2020-06-27,14987,14858,129,0.87,1612
2020-06-28,12282,12306,-24,-0.2,1612
2020-06-29,19758,19513,245,1.26,1612
2020-06-30,20401,19807,594,3.0,1612
2020-07-01,20771,19700,1071,5.44,1612
2020-07-02,20771,19616,1155,5.89,1612
2020-07-03,21011,20102,909,4.52,1612
2020-07-04,15646,14216,1430,10.06,1612
2020-07-05,13975,11670,2305,19.75,1612
2020-07-06,20181,18892,1289,6.82,1612
2020-07-07,20771,19209,1562,8.13,1612
2020-07-08,20771,19132,1639,8.57,1612
2020-07-09,20771,19086,1685,8.83,1612
2020-07-10,21011,19614,1397,7.12,1612
2020-07-11,15646,13776,1870,13.57,1612
2020-07-12,13975,11281,2694,23.88,1612
2020-07-13,20181,18555,1626,8.76,1612
2020-07-14,20771,18926,1845,9.75,1612
2020-07-15,20771,18901,1870,9.89,1612
2020-07-16,20771,18905,1866,9.87,1612
2020-07-17,21011,19478,1533,7.87,1612
2020-07-18,15646,13680,1966,14.37,1612
2020-07-19,13975,11219,2756,24.57,1612
2020-07-20,20181,18519,1662,8.97,1612
2020-07-21,20771,18907,1864,9.86,1612
2020-07-22,20771,18891,1880,9.95,1612
2020-07-23,20771,18894,1877,9.93,1612
2020-07-24,21011,19457,1554,7.99,1612
2020-07-25,15646,13640,2006,14.71,1612
2020-07-26,13975,11150,2825,25.34,1612
2020-07-27,20181,18414,1767,9.6,1612
2020-07-28,20771,18760,2011,10.72,1612
2020-07-29,20771,18695,2076,11.1,1612
2020-07-30,20771,18644,2127,11.41,1612
2020-07-31,21011,19152,1859,9.71,1612
2020-08-01,15286,13278,2008,15.12,1612
2020-08-02,13184,10733,2451,22.84,1612
2020-08-03,19377,17944,1433,7.99,1612
2020-08-04,19715,18240,1475,8.09,1612
2020-08-05,19715,18133,1582,8.72,1612
2020-08-06,19715,18048,1667,9.24,1612
2020-08-07,20079,18531,1548,8.35,1612
2020-08-08,15286,12643,2643,20.9,1612
2020-08-09,13184,10096,3088,30.59,1612
2020-08-10,19377,17317,2060,11.9,1612
2020-08-11,19715,17637,2078,11.78,1612
2020-08-12,19715,17566,2149,12.23,1612
2020-08-13,19715,17531,2184,12.46,1612
2020-08-14,20079,18077,2002,11.07,1612
2020-08-15,15286,12263,3023,24.65,1612
2020-08-16,13184,9801,3383,34.52,1612
2020-08-17,19377,17116,2261,13.21,1612
2020-08-18,19715,17539,2176,12.41,1612
2020-08-19,19715,17578,2137,12.16,1612
2020-08-20,19715,17656,2059,11.66,1612
2020-08-21,20079,18317,1762,9.62,1612
2020-08-22,15286,12618,2668,21.14,1612
2020-08-23,13184,10269,2915,28.39,1612
2020-08-24,19377,17694,1683,9.51,1612
2020-08-25,19715,18219,1496,8.21,1612
2020-08-26,19715,18352,1363,7.43,1612
2020-08-27,19715,18515,1200,6.48,1612
2020-08-28,20079,19249,830,4.31,1612
2020-08-29,15286,13611,1675,12.31,1612
2020-08-30,13184,11309,1875,16.58,1612
2020-08-31,19377,18766,611,3.26,1612
2020-09-01,20610,19310,1300,6.73,1612
2020-09-02,20610,19446,1164,5.99,1612
2020-09-03,20610,19598,1012,5.16,1612
2020-09-04,20846,20308,538,2.65,1612
2020-09-05,16953,14633,2320,15.85,1612
2020-09-06,14077,12283,1794,14.61,1612
2020-09-07,19985,19683,302,1.53,1612
2020-09-08,20610,20160,450,2.23,1612
2020-09-09,20610,20224,386,1.91,1612
2020-09-10,20610,20298,312,1.54,1612
2020-09-11,20846,20928,-82,-0.39,1612
2020-09-12,16953,15172,1781,11.74,1612
2020-09-13,14077,12743,1334,10.47,1612
2020-09-14,19985,20065,-80,-0.4,1612
2020-09-15,20610,20471,139,0.68,1612
2020-09-16,20610,20468,142,0.69,1612
2020-09-17,20610,20485,125,0.61,1612
2020-09-18,20846,21064,-218,-1.03,1612
2020-09-19,16953,15268,1685,11.04,1612
2020-09-20,14077,12807,1270,9.92,1612
2020-09-21,19985,20109,-124,-0.62,1612
2020-09-22,20610,20502,108,0.53,1612
2020-09-23,20610,20498,112,0.55,1612
2020-09-24,20610,20521,89,0.43,1612
2020-09-25,20846,21116,-270,-1.28,1612
2020-09-26,16953,15341,1612,10.51,1612
2020-09-27,14077,12908,1169,9.06,1612
2020-09-28,19985,20241,-256,-1.26,1612
2020-09-29,20610,20670,-60,-0.29,1612
2020-09-30,20610,20702,-92,-0.44,1612
2020-10-01,19406,20762,-1356,-6.53,1612
2020-10-02,19809,21391,-1582,-7.4,1612
2020-10-03,15559,15649,-90,-0.58,1612
2020-10-04,12650,13244,-594,-4.49,1612
2020-10-05,19316,20600,-1284,-6.23,1612
2020-10-06,19406,21046,-1640,-7.79,1612
2020-10-07,19406,21088,-1682,-7.98,1612
2020-10-08,19406,21150,-1744,-8.25,1612
2020-10-09,19809,21775,-1966,-9.03,1612
2020-10-10,15559,16021,-462,-2.88,1612
2020-10-11,12650,13597,-947,-6.96,1612
2020-10-12,19316,20928,-1612,-7.7,1612
2020-10-13,19406,21341,-1935,-9.07,1612
2020-10-14,19406,21347,-1941,-9.09,1612
2020-10-15,19406,21368,-1962,-9.18,1612
2020-10-16,19809,21949,-2140,-9.75,1612
2020-10-17,15559,16149,-590,-3.65,1612
2020-10-18,12650,13678,-1028,-7.52,1612
2020-10-19,19316,20963,-1647,-7.86,1612
2020-10-20,19406,21333,-1927,-9.03,1612
2020-10-21,19406,21298,-1892,-8.88,1612
2020-10-22,19406,21282,-1876,-8.81,1612
2020-10-23,19809,21832,-2023,-9.27,1612
2020-10-24,15559,16006,-447,-2.79,1612
2020-10-25,12650,13516,-866,-6.41,1612
2020-10-26,19316,20789,-1473,-7.09,1612
2020-10-27,19406,21153,-1747,-8.26,1612
2020-10-28,19406,21119,-1713,-8.11,1612
2020-10-29,19406,21112,-1706,-8.08,1612
2020-10-30,19809,21676,-1867,-8.61,1612
2020-10-31,15559,15870,-311,-1.96,1612
2020-11-01,10536,13404,-2868,-21.4,1612
2020-11-02,17473,20705,-3232,-15.61,1612
2020-11-03,16450,21100,-4650,-22.04,1612
2020-11-04,16450,21099,-4649,-22.03,1612
2020-11-05,16450,21124,-4674,-22.13,1612
2020-11-06,17348,21719,-4371,-20.13,1612
2020-11-07,13093,15942,-2849,-17.87,1612
2020-11-08,10536,13503,-2967,-21.97,1612
2020-11-09,17473,20825,-3352,-16.1,1612
2020-11-10,16450,21237,-4787,-22.54,1612
2020-11-11,16450,21246,-4796,-22.57,1612
2020-11-12,16450,21276,-4826,-22.68,1612
2020-11-13,17348,21868,-4520,-20.67,1612
2020-11-14,13093,16082,-2989,-18.59,1612
2020-11-15,10536,13626,-3090,-22.68,1612
2020-11-16,17473,20926,-3453,-16.5,1612
2020-11-17,16450,21308,-4858,-22.8,1612
2020-11-18,16450,21283,-4833,-22.71,1612
2020-11-19,16450,21274,-4824,-22.68,1612
2020-11-20,17348,21824,-4476,-20.51,1612
2020-11-21,13093,15992,-2899,-18.13,1612
2020-11-22,10536,13490,-2954,-21.9,1612
2020-11-23,17473,20743,-3270,-15.76,1612
2020-11-24,16450,21080,-4630,-21.96,1612
2020-11-25,16450,21011,-4561,-21.71,1612
2020-11-26,16450,20962,-4512,-21.52,1612
2020-11-27,17348,21477,-4129,-19.23,1612
2020-11-28,13093,15615,-2522,-16.15,1612
2020-11-29,10536,13089,-2553,-19.5,1612
2020-11-30,17473,20325,-2852,-14.03,1612
2020-12-01,16718,20652,-3934,-19.05,1612
2020-12-02,16718,20581,-3863,-18.77,1612
2020-12-03,16718,20537,-3819,-18.6,1612
2020-12-04,18090,21063,-2973,-14.11,1612
2020-12-05,13408,15220,-1812,-11.91,1612
2020-12-06,9804,12719,-2915,-22.92,1612
2020-12-07,16631,19984,-3353,-16.78,1612
2020-12-08,16718,20346,-3628,-17.83,1612
2020-12-09,16718,20312,-3594,-17.69,1612
2020-12-10,16718,20306,-3588,-17.67,1612
2020-12-11,18090,20873,-2783,-13.33,1612
2020-12-12,13408,15069,-1661,-11.02,1612
2020-12-13,9804,12606,-2802,-22.23,1612
2020-12-14,16631,19906,-3275,-16.45,1612
2020-12-15,16718,20299,-3581,-17.64,1612
2020-12-16,16718,20291,-3573,-17.61,1612
2020-12-17,16718,20306,-3588,-17.67,1612
2020-12-18,18090,20886,-2796,-13.39,1612
2020-12-19,13408,15089,-1681,-11.14,1612
2020-12-20,9804,12626,-2822,-22.35,1612
2020-12-21,16631,19919,-3288,-16.51,1612
2020-12-22,16718,20297,-3579,-17.63,1612
2020-12-23,16718,20268,-3550,-17.52,1612
2020-12-24,16718,20255,-3537,-17.46,1612
2020-12-25,18090,20803,-2713,-13.04,1612
2020-12-26,13408,14969,-1561,-10.43,1612
2020-12-27,9804,12465,-2661,-21.35,1612
2020-12-28,16631,19716,-3085,-15.65,1612
2020-12-29,16718,20050,-3332,-16.62,1612
2020-12-30,16718,19978,-3260,-16.32,1612
2020-12-31,16718,19925,-3207,-16.1,1612
2021-01-01,16991,20434,-3443,-16.85,1612
2021-01-02,12016,14566,-2550,-17.51,1612
2021-01-03,9153,12033,-2880,-23.93,1612
2021-01-04,15979,19261,-3282,-17.04,1612
2021-01-05,16414,19580,-3166,-16.17,1612
2021-01-06,16414,19500,-3086,-15.83,1612
2021-01-07,16414,19446,-3032,-15.59,1612
2021-01-08,16991,19964,-2973,-14.89,1612
2021-01-09,12016,14114,-2098,-14.86,1612
2021-01-10,9153,11606,-2453,-21.14,1612
2021-01-11,15979,18868,-2889,-15.31,1612
2021-01-12,16414,19227,-2813,-14.63,1612
2021-01-13,16414,19195,-2781,-14.49,1612
2021-01-14,16414,19194,-2780,-14.48,1612
2021-01-15,16991,19770,-2779,-14.06,1612
2021-01-16,12016,13980,-1964,-14.05,1612
2021-01-17,9153,11536,-2383,-20.66,1612
2021-01-18,15979,18861,-2882,-15.28,1612
2021-01-19,16414,19284,-2870,-14.88,1612
2021-01-20,16414,19314,-2900,-15.02,1612
2021-01-21,16414,19373,-2959,-15.27,1612
2021-01-22,16991,20004,-3013,-15.06,1612
2021-01-23,12016,14264,-2248,-15.76,1612
2021-01-24,9153,11865,-2712,-22.86,1612
2021-01-25,15979,19228,-3249,-16.9,1612
2021-01-26,16414,19683,-3269,-16.61,1612
2021-01-27,16414,19736,-3322,-16.83,1612
2021-01-28,16414,19812,-3398,-17.15,1612
2021-01-29,16991,20452,-3461,-16.92,1612
2021-01-30,12016,14715,-2699,-18.34,1612
2021-01-31,9153,12311,-3158,-25.65,1612
2021-02-01,18095,19664,-1569,-7.98,1612
2021-02-02,18200,20103,-1903,-9.47,1612
2021-02-03,18200,20136,-1936,-9.61,1612
2021-02-04,18200,20188,-1988,-9.85,1612
2021-02-05,19072,20801,-1729,-8.31,1612
2021-02-06,14462,15036,-574,-3.82,1612
2021-02-07,11430,12603,-1173,-9.31,1612
2021-02-08,18095,19927,-1832,-9.19,1612
2021-02-09,18200,20338,-2138,-10.51,1612
2021-02-10,18200,20345,-2145,-10.54,1612
2021-02-11,18200,20373,-2173,-10.67,1612
2021-02-12,19072,20967,-1895,-9.04,1612
2021-02-13,14462,15185,-723,-4.76,1612
2021-02-14,11430,12740,-1310,-10.28,1612
2021-02-15,18095,20056,-1961,-9.78,1612
2021-02-16,18200,20463,-2263,-11.06,1612
2021-02-17,18200,20470,-2270,-11.09,1612
2021-02-18,18200,20503,-2303,-11.23,1612
2021-02-19,19072,21104,-2032,-9.63,1612
2021-02-20,14462,15332,-870,-5.67,1612
2021-02-21,11430,12899,-1469,-11.39,1612
2021-02-22,18095,20230,-2135,-10.55,1612
2021-02-23,18200,20652,-2452,-11.87,1612
2021-02-24,18200,20675,-2475,-11.97,1612
2021-02-25,18200,20722,-2522,-12.17,1612
2021-02-26,19072,21336,-2264,-10.61,1612
2021-02-27,14462,15577,-1115,-7.16,1612
2021-02-28,11430,13153,-1723,-13.1,1612
2021-03-01,19172,20491,-1319,-6.44,1612
2021-03-02,19602,20916,-1314,-6.28,1612
2021-03-03,19602,20939,-1337,-6.39,1612
2021-03-04,19602,20982,-1380,-6.58,1612
2021-03-05,19726,21590,-1864,-8.63,1612
2021-03-06,16239,15820,419,2.65,1612
2021-03-07,11912,13382,-1470,-10.98,1612
2021-03-08,19172,20702,-1530,-7.39,1612
2021-03-09,19602,21109,-1507,-7.14,1612
2021-03-10,19602,21110,-1508,-7.14,1612
2021-03-11,19602,21131,-1529,-7.24,1612
2021-03-12,19726,21714,-1988,-9.16,1612
2021-03-13,16239,15921,318,2.0,1612
2021-03-14,11912,13460,-1548,-11.5,1612
2021-03-15,19172,20758,-1586,-7.64,1612
2021-03-16,19602,21145,-1543,-7.3,1612
2021-03-17,19602,21128,-1526,-7.22,1612
2021-03-18,19602,21134,-1532,-7.25,1612
2021-03-19,19726,21706,-1980,-9.12,1612
2021-03-20,16239,15904,335,2.11,1612
2021-03-21,11912,13438,-1526,-11.36,1612
2021-03-22,19172,20735,-1563,-7.54,1612
2021-03-23,19602,21124,-1522,-7.21,1612
2021-03-24,19602,21113,-1511,-7.16,1612
2021-03-25,19602,21127,-1525,-7.22,1612
2021-03-26,19726,21710,-1984,-9.14,1612
2021-03-27,16239,15921,318,2.0,1612
2021-03-28,11912,13471,-1559,-11.57,1612
2021-03-29,19172,20783,-1611,-7.75,1612
2021-03-30,19602,21188,-1586,-7.49,1612
2021-03-31,19602,21193,-1591,-7.51,1612
2021-04-01,18685,21222,-2537,-11.95,1612
2021-04-02,19446,21818,-2372,-10.87,1612
2021-04-03,14370,16041,-1671,-10.42,1612
2021-04-04,11318,13599,-2281,-16.77,1612
2021-04-05,18796,20918,-2122,-10.14,1612
2021-04-06,18685,21326,-2641,-12.38,1612
2021-04-07,18685,21331,-2646,-12.4,1612
2021-04-08,18685,21356,-2671,-12.51,1612
2021-04-09,19446,21947,-2501,-11.4,1612
2021-04-10,14370,16160,-1790,-11.08,1612
2021-04-11,11318,13706,-2388,-17.42,1612
2021-04-12,18796,21011,-2215,-10.54,1612
2021-04-13,18685,21402,-2717,-12.7,1612
2021-04-14,18685,21389,-2704,-12.64,1612
2021-04-15,18685,21397,-2712,-12.67,1612
2021-04-16,19446,21969,-2523,-11.48,1612
2021-04-17,14370,16164,-1794,-11.1,1612
2021-04-18,11318,13693,-2375,-17.34,1612
2021-04-19,18796,20982,-2186,-10.42,1612
2021-04-20,18685,21360,-2675,-12.52,1612
2021-04-21,18685,21337,-2652,-12.43,1612
2021-04-22,18685,21337,-2652,-12.43,1612
2021-04-23,19446,21905,-2459,-11.23,1612
2021-04-24,14370,16099,-1729,-10.74,1612
2021-04-25,11318,13631,-2313,-16.97,1612
2021-04-26,18796,20926,-2130,-10.18,1612
2021-04-27,18685,21314,-2629,-12.33,1612
2021-04-28,18685,21303,-2618,-12.29,1612
2021-04-29,18685,21317,-2632,-12.35,1612
2021-04-30,19446,21901,-2455,-11.21,1612
2021-05-01,16578,16114,464,2.88,1612
2021-05-02,12540,13664,-1124,-8.23,1612
2021-05-03,20939,20978,-39,-0.19,1612
2021-05-04,21067,21384,-317,-1.48,1612
2021-05-05,21067,21390,-323,-1.51,1612
2021-05-06,21067,21419,-352,-1.64,1612
2021-05-07,21027,22016,-989,-4.49,1612
2021-05-08,16578,16237,341,2.1,1612
2021-05-09,12540,13794,-1254,-9.09,1612
2021-05-10,20939,21110,-171,-0.81,1612
2021-05-11,21067,21513,-446,-2.07,1612
2021-05-12,21067,21513,-446,-2.07,1612
2021-05-13,21067,21532,-465,-2.16,1612
2021-05-14,21027,22114,-1087,-4.92,1612
2021-05-15,16578,16318,260,1.59,1612
2021-05-16,12540,13853,-1313,-9.48,1612
2021-05-17,20939,21146,-207,-0.98,1612
2021-05-18,21067,21524,-457,-2.12,1612
2021-05-19,21067,21496,-429,-2.0,1612
2021-05-20,21067,21488,-421,-1.96,1612
2021-05-21,21027,22043,-1016,-4.61,1612
2021-05-22,16578,16220,358,2.21,1612
2021-05-23,12540,13731,-1191,-8.67,1612
2021-05-24,20939,21001,-62,-0.3,1612
2021-05-25,21067,21361,-294,-1.38,1612
2021-05-26,21067,21318,-251,-1.18,1612
2021-05-27,21067,21299,-232,-1.09,1612
2021-05-28,21027,21847,-820,-3.75,1612
2021-05-29,16578,16023,555,3.46,1612
2021-05-30,12540,13536,-996,-7.36,1612
2021-05-31,20939,20814,125,0.6,1612
2021-06-01,21299,21185,114,0.54,1612
2021-06-02,21299,21158,141,0.67,1612
2021-06-03,21299,21157,142,0.67,1612
2021-06-04,20992,21727,-735,-3.38,1612
2021-06-05,16636,15925,711,4.46,1612
2021-06-06,14110,13463,647,4.81,1612
2021-06-07,21318,20764,554,2.67,1612
2021-06-08,21299,21158,141,0.67,1612
2021-06-09,21299,21151,148,0.7,1612
2021-06-10,21299,21168,131,0.62,1612
2021-06-11,20992,21751,-759,-3.49,1612
2021-06-12,16636,15958,678,4.25,1612
2021-06-13,14110,13499,611,4.53,1612
2021-06-14,21318,20798,520,2.5,1612
2021-06-15,21299,21183,116,0.55,1612
2021-06-16,21299,21161,138,0.65,1612
2021-06-17,21299,21157,142,0.67,1612
2021-06-18,20992,21712,-720,-3.32,1612
2021-06-19,16636,15886,750,4.72,1612
2021-06-20,14110,13388,722,5.39,1612
2021-06-21,21318,20643,675,3.27,1612
2021-06-22,21299,20981,318,1.52,1612
2021-06-23,21299,20909,390,1.87,1612
2021-06-24,21299,20853,446,2.14,1612
2021-06-25,20992,21357,-365,-1.71,1612
2021-06-26,16636,15479,1157,7.47,1612
2021-06-27,14110,12933,1177,9.1,1612
2021-06-28,21318,20143,1175,5.83,1612
2021-06-29,21299,20440,859,4.2,1612
2021-06-30,21299,20333,966,4.75,1612
2021-07-01,20145,20249,-104,-0.51,1612
2021-07-02,20405,20731,-326,-1.57,1612
2021-07-03,14463,14841,-378,-2.55,1612
2021-07-04,12728,12290,438,3.56,1612
2021-07-05,19804,19505,299,1.53,1612
2021-07-06,20145,19814,331,1.67,1612
2021-07-07,20145,19729,416,2.11,1612
2021-07-08,20145,19673,472,2.4,1612
2021-07-09,20405,20191,214,1.06,1612
2021-07-10,14463,14343,120,0.84,1612
2021-07-11,12728,11838,890,7.52,1612
2021-07-12,19804,19103,701,3.67,1612
2021-07-13,20145,19465,680,3.49,1612
2021-07-14,20145,19432,713,3.67,1612
2021-07-15,20145,19429,716,3.69,1612
2021-07-16,20405,19998,407,2.04,1612
2021-07-17,14463,14196,267,1.88,1612
2021-07-18,12728,11733,995,8.48,1612
2021-07-19,19804,19033,771,4.05,1612
2021-07-20,20145,19423,722,3.72,1612
2021-07-21,20145,19410,735,3.79,1612
2021-07-22,20145,19418,727,3.74,1612
2021-07-23,20405,19988,417,2.09,1612
2021-07-24,14463,14178,285,2.01,1612
2021-07-25,12728,11698,1030,8.8,1612
2021-07-26,19804,18972,832,4.39,1612
2021-07-27,20145,19328,817,4.23,1612
2021-07-28,20145,19274,871,4.52,1612
2021-07-29,20145,19234,911,4.74,1612
2021-07-30,20405,19752,653,3.31,1612
2021-07-31,14463,13887,576,4.15,1612
2021-08-01,12146,11350,796,7.01,1612
2021-08-02,18682,18568,114,0.61,1612
2021-08-03,19040,18870,170,0.9,1612
2021-08-04,19040,18766,274,1.46,1612
2021-08-05,19040,18682,358,1.92,1612
2021-08-06,18913,19164,-251,-1.31,1612
2021-08-07,14085,13272,813,6.13,1612
2021-08-08,12146,10718,1428,13.32,1612
2021-08-09,18682,17930,752,4.19,1612
2021-08-10,19040,18239,801,4.39,1612
2021-08-11,19040,18155,885,4.87,1612
2021-08-12,19040,18105,935,5.16,1612
2021-08-13,18913,18633,280,1.5,1612
2021-08-14,14085,12800,1285,10.04,1612
2021-08-15,12146,10318,1828,17.72,1612
2021-08-16,18682,17613,1069,6.07,1612
2021-08-17,19040,18014,1026,5.7,1612
2021-08-18,19040,18032,1008,5.59,1612
2021-08-19,19040,18089,951,5.26,1612
2021-08-20,18913,18729,184,0.98,1612
2021-08-21,14085,13011,1074,8.25,1612
2021-08-22,12146,10645,1501,14.1,1612
2021-08-23,18682,18054,628,3.48,1612
2021-08-24,19040,18565,475,2.56,1612
2021-08-25,19040,18687,353,1.89,1612
2021-08-26,19040,18840,200,1.06,1612
2021-08-27,18913,19568,-655,-3.35,1612
2021-08-28,14085,13926,159,1.14,1612
2021-08-29,12146,11624,522,4.49,1612
2021-08-30,18682,19083,-401,-2.1,1612
2021-08-31,19040,19631,-591,-3.01,1612
2021-09-01,21081,19774,1307,6.61,1612
2021-09-02,21081,19935,1146,5.75,1612
2021-09-03,21560,20655,905,4.38,1612
2021-09-04,16794,14993,1801,12.01,1612
2021-09-05,14756,12657,2099,16.58,1612
2021-09-06,20639,20070,569,2.84,1612
2021-09-07,21081,20563,518,2.52,1612
2021-09-08,21081,20641,440,2.13,1612
2021-09-09,21081,20731,350,1.69,1612
2021-09-10,21560,21375,185,0.87,1612
2021-09-11,16794,15633,1161,7.43,1612
2021-09-12,14756,13216,1540,11.65,1612
2021-09-13,20639,20550,89,0.43,1612
2021-09-14,21081,20964,117,0.56,1612
2021-09-15,21081,20970,111,0.53,1612
2021-09-16,21081,20992,89,0.42,1612
2021-09-17,21560,21575,-15,-0.07,1612
2021-09-18,16794,15781,1013,6.42,1612
2021-09-19,14756,13320,1436,10.78,1612
2021-09-20,20639,20621,18,0.09,1612
2021-09-21,21081,21012,69,0.33,1612
2021-09-22,21081,21003,78,0.37,1612
2021-09-23,21081,21021,60,0.29,1612
2021-09-24,21560,21609,-49,-0.23,1612
2021-09-25,16794,15828,966,6.1,1612
2021-09-26,14756,13388,1368,10.22,1612
2021-09-27,20639,20714,-75,-0.36,1612
2021-09-28,21081,21136,-55,-0.26,1612
2021-09-29,21081,21162,-81,-0.38,1612
2021-09-30,21081,21216,-135,-0.64,1612
2021-10-01,22223,21841,382,1.75,1612
2021-10-02,17350,16095,1255,7.8,1612
2021-10-03,14017,13688,329,2.4,1612
2021-10-04,20484,21043,-559,-2.66,1612
2021-10-05,20952,21490,-538,-2.5,1612
2021-10-06,20952,21534,-582,-2.7,1612
2021-10-07,20952,21600,-648,-3.0,1612
2021-10-08,22223,22230,-7,-0.03,1612
2021-10-09,17350,16481,869,5.27,1612
2021-10-10,14017,14064,-47,-0.33,1612
2021-10-11,20484,21402,-918,-4.29,1612
2021-10-12,20952,21824,-872,-4.0,1612
2021-10-13,20952,21838,-886,-4.06,1612
2021-10-14,20952,21868,-916,-4.19,1612
2021-10-15,22223,22458,-235,-1.05,1612
2021-10-16,17350,16666,684,4.1,1612
2021-10-17,14017,14203,-186,-1.31,1612
2021-10-18,20484,21495,-1011,-4.7,1612
2021-10-19,20952,21871,-919,-4.2,1612
2021-10-20,20952,21840,-888,-4.07,1612
2021-10-21,20952,21829,-877,-4.02,1612
2021-10-22,22223,22381,-158,-0.71,1612
2021-10-23,17350,16556,794,4.8,1612
2021-10-24,14017,14066,-49,-0.35,1612
2021-10-25,20484,21337,-853,-4.0,1612
2021-10-26,20952,21699,-747,-3.44,1612
2021-10-27,20952,21661,-709,-3.27,1612
2021-10-28,20952,21650,-698,-3.22,1612
2021-10-29,22223,22208,15,0.07,1612
2021-10-30,17350,16396,954,5.82,1612
2021-10-31,14017,13924,93,0.67,1612
2021-11-01,19376,21219,-1843,-8.69,1612
2021-11-02,20233,21608,-1375,-6.36,1612
2021-11-03,20233,21601,-1368,-6.33,1612
2021-11-04,20233,21621,-1388,-6.42,1612
2021-11-05,20685,22212,-1527,-6.87,1612
2021-11-06,16695,16431,264,1.61,1612
2021-11-07,13420,13990,-570,-4.07,1612
2021-11-08,19376,21311,-1935,-9.08,1612
2021-11-09,20233,21723,-1490,-6.86,1612
2021-11-10,20233,21734,-1501,-6.91,1612
2021-11-11,20233,21766,-1533,-7.04,1612
2021-11-12,20685,22363,-1678,-7.5,1612
2021-11-13,16695,16582,113,0.68,1612
2021-11-14,13420,14132,-712,-5.04,1612
2021-11-15,19376,21439,-2063,-9.62,1612
2021-11-16,20233,21830,-1597,-7.32,1612
2021-11-17,20233,21813,-1580,-7.24,1612
2021-11-18,20233,21812,-1579,-7.24,1612
2021-11-19,20685,22371,-1686,-7.54,1612
2021-11-20,16695,16548,147,0.89,1612
2021-11-21,13420,14054,-634,-4.51,1612
2021-11-22,19376,21314,-1938,-9.09,1612
2021-11-23,20233,21658,-1425,-6.58,1612
2021-11-24,20233,21596,-1363,-6.31,1612
2021-11-25,20233,21551,-1318,-6.12,1612
2021-11-26,20685,22069,-1384,-6.27,1612
2021-11-27,16695,16209,486,3.0,1612
2021-11-28,13420,13684,-264,-1.93,1612
2021-11-29,19376,20919,-1543,-7.38,1612
2021-11-30,20233,21244,-1011,-4.76,1612
2021-12-01,18323,21170,-2847,-13.45,1612
2021-12-02,18323,21121,-2798,-13.25,1612
2021-12-03,18047,21642,-3595,-16.61,1612
2021-12-04,14911,15792,-881,-5.58,1612
2021-12-05,11308,13284,-1976,-14.88,1612
2021-12-06,18642,20542,-1900,-9.25,1612
2021-12-07,18323,20896,-2573,-12.31,1612
2021-12-08,18323,20854,-2531,-12.14,1612
2021-12-09,18323,20842,-2519,-12.09,1612
2021-12-10,18047,21402,-3355,-15.68,1612
2021-12-11,14911,15592,-681,-4.37,1612
2021-12-12,11308,13123,-1815,-13.83,1612
2021-12-13,18642,20420,-1778,-8.71,1612
2021-12-14,18323,20809,-2486,-11.95,1612
2021-12-15,18323,20800,-2477,-11.91,1612
2021-12-16,18323,20815,-2492,-11.97,1612
2021-12-17,18047,21396,-3349,-15.65,1612
2021-12-18,14911,15602,-691,-4.43,1612
2021-12-19,11308,13142,-1834,-13.96,1612
2021-12-20,18642,20440,-1798,-8.8,1612
2021-12-21,18323,20824,-2501,-12.01,1612
2021-12-22,18323,20802,-2479,-11.92,1612
2021-12-23,18323,20797,-2474,-11.9,1612
2021-12-24,18047,21353,-3306,-15.48,1612
2021-12-25,14911,15528,-617,-3.97,1612
2021-12-26,11308,13032,-1724,-13.23,1612
2021-12-27,18642,20290,-1648,-8.12,1612
2021-12-28,18323,20632,-2309,-11.19,1612
2021-12-29,18323,20567,-2244,-10.91,1612
2021-12-30,18323,20519,-2196,-10.7,1612
2021-12-31,18047,21033,-2986,-14.2,1612
2022-01-01,14750,15168,-418,-2.76,1612
2022-01-02,11253,12637,-1384,-10.95,1612
2022-01-03,18230,19865,-1635,-8.23,1612
2022-01-04,18335,20182,-1847,-9.15,1612
2022-01-05,18335,20099,-1764,-8.78,1612
2022-01-06,18335,20041,-1706,-8.51,1612
2022-01-07,18894,20554,-1660,-8.08,1612
2022-01-08,14750,14696,54,0.37,1612
2022-01-09,11253,12179,-926,-7.6,1612
2022-01-10,18230,19431,-1201,-6.18,1612
2022-01-11,18335,19780,-1445,-7.31,1612
2022-01-12,18335,19736,-1401,-7.1,1612
2022-01-13,18335,19724,-1389,-7.04,1612
2022-01-14,18894,20288,-1394,-6.87,1612
2022-01-15,14750,14486,264,1.82,1612
2022-01-16,11253,12030,-777,-6.46,1612
2022-01-17,18230,19345,-1115,-5.76,1612
2022-01-18,18335,19758,-1423,-7.2,1612
2022-01-19,18335,19778,-1443,-7.3,1612
2022-01-20,18335,19828,-1493,-7.53,1612
2022-01-21,18894,20452,-1558,-7.62,1612
2022-01-22,14750,14707,43,0.29,1612
2022-01-23,11253,12302,-1049,-8.53,1612
2022-01-24,18230,19663,-1433,-7.29,1612
2022-01-25,18335,20116,-1781,-8.85,1612
2022-01-26,18335,20169,-1834,-9.09,1612
2022-01-27,18335,20245,-1910,-9.43,1612
2022-01-28,18894,20887,-1993,-9.54,1612
2022-01-29,14750,15154,-404,-2.67,1612
2022-01-30,11253,12753,-1500,-11.76,1612
2020-02-01,46795,42997,3798,8.83,1191
2020-02-02,37964,36290,1674,4.61,1191
2020-02-03,49190,48811,379,0.78,1191
2020-02-04,51089,50451,638,1.26,1191
2020-02-05,51089,50493,596,1.18,1191
2020-02-06,51089,50543,546,1.08,1191
2020-02-07,54721,53561,1160,2.17,1191
2020-02-08,46795,43227,3568,8.25,1191
2020-02-09,37964,36452,1512,4.15,1191
2020-02-10,49190,48918,272,0.56,1191
2020-02-11,51089,50518,571,1.13,1191
2020-02-12,51089,50538,551,1.09,1191
2020-02-13,51089,50584,505,1.0,1191
2020-02-14,54721,53616,1105,2.06,1191
2020-02-15,46795,43314,3481,8.04,1191
2020-02-16,37964,36589,1375,3.76,1191
2020-02-17,49190,49121,69,0.14,1191
2020-02-18,51089,50803,286,0.56,1191
2020-02-19,51089,50917,172,0.34,1191
2020-02-20,51089,51066,23,0.05,1191
2020-02-21,54721,54209,512,0.94,1191
2020-02-22,46795,44022,2773,6.3,1191
2020-02-23,37964,37413,551,1.47,1191
2020-02-24,49190,50059,-869,-1.74,1191
2020-02-25,51089,51849,-760,-1.47,1191
2020-02-26,51089,52062,-973,-1.87,1191
2020-02-27,51089,52299,-1210,-2.31,1191
2020-02-28,54721,55516,-795,-1.43,1191
2020-02-29,46795,45388,1407,3.1,1191
2020-03-01,26006,38820,-12814,-33.01,1191
2020-03-02,35170,51489,-16319,-31.69,1191
2020-03-03,36096,53283,-17187,-32.26,1191
2020-03-04,36096,53481,-17385,-32.51,1191
2020-03-05,36096,53685,-17589,-32.76,1191
2020-03-06,39293,56852,-17559,-30.89,1191
2020-03-07,28464,46657,-18193,-38.99,1191
2020-03-08,26006,40009,-14003,-35.0,1191
2020-03-09,35170,52586,-17416,-33.12,1191
2020-03-10,36096,54278,-18182,-33.5,1191
2020-03-11,36096,54369,-18273,-33.61,1191
2020-03-12,36096,54463,-18367,-33.72,1191
2020-03-13,39293,57519,-18226,-31.69,1191
2020-03-14,28464,47216,-18752,-39.72,1191
2020-03-15,26006,40466,-14460,-35.73,1191
2020-03-16,35170,52949,-17779,-33.58,1191
2020-03-17,36096,54559,-18463,-33.84,1191
2020-03-18,36096,54579,-18483,-33.86,1191
2020-03-19,36096,54617,-18521,-33.91,1191
2020-03-20,39293,57632,-18339,-31.82,1191
2020-03-21,28464,47305,-18841,-39.83,1191
2020-03-22,26006,40547,-14541,-35.86,1191
2020-03-23,35170,53038,-17868,-33.69,1191
2020-03-24,36096,54672,-18576,-33.98,1191
2020-03-25,36096,54731,-18635,-34.05,1191
2020-03-26,36096,54819,-18723,-34.15,1191
2020-03-27,39293,57896,-18603,-32.13,1191
2020-03-28,28464,47638,-19174,-40.25,1191
2020-03-29,26006,40955,-14949,-36.5,1191
2020-03-30,35170,53525,-18355,-34.29,1191
2020-03-31,36096,55237,-19141,-34.65,1191
2020-04-01,33345,55371,-22026,-39.78,1191
2020-04-02,33345,55531,-22186,-39.95,1191
2020-04-03,31830,58671,-26841,-45.75,1191
2020-04-04,25125,48468,-23343,-48.16,1191
2020-04-05,19327,41827,-22500,-53.79,1191
2020-04-06,33237,54426,-21189,-38.93,1191
2020-04-07,33345,56153,-22808,-40.62,1191
2020-04-08,33345,56288,-22943,-40.76,1191
2020-04-09,33345,56432,-23087,-40.91,1191
2020-04-10,31830,59543,-27713,-46.54,1191
2020-04-11,25125,49295,-24170,-49.03,1191
2020-04-12,19327,42597,-23270,-54.63,1191
2020-04-13,33237,55126,-21889,-39.71,1191
2020-04-14,33345,56775,-23430,-41.27,1191
2020-04-15,33345,56822,-23477,-41.32,1191
2020-04-16,33345,56874,-23529,-41.37,1191
2020-04-17,31830,59888,-28058,-46.85,1191
2020-04-18,25125,49543,-24418,-49.29,1191
2020-04-19,19327,42749,-23422,-54.79,1191
2020-04-20,33237,55188,-21951,-39.77,1191
2020-04-21,33345,56750,-23405,-41.24,1191
2020-04-22,33345,56721,-23376,-41.21,1191
2020-04-23,33345,56706,-23361,-41.2,1191
2020-04-24,31830,59664,-27834,-46.65,1191
2020-04-25,25125,49276,-24151,-49.01,1191
2020-04-26,19327,42453,-23126,-54.47,1191
2020-04-27,33237,54874,-21637,-39.43,1191
2020-04-28,33345,56433,-23088,-40.91,1191
2020-04-29,33345,56412,-23067,-40.89,1191
2020-04-30,33345,56417,-23072,-40.9,1191
2020-05-01,49980,59406,-9426,-15.87,1191
2020-05-02,41145,49057,-7912,-16.13,1191
2020-05-03,32859,42279,-9420,-22.28,1191
2020-05-04,46448,54752,-8304,-15.17,1191
2020-05-05,47730,56365,-8635,-15.32,1191
2020-05-06,47730,56398,-8668,-15.37,1191
2020-05-07,47730,56457,-8727,-15.46,1191
2020-05-08,49980,59496,-9516,-15.99,1191
2020-05-09,41145,49193,-8048,-16.36,1191
2020-05-10,32859,42454,-9595,-22.6,1191
2020-05-11,46448,54958,-8510,-15.48,1191
2020-05-12,47730,56593,-8863,-15.66,1191
2020-05-13,47730,56640,-8910,-15.73,1191
2020-05-14,47730,56702,-8972,-15.82,1191
2020-05-15,49980,59736,-9756,-16.33,1191
2020-05-16,41145,49418,-8273,-16.74,1191
2020-05-17,32859,42657,-9798,-22.97,1191
2020-05-18,46448,55131,-8683,-15.75,1191
2020-05-19,47730,56731,-9001,-15.87,1191
2020-05-20,47730,56740,-9010,-15.88,1191
2020-05-21,47730,56761,-9031,-15.91,1191
2020-05-22,49980,59754,-9774,-16.36,1191
2020-05-23,41145,49397,-8252,-16.71,1191
2020-05-24,32859,42601,-9742,-22.87,1191
2020-05-25,46448,55045,-8597,-15.62,1191
2020-05-26,47730,56623,-8893,-15.71,1191
2020-05-27,47730,56617,-8887,-15.7,1191
2020-05-28,47730,56633,-8903,-15.72,1191
2020-05-29,49980,59630,-9650,-16.18,1191
2020-05-30,41145,49288,-8143,-16.52,1191
2020-05-31,32859,42517,-9658,-22.72,1191
2020-06-01,52424,54995,-2571,-4.67,1191
2020-06-02,53845,56615,-2770,-4.89,1191
2020-06-03,53845,56659,-2814,-4.97,1191
2020-06-04,53845,56730,-2885,-5.09,1191
2020-06-05,54930,59785,-4855,-8.12,1191
2020-06-06,46520,49502,-2982,-6.02,1191
2020-06-07,39396,42787,-3391,-7.93,1191
2020-06-08,52424,55318,-2894,-5.23,1191
2020-06-09,53845,56983,-3138,-5.51,1191
2020-06-10,53845,57063,-3218,-5.64,1191
2020-06-11,53845,57157,-3312,-5.79,1191
2020-06-12,54930,60221,-5291,-8.79,1191
2020-06-13,46520,49930,-3410,-6.83,1191
2020-06-14,39396,43189,-3793,-8.78,1191
2020-06-15,52424,55675,-3251,-5.84,1191
2020-06-16,53845,57275,-3430,-5.99,1191
2020-06-17,53845,57269,-3424,-5.98,1191
2020-06-18,53845,57258,-3413,-5.96,1191
2020-06-19,54930,60198,-5268,-8.75,1191
2020-06-20,46520,49765,-3245,-6.52,1191
2020-06-21,39396,42867,-3471,-8.1,1191
2020-06-22,52424,55183,-2759,-5.0,1191
2020-06-23,53845,56604,-2759,-4.87,1191
2020-06-24,53845,56411,-2566,-4.55,1191
2020-06-25,53845,56212,-2367,-4.21,1191
2020-06-26,54930,58964,-4034,-6.84,1191
2020-06-27,46520,48350,-1830,-3.78,1191
2020-06-28,39396,41279,-1883,-4.56,1191
2020-06-29,52424,53436,-1012,-1.89,1191
2020-06-30,53845,54715,-870,-1.59,1191
2020-07-01,54174,54402,-228,-0.42,1191
2020-07-02,54174,54105,69,0.13,1191
2020-07-03,56113,56786,-673,-1.19,1191
2020-07-04,46490,46129,361,0.78,1191
2020-07-05,42550,39046,3504,8.97,1191
2020-07-06,53306,51220,2086,4.07,1191
2020-07-07,54174,52547,1627,3.1,1191
2020-07-08,54174,52312,1862,3.56,1191
2020-07-09,54174,52122,2052,3.94,1191
2020-07-10,56113,54937,1176,2.14,1191
2020-07-11,46490,44437,2053,4.62,1191
2020-07-12,42550,37531,5019,13.37,1191
2020-07-13,53306,49901,3405,6.82,1191
2020-07-14,54174,51436,2738,5.32,1191
2020-07-15,54174,51417,2757,5.36,1191
2020-07-16,54174,51447,2727,5.3,1191
2020-07-17,56113,54482,1631,2.99,1191
2020-07-18,46490,44196,2294,5.19,1191
2020-07-19,42550,37496,5054,13.48,1191
2020-07-20,53306,50055,3251,6.49,1191
2020-07-21,54174,51763,2411,4.66,1191
2020-07-22,54174,51895,2279,4.39,1191
2020-07-23,54174,52053,2121,4.07,1191
2020-07-24,56113,55189,924,1.67,1191
2020-07-25,46490,44977,1513,3.36,1191
2020-07-26,42550,38321,4229,11.04,1191
2020-07-27,53306,50898,2408,4.73,1191
2020-07-28,54174,52596,1578,3.0,1191
2020-07-29,54174,52692,1482,2.81,1191
2020-07-30,54174,52790,1384,2.62,1191
2020-07-31,56113,55845,268,0.48,1191
2020-08-01,47880,45534,2346,5.15,1191
2020-08-02,42702,38766,3936,10.15,1191
2020-08-03,52519,51220,1299,2.54,1191
2020-08-04,53342,52790,552,1.05,1191
2020-08-05,53342,52757,585,1.11,1191
2020-08-06,53342,52728,614,1.16,1191
2020-08-07,55716,55665,51,0.09,1191
2020-08-08,47880,45247,2633,5.82,1191
2020-08-09,42702,38387,4315,11.24,1191
2020-08-10,52519,50768,1751,3.45,1191
2020-08-11,53342,52286,1056,2.02,1191
2020-08-12,53342,52224,1118,2.14,1191
2020-08-13,53342,52192,1150,2.2,1191
2020-08-14,55716,55150,566,1.03,1191
2020-08-15,47880,44780,3100,6.92,1191
2020-08-16,42702,37993,4709,12.39,1191
2020-08-17,52519,50471,2048,4.06,1191
2020-08-18,53342,52106,1236,2.37,1191
2020-08-19,53342,52182,1160,2.22,1191
2020-08-20,53342,52303,1039,1.99,1191
2020-08-21,55716,55427,289,0.52,1191
2020-08-22,47880,45231,2649,5.86,1191
2020-08-23,42702,38623,4079,10.56,1191
2020-08-24,52519,51280,1239,2.42,1191
2020-08-25,53342,53090,252,0.47,1191
2020-08-26,53342,53333,9,0.02,1191
2020-08-27,53342,53609,-267,-0.5,1191
2020-08-28,55716,56872,-1156,-2.03,1191
2020-08-29,47880,46797,1083,2.31,1191
2020-08-30,42702,40288,2414,5.99,1191
2020-08-31,52519,53020,-501,-0.94,1191
2020-09-01,54706,54880,-174,-0.32,1191
2020-09-02,54706,55147,-441,-0.8,1191
2020-09-03,54706,55421,-715,-1.29,1191
2020-09-04,57444,58656,-1212,-2.07,1191
2020-09-05,49083,48527,556,1.15,1191
2020-09-06,42286,41941,345,0.82,1191
2020-09-07,52452,54576,-2124,-3.89,1191
2020-09-08,54706,56320,-1614,-2.87,1191
2020-09-09,54706,56456,-1750,-3.1,1191
2020-09-10,54706,56586,-1880,-3.32,1191
2020-09-11,57444,59669,-2225,-3.73,1191
2020-09-12,49083,49384,-301,-0.61,1191
2020-09-13,42286,42641,-355,-0.83,1191
2020-09-14,52452,55121,-2669,-4.84,1191
2020-09-15,54706,56717,-2011,-3.55,1191
2020-09-16,54706,56712,-2006,-3.54,1191
2020-09-17,54706,56715,-2009,-3.54,1191
2020-09-18,57444,59685,-2241,-3.75,1191
2020-09-19,49083,49303,-220,-0.45,1191
2020-09-20,42286,42481,-195,-0.46,1191
2020-09-21,52452,54899,-2447,-4.46,1191
2020-09-22,54706,56453,-1747,-3.09,1191
2020-09-23,54706,56426,-1720,-3.05,1191
2020-09-24,54706,56423,-1717,-3.04,1191
2020-09-25,57444,59404,-1960,-3.3,1191
2020-09-26,49083,49048,35,0.07,1191
2020-09-27,42286,42264,22,0.05,1191
2020-09-28,52452,54732,-2280,-4.17,1191
2020-09-29,54706,56343,-1637,-2.91,1191
2020-09-30,54706,56377,-1671,-2.96,1191
2020-10-01,52470,56439,-3969,-7.03,1191
2020-10-02,54966,59484,-4518,-7.6,1191
2020-10-03,45605,49189,-3584,-7.29,1191
2020-10-04,38064,42461,-4397,-10.36,1191
2020-10-05,50905,54977,-4072,-7.41,1191
2020-10-06,52470,56626,-4156,-7.34,1191
2020-10-07,52470,56688,-4218,-7.44,1191
2020-10-08,52470,56765,-4295,-7.57,1191
2020-10-09,54966,59814,-4848,-8.11,1191
2020-10-10,45605,49509,-3904,-7.89,1191
2020-10-11,38064,42759,-4695,-10.98,1191
2020-10-12,50905,55242,-4337,-7.85,1191
2020-10-13,52470,56847,-4377,-7.7,1191
2020-10-14,52470,56855,-4385,-7.71,1191
2020-10-15,52470,56871,-4401,-7.74,1191
2020-10-16,54966,59852,-4886,-8.16,1191
2020-10-17,45605,49477,-3872,-7.83,1191
2020-10-18,38064,42655,-4591,-10.76,1191
2020-10-19,50905,55065,-4160,-7.55,1191
2020-10-20,52470,56602,-4132,-7.3,1191
2020-10-21,52470,56546,-4076,-7.21,1191
2020-10-22,52470,56505,-4035,-7.14,1191
2020-10-23,54966,59437,-4471,-7.52,1191
2020-10-24,45605,49022,-3417,-6.97,1191
2020-10-25,38064,42171,-4107,-9.74,1191
2020-10-26,50905,54563,-3658,-6.7,1191
2020-10-27,52470,56093,-3623,-6.46,1191
2020-10-28,52470,56041,-3571,-6.37,1191
2020-10-29,52470,56014,-3544,-6.33,1191
2020-10-30,54966,58970,-4004,-6.79,1191
2020-10-31,45605,48587,-2982,-6.14,1191
2020-11-01,28905,41775,-12870,-30.81,1191
2020-11-02,44587,54211,-9624,-17.75,1191
2020-11-03,41168,55788,-14620,-26.21,1191
2020-11-04,41168,55785,-14617,-26.2,1191
2020-11-05,41168,55805,-14637,-26.23,1191
2020-11-06,43159,58806,-15647,-26.61,1191
2020-11-07,33905,48464,-14559,-30.04,1191
2020-11-08,28905,41686,-12781,-30.66,1191
2020-11-09,44587,54149,-9562,-17.66,1191
2020-11-10,41168,55744,-14576,-26.15,1191
2020-11-11,41168,55749,-14581,-26.15,1191
2020-11-12,41168,55769,-14601,-26.18,1191
2020-11-13,43159,58759,-15600,-26.55,1191
2020-11-14,33905,48396,-14491,-29.94,1191
2020-11-15,28905,41588,-12683,-30.5,1191
2020-11-16,44587,54014,-9427,-17.45,1191
2020-11-17,41168,55564,-14396,-25.91,1191
2020-11-18,41168,55520,-14352,-25.85,1191
2020-11-19,41168,55487,-14319,-25.81,1191
2020-11-20,43159,58423,-15264,-26.13,1191
2020-11-21,33905,48006,-14101,-29.37,1191
2020-11-22,28905,41147,-12242,-29.75,1191
2020-11-23,44587,53527,-8940,-16.7,1191
2020-11-24,41168,55037,-13869,-25.2,1191
2020-11-25,41168,54962,-13794,-25.1,1191
2020-11-26,41168,54906,-13738,-25.02,1191
2020-11-27,43159,57831,-14672,-25.37,1191
2020-11-28,33905,47414,-13509,-28.49,1191
2020-11-29,28905,40567,-11662,-28.75,1191
2020-11-30,44587,52970,-8383,-15.83,1191
2020-12-01,43330,54515,-11185,-20.52,1191
2020-12-02,43330,54485,-11155,-20.47,1191
2020-12-03,43330,54483,-11153,-20.47,1191
2020-12-04,48026,57469,-9443,-16.43,1191
2020-12-05,37756,47118,-9362,-19.87,1191
2020-12-06,28899,40340,-11441,-28.36,1191
2020-12-07,44498,52812,-8314,-15.74,1191
2020-12-08,43330,54424,-11094,-20.38,1191
2020-12-09,43330,54455,-11125,-20.43,1191
2020-12-10,43330,54508,-11178,-20.51,1191
2020-12-11,48026,57536,-9510,-16.53,1191
2020-12-12,37756,47216,-9460,-20.04,1191
2020-12-13,28899,40453,-11554,-28.56,1191
2020-12-14,44498,52924,-8426,-15.92,1191
2020-12-15,43330,54516,-11186,-20.52,1191
2020-12-16,43330,54507,-11177,-20.51,1191
2020-12-17,43330,54501,-11171,-20.5,1191
2020-12-18,48026,57451,-9425,-16.41,1191
2020-12-19,37756,47033,-9277,-19.72,1191
2020-12-20,28899,40156,-11257,-28.03,1191
2020-12-21,44498,52495,-7997,-15.23,1191
2020-12-22,43330,53943,-10613,-19.67,1191
2020-12-23,43330,53779,-10449,-19.43,1191
2020-12-24,43330,53609,-10279,-19.17,1191
2020-12-25,48026,56392,-8366,-14.84,1191
2020-12-26,37756,45807,-8051,-17.58,1191
2020-12-27,28899,38764,-9865,-25.45,1191
2020-12-28,44498,50946,-6448,-12.66,1191
2020-12-29,43330,52246,-8916,-17.07,1191
2020-12-30,43330,51950,-8620,-16.59,1191
2020-12-31,43330,51666,-8336,-16.13,1191
2021-01-01,40601,54355,-13754,-25.3,1191
2021-01-02,29930,43700,-13770,-31.51,1191
2021-01-03,24824,36613,-11789,-32.2,1191
2021-01-04,37766,48778,-11012,-22.58,1191
2021-01-05,39490,50090,-10600,-21.16,1191
2021-01-06,39490,49834,-10344,-20.76,1191
2021-01-07,39490,49618,-10128,-20.41,1191
2021-01-08,40601,52403,-11802,-22.52,1191
2021-01-09,29930,41869,-11939,-28.52,1191
2021-01-10,24824,34927,-10103,-28.93,1191
2021-01-11,37766,47258,-9492,-20.09,1191
2021-01-12,39490,48753,-9263,-19.0,1191
2021-01-13,39490,48694,-9204,-18.9,1191
2021-01-14,39490,48685,-9195,-18.89,1191
2021-01-15,40601,51683,-11082,-21.44,1191
2021-01-16,29930,41363,-11433,-27.64,1191
2021-01-17,24824,34633,-9809,-28.32,1191
2021-01-18,37766,47169,-9403,-19.93,1191
2021-01-19,39490,48859,-9369,-19.18,1191
2021-01-20,39490,48980,-9490,-19.38,1191
2021-01-21,39490,49135,-9645,-19.63,1191
2021-01-22,40601,52276,-11675,-22.33,1191
2021-01-23,29930,42078,-12148,-28.87,1191
2021-01-24,24824,35446,-10622,-29.97,1191
2021-01-25,37766,48055,-10289,-21.41,1191
2021-01-26,39490,49793,-10303,-20.69,1191
2021-01-27,39490,49940,-10450,-20.93,1191
2021-01-28,39490,50095,-10605,-21.17,1191
2021-01-29,40601,53216,-12615,-23.71,1191
2021-01-30,29930,42978,-13048,-30.36,1191
2021-01-31,24824,36289,-11465,-31.59,1191
2021-02-01,44035,48827,-4792,-9.81,1191
2021-02-02,45446,50484,-5038,-9.98,1191
2021-02-03,45446,50542,-5096,-10.08,1191
2021-02-04,45446,50605,-5159,-10.19,1191
2021-02-05,47619,53634,-6015,-11.21,1191
2021-02-06,39005,43308,-4303,-9.94,1191
2021-02-07,31644,36537,-4893,-13.39,1191
2021-02-08,44035,49005,-4970,-10.14,1191
2021-02-09,45446,50603,-5157,-10.19,1191
2021-02-10,45446,50617,-5171,-10.22,1191
2021-02-11,45446,50654,-5208,-10.28,1191
2021-02-12,47619,53674,-6055,-11.28,1191
2021-02-13,39005,43357,-4352,-10.04,1191
2021-02-14,31644,36615,-4971,-13.58,1191
2021-02-15,44035,49128,-5093,-10.37,1191
2021-02-16,45446,50789,-5343,-10.52,1191
2021-02-17,45446,50881,-5435,-10.68,1191
2021-02-18,45446,51008,-5562,-10.9,1191
2021-02-19,47619,54130,-6511,-12.03,1191
2021-02-20,39005,43922,-4917,-11.19,1191
2021-02-21,31644,37294,-5650,-15.15,1191
2021-02-22,44035,49923,-5888,-11.79,1191
2021-02-23,45446,51698,-6252,-12.09,1191
2021-02-24,45446,51900,-6454,-12.44,1191
2021-02-25,45446,52129,-6683,-12.82,1191
2021-02-26,47619,55342,-7723,-13.96,1191
2021-02-27,39005,45212,-6207,-13.73,1191
2021-02-28,31644,38647,-7003,-18.12,1191
2021-03-01,46792,51321,-4529,-8.82,1191
2021-03-02,48220,53125,-4905,-9.23,1191
2021-03-03,48220,53335,-5115,-9.59,1191
2021-03-04,48220,53554,-5334,-9.96,1191
2021-03-05,49586,56738,-7152,-12.61,1191
2021-03-06,42402,46562,-4160,-8.93,1191
2021-03-07,32066,39934,-7868,-19.7,1191
2021-03-08,46792,52531,-5739,-10.92,1191
2021-03-09,48220,54245,-6025,-11.11,1191
2021-03-10,48220,54356,-6136,-11.29,1191
2021-03-11,48220,54469,-6249,-11.47,1191
2021-03-12,49586,57543,-7957,-13.83,1191
2021-03-13,42402,47256,-4854,-10.27,1191
2021-03-14,32066,40519,-8453,-20.86,1191
2021-03-15,46792,53013,-6221,-11.73,1191
2021-03-16,48220,54631,-6411,-11.74,1191
2021-03-17,48220,54656,-6436,-11.78,1191
2021-03-18,48220,54695,-6475,-11.84,1191
2021-03-19,49586,57710,-8124,-14.08,1191
2021-03-20,42402,47378,-4976,-10.5,1191
2021-03-21,32066,40613,-8547,-21.04,1191
2021-03-22,46792,53095,-6303,-11.87,1191
2021-03-23,48220,54717,-6497,-11.87,1191
2021-03-24,48220,54762,-6542,-11.95,1191
2021-03-25,48220,54836,-6616,-12.07,1191
2021-03-26,49586,57898,-8312,-14.36,1191
2021-03-27,42402,47626,-5224,-10.97,1191
2021-03-28,32066,40928,-8862,-21.65,1191
2021-03-29,46792,53484,-6692,-12.51,1191
2021-03-30,48220,55183,-6963,-12.62,1191
2021-03-31,48220,55307,-7087,-12.81,1191
2021-04-01,43796,55458,-11662,-21.03,1191
2021-04-02,45178,58593,-13415,-22.9,1191
2021-04-03,34431,48386,-13955,-28.84,1191
2021-04-04,30839,41745,-10906,-26.13,1191
2021-04-05,43166,54346,-11180,-20.57,1191
2021-04-06,43796,56079,-12283,-21.9,1191
2021-04-07,43796,56221,-12425,-22.1,1191
2021-04-08,43796,56376,-12580,-22.31,1191
2021-04-09,45178,59500,-14322,-24.07,1191
2021-04-10,34431,49267,-14836,-30.11,1191
2021-04-11,30839,42585,-11746,-27.58,1191
2021-04-12,43166,55132,-11966,-21.7,1191
2021-04-13,43796,56798,-13002,-22.89,1191
2021-04-14,43796,56863,-13067,-22.98,1191
2021-04-15,43796,56933,-13137,-23.07,1191
2021-04-16,45178,59964,-14786,-24.66,1191
2021-04-17,34431,49636,-15205,-30.63,1191
2021-04-18,30839,42857,-12018,-28.04,1191
2021-04-19,43166,55308,-12142,-21.95,1191
2021-04-20,43796,56881,-13085,-23.0,1191
2021-04-21,43796,56860,-13064,-22.98,1191
2021-04-22,43796,56850,-13054,-22.96,1191
2021-04-23,45178,59812,-14634,-24.47,1191
2021-04-24,34431,49425,-14994,-30.34,1191
2021-04-25,30839,42600,-11761,-27.61,1191
2021-04-26,43166,55017,-11851,-21.54,1191
2021-04-27,43796,56570,-12774,-22.58,1191
2021-04-28,43796,56542,-12746,-22.54,1191
2021-04-29,43796,56538,-12742,-22.54,1191
2021-04-30,45178,59517,-14339,-24.09,1191
2021-05-01,46414,49158,-2744,-5.58,1191
2021-05-02,36105,42370,-6265,-14.79,1191
2021-05-03,51057,54832,-3775,-6.88,1191
2021-05-04,52768,56435,-3667,-6.5,1191
2021-05-05,52768,56460,-3692,-6.54,1191
2021-05-06,52768,56511,-3743,-6.62,1191
2021-05-07,54941,59544,-4603,-7.73,1191
2021-05-08,46414,49236,-2822,-5.73,1191
2021-05-09,36105,42495,-6390,-15.04,1191
2021-05-10,51057,54998,-3941,-7.17,1191
2021-05-11,52768,56634,-3866,-6.83,1191
2021-05-12,52768,56684,-3916,-6.91,1191
2021-05-13,52768,56750,-3982,-7.02,1191
2021-05-14,54941,59790,-4849,-8.11,1191
2021-05-15,46414,49478,-3064,-6.19,1191
2021-05-16,36105,42725,-6620,-15.49,1191
2021-05-17,51057,55207,-4150,-7.52,1191
2021-05-18,52768,56815,-4047,-7.12,1191
2021-05-19,52768,56831,-4063,-7.15,1191
2021-05-20,52768,56860,-4092,-7.2,1191
2021-05-21,54941,59859,-4918,-8.22,1191
2021-05-22,46414,49507,-3093,-6.25,1191
2021-05-23,36105,42713,-6608,-15.47,1191
2021-05-24,51057,55159,-4102,-7.44,1191
2021-05-25,52768,56736,-3968,-6.99,1191
2021-05-26,52768,56728,-3960,-6.98,1191
2021-05-27,52768,56739,-3971,-7.0,1191
2021-05-28,54941,59731,-4790,-8.02,1191
2021-05-29,46414,49381,-2967,-6.01,1191
2021-05-30,36105,42600,-6495,-15.25,1191
2021-05-31,51057,55067,-4010,-7.28,1191
2021-06-01,55393,56677,-1284,-2.27,1191
2021-06-02,55393,56709,-1316,-2.32,1191
2021-06-03,55393,56768,-1375,-2.42,1191
2021-06-04,56704,59813,-3109,-5.2,1191
2021-06-05,48514,49521,-1007,-2.03,1191
2021-06-06,45001,42798,2203,5.15,1191
2021-06-07,53625,55324,-1699,-3.07,1191
2021-06-08,55393,56987,-1594,-2.8,1191
2021-06-09,55393,57066,-1673,-2.93,1191
2021-06-10,55393,57164,-1771,-3.1,1191
2021-06-11,56704,60236,-3532,-5.86,1191
2021-06-12,48514,49956,-1442,-2.89,1191
2021-06-13,45001,43230,1771,4.1,1191
2021-06-14,53625,55735,-2110,-3.79,1191
2021-06-15,55393,57357,-1964,-3.42,1191
2021-06-16,55393,57377,-1984,-3.46,1191
2021-06-17,55393,57394,-2001,-3.49,1191
2021-06-18,56704,60365,-3661,-6.06,1191
2021-06-19,48514,49966,-1452,-2.91,1191
2021-06-20,45001,43102,1899,4.41,1191
2021-06-21,53625,55453,-1828,-3.3,1191
2021-06-22,55393,56909,-1516,-2.66,1191
2021-06-23,55393,56751,-1358,-2.39,1191
2021-06-24,55393,56583,-1190,-2.1,1191
2021-06-25,56704,59366,-2662,-4.48,1191
2021-06-26,48514,48779,-265,-0.54,1191
2021-06-27,45001,41732,3269,7.83,1191
2021-06-28,53625,53907,-282,-0.52,1191
2021-06-29,55393,55200,193,0.35,1191
2021-06-30,55393,54896,497,0.91,1191
2021-07-01,52877,54602,-1725,-3.16,1191
2021-07-02,55296,57281,-1985,-3.47,1191
2021-07-03,46037,46616,-579,-1.24,1191
2021-07-04,40473,39519,954,2.41,1191
2021-07-05,51238,51674,-436,-0.84,1191
2021-07-06,52877,52977,-100,-0.19,1191
2021-07-07,52877,52713,164,0.31,1191
2021-07-08,52877,52490,387,0.74,1191
2021-07-09,55296,55269,27,0.05,1191
2021-07-10,46037,44730,1307,2.92,1191
2021-07-11,40473,37785,2688,7.11,1191
2021-07-12,51238,50113,1125,2.24,1191
2021-07-13,52877,51608,1269,2.46,1191
2021-07-14,52877,51549,1328,2.58,1191
2021-07-15,52877,51541,1336,2.59,1191
2021-07-16,55296,54540,756,1.39,1191
2021-07-17,46037,44221,1816,4.11,1191
2021-07-18,40473,37492,2981,7.95,1191
2021-07-19,51238,50028,1210,2.42,1191
2021-07-20,52877,51716,1161,2.24,1191
2021-07-21,52877,51834,1043,2.01,1191
2021-07-22,52877,51983,894,1.72,1191
2021-07-23,55296,55115,181,0.33,1191
2021-07-24,46037,44905,1132,2.52,1191
2021-07-25,40473,38256,2217,5.8,1191
2021-07-26,51238,50845,393,0.77,1191
2021-07-27,52877,52557,320,0.61,1191
2021-07-28,52877,52672,205,0.39,1191
2021-07-29,52877,52791,86,0.16,1191
2021-07-30,55296,55869,-573,-1.03,1191
2021-07-31,46037,45583,454,1.0,1191
2021-08-01,41986,38840,3146,8.1,1191
2021-08-02,50349,51319,-970,-1.89,1191
2021-08-03,51216,52911,-1695,-3.2,1191
2021-08-04,51216,52899,-1683,-3.18,1191
2021-08-05,51216,52888,-1672,-3.16,1191
2021-08-06,53376,55839,-2463,-4.41,1191
2021-08-07,44978,45432,-454,-1.0,1191
2021-08-08,41986,38578,3408,8.83,1191
2021-08-09,50349,50961,-612,-1.2,1191
2021-08-10,51216,52475,-1259,-2.4,1191
2021-08-11,51216,52405,-1189,-2.27,1191
2021-08-12,51216,52360,-1144,-2.18,1191
2021-08-13,53376,55301,-1925,-3.48,1191
2021-08-14,44978,44909,69,0.15,1191
2021-08-15,41986,38097,3889,10.21,1191
2021-08-16,50349,50546,-197,-0.39,1191
2021-08-17,51216,52151,-935,-1.79,1191
2021-08-18,51216,52194,-978,-1.87,1191
2021-08-19,51216,52282,-1066,-2.04,1191
2021-08-20,53376,55372,-1996,-3.6,1191
2021-08-21,44978,45144,-166,-0.37,1191
2021-08-22,41986,38504,3482,9.04,1191
2021-08-23,50349,51131,-782,-1.53,1191
2021-08-24,51216,52916,-1700,-3.21,1191
2021-08-25,51216,53135,-1919,-3.61,1191
2021-08-26,51216,53392,-2176,-4.08,1191
2021-08-27,53376,56641,-3265,-5.76,1191
2021-08-28,44978,46556,-1578,-3.39,1191
2021-08-29,41986,40042,1944,4.85,1191
2021-08-30,50349,52774,-2425,-4.6,1191
2021-08-31,51216,54639,-3423,-6.26,1191
2021-09-01,55736,54915,821,1.5,1191
2021-09-02,55736,55203,533,0.97,1191
2021-09-03,59750,58456,1294,2.21,1191
2021-09-04,51525,48349,3176,6.57,1191
2021-09-05,45274,41787,3487,8.34,1191
2021-09-06,54085,54448,-363,-0.67,1191
2021-09-07,55736,56221,-485,-0.86,1191
2021-09-08,55736,56386,-650,-1.15,1191
2021-09-09,55736,56546,-810,-1.43,1191
2021-09-10,59750,59658,92,0.15,1191
2021-09-11,51525,49401,2124,4.3,1191
2021-09-12,45274,42684,2590,6.07,1191
2021-09-13,54085,55187,-1102,-2.0,1191
2021-09-14,55736,56805,-1069,-1.88,1191
2021-09-15,55736,56818,-1082,-1.9,1191
2021-09-16,55736,56836,-1100,-1.94,1191
2021-09-17,59750,59818,-68,-0.11,1191
2021-09-18,51525,49443,2082,4.21,1191
2021-09-19,45274,42625,2649,6.21,1191
2021-09-20,54085,55045,-960,-1.74,1191
2021-09-21,55736,56597,-861,-1.52,1191
2021-09-22,55736,56564,-828,-1.46,1191
2021-09-23,55736,56554,-818,-1.45,1191
2021-09-24,59750,59525,225,0.38,1191
2021-09-25,51525,49158,2367,4.82,1191
2021-09-26,45274,42362,2912,6.87,1191
2021-09-27,54085,54818,-733,-1.34,1191
2021-09-28,55736,56416,-680,-1.21,1191
2021-09-29,55736,56439,-703,-1.25,1191
2021-09-30,55736,56489,-753,-1.33,1191
2021-10-01,60298,59525,773,1.3,1191
2021-10-02,51147,49222,1925,3.91,1191
2021-10-03,43017,42488,529,1.25,1191
2021-10-04,53566,55001,-1435,-2.61,1191
2021-10-05,55618,56650,-1032,-1.82,1191
2021-10-06,55618,56713,-1095,-1.93,1191
2021-10-07,55618,56794,-1176,-2.07,1191
2021-10-08,60298,59849,449,0.75,1191
2021-10-09,51147,49553,1594,3.22,1191
2021-10-10,43017,42813,204,0.48,1191
2021-10-11,53566,55307,-1741,-3.15,1191
2021-10-12,55618,56924,-1306,-2.29,1191
2021-10-13,55618,56946,-1328,-2.33,1191
2021-10-14,55618,56976,-1358,-2.38,1191
2021-10-15,60298,59971,327,0.55,1191
2021-10-16,51147,49608,1539,3.1,1191
2021-10-17,43017,42798,219,0.51,1191
2021-10-18,53566,55220,-1654,-3.0,1191
2021-10-19,55618,56766,-1148,-2.02,1191
2021-10-20,55618,56718,-1100,-1.94,1191
2021-10-21,55618,56682,-1064,-1.88,1191
2021-10-22,60298,59618,680,1.14,1191
2021-10-23,51147,49205,1942,3.95,1191
2021-10-24,43017,42352,665,1.57,1191
2021-10-25,53566,54742,-1176,-2.15,1191
2021-10-26,55618,56267,-649,-1.15,1191
2021-10-27,55618,56210,-592,-1.05,1191
2021-10-28,55618,56175,-557,-0.99,1191
2021-10-29,60298,59123,1175,1.99,1191
2021-10-30,51147,48731,2416,4.96,1191
2021-10-31,43017,41909,1108,2.64,1191
2021-11-01,45374,54336,-8962,-16.49,1191
2021-11-02,48839,55904,-7065,-12.64,1191
2021-11-03,48839,55893,-7054,-12.62,1191
2021-11-04,48839,55906,-7067,-12.64,1191
2021-11-05,51386,58902,-7516,-12.76,1191
2021-11-06,42903,48556,-5653,-11.64,1191
2021-11-07,35593,41776,-6183,-14.8,1191
2021-11-08,45374,54239,-8865,-16.34,1191
2021-11-09,48839,55835,-6996,-12.53,1191
2021-11-10,48839,55845,-7006,-12.55,1191
2021-11-11,48839,55870,-7031,-12.58,1191
2021-11-12,51386,58867,-7481,-12.71,1191
2021-11-13,42903,48512,-5609,-11.56,1191
2021-11-14,35593,41714,-6121,-14.67,1191
2021-11-15,45374,54150,-8776,-16.21,1191
2021-11-16,48839,55710,-6871,-12.33,1191
2021-11-17,48839,55677,-6838,-12.28,1191
2021-11-18,48839,55653,-6814,-12.24,1191
2021-11-19,51386,58598,-7212,-12.31,1191
2021-11-20,42903,48190,-5287,-10.97,1191
2021-11-21,35593,41337,-5744,-13.9,1191
2021-11-22,45374,53721,-8347,-15.54,1191
2021-11-23,48839,55234,-6395,-11.58,1191
2021-11-24,48839,55159,-6320,-11.46,1191
2021-11-25,48839,55102,-6263,-11.37,1191
2021-11-26,51386,58022,-6636,-11.44,1191
2021-11-27,42903,47599,-4696,-9.87,1191
2021-11-28,35593,40744,-5151,-12.64,1191
2021-11-29,45374,53137,-7763,-14.61,1191
2021-11-30,48839,54671,-5832,-10.67,1191
2021-12-01,46940,54627,-7687,-14.07,1191
2021-12-02,46940,54613,-7673,-14.05,1191
2021-12-03,44508,57585,-13077,-22.71,1191
2021-12-04,39782,47221,-7439,-15.75,1191
2021-12-05,33453,40431,-6978,-17.26,1191
2021-12-06,47520,52893,-5373,-10.16,1191
2021-12-07,46940,54496,-7556,-13.87,1191
2021-12-08,46940,54520,-7580,-13.9,1191
2021-12-09,46940,54569,-7629,-13.98,1191
2021-12-10,44508,57597,-13089,-22.73,1191
2021-12-11,39782,47280,-7498,-15.86,1191
2021-12-12,33453,40523,-7070,-17.45,1191
2021-12-13,47520,53004,-5484,-10.35,1191
2021-12-14,46940,54609,-7669,-14.04,1191
2021-12-15,46940,54618,-7678,-14.06,1191
2021-12-16,46940,54632,-7692,-14.08,1191
2021-12-17,44508,57607,-13099,-22.74,1191
2021-12-18,39782,47216,-7434,-15.74,1191
2021-12-19,33453,40366,-6913,-17.13,1191
2021-12-20,47520,52736,-5216,-9.89,1191
2021-12-21,46940,54215,-7275,-13.42,1191
2021-12-22,46940,54083,-7143,-13.21,1191
2021-12-23,46940,53944,-7004,-12.98,1191
2021-12-24,44508,56756,-12248,-21.58,1191
2021-12-25,39782,46199,-6417,-13.89,1191
2021-12-26,33453,39181,-5728,-14.62,1191
2021-12-27,47520,51385,-3865,-7.52,1191
2021-12-28,46940,52704,-5764,-10.94,1191
2021-12-29,46940,52422,-5482,-10.46,1191
2021-12-30,46940,52146,-5206,-9.98,1191
2021-12-31,44508,54840,-10332,-18.84,1191
2022-01-01,40466,44183,-3717,-8.41,1191
2022-01-02,30995,37090,-6095,-16.43,1191
2022-01-03,43356,49243,-5887,-11.95,1191
2022-01-04,44897,50538,-5641,-11.16,1191
2022-01-05,44897,50260,-5363,-10.67,1191
2022-01-06,44897,50018,-5121,-10.24,1191
2022-01-07,46679,52773,-6094,-11.55,1191
2022-01-08,40466,42205,-1739,-4.12,1191
2022-01-09,30995,35227,-4232,-12.01,1191
2022-01-10,43356,47519,-4163,-8.76,1191
2022-01-11,44897,48974,-4077,-8.32,1191
2022-01-12,44897,48876,-3979,-8.14,1191
2022-01-13,44897,48827,-3930,-8.05,1191
2022-01-14,46679,51787,-5108,-9.86,1191
2022-01-15,40466,41431,-965,-2.33,1191
2022-01-16,30995,34667,-3672,-10.59,1191
2022-01-17,43356,47172,-3816,-8.09,1191
2022-01-18,44897,48835,-3938,-8.06,1191
2022-01-19,44897,48934,-4037,-8.25,1191
2022-01-20,44897,49070,-4173,-8.5,1191
2022-01-21,46679,52198,-5519,-10.57,1191
2022-01-22,40466,41990,-1524,-3.63,1191
2022-01-23,30995,35353,-4358,-12.33,1191
2022-01-24,43356,47962,-4606,-9.6,1191
2022-01-25,44897,49705,-4808,-9.67,1191
2022-01-26,44897,49859,-4962,-9.95,1191
2022-01-27,44897,50025,-5128,-10.25,1191
2022-01-28,46679,53160,-6481,-12.19,1191
2022-01-29,40466,42937,-2471,-5.75,1191
2022-01-30,30995,36265,-5270,-14.53,1191
2020-02-01,13928,13710,218,1.59,1209
2020-02-02,11828,11214,614,5.48,1209
2020-02-03,19900,20342,-442,-2.17,1209
2020-02-04,20631,21200,-569,-2.68,1209
2020-02-05,20631,21197,-566,-2.67,1209
2020-02-06,20631,21191,-560,-2.64,1209
2020-02-07,20870,20749,121,0.58,1209
2020-02-08,13928,13691,237,1.73,1209
2020-02-09,11828,11171,657,5.88,1209
2020-02-10,19900,20281,-381,-1.88,1209
2020-02-11,20631,21128,-497,-2.35,1209
2020-02-12,20631,21121,-490,-2.32,1209
2020-02-13,20631,21120,-489,-2.32,1209
2020-02-14,20870,20691,179,0.87,1209
2020-02-15,13928,13652,276,2.02,1209
2020-02-16,11828,11159,669,6.0,1209
2020-02-17,19900,20302,-402,-1.98,1209
2020-02-18,20631,21187,-556,-2.62,1209
2020-02-19,20631,21223,-592,-2.79,1209
2020-02-20,20631,21268,-637,-3.0,1209
2020-02-21,20870,20887,-17,-0.08,1209
2020-02-22,13928,13897,31,0.22,1209
2020-02-23,11828,11452,376,3.28,1209
2020-02-24,19900,20641,-741,-3.59,1209
2020-02-25,20631,21569,-938,-4.35,1209
2020-02-26,20631,21643,-1012,-4.68,1209
2020-02-27,20631,21720,-1089,-5.01,1209
2020-02-28,20870,21365,-495,-2.32,1209
2020-02-29,13928,14393,-465,-3.23,1209
2020-03-01,8525,11959,-3434,-28.71,1209
2020-03-02,15363,21151,-5788,-27.37,1209
2020-03-03,15330,22074,-6744,-30.55,1209
2020-03-04,15330,22136,-6806,-30.75,1209
2020-03-05,15330,22193,-6863,-30.92,1209
2020-03-06,15669,21811,-6142,-28.16,1209
2020-03-07,9772,14807,-5035,-34.0,1209
2020-03-08,8525,12335,-3810,-30.89,1209
2020-03-09,15363,21486,-6123,-28.5,1209
2020-03-10,15330,22365,-7035,-31.46,1209
2020-03-11,15330,22381,-7051,-31.5,1209
2020-03-12,15330,22393,-7063,-31.54,1209
2020-03-13,15669,21967,-6298,-28.67,1209
2020-03-14,9772,14921,-5149,-34.51,1209
2020-03-15,8525,12412,-3887,-31.32,1209
2020-03-16,15363,21529,-6166,-28.64,1209
2020-03-17,15330,22381,-7051,-31.5,1209
2020-03-18,15330,22376,-7046,-31.49,1209
2020-03-19,15330,22374,-7044,-31.48,1209
2020-03-20,15669,21940,-6271,-28.58,1209
2020-03-21,9772,14894,-5122,-34.39,1209
2020-03-22,8525,12391,-3866,-31.2,1209
2020-03-23,15363,21521,-6158,-28.61,1209
2020-03-24,15330,22392,-7062,-31.54,1209
2020-03-25,15330,22411,-7081,-31.6,1209
2020-03-26,15330,22437,-7107,-31.68,1209
2020-03-27,15669,22035,-6366,-28.89,1209
2020-03-28,9772,15023,-5251,-34.95,1209
2020-03-29,8525,12555,-4030,-32.1,1209
2020-03-30,15363,21720,-6357,-29.27,1209
2020-03-31,15330,22625,-7295,-32.24,1209
2020-04-01,13708,22675,-8967,-39.55,1209
2020-04-02,13708,22728,-9020,-39.69,1209
2020-04-03,12741,22349,-9608,-42.99,1209
2020-04-04,9026,15354,-6328,-41.21,1209
2020-04-05,6736,12898,-6162,-47.77,1209
2020-04-06,13582,22069,-8487,-38.46,1209
2020-04-07,13708,22972,-9264,-40.33,1209
2020-04-08,13708,23014,-9306,-40.44,1209
2020-04-09,13708,23053,-9345,-40.54,1209
2020-04-10,12741,22654,-9913,-43.76,1209
2020-04-11,9026,15634,-6608,-42.27,1209
2020-04-12,6736,13147,-6411,-48.76,1209
2020-04-13,13582,22283,-8701,-39.05,1209
2020-04-14,13708,23148,-9440,-40.78,1209
2020-04-15,13708,23151,-9443,-40.79,1209
2020-04-16,13708,23151,-9443,-40.79,1209
2020-04-17,12741,22711,-9970,-43.9,1209
2020-04-18,9026,15653,-6627,-42.34,1209
2020-04-19,6736,13130,-6394,-48.7,1209
2020-04-20,13582,22234,-8652,-38.91,1209
2020-04-21,13708,23071,-9363,-40.58,1209
2020-04-22,13708,23051,-9343,-40.53,1209
2020-04-23,13708,23033,-9325,-40.49,1209
2020-04-24,12741,22582,-9841,-43.58,1209
2020-04-25,9026,15517,-6491,-41.83,1209
2020-04-26,6736,12995,-6259,-48.16,1209
2020-04-27,13582,22105,-8523,-38.56,1209
2020-04-28,13708,22953,-9245,-40.28,1209
2020-04-29,13708,22949,-9241,-40.27,1209
2020-04-30,13708,22950,-9242,-40.27,1209
2020-05-01,18951,22523,-3572,-15.86,1209
2020-05-02,12934,15483,-2549,-16.46,1209
2020-05-03,10082,12987,-2905,-22.37,1209
2020-05-04,18593,22124,-3531,-15.96,1209
2020-05-05,19473,22998,-3525,-15.33,1209
2020-05-06,19473,23017,-3544,-15.4,1209
2020-05-07,19473,23040,-3567,-15.48,1209
2020-05-08,18951,22629,-3678,-16.25,1209
2020-05-09,12934,15602,-2668,-17.1,1209
2020-05-10,10082,13114,-3032,-23.12,1209
2020-05-11,18593,22253,-3660,-16.45,1209
2020-05-12,19473,23124,-3651,-15.79,1209
2020-05-13,19473,23135,-3662,-15.83,1209
2020-05-14,19473,23143,-3670,-15.86,1209
2020-05-15,18951,22714,-3763,-16.57,1209
2020-05-16,12934,15664,-2730,-17.43,1209
2020-05-17,10082,13150,-3068,-23.33,1209
2020-05-18,18593,22259,-3666,-16.47,1209
2020-05-19,19473,23099,-3626,-15.7,1209
2020-05-20,19473,23079,-3606,-15.62,1209
2020-05-21,19473,23056,-3583,-15.54,1209
2020-05-22,18951,22597,-3646,-16.13,1209
2020-05-23,12934,15520,-2586,-16.66,1209
2020-05-24,10082,12981,-2899,-22.33,1209
2020-05-25,18593,22071,-3478,-15.76,1209
2020-05-26,19473,22897,-3424,-14.95,1209
2020-05-27,19473,22868,-3395,-14.85,1209
2020-05-28,19473,22843,-3370,-14.75,1209
2020-05-29,18951,22388,-3437,-15.35,1209
2020-05-30,12934,15321,-2387,-15.58,1209
2020-05-31,10082,12798,-2716,-21.22,1209
2020-06-01,20995,21910,-915,-4.18,1209
2020-06-02,21930,22762,-832,-3.66,1209
2020-06-03,21930,22763,-833,-3.66,1209
2020-06-04,21930,22771,-841,-3.69,1209
2020-06-05,20619,22350,-1731,-7.74,1209
2020-06-06,13713,15318,-1605,-10.48,1209
2020-06-07,11149,12829,-1680,-13.1,1209
2020-06-08,20995,21972,-977,-4.45,1209
2020-06-09,21930,22852,-922,-4.03,1209
2020-06-10,21930,22875,-945,-4.13,1209
2020-06-11,21930,22898,-968,-4.23,1209
2020-06-12,20619,22485,-1866,-8.3,1209
2020-06-13,13713,15453,-1740,-11.26,1209
2020-06-14,11149,12954,-1805,-13.93,1209
2020-06-15,20995,22078,-1083,-4.91,1209
2020-06-16,21930,22928,-998,-4.35,1209
2020-06-17,21930,22912,-982,-4.29,1209
2020-06-18,21930,22887,-957,-4.18,1209
2020-06-19,20619,22418,-1799,-8.02,1209
2020-06-20,13713,15321,-1608,-10.5,1209
2020-06-21,11149,12751,-1602,-12.56,1209
2020-06-22,20995,21798,-803,-3.68,1209
2020-06-23,21930,22568,-638,-2.83,1209
2020-06-24,21930,22470,-540,-2.4,1209
2020-06-25,21930,22363,-433,-1.94,1209
2020-06-26,20619,21813,-1194,-5.47,1209
2020-06-27,13713,14640,-927,-6.33,1209
2020-06-28,11149,11999,-850,-7.08,1209
2020-06-29,20995,20982,13,0.06,1209
2020-06-30,21930,21698,232,1.07,1209
2020-07-01,20416,21556,-1140,-5.29,1209
2020-07-02,20416,21416,-1000,-4.67,1209
2020-07-03,19837,20846,-1009,-4.84,1209
2020-07-04,12774,13665,-891,-6.52,1209
2020-07-05,11100,11031,69,0.63,1209
2020-07-06,19674,20035,-361,-1.8,1209
2020-07-07,20416,20783,-367,-1.77,1209
2020-07-08,20416,20686,-270,-1.31,1209
2020-07-09,20416,20603,-187,-0.91,1209
2020-07-10,19837,20099,-262,-1.3,1209
2020-07-11,12774,12993,-219,-1.69,1209
2020-07-12,11100,10439,661,6.33,1209
2020-07-13,19674,19528,146,0.75,1209
2020-07-14,20416,20365,51,0.25,1209
2020-07-15,20416,20355,61,0.3,1209
2020-07-16,20416,20358,58,0.28,1209
2020-07-17,19837,19936,-99,-0.5,1209
2020-07-18,12774,12905,-131,-1.02,1209
2020-07-19,11100,10419,681,6.54,1209
2020-07-20,19674,19565,109,0.56,1209
2020-07-21,20416,20447,-31,-0.15,1209
2020-07-22,20416,20472,-56,-0.27,1209
2020-07-23,20416,20496,-80,-0.39,1209
2020-07-24,19837,20081,-244,-1.22,1209
2020-07-25,12774,13045,-271,-2.08,1209
2020-07-26,11100,10540,560,5.31,1209
2020-07-27,19674,19655,19,0.1,1209
2020-07-28,20416,20495,-79,-0.39,1209
2020-07-29,20416,20468,-52,-0.25,1209
2020-07-30,20416,20432,-16,-0.08,1209
2020-07-31,19837,19951,-114,-0.57,1209
2020-08-01,12902,12845,57,0.44,1209
2020-08-02,10796,10268,528,5.14,1209
2020-08-03,18861,19313,-452,-2.34,1209
2020-08-04,19397,20086,-689,-3.43,1209
2020-08-05,19397,19997,-600,-3.0,1209
2020-08-06,19397,19907,-510,-2.56,1209
2020-08-07,18520,19382,-862,-4.45,1209
2020-08-08,12902,12243,659,5.38,1209
2020-08-09,10796,9648,1148,11.9,1209
2020-08-10,18861,18688,173,0.93,1209
2020-08-11,19397,19472,-75,-0.39,1209
2020-08-12,19397,19410,-13,-0.07,1209
2020-08-13,19397,19362,35,0.18,1209
2020-08-14,18520,18896,-376,-1.99,1209
2020-08-15,12902,11831,1071,9.05,1209
2020-08-16,10796,9323,1473,15.8,1209
2020-08-17,18861,18463,398,2.16,1209
2020-08-18,19397,19358,39,0.2,1209
2020-08-19,19397,19414,-17,-0.09,1209
2020-08-20,19397,19492,-95,-0.49,1209
2020-08-21,18520,19155,-635,-3.32,1209
2020-08-22,12902,12221,681,5.57,1209
2020-08-23,10796,9842,954,9.69,1209
2020-08-24,18861,19107,-246,-1.29,1209
2020-08-25,19397,20120,-723,-3.59,1209
2020-08-26,19397,20287,-890,-4.39,1209
2020-08-27,19397,20463,-1066,-5.21,1209
2020-08-28,18520,20213,-1693,-8.38,1209
2020-08-29,12902,13350,-448,-3.36,1209
2020-08-30,10796,11027,-231,-2.09,1209
2020-08-31,18861,20332,-1471,-7.23,1209
2020-09-01,21381,21368,13,0.06,1209
2020-09-02,21381,21541,-160,-0.74,1209
2020-09-03,21381,21706,-325,-1.5,1209
2020-09-04,20372,21429,-1057,-4.93,1209
2020-09-05,14205,14524,-319,-2.2,1209
2020-09-06,12058,12145,-87,-0.72,1209
2020-09-07,20708,21382,-674,-3.15,1209
2020-09-08,21381,22340,-959,-4.29,1209
2020-09-09,21381,22427,-1046,-4.66,1209
2020-09-10,21381,22501,-1120,-4.98,1209
2020-09-11,20372,22128,-1756,-7.94,1209
2020-09-12,14205,15127,-922,-6.1,1209
2020-09-13,12058,12653,-595,-4.7,1209
2020-09-14,20708,21798,-1090,-5.0,1209
2020-09-15,21381,22669,-1288,-5.68,1209
2020-09-16,21381,22676,-1295,-5.71,1209
2020-09-17,21381,22678,-1297,-5.72,1209
2020-09-18,20372,22244,-1872,-8.42,1209
2020-09-19,14205,15191,-986,-6.49,1209
2020-09-20,12058,12677,-619,-4.88,1209
2020-09-21,20708,21794,-1086,-4.98,1209
2020-09-22,21381,22647,-1266,-5.59,1209
2020-09-23,21381,22648,-1267,-5.59,1209
2020-09-24,21381,22655,-1274,-5.62,1209
2020-09-25,20372,22234,-1862,-8.37,1209
2020-09-26,14205,15203,-998,-6.56,1209
2020-09-27,12058,12718,-660,-5.19,1209
2020-09-28,20708,21869,-1161,-5.31,1209
2020-09-29,21381,22761,-1380,-6.06,1209
2020-09-30,21381,22802,-1421,-6.23,1209
2020-10-01,22612,22849,-237,-1.04,1209
2020-10-02,22289,22467,-178,-0.79,1209
2020-10-03,15007,15472,-465,-3.01,1209
2020-10-04,11686,13019,-1333,-10.24,1209
2020-10-05,21674,22197,-523,-2.36,1209
2020-10-06,22612,23109,-497,-2.15,1209
2020-10-07,22612,23162,-550,-2.37,1209
2020-10-08,22612,23215,-603,-2.6,1209
2020-10-09,22289,22830,-541,-2.37,1209
2020-10-10,15007,15825,-818,-5.17,1209
2020-10-11,11686,13354,-1668,-12.49,1209
2020-10-12,21674,22506,-832,-3.7,1209
2020-10-13,22612,23387,-775,-3.31,1209
2020-10-14,22612,23403,-791,-3.38,1209
2020-10-15,22612,23415,-803,-3.43,1209
2020-10-16,22289,22986,-697,-3.03,1209
2020-10-17,15007,15936,-929,-5.83,1209
2020-10-18,11686,13419,-1733,-12.91,1209
2020-10-19,21674,22526,-852,-3.78,1209
2020-10-20,22612,23364,-752,-3.22,1209
2020-10-21,22612,23342,-730,-3.13,1209
2020-10-22,22612,23320,-708,-3.04,1209
2020-10-23,22289,22863,-574,-2.51,1209
2020-10-24,15007,15790,-783,-4.96,1209
2020-10-25,11686,13258,-1572,-11.86,1209
2020-10-26,21674,22357,-683,-3.05,1209
2020-10-27,22612,23194,-582,-2.51,1209
2020-10-28,22612,23177,-565,-2.44,1209
2020-10-29,22612,23167,-555,-2.4,1209
2020-10-30,22289,22728,-439,-1.93,1209
2020-10-31,15007,15679,-672,-4.29,1209
2020-11-01,9958,13174,-3216,-24.41,1209
2020-11-02,19549,22303,-2754,-12.35,1209
2020-11-03,19036,23172,-4136,-17.85,1209
2020-11-04,19036,23189,-4153,-17.91,1209
2020-11-05,19036,23210,-4174,-17.98,1209
2020-11-06,19342,22802,-3460,-15.17,1209
2020-11-07,12741,15779,-3038,-19.25,1209
2020-11-08,9958,13297,-3339,-25.11,1209
2020-11-09,19549,22444,-2895,-12.9,1209
2020-11-10,19036,23324,-4288,-18.38,1209
2020-11-11,19036,23346,-4310,-18.46,1209
2020-11-12,19036,23365,-4329,-18.53,1209
2020-11-13,19342,22947,-3605,-15.71,1209
2020-11-14,12741,15909,-3168,-19.91,1209
2020-11-15,9958,13404,-3446,-25.71,1209
2020-11-16,19549,22522,-2973,-13.2,1209
2020-11-17,19036,23368,-4332,-18.54,1209
2020-11-18,19036,23351,-4315,-18.48,1209
2020-11-19,19036,23328,-4292,-18.4,1209
2020-11-20,19342,22866,-3524,-15.41,1209
2020-11-21,12741,15781,-3040,-19.26,1209
2020-11-22,9958,13231,-3273,-24.74,1209
2020-11-23,19549,22305,-2756,-12.36,1209
2020-11-24,19036,23110,-4074,-17.63,1209
2020-11-25,19036,23056,-4020,-17.44,1209
2020-11-26,19036,23001,-3965,-17.24,1209
2020-11-27,19342,22512,-3170,-14.08,1209
2020-11-28,12741,15409,-2668,-17.31,1209
2020-11-29,9958,12846,-2888,-22.48,1209
2020-11-30,19549,21915,-2366,-10.8,1209
2020-12-01,18805,22722,-3917,-17.24,1209
2020-12-02,18805,22677,-3872,-17.07,1209
2020-12-03,18805,22639,-3834,-16.94,1209
2020-12-04,20527,22173,-1646,-7.42,1209
2020-12-05,13238,15097,-1859,-12.31,1209
2020-12-06,9801,12567,-2766,-22.01,1209
2020-12-07,18600,21672,-3072,-14.17,1209
2020-12-08,18805,22517,-3712,-16.49,1209
2020-12-09,18805,22510,-3705,-16.46,1209
2020-12-10,18805,22509,-3704,-16.46,1209
2020-12-11,20527,22078,-1551,-7.03,1209
2020-12-12,13238,15034,-1796,-11.95,1209
2020-12-13,9801,12530,-2729,-21.78,1209
2020-12-14,18600,21656,-3056,-14.11,1209
2020-12-15,18805,22515,-3710,-16.48,1209
2020-12-16,18805,22515,-3710,-16.48,1209
2020-12-17,18805,22512,-3707,-16.47,1209
2020-12-18,20527,22070,-1543,-6.99,1209
2020-12-19,13238,15007,-1769,-11.79,1209
2020-12-20,9801,12477,-2676,-21.45,1209
2020-12-21,18600,21567,-2967,-13.76,1209
2020-12-22,18805,22384,-3579,-15.99,1209
2020-12-23,18805,22336,-3531,-15.81,1209
2020-12-24,18805,22280,-3475,-15.6,1209
2020-12-25,20527,21781,-1254,-5.76,1209
2020-12-26,13238,14659,-1421,-9.69,1209
2020-12-27,9801,12068,-2267,-18.79,1209
2020-12-28,18600,21100,-2500,-11.85,1209
2020-12-29,18805,21861,-3056,-13.98,1209
2020-12-30,18805,21760,-2955,-13.58,1209
2020-12-31,18805,21657,-2852,-13.17,1209
2021-01-01,17216,21119,-3903,-18.48,1209
2021-01-02,10589,13965,-3376,-24.17,1209
2021-01-03,8327,11352,-3025,-26.65,1209
2021-01-04,16369,20371,-4002,-19.65,1209
2021-01-05,17326,21129,-3803,-18.0,1209
2021-01-06,17326,21037,-3711,-17.64,1209
2021-01-07,17326,20954,-3628,-17.31,1209
2021-01-08,17216,20446,-3230,-15.8,1209
2021-01-09,10589,13331,-2742,-20.57,1209
2021-01-10,8327,10767,-2440,-22.66,1209
2021-01-11,16369,19843,-3474,-17.51,1209
2021-01-12,17326,20665,-3339,-16.16,1209
2021-01-13,17326,20642,-3316,-16.06,1209
2021-01-14,17326,20632,-3306,-16.02,1209
2021-01-15,17216,20199,-2983,-14.77,1209
2021-01-16,10589,13160,-2571,-19.54,1209
2021-01-17,8327,10671,-2344,-21.97,1209
2021-01-18,16369,19819,-3450,-17.41,1209
2021-01-19,17326,20709,-3383,-16.34,1209
2021-01-20,17326,20748,-3422,-16.49,1209
2021-01-21,17326,20792,-3466,-16.67,1209
2021-01-22,17216,20407,-3191,-15.64,1209
2021-01-23,10589,13407,-2818,-21.02,1209
2021-01-24,8327,10947,-2620,-23.93,1209
2021-01-25,16369,20115,-3746,-18.62,1209
2021-01-26,17326,21016,-3690,-17.56,1209
2021-01-27,17326,21056,-3730,-17.71,1209
2021-01-28,17326,21094,-3768,-17.86,1209
2021-01-29,17216,20693,-3477,-16.8,1209
2021-01-30,10589,13671,-3082,-22.54,1209
2021-01-31,8327,11182,-2855,-25.53,1209
2021-02-01,19007,20317,-1310,-6.45,1209
2021-02-02,19593,21182,-1589,-7.5,1209
2021-02-03,19593,21184,-1591,-7.51,1209
2021-02-04,19593,21184,-1591,-7.51,1209
2021-02-05,19446,20746,-1300,-6.27,1209
2021-02-06,12684,13689,-1005,-7.34,1209
2021-02-07,10069,11171,-1102,-9.86,1209
2021-02-08,19007,20280,-1273,-6.28,1209
2021-02-09,19593,21125,-1532,-7.25,1209
2021-02-10,19593,21115,-1522,-7.21,1209
2021-02-11,19593,21109,-1516,-7.18,1209
2021-02-12,19446,20673,-1227,-5.94,1209
2021-02-13,12684,13627,-943,-6.92,1209
2021-02-14,10069,11126,-1057,-9.5,1209
2021-02-15,19007,20260,-1253,-6.18,1209
2021-02-16,19593,21137,-1544,-7.3,1209
2021-02-17,19593,21164,-1571,-7.42,1209
2021-02-18,19593,21200,-1607,-7.58,1209
2021-02-19,19446,20810,-1364,-6.55,1209
2021-02-20,12684,13811,-1127,-8.16,1209
2021-02-21,10069,11359,-1290,-11.36,1209
2021-02-22,19007,20541,-1534,-7.47,1209
2021-02-23,19593,21465,-1872,-8.72,1209
2021-02-24,19593,21535,-1942,-9.02,1209
2021-02-25,19593,21610,-2017,-9.33,1209
2021-02-26,19446,21254,-1808,-8.51,1209
2021-02-27,12684,14283,-1599,-11.2,1209
2021-02-28,10069,11851,-1782,-15.04,1209
2021-03-01,19670,21047,-1377,-6.54,1209
2021-03-02,19767,21975,-2208,-10.05,1209
2021-03-03,19767,22042,-2275,-10.32,1209
2021-03-04,19767,22107,-2340,-10.58,1209
2021-03-05,19476,21732,-2256,-10.38,1209
2021-03-06,13310,14736,-1426,-9.68,1209
2021-03-07,9764,12273,-2509,-20.44,1209
2021-03-08,19670,21432,-1762,-8.22,1209
2021-03-09,19767,22320,-2553,-11.44,1209
2021-03-10,19767,22344,-2577,-11.53,1209
2021-03-11,19767,22363,-2596,-11.61,1209
2021-03-12,19476,21944,-2468,-11.25,1209
2021-03-13,13310,14903,-1593,-10.69,1209
2021-03-14,9764,12398,-2634,-21.25,1209
2021-03-15,19670,21518,-1848,-8.59,1209
2021-03-16,19767,22372,-2605,-11.64,1209
2021-03-17,19767,22367,-2600,-11.62,1209
2021-03-18,19767,22363,-2596,-11.61,1209
2021-03-19,19476,21927,-2451,-11.18,1209
2021-03-20,13310,14878,-1568,-10.54,1209
2021-03-21,9764,12370,-2606,-21.07,1209
2021-03-22,19670,21495,-1825,-8.49,1209
2021-03-23,19767,22360,-2593,-11.6,1209
2021-03-24,19767,22372,-2605,-11.64,1209
2021-03-25,19767,22392,-2625,-11.72,1209
2021-03-26,19476,21983,-2507,-11.4,1209
2021-03-27,13310,14965,-1655,-11.06,1209
2021-03-28,9764,12491,-2727,-21.83,1209
2021-03-29,19670,21651,-1981,-9.15,1209
2021-03-30,19767,22550,-2783,-12.34,1209
2021-03-31,19767,22597,-2830,-12.52,1209
2021-04-01,18425,22648,-4223,-18.65,1209
2021-04-02,17614,22268,-4654,-20.9,1209
2021-04-03,10554,15273,-4719,-30.9,1209
2021-04-04,9219,12818,-3599,-28.08,1209
2021-04-05,17902,21991,-4089,-18.59,1209
2021-04-06,18425,22898,-4473,-19.53,1209
2021-04-07,18425,22945,-4520,-19.7,1209
2021-04-08,18425,22990,-4565,-19.86,1209
2021-04-09,17614,22597,-4983,-22.05,1209
2021-04-10,10554,15584,-5030,-32.28,1209
2021-04-11,9219,13104,-3885,-29.65,1209
2021-04-12,17902,22248,-4346,-19.53,1209
2021-04-13,18425,23121,-4696,-20.31,1209
2021-04-14,18425,23131,-4706,-20.34,1209
2021-04-15,18425,23137,-4712,-20.37,1209
2021-04-16,17614,22704,-5090,-22.42,1209
2021-04-17,10554,15651,-5097,-32.57,1209
2021-04-18,9219,13133,-3914,-29.8,1209
2021-04-19,17902,22240,-4338,-19.51,1209
2021-04-20,18425,23080,-4655,-20.17,1209
2021-04-21,18425,23061,-4636,-20.1,1209
2021-04-22,18425,23042,-4617,-20.04,1209
2021-04-23,17614,22590,-4976,-22.03,1209
2021-04-24,10554,15524,-4970,-32.01,1209
2021-04-25,9219,12998,-3779,-29.07,1209
2021-04-26,17902,22104,-4202,-19.01,1209
2021-04-27,18425,22949,-4524,-19.71,1209
2021-04-28,18425,22939,-4514,-19.68,1209
2021-04-29,18425,22936,-4511,-19.67,1209
2021-04-30,17614,22503,-4889,-21.73,1209
2021-05-01,13909,15459,-1550,-10.03,1209
2021-05-02,10706,12958,-2252,-17.38,1209
2021-05-03,21244,22090,-846,-3.83,1209
2021-05-04,22039,22961,-922,-4.02,1209
2021-05-05,22039,22978,-939,-4.09,1209
2021-05-06,22039,22998,-959,-4.17,1209
2021-05-07,21254,22587,-1333,-5.9,1209
2021-05-08,13909,15561,-1652,-10.62,1209
2021-05-09,10706,13074,-2368,-18.11,1209
2021-05-10,21244,22215,-971,-4.37,1209
2021-05-11,22039,23090,-1051,-4.55,1209
2021-05-12,22039,23105,-1066,-4.61,1209
2021-05-13,22039,23118,-1079,-4.67,1209
2021-05-14,21254,22695,-1441,-6.35,1209
2021-05-15,13909,15651,-1742,-11.13,1209
2021-05-16,10706,13142,-2436,-18.54,1209
2021-05-17,21244,22258,-1014,-4.56,1209
2021-05-18,22039,23104,-1065,-4.61,1209
2021-05-19,22039,23088,-1049,-4.54,1209
2021-05-20,22039,23070,-1031,-4.47,1209
2021-05-21,21254,22615,-1361,-6.02,1209
2021-05-22,13909,15541,-1632,-10.5,1209
2021-05-23,10706,13004,-2298,-17.67,1209
2021-05-24,21244,22095,-851,-3.85,1209
2021-05-25,22039,22920,-881,-3.84,1209
2021-05-26,22039,22889,-850,-3.71,1209
2021-05-27,22039,22861,-822,-3.6,1209
2021-05-28,21254,22402,-1148,-5.12,1209
2021-05-29,13909,15330,-1421,-9.27,1209
2021-05-30,10706,12802,-2096,-16.37,1209
2021-05-31,21244,21908,-664,-3.03,1209
2021-06-01,23125,22753,372,1.63,1209
2021-06-02,23125,22747,378,1.66,1209
2021-06-03,23125,22748,377,1.66,1209
2021-06-04,21627,22322,-695,-3.11,1209
2021-06-05,14776,15284,-508,-3.32,1209
2021-06-06,12627,12791,-164,-1.28,1209
2021-06-07,21972,21930,42,0.19,1209
2021-06-08,23125,22808,317,1.39,1209
2021-06-09,23125,22830,295,1.29,1209
2021-06-10,23125,22855,270,1.18,1209
2021-06-11,21627,22445,-818,-3.64,1209
2021-06-12,14776,15418,-642,-4.16,1209
2021-06-13,12627,12926,-299,-2.31,1209
2021-06-14,21972,22059,-87,-0.39,1209
2021-06-15,23125,22919,206,0.9,1209
2021-06-16,23125,22915,210,0.92,1209
2021-06-17,23125,22903,222,0.97,1209
2021-06-18,21627,22448,-821,-3.66,1209
2021-06-19,14776,15366,-590,-3.84,1209
2021-06-20,12627,12811,-184,-1.44,1209
2021-06-21,21972,21874,98,0.45,1209
2021-06-22,23125,22659,466,2.06,1209
2021-06-23,23125,22575,550,2.44,1209
2021-06-24,23125,22482,643,2.86,1209
2021-06-25,21627,21944,-317,-1.44,1209
2021-06-26,14776,14781,-5,-0.03,1209
2021-06-27,12627,12149,478,3.93,1209
2021-06-28,21972,21138,834,3.95,1209
2021-06-29,23125,21858,1267,5.8,1209
2021-06-30,23125,21718,1407,6.48,1209
2021-07-01,21979,21577,402,1.86,1209
2021-07-02,21425,21004,421,2.0,1209
2021-07-03,14051,13817,234,1.69,1209
2021-07-04,11514,11175,339,3.03,1209
2021-07-05,20891,20168,723,3.58,1209
2021-07-06,21979,20904,1075,5.14,1209
2021-07-07,21979,20793,1186,5.7,1209
2021-07-08,21979,20695,1284,6.2,1209
2021-07-09,21425,20175,1250,6.2,1209
2021-07-10,14051,13053,998,7.65,1209
2021-07-11,11514,10483,1031,9.83,1209
2021-07-12,20891,19556,1335,6.83,1209
2021-07-13,21979,20376,1603,7.87,1209
2021-07-14,21979,20353,1626,7.99,1209
2021-07-15,21979,20343,1636,8.04,1209
2021-07-16,21425,19909,1516,7.61,1209
2021-07-17,14051,12870,1181,9.18,1209
2021-07-18,11514,10377,1137,10.96,1209
2021-07-19,20891,19519,1372,7.03,1209
2021-07-20,21979,20400,1579,7.74,1209
2021-07-21,21979,20425,1554,7.61,1209
2021-07-22,21979,20452,1527,7.47,1209
2021-07-23,21425,20043,1382,6.9,1209
2021-07-24,14051,13015,1036,7.96,1209
2021-07-25,11514,10519,995,9.46,1209
2021-07-26,20891,19646,1245,6.34,1209
2021-07-27,21979,20499,1480,7.22,1209
2021-07-28,21979,20485,1494,7.29,1209
2021-07-29,21979,20462,1517,7.41,1209
2021-07-30,21425,19995,1430,7.15,1209
2021-07-31,14051,12902,1149,8.91,1209
2021-08-01,11253,10337,916,8.86,1209
2021-08-02,19948,19392,556,2.87,1209
2021-08-03,20629,20174,455,2.26,1209
2021-08-04,20629,20092,537,2.67,1209
2021-08-05,20629,20006,623,3.11,1209
2021-08-06,19714,19482,232,1.19,1209
2021-08-07,13528,12343,1185,9.6,1209
2021-08-08,11253,9743,1510,15.5,1209
2021-08-09,19948,18775,1173,6.25,1209
2021-08-10,20629,19549,1080,5.52,1209
2021-08-11,20629,19474,1155,5.93,1209
2021-08-12,20629,19410,1219,6.28,1209
2021-08-13,19714,18926,788,4.16,1209
2021-08-14,13528,11841,1687,14.25,1209
2021-08-15,11253,9311,1942,20.86,1209
2021-08-16,19948,18428,1520,8.25,1209
2021-08-17,20629,19298,1331,6.9,1209
2021-08-18,20629,19331,1298,6.71,1209
2021-08-19,20629,19384,1245,6.42,1209
2021-08-20,19714,19024,690,3.63,1209
2021-08-21,13528,12067,1461,12.11,1209
2021-08-22,11253,9668,1585,16.39,1209
2021-08-23,19948,18914,1034,5.47,1209
2021-08-24,20629,19911,718,3.61,1209
2021-08-25,20629,20064,565,2.82,1209
2021-08-26,20629,20230,399,1.97,1209
2021-08-27,19714,19972,-258,-1.29,1209
2021-08-28,13528,13104,424,3.24,1209
2021-08-29,11253,10780,473,4.39,1209
2021-08-30,19948,20087,-139,-0.69,1209
2021-08-31,20629,21128,-499,-2.36,1209
2021-09-01,22553,21308,1245,5.84,1209
2021-09-02,22553,21484,1069,4.98,1209
2021-09-03,21996,21219,777,3.66,1209
2021-09-04,15243,14329,914,6.38,1209
2021-09-05,12918,11966,952,7.96,1209
2021-09-06,21563,21220,343,1.62,1209
2021-09-07,22553,22196,357,1.61,1209
2021-09-08,22553,22301,252,1.13,1209
2021-09-09,22553,22393,160,0.71,1209
2021-09-10,21996,22037,-41,-0.19,1209
2021-09-11,15243,15052,191,1.27,1209
2021-09-12,12918,12593,325,2.58,1209
2021-09-13,21563,21752,-189,-0.87,1209
2021-09-14,22553,22635,-82,-0.36,1209
2021-09-15,22553,22651,-98,-0.43,1209
2021-09-16,22553,22661,-108,-0.48,1209
2021-09-17,21996,22231,-235,-1.06,1209
2021-09-18,15243,15182,61,0.4,1209
2021-09-19,12918,12669,249,1.97,1209
2021-09-20,21563,21785,-222,-1.02,1209
2021-09-21,22553,22636,-83,-0.37,1209
2021-09-22,22553,22632,-79,-0.35,1209
2021-09-23,22553,22634,-81,-0.36,1209
2021-09-24,21996,22206,-210,-0.95,1209
2021-09-25,15243,15168,75,0.49,1209
2021-09-26,12918,12675,243,1.92,1209
2021-09-27,21563,21818,-255,-1.17,1209
2021-09-28,22553,22703,-150,-0.66,1209
2021-09-29,22553,22736,-183,-0.8,1209
2021-09-30,22553,22777,-224,-0.98,1209
2021-10-01,22777,22390,387,1.73,1209
2021-10-02,15616,15391,225,1.46,1209
2021-10-03,12741,12936,-195,-1.51,1209
2021-10-04,21326,22112,-786,-3.55,1209
2021-10-05,22687,23024,-337,-1.46,1209
2021-10-06,22687,23079,-392,-1.7,1209
2021-10-07,22687,23135,-448,-1.94,1209
2021-10-08,22777,22755,22,0.1,1209
2021-10-09,15616,15756,-140,-0.89,1209
2021-10-10,12741,13292,-551,-4.15,1209
2021-10-11,21326,22451,-1125,-5.01,1209
2021-10-12,22687,23340,-653,-2.8,1209
2021-10-13,22687,23366,-679,-2.91,1209
2021-10-14,22687,23386,-699,-2.99,1209
2021-10-15,22777,22966,-189,-0.82,1209
2021-10-16,15616,15923,-307,-1.93,1209
2021-10-17,12741,13414,-673,-5.02,1209
2021-10-18,21326,22528,-1202,-5.34,1209
2021-10-19,22687,23371,-684,-2.93,1209
2021-10-20,22687,23354,-667,-2.86,1209
2021-10-21,22687,23334,-647,-2.77,1209
2021-10-22,22777,22879,-102,-0.45,1209
2021-10-23,15616,15806,-190,-1.2,1209
2021-10-24,12741,13273,-532,-4.01,1209
2021-10-25,21326,22370,-1044,-4.67,1209
2021-10-26,22687,23203,-516,-2.22,1209
2021-10-27,22687,23183,-496,-2.14,1209
2021-10-28,22687,23167,-480,-2.07,1209
2021-10-29,22777,22722,55,0.24,1209
2021-10-30,15616,15667,-51,-0.33,1209
2021-10-31,12741,13155,-414,-3.15,1209
2021-11-01,20041,22279,-2238,-10.05,1209
2021-11-02,21691,23142,-1451,-6.27,1209
2021-11-03,21691,23153,-1462,-6.31,1209
2021-11-04,21691,23170,-1479,-6.38,1209
2021-11-05,21874,22758,-884,-3.88,1209
2021-11-06,14968,15733,-765,-4.86,1209
2021-11-07,12277,13249,-972,-7.34,1209
2021-11-08,20041,22396,-2355,-10.52,1209
2021-11-09,21691,23279,-1588,-6.82,1209
2021-11-10,21691,23303,-1612,-6.92,1209
2021-11-11,21691,23327,-1636,-7.01,1209
2021-11-12,21874,22914,-1040,-4.54,1209
2021-11-13,14968,15882,-914,-5.75,1209
2021-11-14,12277,13384,-1107,-8.27,1209
2021-11-15,20041,22510,-2469,-10.97,1209
2021-11-16,21691,23364,-1673,-7.16,1209
2021-11-17,21691,23356,-1665,-7.13,1209
2021-11-18,21691,23342,-1651,-7.07,1209
2021-11-19,21874,22887,-1013,-4.43,1209
2021-11-20,14968,15811,-843,-5.33,1209
2021-11-21,12277,13268,-991,-7.47,1209
2021-11-22,20041,22348,-2307,-10.32,1209
2021-11-23,21691,23159,-1468,-6.34,1209
2021-11-24,21691,23108,-1417,-6.13,1209
2021-11-25,21691,23056,-1365,-5.92,1209
2021-11-26,21874,22568,-694,-3.08,1209
2021-11-27,14968,15464,-496,-3.21,1209
2021-11-28,12277,12899,-622,-4.82,1209
2021-11-29,20041,21965,-1924,-8.76,1209
2021-11-30,21691,22769,-1078,-4.73,1209
2021-12-01,19406,22719,-3313,-14.58,1209
2021-12-02,19406,22674,-3268,-14.41,1209
2021-12-03,18394,22201,-3807,-17.15,1209
2021-12-04,13365,15118,-1753,-11.6,1209
2021-12-05,10883,12581,-1698,-13.5,1209
2021-12-06,19332,21678,-2346,-10.82,1209
2021-12-07,19406,22516,-3110,-13.81,1209
2021-12-08,19406,22504,-3098,-13.77,1209
2021-12-09,19406,22497,-3091,-13.74,1209
2021-12-10,18394,22062,-3668,-16.63,1209
2021-12-11,13365,15015,-1650,-10.99,1209
2021-12-12,10883,12510,-1627,-13.01,1209
2021-12-13,19332,21635,-2303,-10.64,1209
2021-12-14,19406,22496,-3090,-13.74,1209
2021-12-15,19406,22499,-3093,-13.75,1209
2021-12-16,19406,22501,-3095,-13.75,1209
2021-12-17,18394,22066,-3672,-16.64,1209
2021-12-18,13365,15011,-1646,-10.97,1209
2021-12-19,10883,12489,-1606,-12.86,1209
2021-12-20,19332,21589,-2257,-10.45,1209
2021-12-21,19406,22417,-3011,-13.43,1209
2021-12-22,19406,22379,-2973,-13.28,1209
2021-12-23,19406,22335,-2929,-13.11,1209
2021-12-24,18394,21847,-3453,-15.81,1209
2021-12-25,13365,14736,-1371,-9.3,1209
2021-12-26,10883,12155,-1272,-10.46,1209
2021-12-27,19332,21196,-1864,-8.79,1209
2021-12-28,19406,21964,-2558,-11.65,1209
2021-12-29,19406,21870,-2464,-11.27,1209
2021-12-30,19406,21771,-2365,-10.86,1209
2021-12-31,18394,21236,-2842,-13.38,1209
2022-01-01,12727,14083,-1356,-9.63,1209
2022-01-02,9852,11468,-1616,-14.09,1209
2022-01-03,17974,20484,-2510,-12.25,1209
2022-01-04,18735,21237,-2502,-11.78,1209
2022-01-05,18735,21138,-2403,-11.37,1209
2022-01-06,18735,21046,-2311,-10.98,1209
2022-01-07,18332,20527,-2195,-10.69,1209
2022-01-08,12727,13401,-674,-5.03,1209
2022-01-09,9852,10824,-972,-8.98,1209
2022-01-10,17974,19886,-1912,-9.61,1209
2022-01-11,18735,20695,-1960,-9.47,1209
2022-01-12,18735,20657,-1922,-9.3,1209
2022-01-13,18735,20633,-1898,-9.2,1209
2022-01-14,18332,20186,-1854,-9.18,1209
2022-01-15,12727,13135,-408,-3.11,1209
2022-01-16,9852,10634,-782,-7.35,1209
2022-01-17,17974,19771,-1797,-9.09,1209
2022-01-18,18735,20652,-1917,-9.28,1209
2022-01-19,18735,20684,-1949,-9.42,1209
2022-01-20,18735,20723,-1988,-9.59,1209
2022-01-21,18332,20334,-2002,-9.85,1209
2022-01-22,12727,13332,-605,-4.54,1209
2022-01-23,9852,10872,-1020,-9.38,1209
2022-01-24,17974,20041,-2067,-10.31,1209
2022-01-25,18735,20945,-2210,-10.55,1209
2022-01-26,18735,20990,-2255,-10.74,1209
2022-01-27,18735,21032,-2297,-10.92,1209
2022-01-28,18332,20638,-2306,-11.17,1209
2022-01-29,12727,13623,-896,-6.58,1209
2022-01-30,9852,11142,-1290,-11.58,1209
2020-02-01,8560,8204,356,4.34,1613
2020-02-02,6958,6745,213,3.16,1613
2020-02-03,10323,11303,-980,-8.67,1613
2020-02-04,11275,11637,-362,-3.11,1613
2020-02-05,11275,11632,-357,-3.07,1613
2020-02-06,11275,11640,-365,-3.14,1613
2020-02-07,11335,11555,-220,-1.9,1613
2020-02-08,8560,8202,358,4.36,1613
2020-02-09,6958,6730,228,3.39,1613
2020-02-10,10323,11278,-955,-8.47,1613
2020-02-11,11275,11606,-331,-2.85,1613
2020-02-12,11275,11599,-324,-2.79,1613
2020-02-13,11275,11610,-335,-2.89,1613
2020-02-14,11335,11534,-199,-1.73,1613
2020-02-15,8560,8193,367,4.48,1613
2020-02-16,6958,6738,220,3.27,1613
2020-02-17,10323,11306,-983,-8.69,1613
2020-02-18,11275,11659,-384,-3.29,1613
2020-02-19,11275,11679,-404,-3.46,1613
2020-02-20,11275,11719,-444,-3.79,1613
2020-02-21,11335,11672,-337,-2.89,1613
2020-02-22,8560,8362,198,2.37,1613
2020-02-23,6958,6937,21,0.3,1613
2020-02-24,10323,11534,-1211,-10.5,1613
2020-02-25,11275,11913,-638,-5.36,1613
2020-02-26,11275,11957,-682,-5.7,1613
2020-02-27,11275,12018,-743,-6.18,1613
2020-02-28,11335,11988,-653,-5.45,1613
2020-02-29,8560,8690,-130,-1.5,1613
2020-03-01,5295,7272,-1977,-27.19,1613
2020-03-02,8330,11871,-3541,-29.83,1613
2020-03-03,8570,12248,-3678,-30.03,1613
2020-03-04,8570,12285,-3715,-30.24,1613
2020-03-05,8570,12332,-3762,-30.51,1613
2020-03-06,8990,12286,-3296,-26.83,1613
2020-03-07,6121,8967,-2846,-31.74,1613
2020-03-08,5295,7525,-2230,-29.63,1613
2020-03-09,8330,12098,-3768,-31.15,1613
2020-03-10,8570,12446,-3876,-31.14,1613
2020-03-11,8570,12453,-3883,-31.18,1613
2020-03-12,8570,12471,-3901,-31.28,1613
2020-03-13,8990,12395,-3405,-27.47,1613
2020-03-14,6121,9049,-2928,-32.36,1613
2020-03-15,5295,7581,-2286,-30.15,1613
2020-03-16,8330,12131,-3801,-31.33,1613
2020-03-17,8570,12461,-3891,-31.23,1613
2020-03-18,8570,12452,-3882,-31.18,1613
2020-03-19,8570,12460,-3890,-31.22,1613
2020-03-20,8990,12378,-3388,-27.37,1613
2020-03-21,6121,9031,-2910,-32.22,1613
2020-03-22,5295,7567,-2272,-30.03,1613
2020-03-23,8330,12126,-3796,-31.3,1613
2020-03-24,8570,12468,-3898,-31.26,1613
2020-03-25,8570,12477,-3907,-31.31,1613
2020-03-26,8570,12505,-3935,-31.47,1613
2020-03-27,8990,12446,-3456,-27.77,1613
2020-03-28,6121,9124,-3003,-32.91,1613
2020-03-29,5295,7687,-2392,-31.12,1613
2020-03-30,8330,12272,-3942,-32.12,1613
2020-03-31,8570,12641,-4071,-32.2,1613
2020-04-01,7821,12674,-4853,-38.29,1613
2020-04-02,7821,12725,-4904,-38.54,1613
2020-04-03,7489,12686,-5197,-40.97,1613
2020-04-04,6044,9380,-3336,-35.57,1613
2020-04-05,4400,7954,-3554,-44.68,1613
2020-04-06,7686,12547,-4861,-38.74,1613
2020-04-07,7821,12917,-5096,-39.45,1613
2020-04-08,7821,12947,-5126,-39.59,1613
2020-04-09,7821,12989,-5168,-39.79,1613
2020-04-10,7489,12935,-5446,-42.1,1613
2020-04-11,6044,9609,-3565,-37.1,1613
2020-04-12,4400,8159,-3759,-46.07,1613
2020-04-13,7686,12722,-5036,-39.58,1613
2020-04-14,7821,13059,-5238,-40.11,1613
2020-04-15,7821,13052,-5231,-40.08,1613
2020-04-16,7821,13054,-5233,-40.09,1613
2020-04-17,7489,12959,-5470,-42.21,1613
2020-04-18,6044,9591,-3547,-36.98,1613
2020-04-19,4400,8098,-3698,-45.67,1613
2020-04-20,7686,12619,-4933,-39.09,1613
2020-04-21,7821,12915,-5094,-39.44,1613
2020-04-22,7821,12870,-5049,-39.23,1613
2020-04-23,7821,12837,-5016,-39.07,1613
2020-04-24,7489,12710,-5221,-41.08,1613
2020-04-25,6044,9314,-3270,-35.11,1613
2020-04-26,4400,7798,-3398,-43.58,1613
2020-04-27,7686,12301,-4615,-37.52,1613
2020-04-28,7821,12583,-4762,-37.84,1613
2020-04-29,7821,12530,-4709,-37.58,1613
2020-04-30,7821,12493,-4672,-37.4,1613
2020-05-01,10405,12367,-1962,-15.86,1613
2020-05-02,7773,8977,-1204,-13.41,1613
2020-05-03,6055,7471,-1416,-18.95,1613
2020-05-04,10105,11987,-1882,-15.7,1613
2020-05-05,10632,12287,-1655,-13.47,1613
2020-05-06,10632,12252,-1620,-13.22,1613
2020-05-07,10632,12237,-1605,-13.12,1613
2020-05-08,10405,12134,-1729,-14.25,1613
2020-05-09,7773,8768,-995,-11.35,1613
2020-05-10,6055,7285,-1230,-16.88,1613
2020-05-11,10105,11825,-1720,-14.55,1613
2020-05-12,10632,12148,-1516,-12.48,1613
2020-05-13,10632,12135,-1503,-12.39,1613
2020-05-14,10632,12140,-1508,-12.42,1613
2020-05-15,10405,12055,-1650,-13.69,1613
2020-05-16,7773,8705,-932,-10.71,1613
2020-05-17,6055,7236,-1181,-16.32,1613
2020-05-18,10105,11788,-1683,-14.28,1613
2020-05-19,10632,12120,-1488,-12.28,1613
2020-05-20,10632,12115,-1483,-12.24,1613
2020-05-21,10632,12125,-1493,-12.31,1613
2020-05-22,10405,12045,-1640,-13.62,1613
2020-05-23,7773,8698,-925,-10.63,1613
2020-05-24,6055,7232,-1177,-16.27,1613
2020-05-25,10105,11785,-1680,-14.26,1613
2020-05-26,10632,12118,-1486,-12.26,1613
2020-05-27,10632,12114,-1482,-12.23,1613
2020-05-28,10632,12125,-1493,-12.31,1613
2020-05-29,10405,12047,-1642,-13.63,1613
2020-05-30,7773,8702,-929,-10.68,1613
2020-05-31,6055,7239,-1184,-16.36,1613
2020-06-01,11308,11795,-487,-4.13,1613
2020-06-02,11795,12133,-338,-2.79,1613
2020-06-03,11795,12134,-339,-2.79,1613
2020-06-04,11795,12151,-356,-2.93,1613
2020-06-05,11132,12079,-947,-7.84,1613
2020-06-06,7846,8740,-894,-10.23,1613
2020-06-07,6388,7282,-894,-12.28,1613
2020-06-08,11308,11843,-535,-4.52,1613
2020-06-09,11795,12185,-390,-3.2,1613
2020-06-10,11795,12188,-393,-3.22,1613
2020-06-11,11795,12206,-411,-3.37,1613
2020-06-12,11132,12132,-1000,-8.24,1613
2020-06-13,7846,8789,-943,-10.73,1613
2020-06-14,6388,7326,-938,-12.8,1613
2020-06-15,11308,11878,-570,-4.8,1613
2020-06-16,11795,12208,-413,-3.38,1613
2020-06-17,11795,12198,-403,-3.3,1613
2020-06-18,11795,12199,-404,-3.31,1613
2020-06-19,11132,12105,-973,-8.04,1613
2020-06-20,7846,8741,-895,-10.24,1613
2020-06-21,6388,7253,-865,-11.93,1613
2020-06-22,11308,11781,-473,-4.01,1613
2020-06-23,11795,12085,-290,-2.4,1613
2020-06-24,11795,12047,-252,-2.09,1613
2020-06-25,11795,12022,-227,-1.89,1613
2020-06-26,11132,11903,-771,-6.48,1613
2020-06-27,7846,8514,-668,-7.85,1613
2020-06-28,6388,7004,-616,-8.79,1613
2020-06-29,11308,11511,-203,-1.76,1613
2020-06-30,11795,11798,-3,-0.03,1613
2020-07-01,10781,11747,-966,-8.22,1613
2020-07-02,10781,11712,-931,-7.95,1613
2020-07-03,10307,11587,-1280,-11.05,1613
2020-07-04,7040,8197,-1157,-14.11,1613
2020-07-05,6742,6690,52,0.78,1613
2020-07-06,10444,11205,-761,-6.79,1613
2020-07-07,10781,11503,-722,-6.28,1613
2020-07-08,10781,11467,-686,-5.98,1613
2020-07-09,10781,11451,-670,-5.85,1613
2020-07-10,10307,11348,-1041,-9.17,1613
2020-07-11,7040,7981,-941,-11.79,1613
2020-07-12,6742,6500,242,3.72,1613
2020-07-13,10444,11041,-597,-5.41,1613
2020-07-14,10781,11366,-585,-5.15,1613
2020-07-15,10781,11356,-575,-5.06,1613
2020-07-16,10781,11364,-583,-5.13,1613
2020-07-17,10307,11283,-976,-8.65,1613
2020-07-18,7040,7936,-896,-11.29,1613
2020-07-19,6742,6471,271,4.19,1613
2020-07-20,10444,11024,-580,-5.26,1613
2020-07-21,10781,11357,-576,-5.07,1613
2020-07-22,10781,11350,-569,-5.01,1613
2020-07-23,10781,11356,-575,-5.06,1613
2020-07-24,10307,11267,-960,-8.52,1613
2020-07-25,7040,7908,-868,-10.98,1613
2020-07-26,6742,6426,316,4.92,1613
2020-07-27,10444,10959,-515,-4.7,1613
2020-07-28,10781,11267,-486,-4.31,1613
2020-07-29,10781,11232,-451,-4.02,1613
2020-07-30,10781,11208,-427,-3.81,1613
2020-07-31,10307,11089,-782,-7.05,1613
2020-08-01,7226,7699,-473,-6.14,1613
2020-08-02,6380,6186,194,3.14,1613
2020-08-03,9962,10689,-727,-6.8,1613
2020-08-04,10291,10971,-680,-6.2,1613
2020-08-05,10291,10913,-622,-5.7,1613
2020-08-06,10291,10871,-580,-5.34,1613
2020-08-07,10078,10739,-661,-6.16,1613
2020-08-08,7226,7341,-115,-1.57,1613
2020-08-09,6380,5827,553,9.49,1613
2020-08-10,9962,10337,-375,-3.63,1613
2020-08-11,10291,10631,-340,-3.2,1613
2020-08-12,10291,10594,-303,-2.86,1613
2020-08-13,10291,10580,-289,-2.73,1613
2020-08-14,10078,10482,-404,-3.85,1613
2020-08-15,7226,7126,100,1.4,1613
2020-08-16,6380,5659,721,12.74,1613
2020-08-17,9962,10221,-259,-2.53,1613
2020-08-18,10291,10572,-281,-2.66,1613
2020-08-19,10291,10595,-304,-2.87,1613
2020-08-20,10291,10642,-351,-3.3,1613
2020-08-21,10078,10608,-530,-5.0,1613
2020-08-22,7226,7314,-88,-1.2,1613
2020-08-23,6380,5909,471,7.97,1613
2020-08-24,9962,10530,-568,-5.39,1613
2020-08-25,10291,10937,-646,-5.91,1613
2020-08-26,10291,11011,-720,-6.54,1613
2020-08-27,10291,11103,-812,-7.31,1613
2020-08-28,10078,11108,-1030,-9.27,1613
2020-08-29,7226,7847,-621,-7.91,1613
2020-08-30,6380,6466,-86,-1.33,1613
2020-08-31,9962,11104,-1142,-10.28,1613
2020-09-01,11081,11519,-438,-3.8,1613
2020-09-02,11081,11594,-513,-4.42,1613
2020-09-03,11081,11680,-599,-5.13,1613
2020-09-04,10648,11670,-1022,-8.76,1613
2020-09-05,8525,8388,137,1.63,1613
2020-09-06,7027,6980,47,0.67,1613
2020-09-07,10476,11586,-1110,-9.58,1613
2020-09-08,11081,11964,-883,-7.38,1613
2020-09-09,11081,11999,-918,-7.65,1613
2020-09-10,11081,12042,-961,-7.98,1613
2020-09-11,10648,11988,-1340,-11.18,1613
2020-09-12,8525,8662,-137,-1.58,1613
2020-09-13,7027,7210,-183,-2.54,1613
2020-09-14,10476,11774,-1298,-11.02,1613
2020-09-15,11081,12113,-1032,-8.52,1613
2020-09-16,11081,12112,-1031,-8.51,1613
2020-09-17,11081,12123,-1042,-8.6,1613
2020-09-18,10648,12042,-1394,-11.58,1613
2020-09-19,8525,8693,-168,-1.93,1613
2020-09-20,7027,7225,-198,-2.74,1613
2020-09-21,10476,11776,-1300,-11.04,1613
2020-09-22,11081,12109,-1028,-8.49,1613
2020-09-23,11081,12106,-1025,-8.47,1613
2020-09-24,11081,12120,-1039,-8.57,1613
2020-09-25,10648,12046,-1398,-11.61,1613
2020-09-26,8525,8708,-183,-2.1,1613
2020-09-27,7027,7253,-226,-3.12,1613
2020-09-28,10476,11820,-1344,-11.37,1613
2020-09-29,11081,12170,-1089,-8.95,1613
2020-09-30,11081,12185,-1104,-9.06,1613
2020-10-01,10417,12217,-1800,-14.73,1613
2020-10-02,10020,12161,-2141,-17.61,1613
2020-10-03,7561,8838,-1277,-14.45,1613
2020-10-04,6209,7397,-1188,-16.06,1613
2020-10-05,10855,11976,-1121,-9.36,1613
2020-10-06,10417,12334,-1917,-15.54,1613
2020-10-07,10417,12354,-1937,-15.68,1613
2020-10-08,10417,12388,-1971,-15.91,1613
2020-10-09,10020,12330,-2310,-18.73,1613
2020-10-10,7561,9002,-1441,-16.01,1613
2020-10-11,6209,7553,-1344,-17.79,1613
2020-10-12,10855,12121,-1266,-10.44,1613
2020-10-13,10417,12466,-2049,-16.44,1613
2020-10-14,10417,12471,-2054,-16.47,1613
2020-10-15,10417,12488,-2071,-16.58,1613
2020-10-16,10020,12412,-2392,-19.27,1613
2020-10-17,7561,9067,-1506,-16.61,1613
2020-10-18,6209,7601,-1392,-18.31,1613
2020-10-19,10855,12153,-1298,-10.68,1613
2020-10-20,10417,12483,-2066,-16.55,1613
2020-10-21,10417,12476,-2059,-16.5,1613
2020-10-22,10417,12483,-2066,-16.55,1613
2020-10-23,10020,12401,-2381,-19.2,1613
2020-10-24,7561,9052,-1491,-16.47,1613
2020-10-25,6209,7586,-1377,-18.15,1613
2020-10-26,10855,12140,-1285,-10.58,1613
2020-10-27,10417,12477,-2060,-16.51,1613
2020-10-28,10417,12479,-2062,-16.52,1613
2020-10-29,10417,12499,-2082,-16.66,1613
2020-10-30,10020,12430,-2410,-19.39,1613
2020-10-31,7561,9098,-1537,-16.89,1613
2020-11-01,5887,7648,-1761,-23.03,1613
2020-11-02,10120,12221,-2101,-17.19,1613
2020-11-03,9432,12576,-3144,-25.0,1613
2020-11-04,9432,12595,-3163,-25.11,1613
2020-11-05,9432,12630,-3198,-25.32,1613
2020-11-06,10152,12576,-2424,-19.27,1613
2020-11-07,7408,9255,-1847,-19.96,1613
2020-11-08,5887,7814,-1927,-24.66,1613
2020-11-09,10120,12391,-2271,-18.33,1613
2020-11-10,9432,12747,-3315,-26.01,1613
2020-11-11,9432,12763,-3331,-26.1,1613
2020-11-12,9432,12791,-3359,-26.26,1613
2020-11-13,10152,12725,-2573,-20.22,1613
2020-11-14,7408,9389,-1981,-21.1,1613
2020-11-15,5887,7929,-2042,-25.75,1613
2020-11-16,10120,12484,-2364,-18.94,1613
2020-11-17,9432,12815,-3383,-26.4,1613
2020-11-18,9432,12803,-3371,-26.33,1613
2020-11-19,9432,12803,-3371,-26.33,1613
2020-11-20,10152,12708,-2556,-20.11,1613
2020-11-21,7408,9341,-1933,-20.69,1613
2020-11-22,5887,7852,-1965,-25.03,1613
2020-11-23,10120,12379,-2259,-18.25,1613
2020-11-24,9432,12684,-3252,-25.64,1613
2020-11-25,9432,12649,-3217,-25.43,1613
2020-11-26,9432,12629,-3197,-25.31,1613
2020-11-27,10152,12517,-2365,-18.89,1613
2020-11-28,7408,9138,-1730,-18.93,1613
2020-11-29,5887,7641,-1754,-22.96,1613
2020-11-30,10120,12165,-2045,-16.81,1613
2020-12-01,10163,12471,-2308,-18.51,1613
2020-12-02,10163,12442,-2279,-18.32,1613
2020-12-03,10163,12431,-2268,-18.24,1613
2020-12-04,11298,12333,-1035,-8.39,1613
2020-12-05,7978,8971,-993,-11.07,1613
2020-12-06,6038,7493,-1455,-19.42,1613
2020-12-07,10593,12038,-1445,-12.0,1613
2020-12-08,10163,12366,-2203,-17.81,1613
2020-12-09,10163,12360,-2197,-17.78,1613
2020-12-10,10163,12372,-2209,-17.85,1613
2020-12-11,11298,12295,-997,-8.11,1613
2020-12-12,7978,8953,-975,-10.89,1613
2020-12-13,6038,7492,-1454,-19.41,1613
2020-12-14,10593,12050,-1457,-12.09,1613
2020-12-15,10163,12388,-2225,-17.96,1613
2020-12-16,10163,12387,-2224,-17.95,1613
2020-12-17,10163,12400,-2237,-18.04,1613
2020-12-18,11298,12319,-1021,-8.29,1613
2020-12-19,7978,8968,-990,-11.04,1613
2020-12-20,6038,7493,-1455,-19.42,1613
2020-12-21,10593,12034,-1441,-11.97,1613
2020-12-22,10163,12350,-2187,-17.71,1613
2020-12-23,10163,12324,-2161,-17.53,1613
2020-12-24,10163,12308,-2145,-17.43,1613
2020-12-25,11298,12196,-898,-7.36,1613
2020-12-26,7978,8813,-835,-9.47,1613
2020-12-27,6038,7306,-1268,-17.36,1613
2020-12-28,10593,11815,-1222,-10.34,1613
2020-12-29,10163,12100,-1937,-16.01,1613
2020-12-30,10163,12045,-1882,-15.62,1613
2020-12-31,10163,12003,-1840,-15.33,1613
2021-01-01,9777,11870,-2093,-17.63,1613
2021-01-02,6629,8469,-1840,-21.73,1613
2021-01-03,5316,6950,-1634,-23.51,1613
2021-01-04,9052,11451,-2399,-20.95,1613
2021-01-05,9639,11734,-2095,-17.85,1613
2021-01-06,9639,11684,-2045,-17.5,1613
2021-01-07,9639,11653,-2014,-17.28,1613
2021-01-08,9777,11535,-1758,-15.24,1613
2021-01-09,6629,8156,-1527,-18.72,1613
2021-01-10,5316,6663,-1347,-20.22,1613
2021-01-11,9052,11195,-2143,-19.14,1613
2021-01-12,9639,11513,-1874,-16.28,1613
2021-01-13,9639,11500,-1861,-16.18,1613
2021-01-14,9639,11509,-1870,-16.25,1613
2021-01-15,9777,11432,-1655,-14.48,1613
2021-01-16,6629,8094,-1465,-18.1,1613
2021-01-17,5316,6642,-1326,-19.96,1613
2021-01-18,9052,11213,-2161,-19.27,1613
2021-01-19,9639,11568,-1929,-16.68,1613
2021-01-20,9639,11589,-1950,-16.83,1613
2021-01-21,9639,11627,-1988,-17.1,1613
2021-01-22,9777,11576,-1799,-15.54,1613
2021-01-23,6629,8258,-1629,-19.73,1613
2021-01-24,5316,6821,-1505,-22.06,1613
2021-01-25,9052,11403,-2351,-20.62,1613
2021-01-26,9639,11763,-2124,-18.06,1613
2021-01-27,9639,11783,-2144,-18.2,1613
2021-01-28,9639,11816,-2177,-18.42,1613
2021-01-29,9777,11755,-1978,-16.83,1613
2021-01-30,6629,8423,-1794,-21.3,1613
2021-01-31,5316,6969,-1653,-23.72,1613
2021-02-01,10917,11531,-614,-5.32,1613
2021-02-02,11145,11869,-724,-6.1,1613
2021-02-03,11145,11867,-722,-6.08,1613
2021-02-04,11145,11877,-732,-6.16,1613
2021-02-05,11196,11795,-599,-5.08,1613
2021-02-06,8070,8443,-373,-4.42,1613
2021-02-07,6388,6971,-583,-8.36,1613
2021-02-08,10917,11518,-601,-5.22,1613
2021-02-09,11145,11846,-701,-5.92,1613
2021-02-10,11145,11837,-692,-5.85,1613
2021-02-11,11145,11844,-699,-5.9,1613
2021-02-12,11196,11764,-568,-4.83,1613
2021-02-13,8070,8419,-349,-4.15,1613
2021-02-14,6388,6959,-571,-8.21,1613
2021-02-15,10917,11522,-605,-5.25,1613
2021-02-16,11145,11869,-724,-6.1,1613
2021-02-17,11145,11883,-738,-6.21,1613
2021-02-18,11145,11917,-772,-6.48,1613
2021-02-19,11196,11865,-669,-5.64,1613
2021-02-20,8070,8550,-480,-5.61,1613
2021-02-21,6388,7120,-732,-10.28,1613
2021-02-22,10917,11713,-796,-6.8,1613
2021-02-23,11145,12089,-944,-7.81,1613
2021-02-24,11145,12131,-986,-8.13,1613
2021-02-25,11145,12190,-1045,-8.57,1613
2021-02-26,11196,12159,-963,-7.92,1613
2021-02-27,8070,8862,-792,-8.94,1613
2021-02-28,6388,7445,-1057,-14.2,1613
2021-03-01,11551,12047,-496,-4.12,1613
2021-03-02,11902,12427,-525,-4.22,1613
2021-03-03,11902,12467,-565,-4.53,1613
2021-03-04,11902,12519,-617,-4.93,1613
2021-03-05,11279,12478,-1199,-9.61,1613
2021-03-06,8818,9164,-346,-3.78,1613
2021-03-07,6534,7728,-1194,-15.45,1613
2021-03-08,11551,12307,-756,-6.14,1613
2021-03-09,11902,12660,-758,-5.99,1613
2021-03-10,11902,12672,-770,-6.08,1613
2021-03-11,11902,12695,-793,-6.25,1613
2021-03-12,11279,12624,-1345,-10.65,1613
2021-03-13,8818,9281,-463,-4.99,1613
2021-03-14,6534,7816,-1282,-16.4,1613
2021-03-15,11551,12369,-818,-6.61,1613
2021-03-16,11902,12699,-797,-6.28,1613
2021-03-17,11902,12691,-789,-6.22,1613
2021-03-18,11902,12698,-796,-6.27,1613
2021-03-19,11279,12615,-1336,-10.59,1613
2021-03-20,8818,9265,-447,-4.82,1613
2021-03-21,6534,7798,-1264,-16.21,1613
2021-03-22,11551,12353,-802,-6.49,1613
2021-03-23,11902,12691,-789,-6.22,1613
2021-03-24,11902,12695,-793,-6.25,1613
2021-03-25,11902,12718,-816,-6.42,1613
2021-03-26,11279,12654,-1375,-10.87,1613
2021-03-27,8818,9327,-509,-5.46,1613
2021-03-28,6534,7885,-1351,-17.13,1613
2021-03-29,11551,12466,-915,-7.34,1613
2021-03-30,11902,12831,-929,-7.24,1613
2021-03-31,11902,12861,-959,-7.46,1613
2021-04-01,10717,12909,-2192,-16.98,1613
2021-04-02,10771,12869,-2098,-16.3,1613
2021-04-03,7877,9562,-1685,-17.62,1613
2021-04-04,6588,8137,-1549,-19.04,1613
2021-04-05,10799,12731,-1932,-15.18,1613
2021-04-06,10717,13104,-2387,-18.22,1613
2021-04-07,10717,13138,-2421,-18.43,1613
2021-04-08,10717,13184,-2467,-18.71,1613
2021-04-09,10771,13135,-2364,-18.0,1613
2021-04-10,7877,9816,-1939,-19.75,1613
2021-04-11,6588,8372,-1784,-21.31,1613
2021-04-12,10799,12943,-2144,-16.56,1613
2021-04-13,10717,13287,-2570,-19.34,1613
2021-04-14,10717,13288,-2571,-19.35,1613
2021-04-15,10717,13298,-2581,-19.41,1613
2021-04-16,10771,13211,-2440,-18.47,1613
2021-04-17,7877,9850,-1973,-20.03,1613
2021-04-18,6588,8365,-1777,-21.24,1613
2021-04-19,10799,12892,-2093,-16.23,1613
2021-04-20,10717,13195,-2478,-18.78,1613
2021-04-21,10717,13155,-2438,-18.53,1613
2021-04-22,10717,13126,-2409,-18.35,1613
2021-04-23,10771,13002,-2231,-17.16,1613
2021-04-24,7877,9609,-1732,-18.02,1613
2021-04-25,6588,8094,-1506,-18.61,1613
2021-04-26,10799,12598,-1799,-14.28,1613
2021-04-27,10717,12880,-2163,-16.79,1613
2021-04-28,10717,12825,-2108,-16.44,1613
2021-04-29,10717,12787,-2070,-16.19,1613
2021-04-30,10771,12659,-1888,-14.91,1613
2021-05-01,9321,9265,56,0.6,1613
2021-05-02,7272,7755,-483,-6.23,1613
2021-05-03,12334,12267,67,0.55,1613
2021-05-04,12604,12563,41,0.33,1613
2021-05-05,12604,12524,80,0.64,1613
2021-05-06,12604,12504,100,0.8,1613
2021-05-07,12230,12397,-167,-1.35,1613
2021-05-08,9321,9026,295,3.27,1613
2021-05-09,7272,7540,-268,-3.55,1613
2021-05-10,12334,12076,258,2.14,1613
2021-05-11,12604,12395,209,1.69,1613
2021-05-12,12604,12380,224,1.81,1613
2021-05-13,12604,12382,222,1.79,1613
2021-05-14,12230,12295,-65,-0.53,1613
2021-05-15,9321,8943,378,4.23,1613
2021-05-16,7272,7473,-201,-2.69,1613
2021-05-17,12334,12024,310,2.58,1613
2021-05-18,12604,12355,249,2.02,1613
2021-05-19,12604,12350,254,2.06,1613
2021-05-20,12604,12360,244,1.97,1613
2021-05-21,12230,12279,-49,-0.4,1613
2021-05-22,9321,8932,389,4.36,1613
2021-05-23,7272,7466,-194,-2.6,1613
2021-05-24,12334,12018,316,2.63,1613
2021-05-25,12604,12351,253,2.05,1613
2021-05-26,12604,12347,257,2.08,1613
2021-05-27,12604,12358,246,1.99,1613
2021-05-28,12230,12279,-49,-0.4,1613
2021-05-29,9321,8933,388,4.34,1613
2021-05-30,7272,7469,-197,-2.64,1613
2021-05-31,12334,12025,309,2.57,1613
2021-06-01,12727,12361,366,2.96,1613
2021-06-02,12727,12361,366,2.96,1613
2021-06-03,12727,12377,350,2.83,1613
2021-06-04,11746,12304,-558,-4.54,1613
2021-06-05,8593,8964,-371,-4.14,1613
2021-06-06,7486,7505,-19,-0.25,1613
2021-06-07,12135,12067,68,0.56,1613
2021-06-08,12727,12408,319,2.57,1613
2021-06-09,12727,12412,315,2.54,1613
2021-06-10,12727,12431,296,2.38,1613
2021-06-11,11746,12359,-613,-4.96,1613
2021-06-12,8593,9018,-425,-4.71,1613
2021-06-13,7486,7556,-70,-0.93,1613
2021-06-14,12135,12112,23,0.19,1613
2021-06-15,12727,12446,281,2.26,1613
2021-06-16,12727,12439,288,2.32,1613
2021-06-17,12727,12444,283,2.27,1613
2021-06-18,11746,12355,-609,-4.93,1613
2021-06-19,8593,8996,-403,-4.48,1613
2021-06-20,7486,7513,-27,-0.36,1613
2021-06-21,12135,12046,89,0.74,1613
2021-06-22,12727,12354,373,3.02,1613
2021-06-23,12727,12322,405,3.29,1613
2021-06-24,12727,12301,426,3.46,1613
2021-06-25,11746,12185,-439,-3.6,1613
2021-06-26,8593,8800,-207,-2.35,1613
2021-06-27,7486,7292,194,2.66,1613
2021-06-28,12135,11802,333,2.82,1613
2021-06-29,12727,12090,637,5.27,1613
2021-06-30,12727,12039,688,5.71,1613
2021-07-01,10914,12004,-1090,-9.08,1613
2021-07-02,10709,11878,-1169,-9.84,1613
2021-07-03,7489,8485,-996,-11.74,1613
2021-07-04,6426,6975,-549,-7.87,1613
2021-07-05,10503,11487,-984,-8.57,1613
2021-07-06,10914,11781,-867,-7.36,1613
2021-07-07,10914,11741,-827,-7.04,1613
2021-07-08,10914,11720,-806,-6.88,1613
2021-07-09,10709,11611,-902,-7.77,1613
2021-07-10,7489,8240,-751,-9.11,1613
2021-07-11,6426,6753,-327,-4.84,1613
2021-07-12,10503,11290,-787,-6.97,1613
2021-07-13,10914,11610,-696,-5.99,1613
2021-07-14,10914,11597,-683,-5.89,1613
2021-07-15,10914,11602,-688,-5.93,1613
2021-07-16,10709,11519,-810,-7.03,1613
2021-07-17,7489,8170,-681,-8.34,1613
2021-07-18,6426,6704,-278,-4.15,1613
2021-07-19,10503,11258,-755,-6.71,1613
2021-07-20,10914,11591,-677,-5.84,1613
2021-07-21,10914,11586,-672,-5.8,1613
2021-07-22,10914,11595,-681,-5.87,1613
2021-07-23,10709,11511,-802,-6.97,1613
2021-07-24,7489,8157,-668,-8.19,1613
2021-07-25,6426,6680,-254,-3.8,1613
2021-07-26,10503,11218,-715,-6.37,1613
2021-07-27,10914,11531,-617,-5.35,1613
2021-07-28,10914,11503,-589,-5.12,1613
2021-07-29,10914,11485,-571,-4.97,1613
2021-07-30,10709,11371,-662,-5.82,1613
2021-07-31,7489,7986,-497,-6.22,1613
2021-08-01,6535,6478,57,0.88,1613
2021-08-02,9982,10985,-1003,-9.13,1613
2021-08-03,10389,11269,-880,-7.81,1613
2021-08-04,10389,11213,-824,-7.35,1613
2021-08-05,10389,11171,-782,-7.0,1613
2021-08-06,9886,11038,-1152,-10.44,1613
2021-08-07,7368,7638,-270,-3.53,1613
2021-08-08,6535,6121,414,6.76,1613
2021-08-09,9982,10626,-644,-6.06,1613
2021-08-10,10389,10914,-525,-4.81,1613
2021-08-11,10389,10870,-481,-4.43,1613
2021-08-12,10389,10847,-458,-4.22,1613
2021-08-13,9886,10739,-853,-7.94,1613
2021-08-14,7368,7372,-4,-0.05,1613
2021-08-15,6535,5895,640,10.86,1613
2021-08-16,9982,10445,-463,-4.43,1613
2021-08-17,10389,10784,-395,-3.66,1613
2021-08-18,10389,10796,-407,-3.77,1613
2021-08-19,10389,10832,-443,-4.09,1613
2021-08-20,9886,10786,-900,-8.34,1613
2021-08-21,7368,7482,-114,-1.52,1613
2021-08-22,6535,6068,467,7.7,1613
2021-08-23,9982,10680,-698,-6.54,1613
2021-08-24,10389,11079,-690,-6.23,1613
2021-08-25,10389,11147,-758,-6.8,1613
2021-08-26,10389,11235,-846,-7.53,1613
2021-08-27,9886,11237,-1351,-12.02,1613
2021-08-28,7368,7973,-605,-7.59,1613
2021-08-29,6535,6593,-58,-0.88,1613
2021-08-30,9982,11232,-1250,-11.13,1613
2021-08-31,10389,11650,-1261,-10.82,1613
2021-09-01,12040,11728,312,2.66,1613
2021-09-02,12040,11819,221,1.87,1613
2021-09-03,11694,11816,-122,-1.03,1613
2021-09-04,8336,8540,-204,-2.39,1613
2021-09-05,8070,7140,930,13.03,1613
2021-09-06,11684,11753,-69,-0.59,1613
2021-09-07,12040,12140,-100,-0.82,1613
2021-09-08,12040,12183,-143,-1.17,1613
2021-09-09,12040,12234,-194,-1.59,1613
2021-09-10,11694,12189,-495,-4.06,1613
2021-09-11,8336,8869,-533,-6.01,1613
2021-09-12,8070,7425,645,8.69,1613
2021-09-13,11684,11994,-310,-2.58,1613
2021-09-14,12040,12338,-298,-2.42,1613
2021-09-15,12040,12341,-301,-2.44,1613
2021-09-16,12040,12356,-316,-2.56,1613
2021-09-17,11694,12277,-583,-4.75,1613
2021-09-18,8336,8929,-593,-6.64,1613
2021-09-19,8070,7461,609,8.16,1613
2021-09-20,11684,12012,-328,-2.73,1613
2021-09-21,12040,12343,-303,-2.45,1613
2021-09-22,12040,12338,-298,-2.42,1613
2021-09-23,12040,12350,-310,-2.51,1613
2021-09-24,11694,12273,-579,-4.72,1613
2021-09-25,8336,8931,-595,-6.66,1613
2021-09-26,8070,7473,597,7.99,1613
2021-09-27,11684,12037,-353,-2.93,1613
2021-09-28,12040,12383,-343,-2.77,1613
2021-09-29,12040,12395,-355,-2.86,1613
2021-09-30,12040,12425,-385,-3.1,1613
2021-10-01,12663,12366,297,2.4,1613
2021-10-02,9552,9041,511,5.65,1613
2021-10-03,7826,7600,226,2.97,1613
2021-10-04,11958,12178,-220,-1.81,1613
2021-10-05,12548,12536,12,0.1,1613
2021-10-06,12548,12557,-9,-0.07,1613
2021-10-07,12548,12593,-45,-0.36,1613
2021-10-08,12663,12537,126,1.01,1613
2021-10-09,9552,9211,341,3.7,1613
2021-10-10,7826,7765,61,0.79,1613
2021-10-11,11958,12336,-378,-3.06,1613
2021-10-12,12548,12684,-136,-1.07,1613
2021-10-13,12548,12693,-145,-1.14,1613
2021-10-14,12548,12713,-165,-1.3,1613
2021-10-15,12663,12641,22,0.17,1613
2021-10-16,9552,9298,254,2.73,1613
2021-10-17,7826,7835,-9,-0.11,1613
2021-10-18,11958,12388,-430,-3.47,1613
2021-10-19,12548,12720,-172,-1.35,1613
2021-10-20,12548,12713,-165,-1.3,1613
2021-10-21,12548,12721,-173,-1.36,1613
2021-10-22,12663,12638,25,0.2,1613
2021-10-23,9552,9288,264,2.84,1613
2021-10-24,7826,7820,6,0.08,1613
2021-10-25,11958,12373,-415,-3.35,1613
2021-10-26,12548,12707,-159,-1.25,1613
2021-10-27,12548,12705,-157,-1.24,1613
2021-10-28,12548,12722,-174,-1.37,1613
2021-10-29,12663,12650,13,0.1,1613
2021-10-30,9552,9314,238,2.56,1613
2021-10-31,7826,7861,-35,-0.45,1613
2021-11-01,11310,12431,-1121,-9.02,1613
2021-11-02,12107,12783,-676,-5.29,1613
2021-11-03,12107,12800,-693,-5.41,1613
2021-11-04,12107,12833,-726,-5.66,1613
2021-11-05,11956,12778,-822,-6.43,1613
2021-11-06,9168,9456,-288,-3.05,1613
2021-11-07,7391,8016,-625,-7.8,1613
2021-11-08,11310,12594,-1284,-10.2,1613
2021-11-09,12107,12952,-845,-6.52,1613
2021-11-10,12107,12971,-864,-6.66,1613
2021-11-11,12107,13003,-896,-6.89,1613
2021-11-12,11956,12941,-985,-7.61,1613
2021-11-13,9168,9609,-441,-4.59,1613
2021-11-14,7391,8154,-763,-9.36,1613
2021-11-15,11310,12715,-1405,-11.05,1613
2021-11-16,12107,13051,-944,-7.23,1613
2021-11-17,12107,13045,-938,-7.19,1613
2021-11-18,12107,13050,-943,-7.23,1613
2021-11-19,11956,12960,-1004,-7.75,1613
2021-11-20,9168,9599,-431,-4.49,1613
2021-11-21,7391,8114,-723,-8.91,1613
2021-11-22,11310,12645,-1335,-10.56,1613
2021-11-23,12107,12953,-846,-6.53,1613
2021-11-24,12107,12920,-813,-6.29,1613
2021-11-25,12107,12901,-794,-6.15,1613
2021-11-26,11956,12790,-834,-6.52,1613
2021-11-27,9168,9412,-244,-2.59,1613
2021-11-28,7391,7914,-523,-6.61,1613
2021-11-29,11310,12436,-1126,-9.05,1613
2021-11-30,12107,12739,-632,-4.96,1613
2021-12-01,10742,12707,-1965,-15.46,1613
2021-12-02,10742,12693,-1951,-15.37,1613
2021-12-03,10292,12590,-2298,-18.25,1613
2021-12-04,8177,9224,-1047,-11.35,1613
2021-12-05,6381,7742,-1361,-17.58,1613
2021-12-06,10909,12283,-1374,-11.19,1613
2021-12-07,10742,12607,-1865,-14.79,1613
2021-12-08,10742,12597,-1855,-14.73,1613
2021-12-09,10742,12605,-1863,-14.78,1613
2021-12-10,10292,12526,-2234,-17.83,1613
2021-12-11,8177,9181,-1004,-10.94,1613
2021-12-12,6381,7719,-1338,-17.33,1613
2021-12-13,10909,12277,-1368,-11.14,1613
2021-12-14,10742,12616,-1874,-14.85,1613
2021-12-15,10742,12617,-1875,-14.86,1613
2021-12-16,10742,12631,-1889,-14.96,1613
2021-12-17,10292,12554,-2262,-18.02,1613
2021-12-18,8177,9206,-1029,-11.18,1613
2021-12-19,6381,7737,-1356,-17.53,1613
2021-12-20,10909,12283,-1374,-11.19,1613
2021-12-21,10742,12604,-1862,-14.77,1613
2021-12-22,10742,12584,-1842,-14.64,1613
2021-12-23,10742,12574,-1832,-14.57,1613
2021-12-24,10292,12469,-2177,-17.46,1613
2021-12-25,8177,9091,-914,-10.05,1613
2021-12-26,6381,7590,-1209,-15.93,1613
2021-12-27,10909,12104,-1195,-9.87,1613
2021-12-28,10742,12393,-1651,-13.32,1613
2021-12-29,10742,12342,-1600,-12.96,1613
2021-12-30,10742,12303,-1561,-12.69,1613
2021-12-31,10292,12171,-1879,-15.44,1613
2022-01-01,7638,8770,-1132,-12.91,1613
2022-01-02,5906,7250,-1344,-18.54,1613
2022-01-03,9978,11750,-1772,-15.08,1613
2022-01-04,10558,12030,-1472,-12.24,1613
2022-01-05,10558,11976,-1418,-11.84,1613
2022-01-06,10558,11940,-1382,-11.57,1613
2022-01-07,10446,11817,-1371,-11.6,1613
2022-01-08,7638,8431,-793,-9.41,1613
2022-01-09,5906,6931,-1025,-14.79,1613
2022-01-10,9978,11456,-1478,-12.9,1613
2022-01-11,10558,11766,-1208,-10.27,1613
2022-01-12,10558,11746,-1188,-10.11,1613
2022-01-13,10558,11747,-1189,-10.12,1613
2022-01-14,10446,11663,-1217,-10.43,1613
2022-01-15,7638,8318,-680,-8.18,1613
2022-01-16,5906,6859,-953,-13.89,1613
2022-01-17,9978,11425,-1447,-12.67,1613
2022-01-18,10558,11775,-1217,-10.34,1613
2022-01-19,10558,11792,-1234,-10.46,1613
2022-01-20,10558,11827,-1269,-10.73,1613
2022-01-21,10446,11774,-1328,-11.28,1613
2022-01-22,7638,8456,-818,-9.67,1613
2022-01-23,5906,7019,-1113,-15.86,1613
2022-01-24,9978,11601,-1623,-13.99,1613
2022-01-25,10558,11963,-1405,-11.74,1613
2022-01-26,10558,11986,-1428,-11.91,1613
2022-01-27,10558,12022,-1464,-12.18,1613
2022-01-28,10446,11964,-1518,-12.69,1613
2022-01-29,7638,8637,-999,-11.57,1613
2022-01-30,5906,7187,-1281,-17.82,1613
2020-02-01,9898,9242,656,7.1,1614
2020-02-02,8563,8219,344,4.19,1614
2020-02-03,12929,13215,-286,-2.16,1614
2020-02-04,13515,13698,-183,-1.34,1614
2020-02-05,13515,13701,-186,-1.36,1614
2020-02-06,13515,13700,-185,-1.35,1614
2020-02-07,13515,13515,0,0.0,1614
2020-02-08,9898,9254,644,6.96,1614
2020-02-09,8563,8215,348,4.24,1614
2020-02-10,12929,13199,-270,-2.05,1614
2020-02-11,13515,13675,-160,-1.17,1614
2020-02-12,13515,13676,-161,-1.18,1614
2020-02-13,13515,13677,-162,-1.18,1614
2020-02-14,13515,13501,14,0.1,1614
2020-02-15,9898,9253,645,6.97,1614
2020-02-16,8563,8232,331,4.02,1614
2020-02-17,12929,13238,-309,-2.33,1614
2020-02-18,13515,13740,-225,-1.64,1614
2020-02-19,13515,13769,-254,-1.84,1614
2020-02-20,13515,13802,-287,-2.08,1614
2020-02-21,13515,13657,-142,-1.04,1614
2020-02-22,9898,9442,456,4.83,1614
2020-02-23,8563,8453,110,1.3,1614
2020-02-24,12929,13489,-560,-4.15,1614
2020-02-25,13515,14019,-504,-3.6,1614
2020-02-26,13515,14074,-559,-3.97,1614
2020-02-27,13515,14128,-613,-4.34,1614
2020-02-28,13515,14000,-485,-3.46,1614
2020-02-29,9898,9797,101,1.03,1614
2020-03-01,6069,8815,-2746,-31.15,1614
2020-03-02,9945,13854,-3909,-28.22,1614
2020-03-03,10203,14380,-4177,-29.05,1614
2020-03-04,10203,14426,-4223,-29.27,1614
2020-03-05,10203,14466,-4263,-29.47,1614
2020-03-06,10360,14320,-3960,-27.65,1614
2020-03-07,6598,10095,-3497,-34.64,1614
2020-03-08,6069,9087,-3018,-33.21,1614
2020-03-09,9945,14097,-4152,-29.45,1614
2020-03-10,10203,14594,-4391,-30.09,1614
2020-03-11,10203,14609,-4406,-30.16,1614
2020-03-12,10203,14618,-4415,-30.2,1614
2020-03-13,10360,14443,-4083,-28.27,1614
2020-03-14,6598,10190,-3592,-35.25,1614
2020-03-15,6069,9156,-3087,-33.72,1614
2020-03-16,9945,14144,-4199,-29.69,1614
2020-03-17,10203,14622,-4419,-30.22,1614
2020-03-18,10203,14623,-4420,-30.23,1614
2020-03-19,10203,14623,-4420,-30.23,1614
2020-03-20,10360,14442,-4082,-28.26,1614
2020-03-21,6598,10189,-3591,-35.24,1614
2020-03-22,6069,9160,-3091,-33.74,1614
2020-03-23,9945,14158,-4213,-29.76,1614
2020-03-24,10203,14649,-4446,-30.35,1614
2020-03-25,10203,14667,-4464,-30.44,1614
2020-03-26,10203,14687,-4484,-30.53,1614
2020-03-27,10360,14529,-4169,-28.69,1614
2020-03-28,6598,10300,-3702,-35.94,1614
2020-03-29,6069,9296,-3227,-34.71,1614
2020-03-30,9945,14318,-4373,-30.54,1614
2020-03-31,10203,14833,-4630,-31.21,1614
2020-04-01,9123,14873,-5750,-38.66,1614
2020-04-02,9123,14913,-5790,-38.83,1614
2020-04-03,8510,14771,-6261,-42.39,1614
2020-04-04,6093,10555,-4462,-42.27,1614
2020-04-05,4830,9560,-4730,-49.48,1614
2020-04-06,9052,14586,-5534,-37.94,1614
2020-04-07,9123,15101,-5978,-39.59,1614
2020-04-08,9123,15135,-6012,-39.72,1614
2020-04-09,9123,15165,-6042,-39.84,1614
2020-04-10,8510,15009,-6499,-43.3,1614
2020-04-11,6093,10774,-4681,-43.45,1614
2020-04-12,4830,9756,-4926,-50.49,1614
2020-04-13,9052,14756,-5704,-38.66,1614
2020-04-14,9123,15243,-6120,-40.15,1614
2020-04-15,9123,15247,-6124,-40.17,1614
2020-04-16,9123,15245,-6122,-40.16,1614
2020-04-17,8510,15057,-6547,-43.48,1614
2020-04-18,6093,10791,-4698,-43.54,1614
2020-04-19,4830,9743,-4913,-50.43,1614
2020-04-20,9052,14715,-5663,-38.48,1614
2020-04-21,9123,15175,-6052,-39.88,1614
2020-04-22,9123,15157,-6034,-39.81,1614
2020-04-23,9123,15136,-6013,-39.73,1614
2020-04-24,8510,14933,-6423,-43.01,1614
2020-04-25,6093,10656,-4563,-42.82,1614
2020-04-26,4830,9601,-4771,-49.69,1614
2020-04-27,9052,14571,-5519,-37.88,1614
2020-04-28,9123,15033,-5910,-39.31,1614
2020-04-29,9123,15020,-5897,-39.26,1614
2020-04-30,9123,15008,-5885,-39.21,1614
2020-05-01,12343,14817,-2474,-16.7,1614
2020-05-02,8680,10553,-1873,-17.75,1614
2020-05-03,7289,9514,-2225,-23.39,1614
2020-05-04,12179,14501,-2322,-16.01,1614
2020-05-05,12776,14980,-2204,-14.71,1614
2020-05-06,12776,14985,-2209,-14.74,1614
2020-05-07,12776,14989,-2213,-14.76,1614
2020-05-08,12343,14813,-2470,-16.67,1614
2020-05-09,8680,10562,-1882,-17.82,1614
2020-05-10,7289,9534,-2245,-23.55,1614
2020-05-11,12179,14528,-2349,-16.17,1614
2020-05-12,12776,15012,-2236,-14.89,1614
2020-05-13,12776,15018,-2242,-14.93,1614
2020-05-14,12776,15021,-2245,-14.95,1614
2020-05-15,12343,14840,-2497,-16.83,1614
2020-05-16,8680,10582,-1902,-17.97,1614
2020-05-17,7289,9544,-2255,-23.63,1614
2020-05-18,12179,14526,-2347,-16.16,1614
2020-05-19,12776,14997,-2221,-14.81,1614
2020-05-20,12776,14989,-2213,-14.76,1614
2020-05-21,12776,14977,-2201,-14.7,1614
2020-05-22,12343,14781,-2438,-16.49,1614
2020-05-23,8680,10509,-1829,-17.4,1614
2020-05-24,7289,9459,-2170,-22.94,1614
2020-05-25,12179,14431,-2252,-15.61,1614
2020-05-26,12776,14894,-2118,-14.22,1614
2020-05-27,12776,14880,-2104,-14.14,1614
2020-05-28,12776,14866,-2090,-14.06,1614
2020-05-29,12343,14671,-2328,-15.87,1614
2020-05-30,8680,10404,-1724,-16.57,1614
2020-05-31,7289,9362,-2073,-22.14,1614
2020-06-01,13565,14344,-779,-5.43,1614
2020-06-02,14079,14821,-742,-5.01,1614
2020-06-03,14079,14823,-744,-5.02,1614
2020-06-04,14079,14826,-747,-5.04,1614
2020-06-05,13188,14651,-1463,-9.99,1614
2020-06-06,9118,10404,-1286,-12.36,1614
2020-06-07,8104,9380,-1276,-13.6,1614
2020-06-08,13565,14381,-816,-5.67,1614
2020-06-09,14079,14874,-795,-5.34,1614
2020-06-10,14079,14891,-812,-5.45,1614
2020-06-11,14079,14905,-826,-5.54,1614
2020-06-12,13188,14736,-1548,-10.5,1614
2020-06-13,9118,10491,-1373,-13.09,1614
2020-06-14,8104,9465,-1361,-14.38,1614
2020-06-15,13565,14458,-893,-6.18,1614
2020-06-16,14079,14938,-859,-5.75,1614
2020-06-17,14079,14936,-857,-5.74,1614
2020-06-18,14079,14926,-847,-5.67,1614
2020-06-19,13188,14729,-1541,-10.46,1614
2020-06-20,9118,10450,-1332,-12.75,1614
2020-06-21,8104,9387,-1283,-13.67,1614
2020-06-22,13565,14340,-775,-5.4,1614
2020-06-23,14079,14777,-698,-4.72,1614
2020-06-24,14079,14730,-651,-4.42,1614
2020-06-25,14079,14676,-597,-4.07,1614
2020-06-26,13188,14434,-1246,-8.63,1614
2020-06-27,9118,10113,-995,-9.84,1614
2020-06-28,8104,9010,-906,-10.06,1614
2020-06-29,13565,13927,-362,-2.6,1614
2020-06-30,14079,14332,-253,-1.77,1614
2020-07-01,13517,14260,-743,-5.21,1614
2020-07-02,13517,14186,-669,-4.72,1614
2020-07-03,12922,13931,-1009,-7.24,1614
2020-07-04,8531,9604,-1073,-11.17,1614
2020-07-05,8375,8503,-128,-1.51,1614
2020-07-06,13034,13428,-394,-2.93,1614
2020-07-07,13517,13849,-332,-2.4,1614
2020-07-08,13517,13800,-283,-2.05,1614
2020-07-09,13517,13755,-238,-1.73,1614
2020-07-10,12922,13535,-613,-4.53,1614
2020-07-11,8531,9247,-716,-7.74,1614
2020-07-12,8375,8189,186,2.27,1614
2020-07-13,13034,13161,-127,-0.96,1614
2020-07-14,13517,13630,-113,-0.83,1614
2020-07-15,13517,13628,-111,-0.81,1614
2020-07-16,13517,13630,-113,-0.83,1614
2020-07-17,12922,13456,-534,-3.97,1614
2020-07-18,8531,9211,-680,-7.38,1614
2020-07-19,8375,8190,185,2.26,1614
2020-07-20,13034,13195,-161,-1.22,1614
2020-07-21,13517,13691,-174,-1.27,1614
2020-07-22,13517,13710,-193,-1.41,1614
2020-07-23,13517,13725,-208,-1.52,1614
2020-07-24,12922,13557,-635,-4.68,1614
2020-07-25,8531,9310,-779,-8.37,1614
2020-07-26,8375,8282,93,1.12,1614
2020-07-27,13034,13271,-237,-1.79,1614
2020-07-28,13517,13746,-229,-1.67,1614
2020-07-29,13517,13738,-221,-1.61,1614
2020-07-30,13517,13722,-205,-1.49,1614
2020-07-31,12922,13519,-597,-4.42,1614
2020-08-01,8710,9236,-526,-5.7,1614
2020-08-02,7933,8169,-236,-2.89,1614
2020-08-03,12336,13120,-784,-5.98,1614
2020-08-04,12922,13558,-636,-4.69,1614
2020-08-05,12922,13516,-594,-4.39,1614
2020-08-06,12922,13471,-549,-4.08,1614
2020-08-07,12282,13243,-961,-7.26,1614
2020-08-08,8710,8941,-231,-2.58,1614
2020-08-09,7933,7863,70,0.89,1614
2020-08-10,12336,12810,-474,-3.7,1614
2020-08-11,12922,13253,-331,-2.5,1614
2020-08-12,12922,13224,-302,-2.28,1614
2020-08-13,12922,13200,-278,-2.11,1614
2020-08-14,12282,13002,-720,-5.54,1614
2020-08-15,8710,8738,-28,-0.32,1614
2020-08-16,7933,7705,228,2.96,1614
2020-08-17,12336,12704,-368,-2.9,1614
2020-08-18,12922,13204,-282,-2.14,1614
2020-08-19,12922,13238,-316,-2.39,1614
2020-08-20,12922,13280,-358,-2.7,1614
2020-08-21,12282,13150,-868,-6.6,1614
2020-08-22,8710,8954,-244,-2.73,1614
2020-08-23,7933,7989,-56,-0.7,1614
2020-08-24,12336,13054,-718,-5.5,1614
2020-08-25,12922,13617,-695,-5.1,1614
2020-08-26,12922,13708,-786,-5.73,1614
2020-08-27,12922,13802,-880,-6.38,1614
2020-08-28,12282,13717,-1435,-10.46,1614
2020-08-29,8710,9559,-849,-8.88,1614
2020-08-30,7933,8623,-690,-8.0,1614
2020-08-31,12336,13709,-1373,-10.02,1614
2020-09-01,14095,14283,-188,-1.32,1614
2020-09-02,14095,14377,-282,-1.96,1614
2020-09-03,14095,14464,-369,-2.55,1614
2020-09-04,13806,14365,-559,-3.89,1614
2020-09-05,9817,10184,-367,-3.6,1614
2020-09-06,8711,9218,-507,-5.5,1614
2020-09-07,13472,14267,-795,-5.57,1614
2020-09-08,14095,14800,-705,-4.76,1614
2020-09-09,14095,14848,-753,-5.07,1614
2020-09-10,14095,14887,-792,-5.32,1614
2020-09-11,13806,14737,-931,-6.32,1614
2020-09-12,9817,10505,-688,-6.55,1614
2020-09-13,8711,9488,-777,-8.19,1614
2020-09-14,13472,14489,-1017,-7.02,1614
2020-09-15,14095,14976,-881,-5.88,1614
2020-09-16,14095,14982,-887,-5.92,1614
2020-09-17,14095,14983,-888,-5.93,1614
2020-09-18,13806,14800,-994,-6.72,1614
2020-09-19,9817,10541,-724,-6.87,1614
2020-09-20,8711,9504,-793,-8.34,1614
2020-09-21,13472,14489,-1017,-7.02,1614
2020-09-22,14095,14967,-872,-5.83,1614
2020-09-23,14095,14969,-874,-5.84,1614
2020-09-24,14095,14971,-876,-5.85,1614
2020-09-25,13806,14795,-989,-6.68,1614
2020-09-26,9817,10546,-729,-6.91,1614
2020-09-27,8711,9523,-812,-8.53,1614
2020-09-28,13472,14525,-1053,-7.25,1614
2020-09-29,14095,15020,-925,-6.16,1614
2020-09-30,14095,15041,-946,-6.29,1614
2020-10-01,14181,15062,-881,-5.85,1614
2020-10-02,14056,14904,-848,-5.69,1614
2020-10-03,9959,10672,-713,-6.68,1614
2020-10-04,8707,9662,-955,-9.88,1614
2020-10-05,13571,14676,-1105,-7.53,1614
2020-10-06,14181,15179,-998,-6.57,1614
2020-10-07,14181,15205,-1024,-6.73,1614
2020-10-08,14181,15228,-1047,-6.88,1614
2020-10-09,14056,15067,-1011,-6.71,1614
2020-10-10,9959,10828,-869,-8.03,1614
2020-10-11,8707,9809,-1102,-11.23,1614
2020-10-12,13571,14810,-1239,-8.37,1614
2020-10-13,14181,15299,-1118,-7.31,1614
2020-10-14,14181,15308,-1127,-7.36,1614
2020-10-15,14181,15312,-1131,-7.39,1614
2020-10-16,14056,15132,-1076,-7.11,1614
2020-10-17,9959,10875,-916,-8.42,1614
2020-10-18,8707,9838,-1131,-11.5,1614
2020-10-19,13571,14822,-1251,-8.44,1614
2020-10-20,14181,15296,-1115,-7.29,1614
2020-10-21,14181,15293,-1112,-7.27,1614
2020-10-22,14181,15288,-1107,-7.24,1614
2020-10-23,14056,15102,-1046,-6.93,1614
2020-10-24,9959,10842,-883,-8.14,1614
2020-10-25,8707,9807,-1100,-11.22,1614
2020-10-26,13571,14796,-1225,-8.28,1614
2020-10-27,14181,15278,-1097,-7.18,1614
2020-10-28,14181,15287,-1106,-7.23,1614
2020-10-29,14181,15296,-1115,-7.29,1614
2020-10-30,14056,15127,-1071,-7.08,1614
2020-10-31,9959,10887,-928,-8.52,1614
2020-11-01,7083,9871,-2788,-28.24,1614
2020-11-02,12499,14880,-2381,-16.0,1614
2020-11-03,11938,15383,-3445,-22.39,1614
2020-11-04,11938,15410,-3472,-22.53,1614
2020-11-05,11938,15436,-3498,-22.66,1614
2020-11-06,12019,15282,-3263,-21.35,1614
2020-11-07,8057,11052,-2995,-27.1,1614
2020-11-08,7083,10044,-2961,-29.48,1614
2020-11-09,12499,15057,-2558,-16.99,1614
2020-11-10,11938,15558,-3620,-23.27,1614
2020-11-11,11938,15579,-3641,-23.37,1614
2020-11-12,11938,15596,-3658,-23.45,1614
2020-11-13,12019,15427,-3408,-22.09,1614
2020-11-14,8057,11178,-3121,-27.92,1614
2020-11-15,7083,10147,-3064,-30.2,1614
2020-11-16,12499,15134,-2635,-17.41,1614
2020-11-17,11938,15606,-3668,-23.5,1614
2020-11-18,11938,15597,-3659,-23.46,1614
2020-11-19,11938,15581,-3643,-23.38,1614
2020-11-20,12019,15379,-3360,-21.85,1614
2020-11-21,8057,11098,-3041,-27.4,1614
2020-11-22,7083,10036,-2953,-29.42,1614
2020-11-23,12499,14994,-2495,-16.64,1614
2020-11-24,11938,15440,-3502,-22.68,1614
2020-11-25,11938,15408,-3470,-22.52,1614
2020-11-26,11938,15374,-3436,-22.35,1614
2020-11-27,12019,15158,-3139,-20.71,1614
2020-11-28,8057,10868,-2811,-25.86,1614
2020-11-29,7083,9801,-2718,-27.73,1614
2020-11-30,12499,14760,-2261,-15.32,1614
2020-12-01,11864,15212,-3348,-22.01,1614
2020-12-02,11864,15191,-3327,-21.9,1614
2020-12-03,11864,15172,-3308,-21.8,1614
2020-12-04,12914,14974,-2060,-13.76,1614
2020-12-05,8586,10706,-2120,-19.8,1614
2020-12-06,6762,9664,-2902,-30.03,1614
2020-12-07,11894,14649,-2755,-18.81,1614
2020-12-08,11864,15127,-3263,-21.57,1614
2020-12-09,11864,15132,-3268,-21.6,1614
2020-12-10,11864,15137,-3273,-21.62,1614
2020-12-11,12914,14962,-2048,-13.69,1614
2020-12-12,8586,10712,-2126,-19.85,1614
2020-12-13,6762,9685,-2923,-30.18,1614
2020-12-14,11894,14680,-2786,-18.98,1614
2020-12-15,11864,15164,-3300,-21.76,1614
2020-12-16,11864,15168,-3304,-21.78,1614
2020-12-17,11864,15167,-3303,-21.78,1614
2020-12-18,12914,14979,-2065,-13.79,1614
2020-12-19,8586,10712,-2126,-19.85,1614
2020-12-20,6762,9662,-2900,-30.01,1614
2020-12-21,11894,14628,-2734,-18.69,1614
2020-12-22,11864,15078,-3214,-21.32,1614
2020-12-23,11864,15045,-3181,-21.14,1614
2020-12-24,11864,15003,-3139,-20.92,1614
2020-12-25,12914,14774,-1860,-12.59,1614
2020-12-26,8586,10463,-1877,-17.94,1614
2020-12-27,6762,9369,-2607,-27.83,1614
2020-12-28,11894,14293,-2399,-16.78,1614
2020-12-29,11864,14704,-2840,-19.31,1614
2020-12-30,11864,14634,-2770,-18.93,1614
2020-12-31,11864,14561,-2697,-18.52,1614
2021-01-01,11107,14305,-3198,-22.36,1614
2021-01-02,6940,9974,-3034,-30.42,1614
2021-01-03,5895,8866,-2971,-33.51,1614
2021-01-04,10618,13783,-3165,-22.96,1614
2021-01-05,11263,14194,-2931,-20.65,1614
2021-01-06,11263,14133,-2870,-20.31,1614
2021-01-07,11263,14075,-2812,-19.98,1614
2021-01-08,11107,13842,-2735,-19.76,1614
2021-01-09,6940,9540,-2600,-27.25,1614
2021-01-10,5895,8468,-2573,-30.38,1614
2021-01-11,10618,13427,-2809,-20.92,1614
2021-01-12,11263,13884,-2621,-18.88,1614
2021-01-13,11263,13872,-2609,-18.81,1614
2021-01-14,11263,13866,-2603,-18.77,1614
2021-01-15,11107,13686,-2579,-18.84,1614
2021-01-16,6940,9438,-2498,-26.47,1614
2021-01-17,5895,8418,-2523,-29.97,1614
2021-01-18,10618,13427,-2809,-20.92,1614
2021-01-19,11263,13931,-2668,-19.15,1614
2021-01-20,11263,13962,-2699,-19.33,1614
2021-01-21,11263,13994,-2731,-19.52,1614
2021-01-22,11107,13847,-2740,-19.79,1614
2021-01-23,6940,9626,-2686,-27.9,1614
2021-01-24,5895,8627,-2732,-31.67,1614
2021-01-25,10618,13650,-3032,-22.21,1614
2021-01-26,11263,14161,-2898,-20.46,1614
2021-01-27,11263,14194,-2931,-20.65,1614
2021-01-28,11263,14221,-2958,-20.8,1614
2021-01-29,11107,14064,-2957,-21.03,1614
2021-01-30,6940,9828,-2888,-29.39,1614
2021-01-31,5895,8810,-2915,-33.09,1614
2021-02-01,12432,13810,-1378,-9.98,1614
2021-02-02,12884,14298,-1414,-9.89,1614
2021-02-03,12884,14304,-1420,-9.93,1614
2021-02-04,12884,14306,-1422,-9.94,1614
2021-02-05,12911,14124,-1213,-8.59,1614
2021-02-06,8572,9865,-1293,-13.11,1614
2021-02-07,7311,8826,-1515,-17.17,1614
2021-02-08,12432,13810,-1378,-9.98,1614
2021-02-09,12884,14284,-1400,-9.8,1614
2021-02-10,12884,14283,-1399,-9.79,1614
2021-02-11,12884,14281,-1397,-9.78,1614
2021-02-12,12911,14101,-1190,-8.44,1614
2021-02-13,8572,9848,-1276,-12.96,1614
2021-02-14,7311,8822,-1511,-17.13,1614
2021-02-15,12432,13822,-1390,-10.06,1614
2021-02-16,12884,14317,-1433,-10.01,1614
2021-02-17,12884,14341,-1457,-10.16,1614
2021-02-18,12884,14367,-1483,-10.32,1614
2021-02-19,12911,14217,-1306,-9.19,1614
2021-02-20,8572,9996,-1424,-14.25,1614
2021-02-21,7311,9002,-1691,-18.78,1614
2021-02-22,12432,14035,-1603,-11.42,1614
2021-02-23,12884,14561,-1677,-11.52,1614
2021-02-24,12884,14614,-1730,-11.84,1614
2021-02-25,12884,14666,-1782,-12.15,1614
2021-02-26,12911,14538,-1627,-11.19,1614
2021-02-27,8572,10336,-1764,-17.07,1614
2021-02-28,7311,9355,-2044,-21.85,1614
2021-03-01,13208,14396,-1188,-8.25,1614
2021-03-02,13741,14926,-1185,-7.94,1614
2021-03-03,13741,14975,-1234,-8.24,1614
2021-03-04,13741,15020,-1279,-8.52,1614
2021-03-05,13385,14880,-1495,-10.05,1614
2021-03-06,9569,10660,-1091,-10.23,1614
2021-03-07,7464,9658,-2194,-22.72,1614
2021-03-08,13208,14674,-1466,-9.99,1614
2021-03-09,13741,15176,-1435,-9.46,1614
2021-03-10,13741,15197,-1456,-9.58,1614
2021-03-11,13741,15211,-1470,-9.66,1614
2021-03-12,13385,15040,-1655,-11.0,1614
2021-03-13,9569,10790,-1221,-11.32,1614
2021-03-14,7464,9760,-2296,-23.52,1614
2021-03-15,13208,14750,-1542,-10.45,1614
2021-03-16,13741,15229,-1488,-9.77,1614
2021-03-17,13741,15230,-1489,-9.78,1614
2021-03-18,13741,15228,-1487,-9.76,1614
2021-03-19,13385,15046,-1661,-11.04,1614
2021-03-20,9569,10791,-1222,-11.32,1614
2021-03-21,7464,9759,-2295,-23.52,1614
2021-03-22,13208,14752,-1544,-10.47,1614
2021-03-23,13741,15239,-1498,-9.83,1614
2021-03-24,13741,15253,-1512,-9.91,1614
2021-03-25,13741,15268,-1527,-10.0,1614
2021-03-26,13385,15105,-1720,-11.39,1614
2021-03-27,9569,10871,-1302,-11.98,1614
2021-03-28,7464,9863,-2399,-24.32,1614
2021-03-29,13208,14881,-1673,-11.24,1614
2021-03-30,13741,15393,-1652,-10.73,1614
2021-03-31,13741,15431,-1690,-10.95,1614
2021-04-01,12655,15469,-2814,-18.19,1614
2021-04-02,12477,15327,-2850,-18.59,1614
2021-04-03,8230,11110,-2880,-25.92,1614
2021-04-04,7178,10116,-2938,-29.04,1614
2021-04-05,12512,15144,-2632,-17.38,1614
2021-04-06,12655,15661,-3006,-19.19,1614
2021-04-07,12655,15699,-3044,-19.39,1614
2021-04-08,12655,15733,-3078,-19.56,1614
2021-04-09,12477,15582,-3105,-19.93,1614
2021-04-10,8230,11352,-3122,-27.5,1614
2021-04-11,7178,10340,-3162,-30.58,1614
2021-04-12,12512,15346,-2834,-18.47,1614
2021-04-13,12655,15838,-3183,-20.1,1614
2021-04-14,12655,15848,-3193,-20.15,1614
2021-04-15,12655,15852,-3197,-20.17,1614
2021-04-16,12477,15670,-3193,-20.38,1614
2021-04-17,8230,11408,-3178,-27.86,1614
2021-04-18,7178,10364,-3186,-30.74,1614
2021-04-19,12512,15340,-2828,-18.44,1614
2021-04-20,12655,15803,-3148,-19.92,1614
2021-04-21,12655,15787,-3132,-19.84,1614
2021-04-22,12655,15768,-3113,-19.74,1614
2021-04-23,12477,15565,-3088,-19.84,1614
2021-04-24,8230,11287,-3057,-27.08,1614
2021-04-25,7178,10232,-3054,-29.85,1614
2021-04-26,12512,15200,-2688,-17.68,1614
2021-04-27,12655,15659,-3004,-19.18,1614
2021-04-28,12655,15644,-2989,-19.11,1614
2021-04-29,12655,15629,-2974,-19.03,1614
2021-04-30,12477,15434,-2957,-19.16,1614
2021-05-01,10158,11168,-1010,-9.04,1614
2021-05-02,8102,10126,-2024,-19.99,1614
2021-05-03,14323,15109,-786,-5.2,1614
2021-05-04,14874,15585,-711,-4.56,1614
2021-05-05,14874,15587,-713,-4.57,1614
2021-05-06,14874,15589,-715,-4.59,1614
2021-05-07,14422,15411,-989,-6.42,1614
2021-05-08,10158,11160,-1002,-8.98,1614
2021-05-09,8102,10131,-2029,-20.03,1614
2021-05-10,14323,15126,-803,-5.31,1614
2021-05-11,14874,15611,-737,-4.72,1614
2021-05-12,14874,15618,-744,-4.76,1614
2021-05-13,14874,15623,-749,-4.79,1614
2021-05-14,14422,15444,-1022,-6.62,1614
2021-05-15,10158,11189,-1031,-9.21,1614
2021-05-16,8102,10154,-2052,-20.21,1614
2021-05-17,14323,15139,-816,-5.39,1614
2021-05-18,14874,15612,-738,-4.73,1614
2021-05-19,14874,15607,-733,-4.7,1614
2021-05-20,14874,15597,-723,-4.64,1614
2021-05-21,14422,15404,-982,-6.37,1614
2021-05-22,10158,11134,-976,-8.77,1614
2021-05-23,8102,10084,-1982,-19.65,1614
2021-05-24,14323,15057,-734,-4.87,1614
2021-05-25,14874,15519,-645,-4.16,1614
2021-05-26,14874,15505,-631,-4.07,1614
2021-05-27,14874,15489,-615,-3.97,1614
2021-05-28,14422,15293,-871,-5.7,1614
2021-05-29,10158,11023,-865,-7.85,1614
2021-05-30,8102,9978,-1876,-18.8,1614
2021-05-31,14323,14957,-634,-4.24,1614
2021-06-01,15125,15430,-305,-1.98,1614
2021-06-02,15125,15428,-303,-1.96,1614
2021-06-03,15125,15428,-303,-1.96,1614
2021-06-04,14282,15249,-967,-6.34,1614
2021-06-05,10013,10998,-985,-8.96,1614
2021-06-06,9207,9972,-765,-7.67,1614
2021-06-07,14499,14971,-472,-3.15,1614
2021-06-08,15125,15462,-337,-2.18,1614
2021-06-09,15125,15478,-353,-2.28,1614
2021-06-10,15125,15492,-367,-2.37,1614
2021-06-11,14282,15325,-1043,-6.81,1614
2021-06-12,10013,11082,-1069,-9.65,1614
2021-06-13,9207,10059,-852,-8.47,1614
2021-06-14,14499,15057,-558,-3.71,1614
2021-06-15,15125,15542,-417,-2.68,1614
2021-06-16,15125,15546,-421,-2.71,1614
2021-06-17,15125,15543,-418,-2.69,1614
2021-06-18,14282,15353,-1071,-6.98,1614
2021-06-19,10013,11082,-1069,-9.65,1614
2021-06-20,9207,10027,-820,-8.18,1614
2021-06-21,14499,14989,-490,-3.27,1614
2021-06-22,15125,15434,-309,-2.0,1614
2021-06-23,15125,15395,-270,-1.75,1614
2021-06-24,15125,15348,-223,-1.45,1614
2021-06-25,14282,15114,-832,-5.5,1614
2021-06-26,10013,10799,-786,-7.28,1614
2021-06-27,9207,9701,-494,-5.09,1614
2021-06-28,14499,14621,-122,-0.83,1614
2021-06-29,15125,15029,96,0.64,1614
2021-06-30,15125,14958,167,1.12,1614
2021-07-01,14303,14884,-581,-3.9,1614
2021-07-02,13884,14628,-744,-5.09,1614
2021-07-03,9219,10298,-1079,-10.48,1614
2021-07-04,8216,9193,-977,-10.63,1614
2021-07-05,13787,14113,-326,-2.31,1614
2021-07-06,14303,14528,-225,-1.55,1614
2021-07-07,14303,14470,-167,-1.15,1614
2021-07-08,14303,14417,-114,-0.79,1614
2021-07-09,13884,14189,-305,-2.15,1614
2021-07-10,9219,9893,-674,-6.81,1614
2021-07-11,8216,8825,-609,-6.9,1614
2021-07-12,13787,13788,-1,-0.01,1614
2021-07-13,14303,14248,55,0.39,1614
2021-07-14,14303,14239,64,0.45,1614
2021-07-15,14303,14234,69,0.48,1614
2021-07-16,13884,14053,-169,-1.2,1614
2021-07-17,9219,9803,-584,-5.96,1614
2021-07-18,8216,8778,-562,-6.4,1614
2021-07-19,13787,13780,7,0.05,1614
2021-07-20,14303,14275,28,0.2,1614
2021-07-21,14303,14294,9,0.06,1614
2021-07-22,14303,14311,-8,-0.06,1614
2021-07-23,13884,14145,-261,-1.85,1614
2021-07-24,9219,9903,-684,-6.91,1614
2021-07-25,8216,8879,-663,-7.47,1614
2021-07-26,13787,13874,-87,-0.63,1614
2021-07-27,14303,14356,-53,-0.37,1614
2021-07-28,14303,14355,-52,-0.36,1614
2021-07-29,14303,14346,-43,-0.3,1614
2021-07-30,13884,14151,-267,-1.89,1614
2021-07-31,9219,9874,-655,-6.63,1614
2021-08-01,8140,8814,-674,-7.65,1614
2021-08-02,13103,13771,-668,-4.85,1614
2021-08-03,13798,14214,-416,-2.93,1614
2021-08-04,13798,14176,-378,-2.67,1614
2021-08-05,13798,14133,-335,-2.37,1614
2021-08-06,13124,13906,-782,-5.62,1614
2021-08-07,9173,9604,-431,-4.49,1614
2021-08-08,8140,8523,-383,-4.49,1614
2021-08-09,13103,13467,-364,-2.7,1614
2021-08-10,13798,13904,-106,-0.76,1614
2021-08-11,13798,13869,-71,-0.51,1614
2021-08-12,13798,13836,-38,-0.27,1614
2021-08-13,13124,13629,-505,-3.71,1614
2021-08-14,9173,9354,-181,-1.94,1614
2021-08-15,8140,8310,-170,-2.05,1614
2021-08-16,13103,13297,-194,-1.46,1614
2021-08-17,13798,13785,13,0.09,1614
2021-08-18,13798,13805,-7,-0.05,1614
2021-08-19,13798,13834,-36,-0.26,1614
2021-08-20,13124,13692,-568,-4.15,1614
2021-08-21,9173,9485,-312,-3.29,1614
2021-08-22,8140,8509,-369,-4.34,1614
2021-08-23,13103,13564,-461,-3.4,1614
2021-08-24,13798,14119,-321,-2.27,1614
2021-08-25,13798,14203,-405,-2.85,1614
2021-08-26,13798,14291,-493,-3.45,1614
2021-08-27,13124,14202,-1078,-7.59,1614
2021-08-28,9173,10042,-869,-8.65,1614
2021-08-29,8140,9105,-965,-10.6,1614
2021-08-30,13103,14192,-1089,-7.67,1614
2021-08-31,13798,14769,-971,-6.57,1614
2021-09-01,14426,14867,-441,-2.97,1614
2021-09-02,14426,14960,-534,-3.57,1614
2021-09-03,14340,14867,-527,-3.54,1614
2021-09-04,10446,10694,-248,-2.32,1614
2021-09-05,10052,9736,316,3.25,1614
2021-09-06,13944,14795,-851,-5.75,1614
2021-09-07,14426,15337,-911,-5.94,1614
2021-09-08,14426,15395,-969,-6.29,1614
2021-09-09,14426,15443,-1017,-6.59,1614
2021-09-10,14340,15302,-962,-6.29,1614
2021-09-11,10446,11078,-632,-5.71,1614
2021-09-12,10052,10070,-18,-0.18,1614
2021-09-13,13944,15078,-1134,-7.52,1614
2021-09-14,14426,15571,-1145,-7.35,1614
2021-09-15,14426,15582,-1156,-7.42,1614
2021-09-16,14426,15587,-1161,-7.45,1614
2021-09-17,14340,15407,-1067,-6.93,1614
2021-09-18,10446,11149,-703,-6.31,1614
2021-09-19,10052,10113,-61,-0.6,1614
2021-09-20,13944,15098,-1154,-7.64,1614
2021-09-21,14426,15574,-1148,-7.37,1614
2021-09-22,14426,15574,-1148,-7.37,1614
2021-09-23,14426,15574,-1148,-7.37,1614
2021-09-24,14340,15395,-1055,-6.85,1614
2021-09-25,10446,11142,-696,-6.25,1614
2021-09-26,10052,10115,-63,-0.62,1614
2021-09-27,13944,15113,-1169,-7.74,1614
2021-09-28,14426,15605,-1179,-7.56,1614
2021-09-29,14426,15623,-1197,-7.66,1614
2021-09-30,14426,15641,-1215,-7.77,1614
2021-10-01,14999,15481,-482,-3.11,1614
2021-10-02,10698,11247,-549,-4.88,1614
2021-10-03,9432,10236,-804,-7.85,1614
2021-10-04,14200,15250,-1050,-6.89,1614
2021-10-05,15032,15754,-722,-4.58,1614
2021-10-06,15032,15781,-749,-4.75,1614
2021-10-07,15032,15805,-773,-4.89,1614
2021-10-08,14999,15646,-647,-4.14,1614
2021-10-09,10698,11411,-713,-6.25,1614
2021-10-10,9432,10395,-963,-9.26,1614
2021-10-11,14200,15399,-1199,-7.79,1614
2021-10-12,15032,15892,-860,-5.41,1614
2021-10-13,15032,15904,-872,-5.48,1614
2021-10-14,15032,15912,-880,-5.53,1614
2021-10-15,14999,15735,-736,-4.68,1614
2021-10-16,10698,11481,-783,-6.82,1614
2021-10-17,9432,10446,-1014,-9.71,1614
2021-10-18,14200,15432,-1232,-7.98,1614
2021-10-19,15032,15907,-875,-5.5,1614
2021-10-20,15032,15905,-873,-5.49,1614
2021-10-21,15032,15899,-867,-5.45,1614
2021-10-22,14999,15713,-714,-4.54,1614
2021-10-23,10698,11452,-754,-6.58,1614
2021-10-24,9432,10414,-982,-9.43,1614
2021-10-25,14200,15400,-1200,-7.79,1614
2021-10-26,15032,15880,-848,-5.34,1614
2021-10-27,15032,15884,-852,-5.36,1614
2021-10-28,15032,15890,-858,-5.4,1614
2021-10-29,14999,15717,-718,-4.57,1614
2021-10-30,10698,11473,-775,-6.75,1614
2021-10-31,9432,10453,-1021,-9.77,1614
2021-11-01,13222,15459,-2237,-14.47,1614
2021-11-02,14218,15959,-1741,-10.91,1614
2021-11-03,14218,15984,-1766,-11.05,1614
2021-11-04,14218,16009,-1791,-11.19,1614
2021-11-05,14215,15853,-1638,-10.33,1614
2021-11-06,10061,11624,-1563,-13.45,1614
2021-11-07,8623,10616,-1993,-18.77,1614
2021-11-08,13222,15631,-2409,-15.41,1614
2021-11-09,14218,16135,-1917,-11.88,1614
2021-11-10,14218,16160,-1942,-12.02,1614
2021-11-11,14218,16180,-1962,-12.13,1614
2021-11-12,14215,16016,-1801,-11.25,1614
2021-11-13,10061,11773,-1712,-14.54,1614
2021-11-14,8623,10747,-2124,-19.76,1614
2021-11-15,13222,15740,-2518,-16.0,1614
2021-11-16,14218,16219,-2001,-12.34,1614
2021-11-17,14218,16216,-1998,-12.32,1614
2021-11-18,14218,16206,-1988,-12.27,1614
2021-11-19,14215,16009,-1794,-11.21,1614
2021-11-20,10061,11733,-1672,-14.25,1614
2021-11-21,8623,10676,-2053,-19.23,1614
2021-11-22,13222,15637,-2415,-15.44,1614
2021-11-23,14218,16086,-1868,-11.61,1614
2021-11-24,14218,16056,-1838,-11.45,1614
2021-11-25,14218,16022,-1804,-11.26,1614
2021-11-26,14215,15806,-1591,-10.07,1614
2021-11-27,10061,11515,-1454,-12.63,1614
2021-11-28,8623,10447,-1824,-17.46,1614
2021-11-29,13222,15403,-2181,-14.16,1614
2021-11-30,14218,15852,-1634,-10.31,1614
2021-12-01,12972,15826,-2854,-18.03,1614
2021-12-02,12972,15802,-2830,-17.91,1614
2021-12-03,12323,15600,-3277,-21.01,1614
2021-12-04,9056,11327,-2271,-20.05,1614
2021-12-05,7620,10280,-2660,-25.88,1614
2021-12-06,13069,15259,-2190,-14.35,1614
2021-12-07,12972,15734,-2762,-17.55,1614
2021-12-08,12972,15734,-2762,-17.55,1614
2021-12-09,12972,15736,-2764,-17.56,1614
2021-12-10,12323,15559,-3236,-20.8,1614
2021-12-11,9056,11309,-2253,-19.92,1614
2021-12-12,7620,10281,-2661,-25.88,1614
2021-12-13,13069,15277,-2208,-14.45,1614
2021-12-14,12972,15763,-2791,-17.71,1614
2021-12-15,12972,15770,-2798,-17.74,1614
2021-12-16,12972,15773,-2801,-17.76,1614
2021-12-17,12323,15591,-3268,-20.96,1614
2021-12-18,9056,11330,-2274,-20.07,1614
2021-12-19,7620,10286,-2666,-25.92,1614
2021-12-20,13069,15260,-2191,-14.36,1614
2021-12-21,12972,15718,-2746,-17.47,1614
2021-12-22,12972,15693,-2721,-17.34,1614
2021-12-23,12972,15659,-2687,-17.16,1614
2021-12-24,12323,15438,-3115,-20.18,1614
2021-12-25,9056,11135,-2079,-18.67,1614
2021-12-26,7620,10048,-2428,-24.16,1614
2021-12-27,13069,14978,-1909,-12.75,1614
2021-12-28,12972,15394,-2422,-15.73,1614
2021-12-29,12972,15329,-2357,-15.38,1614
2021-12-30,12972,15258,-2286,-14.98,1614
2021-12-31,12323,15003,-2680,-17.86,1614
2022-01-01,8512,10672,-2160,-20.24,1614
2022-01-02,7196,9563,-2367,-24.75,1614
2022-01-03,12159,14478,-2319,-16.02,1614
2022-01-04,12617,14885,-2268,-15.24,1614
2022-01-05,12617,14818,-2201,-14.85,1614
2022-01-06,12617,14754,-2137,-14.48,1614
2022-01-07,12355,14513,-2158,-14.87,1614
2022-01-08,8512,10203,-1691,-16.57,1614
2022-01-09,7196,9122,-1926,-21.11,1614
2022-01-10,12159,14071,-1912,-13.59,1614
2022-01-11,12617,14518,-1901,-13.09,1614
2022-01-12,12617,14496,-1879,-12.96,1614
2022-01-13,12617,14480,-1863,-12.87,1614
2022-01-14,12355,14291,-1936,-13.55,1614
2022-01-15,8512,10034,-1522,-15.17,1614
2022-01-16,7196,9006,-1810,-20.1,1614
2022-01-17,12159,14007,-1848,-13.19,1614
2022-01-18,12617,14505,-1888,-13.02,1614
2022-01-19,12617,14531,-1914,-13.17,1614
2022-01-20,12617,14560,-1943,-13.34,1614
2022-01-21,12355,14410,-2055,-14.26,1614
2022-01-22,8512,10187,-1675,-16.44,1614
2022-01-23,7196,9188,-1992,-21.68,1614
2022-01-24,12159,14212,-2053,-14.45,1614
2022-01-25,12617,14725,-2108,-14.32,1614
2022-01-26,12617,14761,-2144,-14.52,1614
2022-01-27,12617,14792,-2175,-14.7,1614
2022-01-28,12355,14639,-2284,-15.6,1614
2022-01-29,8512,10407,-1895,-18.21,1614
2022-01-30,7196,9394,-2198,-23.4,1614
2020-02-01,11195,10293,902,8.76,1192
2020-02-02,7236,6452,784,12.15,1192
2020-02-03,11361,11026,335,3.04,1192
2020-02-04,11392,11282,110,0.98,1192
2020-02-05,11392,11276,116,1.03,1192
2020-02-06,11392,11275,117,1.04,1192
2020-02-07,12420,12114,306,2.53,1192
2020-02-08,11195,10268,927,9.03,1192
2020-02-09,7236,6416,820,12.78,1192
2020-02-10,11361,10984,377,3.43,1192
2020-02-11,11392,11238,154,1.37,1192
2020-02-12,11392,11235,157,1.4,1192
2020-02-13,11392,11242,150,1.33,1192
2020-02-14,12420,12093,327,2.7,1192
2020-02-15,11195,10264,931,9.07,1192
2020-02-16,7236,6434,802,12.47,1192
2020-02-17,11361,11027,334,3.03,1192
2020-02-18,11392,11308,84,0.74,1192
2020-02-19,11392,11336,56,0.49,1192
2020-02-20,11392,11374,18,0.16,1192
2020-02-21,12420,12258,162,1.32,1192
2020-02-22,11195,10460,735,7.03,1192
2020-02-23,7236,6661,575,8.63,1192
2020-02-24,11361,11283,78,0.69,1192
2020-02-25,11392,11591,-199,-1.72,1192
2020-02-26,11392,11642,-250,-2.15,1192
2020-02-27,11392,11699,-307,-2.62,1192
2020-02-28,12420,12599,-179,-1.42,1192
2020-02-29,11195,10812,383,3.54,1192
2020-03-01,5697,7019,-1322,-18.83,1192
2020-03-02,8776,11642,-2866,-24.62,1192
2020-03-03,9092,11946,-2854,-23.89,1192
2020-03-04,9092,11989,-2897,-24.16,1192
2020-03-05,9092,12033,-2941,-24.44,1192
2020-03-06,10614,12916,-2302,-17.82,1192
2020-03-07,8504,11110,-2606,-23.46,1192
2020-03-08,5697,7294,-1597,-21.89,1192
2020-03-09,8776,11892,-3116,-26.2,1192
2020-03-10,9092,12171,-3079,-25.3,1192
2020-03-11,9092,12187,-3095,-25.4,1192
2020-03-12,9092,12206,-3114,-25.51,1192
2020-03-13,10614,13064,-2450,-18.75,1192
2020-03-14,8504,11235,-2731,-24.31,1192
2020-03-15,5697,7398,-1701,-22.99,1192
2020-03-16,8776,11979,-3203,-26.74,1192
2020-03-17,9092,12243,-3151,-25.74,1192
2020-03-18,9092,12248,-3156,-25.77,1192
2020-03-19,9092,12260,-3168,-25.84,1192
2020-03-20,10614,13116,-2502,-19.08,1192
2020-03-21,8504,11288,-2784,-24.66,1192
2020-03-22,5697,7456,-1759,-23.59,1192
2020-03-23,8776,12046,-3270,-27.15,1192
2020-03-24,9092,12322,-3230,-26.21,1192
2020-03-25,9092,12342,-3250,-26.33,1192
2020-03-26,9092,12372,-3280,-26.51,1192
2020-03-27,10614,13246,-2632,-19.87,1192
2020-03-28,8504,11437,-2933,-25.64,1192
2020-03-29,5697,7626,-1929,-25.3,1192
2020-03-30,8776,12235,-3459,-28.27,1192
2020-03-31,9092,12530,-3438,-27.44,1192
2020-04-01,9081,12568,-3487,-27.75,1192
2020-04-02,9081,12612,-3531,-28.0,1192
2020-04-03,9214,13498,-4284,-31.74,1192
2020-04-04,8464,11699,-3235,-27.65,1192
2020-04-05,5393,7893,-2500,-31.67,1192
2020-04-06,8903,12504,-3601,-28.8,1192
2020-04-07,9081,12797,-3716,-29.04,1192
2020-04-08,9081,12829,-3748,-29.22,1192
2020-04-09,9081,12864,-3783,-29.41,1192
2020-04-10,9214,13737,-4523,-32.93,1192
2020-04-11,8464,11923,-3459,-29.01,1192
2020-04-12,5393,8099,-2706,-33.41,1192
2020-04-13,8903,12689,-3786,-29.84,1192
2020-04-14,9081,12961,-3880,-29.94,1192
2020-04-15,9081,12970,-3889,-29.98,1192
2020-04-16,9081,12982,-3901,-30.05,1192
2020-04-17,9214,13833,-4619,-33.39,1192
2020-04-18,8464,11996,-3532,-29.44,1192
2020-04-19,5393,8152,-2759,-33.84,1192
2020-04-20,8903,12724,-3821,-30.03,1192
2020-04-21,9081,12979,-3898,-30.03,1192
2020-04-22,9081,12976,-3895,-30.02,1192
2020-04-23,9081,12978,-3897,-30.03,1192
2020-04-24,9214,13822,-4608,-33.34,1192
2020-04-25,8464,11982,-3518,-29.36,1192
2020-04-26,5393,8137,-2744,-33.72,1192
2020-04-27,8903,12713,-3810,-29.97,1192
2020-04-28,9081,12974,-3893,-30.01,1192
2020-04-29,9081,12978,-3897,-30.03,1192
2020-04-30,9081,12990,-3909,-30.09,1192
2020-05-01,12594,13847,-1253,-9.05,1192
2020-05-02,11352,12020,-668,-5.56,1192
2020-05-03,7123,8189,-1066,-13.02,1192
2020-05-04,11654,12778,-1124,-8.8,1192
2020-05-05,11867,13053,-1186,-9.09,1192
2020-05-06,11867,13070,-1203,-9.2,1192
2020-05-07,11867,13093,-1226,-9.36,1192
2020-05-08,12594,13957,-1363,-9.77,1192
2020-05-09,11352,12137,-785,-6.47,1192
2020-05-10,7123,8310,-1187,-14.28,1192
2020-05-11,11654,12900,-1246,-9.66,1192
2020-05-12,11867,13172,-1305,-9.91,1192
2020-05-13,11867,13183,-1316,-9.98,1192
2020-05-14,11867,13198,-1331,-10.08,1192
2020-05-15,12594,14052,-1458,-10.38,1192
2020-05-16,11352,12219,-867,-7.1,1192
2020-05-17,7123,8377,-1254,-14.97,1192
2020-05-18,11654,12950,-1296,-10.01,1192
2020-05-19,11867,13205,-1338,-10.13,1192
2020-05-20,11867,13199,-1332,-10.09,1192
2020-05-21,11867,13196,-1329,-10.07,1192
2020-05-22,12594,14033,-1439,-10.25,1192
2020-05-23,11352,12184,-832,-6.83,1192
2020-05-24,7123,8327,-1204,-14.46,1192
2020-05-25,11654,12889,-1235,-9.58,1192
2020-05-26,11867,13135,-1268,-9.65,1192
2020-05-27,11867,13122,-1255,-9.56,1192
2020-05-28,11867,13116,-1249,-9.52,1192
2020-05-29,12594,13953,-1359,-9.74,1192
2020-05-30,11352,12107,-755,-6.24,1192
2020-05-31,7123,8257,-1134,-13.73,1192
2020-06-01,11988,12828,-840,-6.55,1192
2020-06-02,12573,13085,-512,-3.91,1192
2020-06-03,12573,13086,-513,-3.92,1192
2020-06-04,12573,13095,-522,-3.99,1192
2020-06-05,12873,13948,-1075,-7.71,1192
2020-06-06,11328,12119,-791,-6.53,1192
2020-06-07,7635,8285,-650,-7.85,1192
2020-06-08,11988,12871,-883,-6.86,1192
2020-06-09,12573,13142,-569,-4.33,1192
2020-06-10,12573,13155,-582,-4.42,1192
2020-06-11,12573,13173,-600,-4.55,1192
2020-06-12,12873,14031,-1158,-8.25,1192
2020-06-13,11328,12203,-875,-7.17,1192
2020-06-14,7635,8366,-731,-8.74,1192
2020-06-15,11988,12945,-957,-7.39,1192
2020-06-16,12573,13204,-631,-4.78,1192
2020-06-17,12573,13200,-627,-4.75,1192
2020-06-18,12573,13197,-624,-4.73,1192
2020-06-19,12873,14031,-1158,-8.25,1192
2020-06-20,11328,12174,-846,-6.95,1192
2020-06-21,7635,8306,-671,-8.08,1192
2020-06-22,11988,12851,-863,-6.72,1192
2020-06-23,12573,13073,-500,-3.82,1192
2020-06-24,12573,13033,-460,-3.53,1192
2020-06-25,12573,12993,-420,-3.23,1192
2020-06-26,12873,13790,-917,-6.65,1192
2020-06-27,11328,11898,-570,-4.79,1192
2020-06-28,7635,7997,-362,-4.53,1192
2020-06-29,11988,12513,-525,-4.2,1192
2020-06-30,12573,12710,-137,-1.08,1192
2020-07-01,12117,12649,-532,-4.21,1192
2020-07-02,12117,12593,-476,-3.78,1192
2020-07-03,12290,13380,-1090,-8.15,1192
2020-07-04,10375,11484,-1109,-9.66,1192
2020-07-05,7662,7584,78,1.03,1192
2020-07-06,11779,12107,-328,-2.71,1192
2020-07-07,12117,12318,-201,-1.63,1192
2020-07-08,12117,12274,-157,-1.28,1192
2020-07-09,12117,12242,-125,-1.02,1192
2020-07-10,12290,13056,-766,-5.87,1192
2020-07-11,10375,11191,-816,-7.29,1192
2020-07-12,7662,7326,336,4.59,1192
2020-07-13,11779,11885,-106,-0.89,1192
2020-07-14,12117,12133,-16,-0.13,1192
2020-07-15,12117,12126,-9,-0.07,1192
2020-07-16,12117,12130,-13,-0.11,1192
2020-07-17,12290,12979,-689,-5.31,1192
2020-07-18,10375,11146,-771,-6.92,1192
2020-07-19,7662,7310,352,4.82,1192
2020-07-20,11779,11893,-114,-0.96,1192
2020-07-21,12117,12160,-43,-0.35,1192
2020-07-22,12117,12169,-52,-0.43,1192
2020-07-23,12117,12182,-65,-0.53,1192
2020-07-24,12290,13035,-745,-5.72,1192
2020-07-25,10375,11200,-825,-7.37,1192
2020-07-26,7662,7357,305,4.15,1192
2020-07-27,11779,11928,-149,-1.25,1192
2020-07-28,12117,12179,-62,-0.51,1192
2020-07-29,12117,12166,-49,-0.4,1192
2020-07-30,12117,12156,-39,-0.32,1192
2020-07-31,12290,12982,-692,-5.33,1192
2020-08-01,9906,11120,-1214,-10.92,1192
2020-08-02,7207,7248,-41,-0.57,1192
2020-08-03,10976,11791,-815,-6.91,1192
2020-08-04,11133,12014,-881,-7.33,1192
2020-08-05,11133,11978,-845,-7.05,1192
2020-08-06,11133,11945,-812,-6.8,1192
2020-08-07,11596,12754,-1158,-9.08,1192
2020-08-08,9906,10879,-973,-8.94,1192
2020-08-09,7207,6999,208,2.97,1192
2020-08-10,10976,11539,-563,-4.88,1192
2020-08-11,11133,11767,-634,-5.39,1192
2020-08-12,11133,11739,-606,-5.16,1192
2020-08-13,11133,11723,-590,-5.03,1192
2020-08-14,11596,12553,-957,-7.62,1192
2020-08-15,9906,10704,-798,-7.46,1192
2020-08-16,7207,6855,352,5.13,1192
2020-08-17,10976,11432,-456,-3.99,1192
2020-08-18,11133,11699,-566,-4.84,1192
2020-08-19,11133,11714,-581,-4.96,1192
2020-08-20,11133,11741,-608,-5.18,1192
2020-08-21,11596,12616,-1020,-8.08,1192
2020-08-22,9906,10812,-906,-8.38,1192
2020-08-23,7207,7008,199,2.84,1192
2020-08-24,10976,11626,-650,-5.59,1192
2020-08-25,11133,11932,-799,-6.7,1192
2020-08-26,11133,11983,-850,-7.09,1192
2020-08-27,11133,12041,-908,-7.54,1192
2020-08-28,11596,12943,-1347,-10.41,1192
2020-08-29,9906,11159,-1253,-11.23,1192
2020-08-30,7207,7370,-163,-2.21,1192
2020-08-31,10976,11997,-1021,-8.51,1192
2020-09-01,12116,12306,-190,-1.54,1192
2020-09-02,12116,12353,-237,-1.92,1192
2020-09-03,12116,12402,-286,-2.31,1192
2020-09-04,12762,13290,-528,-3.97,1192
2020-09-05,11301,11487,-186,-1.62,1192
2020-09-06,7956,7674,282,3.67,1192
2020-09-07,11768,12274,-506,-4.12,1192
2020-09-08,12116,12553,-437,-3.48,1192
2020-09-09,12116,12569,-453,-3.6,1192
2020-09-10,12116,12586,-470,-3.73,1192
2020-09-11,12762,13440,-678,-5.04,1192
2020-09-12,11301,11604,-303,-2.61,1192
2020-09-13,7956,7760,196,2.53,1192
2020-09-14,11768,12331,-563,-4.57,1192
2020-09-15,12116,12583,-467,-3.71,1192
2020-09-16,12116,12574,-458,-3.64,1192
2020-09-17,12116,12570,-454,-3.61,1192
2020-09-18,12762,13407,-645,-4.81,1192
2020-09-19,11301,11558,-257,-2.22,1192
2020-09-20,7956,7704,252,3.27,1192
2020-09-21,11768,12269,-501,-4.08,1192
2020-09-22,12116,12519,-403,-3.22,1192
2020-09-23,12116,12512,-396,-3.16,1192
2020-09-24,12116,12512,-396,-3.16,1192
2020-09-25,12762,13356,-594,-4.45,1192
2020-09-26,11301,11516,-215,-1.87,1192
2020-09-27,7956,7673,283,3.69,1192
2020-09-28,11768,12249,-481,-3.93,1192
2020-09-29,12116,12510,-394,-3.15,1192
2020-09-30,12116,12515,-399,-3.19,1192
2020-10-01,12155,12525,-370,-2.95,1192
2020-10-02,13162,13378,-216,-1.61,1192
2020-10-03,11396,11546,-150,-1.3,1192
2020-10-04,7642,7708,-66,-0.86,1192
2020-10-05,11683,12288,-605,-4.92,1192
2020-10-06,12155,12550,-395,-3.15,1192
2020-10-07,12155,12553,-398,-3.17,1192
2020-10-08,12155,12560,-405,-3.22,1192
2020-10-09,13162,13408,-246,-1.83,1192
2020-10-10,11396,11568,-172,-1.49,1192
2020-10-11,7642,7721,-79,-1.02,1192
2020-10-12,11683,12290,-607,-4.94,1192
2020-10-13,12155,12542,-387,-3.09,1192
2020-10-14,12155,12533,-378,-3.02,1192
2020-10-15,12155,12529,-374,-2.99,1192
2020-10-16,13162,13366,-204,-1.53,1192
2020-10-17,11396,11516,-120,-1.04,1192
2020-10-18,7642,7661,-19,-0.25,1192
2020-10-19,11683,12225,-542,-4.43,1192
2020-10-20,12155,12472,-317,-2.54,1192
2020-10-21,12155,12462,-307,-2.46,1192
2020-10-22,12155,12459,-304,-2.44,1192
2020-10-23,13162,13300,-138,-1.04,1192
2020-10-24,11396,11457,-61,-0.53,1192
2020-10-25,7642,7611,31,0.41,1192
2020-10-26,11683,12186,-503,-4.13,1192
2020-10-27,12155,12447,-292,-2.35,1192
2020-10-28,12155,12452,-297,-2.39,1192
2020-10-29,12155,12465,-310,-2.49,1192
2020-10-30,13162,13322,-160,-1.2,1192
2020-10-31,11396,11496,-100,-0.87,1192
2020-11-01,6267,7666,-1399,-18.25,1192
2020-11-02,11052,12256,-1204,-9.82,1192
2020-11-03,10148,12531,-2383,-19.02,1192
2020-11-04,10148,12547,-2399,-19.12,1192
2020-11-05,10148,12569,-2421,-19.26,1192
2020-11-06,11206,13432,-2226,-16.57,1192
2020-11-07,9893,11609,-1716,-14.78,1192
2020-11-08,6267,7779,-1512,-19.44,1192
2020-11-09,11052,12365,-1313,-10.62,1192
2020-11-10,10148,12631,-2483,-19.66,1192
2020-11-11,10148,12637,-2489,-19.7,1192
2020-11-12,10148,12644,-2496,-19.74,1192
2020-11-13,11206,13490,-2284,-16.93,1192
2020-11-14,9893,11648,-1755,-15.07,1192
2020-11-15,6267,7796,-1529,-19.61,1192
2020-11-16,11052,12359,-1307,-10.58,1192
2020-11-17,10148,12602,-2454,-19.47,1192
2020-11-18,10148,12583,-2435,-19.35,1192
2020-11-19,10148,12568,-2420,-19.26,1192
2020-11-20,11206,13392,-2186,-16.32,1192
2020-11-21,9893,11530,-1637,-14.2,1192
2020-11-22,6267,7661,-1394,-18.2,1192
2020-11-23,11052,12209,-1157,-9.48,1192
2020-11-24,10148,12442,-2294,-18.44,1192
2020-11-25,10148,12417,-2269,-18.27,1192
2020-11-26,10148,12399,-2251,-18.15,1192
2020-11-27,11206,13224,-2018,-15.26,1192
2020-11-28,9893,11367,-1474,-12.97,1192
2020-11-29,6267,7508,-1241,-16.53,1192
2020-11-30,11052,12070,-1018,-8.43,1192
2020-12-01,10918,12319,-1401,-11.37,1192
2020-12-02,10918,12313,-1395,-11.33,1192
2020-12-03,10918,12316,-1398,-11.35,1192
2020-12-04,12036,13164,-1128,-8.57,1192
2020-12-05,10282,11331,-1049,-9.26,1192
2020-12-06,5993,7494,-1501,-20.03,1192
2020-12-07,11334,12078,-744,-6.16,1192
2020-12-08,10918,12347,-1429,-11.57,1192
2020-12-09,10918,12358,-1440,-11.65,1192
2020-12-10,10918,12376,-1458,-11.78,1192
2020-12-11,12036,13233,-1197,-9.05,1192
2020-12-12,10282,11404,-1122,-9.84,1192
2020-12-13,5993,7567,-1574,-20.8,1192
2020-12-14,11334,12145,-811,-6.68,1192
2020-12-15,10918,12401,-1483,-11.96,1192
2020-12-16,10918,12395,-1477,-11.92,1192
2020-12-17,10918,12388,-1470,-11.87,1192
2020-12-18,12036,13216,-1180,-8.93,1192
2020-12-19,10282,11352,-1070,-9.43,1192
2020-12-20,5993,7476,-1483,-19.84,1192
2020-12-21,11334,12010,-676,-5.63,1192
2020-12-22,10918,12221,-1303,-10.66,1192
2020-12-23,10918,12166,-1248,-10.26,1192
2020-12-24,10918,12110,-1192,-9.84,1192
2020-12-25,12036,12889,-853,-6.62,1192
2020-12-26,10282,10977,-695,-6.33,1192
2020-12-27,5993,7055,-1062,-15.05,1192
2020-12-28,11334,11547,-213,-1.84,1192
2020-12-29,10918,11719,-801,-6.84,1192
2020-12-30,10918,11631,-713,-6.13,1192
2020-12-31,10918,11548,-630,-5.46,1192
2021-01-01,10171,12307,-2136,-17.36,1192
2021-01-02,8344,10382,-2038,-19.63,1192
2021-01-03,5253,6454,-1201,-18.61,1192
2021-01-04,9242,10948,-1706,-15.58,1192
2021-01-05,9577,11130,-1553,-13.95,1192
2021-01-06,9577,11060,-1483,-13.41,1192
2021-01-07,9577,11001,-1424,-12.94,1192
2021-01-08,10171,11792,-1621,-13.75,1192
2021-01-09,8344,9904,-1560,-15.75,1192
2021-01-10,5253,6019,-766,-12.73,1192
2021-01-11,9242,10561,-1319,-12.49,1192
2021-01-12,9577,10794,-1217,-11.27,1192
2021-01-13,9577,10777,-1200,-11.13,1192
2021-01-14,9577,10773,-1196,-11.1,1192
2021-01-15,10171,11618,-1447,-12.45,1192
2021-01-16,8344,9785,-1441,-14.73,1192
2021-01-17,5253,5951,-698,-11.73,1192
2021-01-18,9242,10541,-1299,-12.32,1192
2021-01-19,9577,10819,-1242,-11.48,1192
2021-01-20,9577,10842,-1265,-11.67,1192
2021-01-21,9577,10873,-1296,-11.92,1192
2021-01-22,10171,11746,-1575,-13.41,1192
2021-01-23,8344,9935,-1591,-16.01,1192
2021-01-24,5253,6118,-865,-14.14,1192
2021-01-25,9242,10718,-1476,-13.77,1192
2021-01-26,9577,10999,-1422,-12.93,1192
2021-01-27,9577,11020,-1443,-13.09,1192
2021-01-28,9577,11043,-1466,-13.28,1192
2021-01-29,10171,11904,-1733,-14.56,1192
2021-01-30,8344,10077,-1733,-17.2,1192
2021-01-31,5253,6240,-987,-15.82,1192
2021-02-01,10914,10819,95,0.88,1192
2021-02-02,10910,11078,-168,-1.52,1192
2021-02-03,10910,11075,-165,-1.49,1192
2021-02-04,10910,11076,-166,-1.5,1192
2021-02-05,11709,11917,-208,-1.75,1192
2021-02-06,10044,10071,-27,-0.27,1192
2021-02-07,6096,6219,-123,-1.98,1192
2021-02-08,10914,10785,129,1.2,1192
2021-02-09,10910,11037,-127,-1.15,1192
2021-02-10,10910,11031,-121,-1.1,1192
2021-02-11,10910,11034,-124,-1.12,1192
2021-02-12,11709,11881,-172,-1.45,1192
2021-02-13,10044,10047,-3,-0.03,1192
2021-02-14,6096,6211,-115,-1.85,1192
2021-02-15,10914,10798,116,1.07,1192
2021-02-16,10910,11073,-163,-1.47,1192
2021-02-17,10910,11094,-184,-1.66,1192
2021-02-18,10910,11126,-216,-1.94,1192
2021-02-19,11709,12005,-296,-2.47,1192
2021-02-20,10044,10203,-159,-1.56,1192
2021-02-21,6096,6399,-303,-4.74,1192
2021-02-22,10914,11017,-103,-0.93,1192
2021-02-23,10910,11322,-412,-3.64,1192
2021-02-24,10910,11371,-461,-4.05,1192
2021-02-25,10910,11427,-517,-4.52,1192
2021-02-26,11709,12326,-617,-5.01,1192
2021-02-27,10044,10540,-496,-4.71,1192
2021-02-28,6096,6749,-653,-9.68,1192
2021-03-01,11610,11374,236,2.07,1192
2021-03-02,11798,11681,117,1.0,1192
2021-03-03,11798,11727,71,0.61,1192
2021-03-04,11798,11776,22,0.19,1192
2021-03-05,12391,12664,-273,-2.16,1192
2021-03-06,11170,10862,308,2.84,1192
2021-03-07,6408,7051,-643,-9.12,1192
2021-03-08,11610,11655,-45,-0.39,1192
2021-03-09,11798,11938,-140,-1.17,1192
2021-03-10,11798,11959,-161,-1.35,1192
2021-03-11,11798,11982,-184,-1.54,1192
2021-03-12,12391,12843,-452,-3.52,1192
2021-03-13,11170,11016,154,1.4,1192
2021-03-14,6408,7182,-774,-10.78,1192
2021-03-15,11610,11764,-154,-1.31,1192
2021-03-16,11798,12028,-230,-1.91,1192
2021-03-17,11798,12034,-236,-1.96,1192
2021-03-18,11798,12045,-247,-2.05,1192
2021-03-19,12391,12899,-508,-3.94,1192
2021-03-20,11170,11068,102,0.92,1192
2021-03-21,6408,7234,-826,-11.42,1192
2021-03-22,11610,11820,-210,-1.78,1192
2021-03-23,11798,12093,-295,-2.44,1192
2021-03-24,11798,12110,-312,-2.58,1192
2021-03-25,11798,12135,-337,-2.78,1192
2021-03-26,12391,13005,-614,-4.72,1192
2021-03-27,11170,11193,-23,-0.21,1192
2021-03-28,6408,7379,-971,-13.16,1192
2021-03-29,11610,11985,-375,-3.13,1192
2021-03-30,11798,12278,-480,-3.91,1192
2021-03-31,11798,12313,-515,-4.18,1192
2021-04-01,10716,12356,-1640,-13.27,1192
2021-04-02,11706,13242,-1536,-11.6,1192
2021-04-03,10152,11443,-1291,-11.28,1192
2021-04-04,6953,7638,-685,-8.97,1192
2021-04-05,10816,12251,-1435,-11.71,1192
2021-04-06,10716,12546,-1830,-14.59,1192
2021-04-07,10716,12581,-1865,-14.82,1192
2021-04-08,10716,12619,-1903,-15.08,1192
2021-04-09,11706,13497,-1791,-13.27,1192
2021-04-10,10152,11686,-1534,-13.13,1192
2021-04-11,6953,7866,-913,-11.61,1192
2021-04-12,10816,12461,-1645,-13.2,1192
2021-04-13,10716,12737,-2021,-15.87,1192
2021-04-14,10716,12750,-2034,-15.95,1192
2021-04-15,10716,12766,-2050,-16.06,1192
2021-04-16,11706,13620,-1914,-14.05,1192
2021-04-17,10152,11787,-1635,-13.87,1192
2021-04-18,6953,7945,-992,-12.49,1192
2021-04-19,10816,12519,-1703,-13.6,1192
2021-04-20,10716,12776,-2060,-16.12,1192
2021-04-21,10716,12773,-2057,-16.1,1192
2021-04-22,10716,12775,-2059,-16.12,1192
2021-04-23,11706,13618,-1912,-14.04,1192
2021-04-24,10152,11777,-1625,-13.8,1192
2021-04-25,6953,7931,-978,-12.33,1192
2021-04-26,10816,12505,-1689,-13.51,1192
2021-04-27,10716,12763,-2047,-16.04,1192
2021-04-28,10716,12765,-2049,-16.05,1192
2021-04-29,10716,12775,-2059,-16.12,1192
2021-04-30,11706,13629,-1923,-14.11,1192
2021-05-01,11997,11799,198,1.68,1192
2021-05-02,7301,7966,-665,-8.35,1192
2021-05-03,12492,12553,-61,-0.49,1192
2021-05-04,12915,12826,89,0.69,1192
2021-05-05,12915,12841,74,0.58,1192
2021-05-06,12915,12863,52,0.4,1192
2021-05-07,13737,13728,9,0.07,1192
2021-05-08,11997,11908,89,0.75,1192
2021-05-09,7301,8081,-780,-9.65,1192
2021-05-10,12492,12673,-181,-1.43,1192
2021-05-11,12915,12947,-32,-0.25,1192
2021-05-12,12915,12961,-46,-0.35,1192
2021-05-13,12915,12979,-64,-0.49,1192
2021-05-14,13737,13836,-99,-0.72,1192
2021-05-15,11997,12006,-9,-0.07,1192
2021-05-16,7301,8167,-866,-10.6,1192
2021-05-17,12492,12744,-252,-1.98,1192
2021-05-18,12915,13002,-87,-0.67,1192
2021-05-19,12915,12999,-84,-0.65,1192
2021-05-20,12915,12999,-84,-0.65,1192
2021-05-21,13737,13838,-101,-0.73,1192
2021-05-22,11997,11990,7,0.06,1192
2021-05-23,7301,8136,-835,-10.26,1192
2021-05-24,12492,12698,-206,-1.62,1192
2021-05-25,12915,12944,-29,-0.22,1192
2021-05-26,12915,12930,-15,-0.12,1192
2021-05-27,12915,12923,-8,-0.06,1192
2021-05-28,13737,13759,-22,-0.16,1192
2021-05-29,11997,11910,87,0.73,1192
2021-05-30,7301,8058,-757,-9.39,1192
2021-05-31,12492,12626,-134,-1.06,1192
2021-06-01,13243,12880,363,2.82,1192
2021-06-02,13243,12877,366,2.84,1192
2021-06-03,13243,12883,360,2.79,1192
2021-06-04,13852,13734,118,0.86,1192
2021-06-05,12155,11901,254,2.13,1192
2021-06-06,8610,8066,544,6.74,1192
2021-06-07,12933,12650,283,2.24,1192
2021-06-08,13243,12920,323,2.5,1192
2021-06-09,13243,12932,311,2.4,1192
2021-06-10,13243,12950,293,2.26,1192
2021-06-11,13852,13810,42,0.3,1192
2021-06-12,12155,11983,172,1.44,1192
2021-06-13,8610,8150,460,5.64,1192
2021-06-14,12933,12732,201,1.58,1192
2021-06-15,13243,12996,247,1.9,1192
2021-06-16,13243,12997,246,1.89,1192
2021-06-17,13243,13000,243,1.87,1192
2021-06-18,13852,13840,12,0.09,1192
2021-06-19,12155,11989,166,1.38,1192
2021-06-20,8610,8128,482,5.93,1192
2021-06-21,12933,12680,253,2.0,1192
2021-06-22,13243,12910,333,2.58,1192
2021-06-23,13243,12875,368,2.86,1192
2021-06-24,13243,12841,402,3.13,1192
2021-06-25,13852,13644,208,1.52,1192
2021-06-26,12155,11757,398,3.39,1192
2021-06-27,8610,7861,749,9.53,1192
2021-06-28,12933,12379,554,4.48,1192
2021-06-29,13243,12579,664,5.28,1192
2021-06-30,13243,12518,725,5.79,1192
2021-07-01,12045,12462,-417,-3.35,1192
2021-07-02,12779,13248,-469,-3.54,1192
2021-07-03,11362,11350,12,0.11,1192
2021-07-04,7502,7447,55,0.74,1192
2021-07-05,11894,11966,-72,-0.6,1192
2021-07-06,12045,12171,-126,-1.04,1192
2021-07-07,12045,12122,-77,-0.64,1192
2021-07-08,12045,12083,-38,-0.31,1192
2021-07-09,12779,12891,-112,-0.87,1192
2021-07-10,11362,11019,343,3.11,1192
2021-07-11,7502,7147,355,4.97,1192
2021-07-12,11894,11699,195,1.67,1192
2021-07-13,12045,11940,105,0.88,1192
2021-07-14,12045,11927,118,0.99,1192
2021-07-15,12045,11926,119,1.0,1192
2021-07-16,12779,12770,9,0.07,1192
2021-07-17,11362,10933,429,3.92,1192
2021-07-18,7502,7094,408,5.75,1192
2021-07-19,11894,11675,219,1.88,1192
2021-07-20,12045,11942,103,0.86,1192
2021-07-21,12045,11951,94,0.79,1192
2021-07-22,12045,11965,80,0.67,1192
2021-07-23,12779,12820,-41,-0.32,1192
2021-07-24,11362,10989,373,3.39,1192
2021-07-25,7502,7149,353,4.94,1192
2021-07-26,11894,11725,169,1.44,1192
2021-07-27,12045,11980,65,0.54,1192
2021-07-28,12045,11973,72,0.6,1192
2021-07-29,12045,11968,77,0.64,1192
2021-07-30,12779,12800,-21,-0.16,1192
2021-07-31,11362,10943,419,3.83,1192
2021-08-01,7010,7075,-65,-0.92,1192
2021-08-02,11295,11622,-327,-2.81,1192
2021-08-03,11180,11850,-670,-5.65,1192
2021-08-04,11180,11816,-636,-5.38,1192
2021-08-05,11180,11785,-605,-5.13,1192
2021-08-06,11738,12595,-857,-6.8,1192
2021-08-07,11096,10719,377,3.52,1192
2021-08-08,7010,6837,173,2.53,1192
2021-08-09,11295,11375,-80,-0.7,1192
2021-08-10,11180,11599,-419,-3.61,1192
2021-08-11,11180,11567,-387,-3.35,1192
2021-08-12,11180,11544,-364,-3.15,1192
2021-08-13,11738,12368,-630,-5.09,1192
2021-08-14,11096,10511,585,5.57,1192
2021-08-15,7010,6655,355,5.33,1192
2021-08-16,11295,11223,72,0.64,1192
2021-08-17,11180,11482,-302,-2.63,1192
2021-08-18,11180,11488,-308,-2.68,1192
2021-08-19,11180,11508,-328,-2.85,1192
2021-08-20,11738,12375,-637,-5.15,1192
2021-08-21,11096,10563,533,5.05,1192
2021-08-22,7010,6752,258,3.82,1192
2021-08-23,11295,11365,-70,-0.62,1192
2021-08-24,11180,11666,-486,-4.17,1192
2021-08-25,11180,11713,-533,-4.55,1192
2021-08-26,11180,11768,-588,-5.0,1192
2021-08-27,11738,12668,-930,-7.34,1192
2021-08-28,11096,10884,212,1.95,1192
2021-08-29,7010,7095,-85,-1.2,1192
2021-08-30,11295,11724,-429,-3.66,1192
2021-08-31,11180,12035,-855,-7.1,1192
2021-09-01,12504,12086,418,3.46,1192
2021-09-02,12504,12140,364,3.0,1192
2021-09-03,13291,13032,259,1.99,1192
2021-09-04,11929,11235,694,6.18,1192
2021-09-05,8768,7428,1340,18.04,1192
2021-09-06,12198,12034,164,1.36,1192
2021-09-07,12504,12320,184,1.49,1192
2021-09-08,12504,12341,163,1.32,1192
2021-09-09,12504,12364,140,1.13,1192
2021-09-10,13291,13223,68,0.51,1192
2021-09-11,11929,11393,536,4.7,1192
2021-09-12,8768,7553,1215,16.09,1192
2021-09-13,12198,12128,70,0.58,1192
2021-09-14,12504,12383,121,0.98,1192
2021-09-15,12504,12377,127,1.03,1192
2021-09-16,12504,12374,130,1.05,1192
2021-09-17,13291,13212,79,0.6,1192
2021-09-18,11929,11364,565,4.97,1192
2021-09-19,8768,7510,1258,16.75,1192
2021-09-20,12198,12074,124,1.03,1192
2021-09-21,12504,12323,181,1.47,1192
2021-09-22,12504,12314,190,1.54,1192
2021-09-23,12504,12312,192,1.56,1192
2021-09-24,13291,13154,137,1.04,1192
2021-09-25,11929,11311,618,5.46,1192
2021-09-26,8768,7466,1302,17.44,1192
2021-09-27,12198,12040,158,1.31,1192
2021-09-28,12504,12300,204,1.66,1192
2021-09-29,12504,12302,202,1.64,1192
2021-09-30,12504,12312,192,1.56,1192
2021-10-01,13561,13164,397,3.02,1192
2021-10-02,11857,11331,526,4.64,1192
2021-10-03,8229,7493,736,9.82,1192
2021-10-04,12464,12074,390,3.23,1192
2021-10-05,12397,12338,59,0.48,1192
2021-10-06,12397,12342,55,0.45,1192
2021-10-07,12397,12351,46,0.37,1192
2021-10-08,13561,13200,361,2.73,1192
2021-10-09,11857,11362,495,4.36,1192
2021-10-10,8229,7517,712,9.47,1192
2021-10-11,12464,12089,375,3.1,1192
2021-10-12,12397,12343,54,0.44,1192
2021-10-13,12397,12336,61,0.49,1192
2021-10-14,12397,12334,63,0.51,1192
2021-10-15,13561,13171,390,2.96,1192
2021-10-16,11857,11323,534,4.72,1192
2021-10-17,8229,7468,761,10.19,1192
2021-10-18,12464,12032,432,3.59,1192
2021-10-19,12397,12278,119,0.97,1192
2021-10-20,12397,12267,130,1.06,1192
2021-10-21,12397,12263,134,1.09,1192
2021-10-22,13561,13101,460,3.51,1192
2021-10-23,11857,11256,601,5.34,1192
2021-10-24,8229,7407,822,11.1,1192
2021-10-25,12464,11979,485,4.05,1192
2021-10-26,12397,12237,160,1.31,1192
2021-10-27,12397,12238,159,1.3,1192
2021-10-28,12397,12248,149,1.22,1192
2021-10-29,13561,13103,458,3.5,1192
2021-10-30,11857,11274,583,5.17,1192
2021-10-31,8229,7442,787,10.58,1192
2021-11-01,10866,12030,-1164,-9.68,1192
2021-11-02,11378,12303,-925,-7.52,1192
2021-11-03,11378,12319,-941,-7.64,1192
2021-11-04,11378,12341,-963,-7.8,1192
2021-11-05,12394,13205,-811,-6.14,1192
2021-11-06,10397,11383,-986,-8.66,1192
2021-11-07,6764,7555,-791,-10.47,1192
2021-11-08,10866,12143,-1277,-10.52,1192
2021-11-09,11378,12413,-1035,-8.34,1192
2021-11-10,11378,12422,-1044,-8.4,1192
2021-11-11,11378,12434,-1056,-8.49,1192
2021-11-12,12394,13284,-890,-6.7,1192
2021-11-13,10397,11446,-1049,-9.16,1192
2021-11-14,6764,7598,-834,-10.98,1192
2021-11-15,10866,12166,-1300,-10.69,1192
2021-11-16,11378,12413,-1035,-8.34,1192
2021-11-17,11378,12398,-1020,-8.23,1192
2021-11-18,11378,12386,-1008,-8.14,1192
2021-11-19,12394,13213,-819,-6.2,1192
2021-11-20,10397,11353,-956,-8.42,1192
2021-11-21,6764,7485,-721,-9.63,1192
2021-11-22,10866,12034,-1168,-9.71,1192
2021-11-23,11378,12267,-889,-7.25,1192
2021-11-24,11378,12241,-863,-7.05,1192
2021-11-25,11378,12221,-843,-6.9,1192
2021-11-26,12394,13044,-650,-4.98,1192
2021-11-27,10397,11184,-787,-7.04,1192
2021-11-28,6764,7321,-557,-7.61,1192
2021-11-29,10866,11879,-1013,-8.53,1192
2021-11-30,11378,12123,-745,-6.15,1192
2021-12-01,10470,12113,-1643,-13.56,1192
2021-12-02,10470,12112,-1642,-13.56,1192
2021-12-03,9818,12956,-3138,-24.22,1192
2021-12-04,9306,11119,-1813,-16.31,1192
2021-12-05,5918,7278,-1360,-18.69,1192
2021-12-06,10870,11860,-990,-8.35,1192
2021-12-07,10470,12127,-1657,-13.66,1192
2021-12-08,10470,12137,-1667,-13.73,1192
2021-12-09,10470,12154,-1684,-13.86,1192
2021-12-10,9818,13013,-3195,-24.55,1192
2021-12-11,9306,11186,-1880,-16.81,1192
2021-12-12,5918,7351,-1433,-19.49,1192
2021-12-13,10870,11933,-1063,-8.91,1192
2021-12-14,10470,12195,-1725,-14.15,1192
2021-12-15,10470,12195,-1725,-14.15,1192
2021-12-16,10470,12195,-1725,-14.15,1192
2021-12-17,9818,13031,-3213,-24.66,1192
2021-12-18,9306,11176,-1870,-16.73,1192
2021-12-19,5918,7308,-1390,-19.02,1192
2021-12-20,10870,11852,-982,-8.29,1192
2021-12-21,10470,12072,-1602,-13.27,1192
2021-12-22,10470,12026,-1556,-12.94,1192
2021-12-23,10470,11979,-1509,-12.6,1192
2021-12-24,9818,12766,-2948,-23.09,1192
2021-12-25,9306,10861,-1555,-14.32,1192
2021-12-26,5918,6945,-1027,-14.79,1192
2021-12-27,10870,11443,-573,-5.01,1192
2021-12-28,10470,11619,-1149,-9.89,1192
2021-12-29,10470,11534,-1064,-9.22,1192
2021-12-30,10470,11452,-982,-8.57,1192
2021-12-31,9818,12210,-2392,-19.59,1192
2022-01-01,9088,10284,-1196,-11.63,1192
2022-01-02,5053,6352,-1299,-20.45,1192
2022-01-03,10109,10842,-733,-6.76,1192
2022-01-04,10129,11019,-890,-8.08,1192
2022-01-05,10129,10941,-812,-7.42,1192
2022-01-06,10129,10875,-746,-6.86,1192
2022-01-07,10781,11657,-876,-7.51,1192
2022-01-08,9088,9760,-672,-6.89,1192
2022-01-09,5053,5865,-812,-13.84,1192
2022-01-10,10109,10396,-287,-2.76,1192
2022-01-11,10129,10620,-491,-4.62,1192
2022-01-12,10129,10592,-463,-4.37,1192
2022-01-13,10129,10579,-450,-4.25,1192
2022-01-14,10781,11415,-634,-5.55,1192
2022-01-15,9088,9573,-485,-5.07,1192
2022-01-16,5053,5732,-679,-11.85,1192
2022-01-17,10109,10316,-207,-2.01,1192
2022-01-18,10129,10588,-459,-4.34,1192
2022-01-19,10129,10607,-478,-4.51,1192
2022-01-20,10129,10634,-505,-4.75,1192
2022-01-21,10781,11506,-725,-6.3,1192
2022-01-22,9088,9694,-606,-6.25,1192
2022-01-23,5053,5877,-824,-14.02,1192
2022-01-24,10109,10479,-370,-3.53,1192
2022-01-25,10129,10763,-634,-5.89,1192
2022-01-26,10129,10786,-657,-6.09,1192
2022-01-27,10129,10813,-684,-6.33,1192
2022-01-28,10781,11679,-898,-7.69,1192
2022-01-29,9088,9856,-768,-7.79,1192
2022-01-30,5053,6024,-971,-16.12,1192
2020-02-01,10325,9840,485,4.93,1206
2020-02-02,8049,7582,467,6.16,1206
2020-02-03,10412,10617,-205,-1.93,1206
2020-02-04,10713,10909,-196,-1.8,1206
2020-02-05,10713,10914,-201,-1.84,1206
2020-02-06,10713,10917,-204,-1.87,1206
2020-02-07,11487,11413,74,0.65,1206
2020-02-08,10325,9913,412,4.16,1206
2020-02-09,8049,7642,407,5.33,1206
2020-02-10,10412,10666,-254,-2.38,1206
2020-02-11,10713,10949,-236,-2.16,1206
2020-02-12,10713,10947,-234,-2.14,1206
2020-02-13,10713,10945,-232,-2.12,1206
2020-02-14,11487,11438,49,0.43,1206
2020-02-15,10325,9937,388,3.9,1206
2020-02-16,8049,7667,382,4.98,1206
2020-02-17,10412,10695,-283,-2.65,1206
2020-02-18,10713,10982,-269,-2.45,1206
2020-02-19,10713,10987,-274,-2.49,1206
2020-02-20,10713,10992,-279,-2.54,1206
2020-02-21,11487,11493,-6,-0.05,1206
2020-02-22,10325,10001,324,3.24,1206
2020-02-23,8049,7740,309,3.99,1206
2020-02-24,10412,10776,-364,-3.38,1206
2020-02-25,10713,11071,-358,-3.23,1206
2020-02-26,10713,11082,-369,-3.33,1206
2020-02-27,10713,11092,-379,-3.42,1206
2020-02-28,11487,11596,-109,-0.94,1206
2020-02-29,10325,10106,219,2.17,1206
2020-03-01,5960,7845,-1885,-24.03,1206
2020-03-02,8291,10879,-2588,-23.79,1206
2020-03-03,8361,11170,-2809,-25.15,1206
2020-03-04,8361,11176,-2815,-25.19,1206
2020-03-05,8361,11179,-2818,-25.21,1206
2020-03-06,9286,11676,-2390,-20.47,1206
2020-03-07,7589,10177,-2588,-25.43,1206
2020-03-08,5960,7906,-1946,-24.61,1206
2020-03-09,8291,10930,-2639,-24.14,1206
2020-03-10,8361,11211,-2850,-25.42,1206
2020-03-11,8361,11207,-2846,-25.39,1206
2020-03-12,8361,11202,-2841,-25.36,1206
2020-03-13,9286,11691,-2405,-20.57,1206
2020-03-14,7589,10185,-2596,-25.49,1206
2020-03-15,5960,7909,-1949,-24.64,1206
2020-03-16,8291,10929,-2638,-24.14,1206
2020-03-17,8361,11209,-2848,-25.41,1206
2020-03-18,8361,11206,-2845,-25.39,1206
2020-03-19,8361,11202,-2841,-25.36,1206
2020-03-20,9286,11695,-2409,-20.6,1206
2020-03-21,7589,10196,-2607,-25.57,1206
2020-03-22,5960,7928,-1968,-24.82,1206
2020-03-23,8291,10958,-2667,-24.34,1206
2020-03-24,8361,11248,-2887,-25.67,1206
2020-03-25,8361,11256,-2895,-25.72,1206
2020-03-26,8361,11265,-2904,-25.78,1206
2020-03-27,9286,11771,-2485,-21.11,1206
2020-03-28,7589,10283,-2694,-26.2,1206
2020-03-29,5960,8026,-2066,-25.74,1206
2020-03-30,8291,11067,-2776,-25.08,1206
2020-03-31,8361,11367,-3006,-26.44,1206
2020-04-01,8196,11383,-3187,-28.0,1206
2020-04-02,8196,11397,-3201,-28.09,1206
2020-04-03,8176,11907,-3731,-31.33,1206
2020-04-04,7172,10421,-3249,-31.18,1206
2020-04-05,4899,8165,-3266,-40.0,1206
2020-04-06,8084,11203,-3119,-27.84,1206
2020-04-07,8196,11498,-3302,-28.72,1206
2020-04-08,8196,11508,-3312,-28.78,1206
2020-04-09,8196,11515,-3319,-28.82,1206
2020-04-10,8176,12015,-3839,-31.95,1206
2020-04-11,7172,10519,-3347,-31.82,1206
2020-04-12,4899,8251,-3352,-40.63,1206
2020-04-13,8084,11277,-3193,-28.31,1206
2020-04-14,8196,11560,-3364,-29.1,1206
2020-04-15,8196,11558,-3362,-29.09,1206
2020-04-16,8196,11554,-3358,-29.06,1206
2020-04-17,8176,12045,-3869,-32.12,1206
2020-04-18,7172,10540,-3368,-31.95,1206
2020-04-19,4899,8265,-3366,-40.73,1206
2020-04-20,8084,11287,-3203,-28.38,1206
2020-04-21,8196,11567,-3371,-29.14,1206
2020-04-22,8196,11565,-3369,-29.13,1206
2020-04-23,8196,11562,-3366,-29.11,1206
2020-04-24,8176,12057,-3881,-32.19,1206
2020-04-25,7172,10558,-3386,-32.07,1206
2020-04-26,4899,8291,-3392,-40.91,1206
2020-04-27,8084,11322,-3238,-28.6,1206
2020-04-28,8196,11613,-3417,-29.42,1206
2020-04-29,8196,11622,-3426,-29.48,1206
2020-04-30,8196,11632,-3436,-29.54,1206
2020-05-01,10980,12139,-1159,-9.55,1206
2020-05-02,9670,10652,-982,-9.22,1206
2020-05-03,6902,8397,-1495,-17.8,1206
2020-05-04,10344,11438,-1094,-9.56,1206
2020-05-05,10404,11738,-1334,-11.36,1206
2020-05-06,10404,11755,-1351,-11.49,1206
2020-05-07,10404,11770,-1366,-11.61,1206
2020-05-08,10980,12279,-1299,-10.58,1206
2020-05-09,9670,10792,-1122,-10.4,1206
2020-05-10,6902,8534,-1632,-19.12,1206
2020-05-11,10344,11570,-1226,-10.6,1206
2020-05-12,10404,11862,-1458,-12.29,1206
2020-05-13,10404,11868,-1464,-12.34,1206
2020-05-14,10404,11869,-1465,-12.34,1206
2020-05-15,10980,12363,-1383,-11.19,1206
2020-05-16,9670,10860,-1190,-10.96,1206
2020-05-17,6902,8584,-1682,-19.59,1206
2020-05-18,10344,11601,-1257,-10.84,1206
2020-05-19,10404,11874,-1470,-12.38,1206
2020-05-20,10404,11860,-1456,-12.28,1206
2020-05-21,10404,11843,-1439,-12.15,1206
2020-05-22,10980,12320,-1340,-10.88,1206
2020-05-23,9670,10800,-1130,-10.46,1206
2020-05-24,6902,8509,-1607,-18.89,1206
2020-05-25,10344,11514,-1170,-10.16,1206
2020-05-26,10404,11778,-1374,-11.67,1206
2020-05-27,10404,11758,-1354,-11.52,1206
2020-05-28,10404,11737,-1333,-11.36,1206
2020-05-29,10980,12212,-1232,-10.09,1206
2020-05-30,9670,10695,-1025,-9.58,1206
2020-05-31,6902,8409,-1507,-17.92,1206
2020-06-01,10848,11421,-573,-5.02,1206
2020-06-02,11152,11694,-542,-4.63,1206
2020-06-03,11152,11686,-534,-4.57,1206
2020-06-04,11152,11678,-526,-4.5,1206
2020-06-05,11352,12168,-816,-6.71,1206
2020-06-06,9861,10665,-804,-7.54,1206
2020-06-07,7490,8393,-903,-10.76,1206
2020-06-08,10848,11420,-572,-5.01,1206
2020-06-09,11152,11706,-554,-4.73,1206
2020-06-10,11152,11709,-557,-4.76,1206
2020-06-11,11152,11711,-559,-4.77,1206
2020-06-12,11352,12209,-857,-7.02,1206
2020-06-13,9861,10711,-850,-7.94,1206
2020-06-14,7490,8442,-952,-11.28,1206
2020-06-15,10848,11467,-619,-5.4,1206
2020-06-16,11152,11750,-598,-5.09,1206
2020-06-17,11152,11746,-594,-5.06,1206
2020-06-18,11152,11738,-586,-4.99,1206
2020-06-19,11352,12223,-871,-7.13,1206
2020-06-20,9861,10710,-849,-7.93,1206
2020-06-21,7490,8425,-935,-11.1,1206
2020-06-22,10848,11432,-584,-5.11,1206
2020-06-23,11152,11695,-543,-4.64,1206
2020-06-24,11152,11671,-519,-4.45,1206
2020-06-25,11152,11644,-492,-4.23,1206
2020-06-26,11352,12109,-757,-6.25,1206
2020-06-27,9861,10578,-717,-6.78,1206
2020-06-28,7490,8276,-786,-9.5,1206
2020-06-29,10848,11269,-421,-3.74,1206
2020-06-30,11152,11520,-368,-3.19,1206
2020-07-01,10474,11487,-1013,-8.82,1206
2020-07-02,10474,11454,-980,-8.56,1206
2020-07-03,10873,11917,-1044,-8.76,1206
2020-07-04,9130,10387,-1257,-12.1,1206
2020-07-05,7038,8089,-1051,-12.99,1206
2020-07-06,10235,11089,-854,-7.7,1206
2020-07-07,10474,11350,-876,-7.72,1206
2020-07-08,10474,11330,-856,-7.56,1206
2020-07-09,10474,11312,-838,-7.41,1206
2020-07-10,10873,11792,-919,-7.79,1206
2020-07-11,9130,10280,-1150,-11.19,1206
2020-07-12,7038,8000,-962,-12.02,1206
2020-07-13,10235,11018,-783,-7.11,1206
2020-07-14,10474,11297,-823,-7.29,1206
2020-07-15,10474,11294,-820,-7.26,1206
2020-07-16,10474,11290,-816,-7.23,1206
2020-07-17,10873,11781,-908,-7.71,1206
2020-07-18,9130,10277,-1147,-11.16,1206
2020-07-19,7038,8002,-964,-12.05,1206
2020-07-20,10235,11022,-787,-7.14,1206
2020-07-21,10474,11298,-824,-7.29,1206
2020-07-22,10474,11288,-814,-7.21,1206
2020-07-23,10474,11273,-799,-7.09,1206
2020-07-24,10873,11750,-877,-7.46,1206
2020-07-25,9130,10228,-1098,-10.74,1206
2020-07-26,7038,7931,-893,-11.26,1206
2020-07-27,10235,10927,-692,-6.33,1206
2020-07-28,10474,11177,-703,-6.29,1206
2020-07-29,10474,11138,-664,-5.96,1206
2020-07-30,10474,11095,-621,-5.6,1206
2020-07-31,10873,11543,-670,-5.8,1206
2020-08-01,8958,9993,-1035,-10.36,1206
2020-08-02,7172,7671,-499,-6.51,1206
2020-08-03,10377,10643,-266,-2.5,1206
2020-08-04,10371,10873,-502,-4.62,1206
2020-08-05,10371,10818,-447,-4.13,1206
2020-08-06,10371,10763,-392,-3.64,1206
2020-08-07,10647,11205,-558,-4.98,1206
2020-08-08,8958,9655,-697,-7.22,1206
2020-08-09,7172,7338,-166,-2.26,1206
2020-08-10,10377,10321,56,0.54,1206
2020-08-11,10371,10569,-198,-1.87,1206
2020-08-12,10371,10538,-167,-1.58,1206
2020-08-13,10371,10512,-141,-1.34,1206
2020-08-14,10647,10988,-341,-3.1,1206
2020-08-15,8958,9477,-519,-5.48,1206
2020-08-16,7172,7204,-32,-0.44,1206
2020-08-17,10377,10234,143,1.4,1206
2020-08-18,10371,10531,-160,-1.52,1206
2020-08-19,10371,10551,-180,-1.71,1206
2020-08-20,10371,10577,-206,-1.95,1206
2020-08-21,10647,11105,-458,-4.12,1206
2020-08-22,8958,9645,-687,-7.12,1206
2020-08-23,7172,7420,-248,-3.34,1206
2020-08-24,10377,10495,-118,-1.12,1206
2020-08-25,10371,10833,-462,-4.26,1206
2020-08-26,10371,10890,-519,-4.77,1206
2020-08-27,10371,10948,-577,-5.27,1206
2020-08-28,10647,11502,-855,-7.43,1206
2020-08-29,8958,10061,-1103,-10.96,1206
2020-08-30,7172,7849,-677,-8.63,1206
2020-08-31,10377,10932,-555,-5.08,1206
2020-09-01,11340,11271,69,0.61,1206
2020-09-02,11340,11323,17,0.15,1206
2020-09-03,11340,11370,-30,-0.26,1206
2020-09-04,11814,11907,-93,-0.78,1206
2020-09-05,10100,10446,-346,-3.31,1206
2020-09-06,8056,8209,-153,-1.86,1206
2020-09-07,11018,11264,-246,-2.18,1206
2020-09-08,11340,11572,-232,-2.0,1206
2020-09-09,11340,11592,-252,-2.17,1206
2020-09-10,11340,11605,-265,-2.28,1206
2020-09-11,11814,12110,-296,-2.44,1206
2020-09-12,10100,10616,-516,-4.86,1206
2020-09-13,8056,8349,-293,-3.51,1206
2020-09-14,11018,11375,-357,-3.14,1206
2020-09-15,11340,11657,-317,-2.72,1206
2020-09-16,11340,11654,-314,-2.69,1206
2020-09-17,11340,11649,-309,-2.65,1206
2020-09-18,11814,12139,-325,-2.68,1206
2020-09-19,10100,10634,-534,-5.02,1206
2020-09-20,8056,8361,-305,-3.65,1206
2020-09-21,11018,11384,-366,-3.22,1206
2020-09-22,11340,11668,-328,-2.81,1206
2020-09-23,11340,11670,-330,-2.83,1206
2020-09-24,11340,11673,-333,-2.85,1206
2020-09-25,11814,12173,-359,-2.95,1206
2020-09-26,10100,10681,-581,-5.44,1206
2020-09-27,8056,8421,-365,-4.33,1206
2020-09-28,11018,11460,-442,-3.86,1206
2020-09-29,11340,11759,-419,-3.56,1206
2020-09-30,11340,11776,-436,-3.7,1206
2020-10-01,9656,11792,-2136,-18.11,1206
2020-10-02,10383,12305,-1922,-15.62,1206
2020-10-03,9045,10823,-1778,-16.43,1206
2020-10-04,6754,8572,-1818,-21.21,1206
2020-10-05,10161,11616,-1455,-12.53,1206
2020-10-06,9656,11917,-2261,-18.97,1206
2020-10-07,9656,11934,-2278,-19.09,1206
2020-10-08,9656,11947,-2291,-19.18,1206
2020-10-09,10383,12454,-2071,-16.63,1206
2020-10-10,9045,10963,-1918,-17.5,1206
2020-10-11,6754,8700,-1946,-22.37,1206
2020-10-12,10161,11730,-1569,-13.38,1206
2020-10-13,9656,12017,-2361,-19.65,1206
2020-10-14,9656,12016,-2360,-19.64,1206
2020-10-15,9656,12012,-2356,-19.61,1206
2020-10-16,10383,12501,-2118,-16.94,1206
2020-10-17,9045,10993,-1948,-17.72,1206
2020-10-18,6754,8713,-1959,-22.48,1206
2020-10-19,10161,11728,-1567,-13.36,1206
2020-10-20,9656,12001,-2345,-19.54,1206
2020-10-21,9656,11988,-2332,-19.45,1206
2020-10-22,9656,11975,-2319,-19.37,1206
2020-10-23,10383,12456,-2073,-16.64,1206
2020-10-24,9045,10944,-1899,-17.35,1206
2020-10-25,6754,8663,-1909,-22.04,1206
2020-10-26,10161,11678,-1517,-12.99,1206
2020-10-27,9656,11954,-2298,-19.22,1206
2020-10-28,9656,11948,-2292,-19.18,1206
2020-10-29,9656,11943,-2287,-19.15,1206
2020-10-30,10383,12434,-2051,-16.5,1206
2020-10-31,9045,10933,-1888,-17.27,1206
2020-11-01,5829,8664,-2835,-32.72,1206
2020-11-02,9433,11692,-2259,-19.32,1206
2020-11-03,8415,11980,-3565,-29.76,1206
2020-11-04,8415,11986,-3571,-29.79,1206
2020-11-05,8415,11992,-3577,-29.83,1206
2020-11-06,9328,12493,-3165,-25.33,1206
2020-11-07,7911,10999,-3088,-28.08,1206
2020-11-08,5829,8735,-2906,-33.27,1206
2020-11-09,9433,11767,-2334,-19.84,1206
2020-11-10,8415,12056,-3641,-30.2,1206
2020-11-11,8415,12060,-3645,-30.22,1206
2020-11-12,8415,12061,-3646,-30.23,1206
2020-11-13,9328,12555,-3227,-25.7,1206
2020-11-14,7911,11052,-3141,-28.42,1206
2020-11-15,5829,8777,-2948,-33.59,1206
2020-11-16,9433,11795,-2362,-20.03,1206
2020-11-17,8415,12069,-3654,-30.28,1206
2020-11-18,8415,12057,-3642,-30.21,1206
2020-11-19,8415,12041,-3626,-30.11,1206
2020-11-20,9328,12519,-3191,-25.49,1206
2020-11-21,7911,11000,-3089,-28.08,1206
2020-11-22,5829,8709,-2880,-33.07,1206
2020-11-23,9433,11714,-2281,-19.47,1206
2020-11-24,8415,11976,-3561,-29.73,1206
2020-11-25,8415,11954,-3539,-29.61,1206
2020-11-26,8415,11931,-3516,-29.47,1206
2020-11-27,9328,12403,-3075,-24.79,1206
2020-11-28,7911,10882,-2971,-27.3,1206
2020-11-29,5829,8592,-2763,-32.16,1206
2020-11-30,9433,11600,-2167,-18.68,1206
2020-12-01,10305,11869,-1564,-13.18,1206
2020-12-02,10305,11855,-1550,-13.07,1206
2020-12-03,10305,11843,-1538,-12.99,1206
2020-12-04,11531,12328,-797,-6.46,1206
2020-12-05,9607,10820,-1213,-11.21,1206
2020-12-06,6627,8545,-1918,-22.45,1206
2020-12-07,10491,11567,-1076,-9.3,1206
2020-12-08,10305,11850,-1545,-13.04,1206
2020-12-09,10305,11850,-1545,-13.04,1206
2020-12-10,10305,11849,-1544,-13.03,1206
2020-12-11,11531,12343,-812,-6.58,1206
2020-12-12,9607,10843,-1236,-11.4,1206
2020-12-13,6627,8572,-1945,-22.69,1206
2020-12-14,10491,11595,-1104,-9.52,1206
2020-12-15,10305,11875,-1570,-13.22,1206
2020-12-16,10305,11868,-1563,-13.17,1206
2020-12-17,10305,11858,-1553,-13.1,1206
2020-12-18,11531,12338,-807,-6.54,1206
2020-12-19,9607,10820,-1213,-11.21,1206
2020-12-20,6627,8528,-1901,-22.29,1206
2020-12-21,10491,11527,-1036,-8.99,1206
2020-12-22,10305,11780,-1475,-12.52,1206
2020-12-23,10305,11745,-1440,-12.26,1206
2020-12-24,10305,11704,-1399,-11.95,1206
2020-12-25,11531,12154,-623,-5.13,1206
2020-12-26,9607,10605,-998,-9.41,1206
2020-12-27,6627,8282,-1655,-19.98,1206
2020-12-28,10491,11252,-761,-6.76,1206
2020-12-29,10305,11479,-1174,-10.23,1206
2020-12-30,10305,11419,-1114,-9.76,1206
2020-12-31,10305,11357,-1052,-9.26,1206
2021-01-01,9456,11790,-2334,-19.8,1206
2021-01-02,7606,10228,-2622,-25.64,1206
2021-01-03,5755,7897,-2142,-27.12,1206
2021-01-04,8741,10864,-2123,-19.54,1206
2021-01-05,8986,11093,-2107,-18.99,1206
2021-01-06,8986,11040,-2054,-18.61,1206
2021-01-07,8986,10991,-2005,-18.24,1206
2021-01-08,9456,11440,-1984,-17.34,1206
2021-01-09,7606,9900,-2294,-23.17,1206
2021-01-10,5755,7595,-1840,-24.23,1206
2021-01-11,8741,10592,-1851,-17.48,1206
2021-01-12,8986,10853,-1867,-17.2,1206
2021-01-13,8986,10835,-1849,-17.07,1206
2021-01-14,8986,10822,-1836,-16.97,1206
2021-01-15,9456,11310,-1854,-16.39,1206
2021-01-16,7606,9808,-2202,-22.45,1206
2021-01-17,5755,7541,-1786,-23.68,1206
2021-01-18,8741,10574,-1833,-17.33,1206
2021-01-19,8986,10870,-1884,-17.33,1206
2021-01-20,8986,10885,-1899,-17.45,1206
2021-01-21,8986,10901,-1915,-17.57,1206
2021-01-22,9456,11415,-1959,-17.16,1206
2021-01-23,7606,9936,-2330,-23.45,1206
2021-01-24,5755,7687,-1932,-25.13,1206
2021-01-25,8741,10735,-1994,-18.57,1206
2021-01-26,8986,11041,-2055,-18.61,1206
2021-01-27,8986,11063,-2077,-18.77,1206
2021-01-28,8986,11082,-2096,-18.91,1206
2021-01-29,9456,11594,-2138,-18.44,1206
2021-01-30,7606,10111,-2505,-24.77,1206
2021-01-31,5755,7855,-2100,-26.73,1206
2021-02-01,9869,10893,-1024,-9.4,1206
2021-02-02,9906,11187,-1281,-11.45,1206
2021-02-03,9906,11195,-1289,-11.51,1206
2021-02-04,9906,11200,-1294,-11.55,1206
2021-02-05,10553,11698,-1145,-9.79,1206
2021-02-06,9054,10200,-1146,-11.24,1206
2021-02-07,6750,7930,-1180,-14.88,1206
2021-02-08,9869,10956,-1087,-9.92,1206
2021-02-09,9906,11239,-1333,-11.86,1206
2021-02-10,9906,11237,-1331,-11.84,1206
2021-02-11,9906,11235,-1329,-11.83,1206
2021-02-12,10553,11727,-1174,-10.01,1206
2021-02-13,9054,10225,-1171,-11.45,1206
2021-02-14,6750,7955,-1205,-15.15,1206
2021-02-15,9869,10981,-1112,-10.13,1206
2021-02-16,9906,11267,-1361,-12.08,1206
2021-02-17,9906,11270,-1364,-12.1,1206
2021-02-18,9906,11273,-1367,-12.13,1206
2021-02-19,10553,11773,-1220,-10.36,1206
2021-02-20,9054,10279,-1225,-11.92,1206
2021-02-21,6750,8017,-1267,-15.8,1206
2021-02-22,9869,11051,-1182,-10.7,1206
2021-02-23,9906,11346,-1440,-12.69,1206
2021-02-24,9906,11356,-1450,-12.77,1206
2021-02-25,9906,11366,-1460,-12.85,1206
2021-02-26,10553,11871,-1318,-11.1,1206
2021-02-27,9054,10381,-1327,-12.78,1206
2021-02-28,6750,8121,-1371,-16.88,1206
2021-03-01,10028,11156,-1128,-10.11,1206
2021-03-02,10358,11449,-1091,-9.53,1206
2021-03-03,10358,11457,-1099,-9.59,1206
2021-03-04,10358,11462,-1104,-9.63,1206
2021-03-05,10938,11961,-1023,-8.55,1206
2021-03-06,9435,10463,-1028,-9.83,1206
2021-03-07,6809,8194,-1385,-16.9,1206
2021-03-08,10028,11220,-1192,-10.62,1206
2021-03-09,10358,11503,-1145,-9.95,1206
2021-03-10,10358,11500,-1142,-9.93,1206
2021-03-11,10358,11496,-1138,-9.9,1206
2021-03-12,10938,11985,-1047,-8.74,1206
2021-03-13,9435,10480,-1045,-9.97,1206
2021-03-14,6809,8204,-1395,-17.0,1206
2021-03-15,10028,11224,-1196,-10.66,1206
2021-03-16,10358,11503,-1145,-9.95,1206
2021-03-17,10358,11498,-1140,-9.91,1206
2021-03-18,10358,11494,-1136,-9.88,1206
2021-03-19,10938,11985,-1047,-8.74,1206
2021-03-20,9435,10483,-1048,-10.0,1206
2021-03-21,6809,8213,-1404,-17.09,1206
2021-03-22,10028,11241,-1213,-10.79,1206
2021-03-23,10358,11529,-1171,-10.16,1206
2021-03-24,10358,11535,-1177,-10.2,1206
2021-03-25,10358,11541,-1183,-10.25,1206
2021-03-26,10938,12045,-1107,-9.19,1206
2021-03-27,9435,10555,-1120,-10.61,1206
2021-03-28,6809,8297,-1488,-17.93,1206
2021-03-29,10028,11336,-1308,-11.54,1206
2021-03-30,10358,11635,-1277,-10.98,1206
2021-03-31,10358,11651,-1293,-11.1,1206
2021-04-01,9605,11666,-2061,-17.67,1206
2021-04-02,10113,12176,-2063,-16.94,1206
2021-04-03,8395,10691,-2296,-21.48,1206
2021-04-04,6548,8435,-1887,-22.37,1206
2021-04-05,9528,11475,-1947,-16.97,1206
2021-04-06,9605,11772,-2167,-18.41,1206
2021-04-07,9605,11784,-2179,-18.49,1206
2021-04-08,9605,11793,-2188,-18.55,1206
2021-04-09,10113,12295,-2182,-17.75,1206
2021-04-10,8395,10801,-2406,-22.28,1206
2021-04-11,6548,8535,-1987,-23.28,1206
2021-04-12,9528,11564,-2036,-17.61,1206
2021-04-13,9605,11849,-2244,-18.94,1206
2021-04-14,9605,11849,-2244,-18.94,1206
2021-04-15,9605,11846,-2241,-18.92,1206
2021-04-16,10113,12337,-2224,-18.03,1206
2021-04-17,8395,10833,-2438,-22.51,1206
2021-04-18,6548,8559,-2011,-23.5,1206
2021-04-19,9528,11580,-2052,-17.72,1206
2021-04-20,9605,11860,-2255,-19.01,1206
2021-04-21,9605,11856,-2251,-18.99,1206
2021-04-22,9605,11853,-2248,-18.97,1206
2021-04-23,10113,12345,-2232,-18.08,1206
2021-04-24,8395,10844,-2449,-22.58,1206
2021-04-25,6548,8575,-2027,-23.64,1206
2021-04-26,9528,11603,-2075,-17.88,1206
2021-04-27,9605,11892,-2287,-19.23,1206
2021-04-28,9605,11899,-2294,-19.28,1206
2021-04-29,9605,11907,-2302,-19.33,1206
2021-04-30,10113,12411,-2298,-18.52,1206
2021-05-01,9826,10923,-1097,-10.04,1206
2021-05-02,7440,8666,-1226,-14.15,1206
2021-05-03,10808,11707,-899,-7.68,1206
2021-05-04,10981,12006,-1025,-8.54,1206
2021-05-05,10981,12023,-1042,-8.67,1206
2021-05-06,10981,12038,-1057,-8.78,1206
2021-05-07,11476,12548,-1072,-8.54,1206
2021-05-08,9826,11063,-1237,-11.18,1206
2021-05-09,7440,8806,-1366,-15.51,1206
2021-05-10,10808,11845,-1037,-8.75,1206
2021-05-11,10981,12140,-1159,-9.55,1206
2021-05-12,10981,12148,-1167,-9.61,1206
2021-05-13,10981,12154,-1173,-9.65,1206
2021-05-14,11476,12651,-1175,-9.29,1206
2021-05-15,9826,11151,-1325,-11.88,1206
2021-05-16,7440,8879,-1439,-16.21,1206
2021-05-17,10808,11899,-1091,-9.17,1206
2021-05-18,10981,12175,-1194,-9.81,1206
2021-05-19,10981,12165,-1184,-9.73,1206
2021-05-20,10981,12151,-1170,-9.63,1206
2021-05-21,11476,12630,-1154,-9.14,1206
2021-05-22,9826,11112,-1286,-11.57,1206
2021-05-23,7440,8823,-1383,-15.67,1206
2021-05-24,10808,11828,-1020,-8.62,1206
2021-05-25,10981,12092,-1111,-9.19,1206
2021-05-26,10981,12071,-1090,-9.03,1206
2021-05-27,10981,12050,-1069,-8.87,1206
2021-05-28,11476,12524,-1048,-8.37,1206
2021-05-29,9826,11005,-1179,-10.71,1206
2021-05-30,7440,8717,-1277,-14.65,1206
2021-05-31,10808,11726,-918,-7.83,1206
2021-06-01,11333,11997,-664,-5.53,1206
2021-06-02,11333,11985,-652,-5.44,1206
2021-06-03,11333,11975,-642,-5.36,1206
2021-06-04,11432,12462,-1030,-8.27,1206
2021-06-05,9804,10956,-1152,-10.51,1206
2021-06-06,8056,8683,-627,-7.22,1206
2021-06-07,11120,11707,-587,-5.01,1206
2021-06-08,11333,11992,-659,-5.5,1206
2021-06-09,11333,11994,-661,-5.51,1206
2021-06-10,11333,11996,-663,-5.53,1206
2021-06-11,11432,12493,-1061,-8.49,1206
2021-06-12,9804,10996,-1192,-10.84,1206
2021-06-13,8056,8728,-672,-7.7,1206
2021-06-14,11120,11755,-635,-5.4,1206
2021-06-15,11333,12040,-707,-5.87,1206
2021-06-16,11333,12039,-706,-5.86,1206
2021-06-17,11333,12034,-701,-5.83,1206
2021-06-18,11432,12523,-1091,-8.71,1206
2021-06-19,9804,11013,-1209,-10.98,1206
2021-06-20,8056,8731,-675,-7.73,1206
2021-06-21,11120,11743,-623,-5.31,1206
2021-06-22,11333,12009,-676,-5.63,1206
2021-06-23,11333,11989,-656,-5.47,1206
2021-06-24,11333,11965,-632,-5.28,1206
2021-06-25,11432,12433,-1001,-8.05,1206
2021-06-26,9804,10904,-1100,-10.09,1206
2021-06-27,8056,8604,-548,-6.37,1206
2021-06-28,11120,11598,-478,-4.12,1206
2021-06-29,11333,11849,-516,-4.35,1206
2021-06-30,11333,11817,-484,-4.1,1206
2021-07-01,10566,11783,-1217,-10.33,1206
2021-07-02,11092,12244,-1152,-9.41,1206
2021-07-03,9134,10712,-1578,-14.73,1206
2021-07-04,7358,8412,-1054,-12.53,1206
2021-07-05,10461,11409,-948,-8.31,1206
2021-07-06,10566,11667,-1101,-9.44,1206
2021-07-07,10566,11644,-1078,-9.26,1206
2021-07-08,10566,11622,-1056,-9.09,1206
2021-07-09,11092,12098,-1006,-8.32,1206
2021-07-10,9134,10583,-1449,-13.69,1206
2021-07-11,7358,8300,-942,-11.35,1206
2021-07-12,10461,11316,-855,-7.56,1206
2021-07-13,10566,11592,-1026,-8.85,1206
2021-07-14,10566,11587,-1021,-8.81,1206
2021-07-15,10566,11582,-1016,-8.77,1206
2021-07-16,11092,12072,-980,-8.12,1206
2021-07-17,9134,10569,-1435,-13.58,1206
2021-07-18,7358,8296,-938,-11.31,1206
2021-07-19,10461,11317,-856,-7.56,1206
2021-07-20,10566,11596,-1030,-8.88,1206
2021-07-21,10566,11589,-1023,-8.83,1206
2021-07-22,10566,11578,-1012,-8.74,1206
2021-07-23,11092,12059,-967,-8.02,1206
2021-07-24,9134,10542,-1408,-13.36,1206
2021-07-25,7358,8251,-893,-10.82,1206
2021-07-26,10461,11252,-791,-7.03,1206
2021-07-27,10566,11507,-941,-8.18,1206
2021-07-28,10566,11474,-908,-7.91,1206
2021-07-29,10566,11435,-869,-7.6,1206
2021-07-30,11092,11888,-796,-6.7,1206
2021-07-31,9134,10342,-1208,-11.68,1206
2021-08-01,7112,8023,-911,-11.35,1206
2021-08-02,10058,10998,-940,-8.55,1206
2021-08-03,10069,11229,-1160,-10.33,1206
2021-08-04,10069,11175,-1106,-9.9,1206
2021-08-05,10069,11119,-1050,-9.44,1206
2021-08-06,10401,11559,-1158,-10.02,1206
2021-08-07,8756,10005,-1249,-12.48,1206
2021-08-08,7112,7684,-572,-7.44,1206
2021-08-09,10058,10663,-605,-5.67,1206
2021-08-10,10069,10904,-835,-7.66,1206
2021-08-11,10069,10866,-797,-7.33,1206
2021-08-12,10069,10832,-763,-7.04,1206
2021-08-13,10401,11300,-899,-7.96,1206
2021-08-14,8756,9780,-1024,-10.47,1206
2021-08-15,7112,7497,-385,-5.14,1206
2021-08-16,10058,10518,-460,-4.37,1206
2021-08-17,10069,10805,-736,-6.81,1206
2021-08-18,10069,10816,-747,-6.91,1206
2021-08-19,10069,10833,-764,-7.05,1206
2021-08-20,10401,11352,-951,-8.38,1206
2021-08-21,8756,9884,-1128,-11.41,1206
2021-08-22,7112,7652,-540,-7.06,1206
2021-08-23,10058,10721,-663,-6.18,1206
2021-08-24,10069,11055,-986,-8.92,1206
2021-08-25,10069,11108,-1039,-9.35,1206
2021-08-26,10069,11163,-1094,-9.8,1206
2021-08-27,10401,11715,-1314,-11.22,1206
2021-08-28,8756,10274,-1518,-14.78,1206
2021-08-29,7112,8064,-952,-11.81,1206
2021-08-30,10058,11148,-1090,-9.78,1206
2021-08-31,10069,11490,-1421,-12.37,1206
2021-09-01,11055,11546,-491,-4.25,1206
2021-09-02,11055,11597,-542,-4.67,1206
2021-09-03,11399,12140,-741,-6.1,1206
2021-09-04,9916,10684,-768,-7.19,1206
2021-09-05,8245,8454,-209,-2.47,1206
2021-09-06,10806,11515,-709,-6.16,1206
2021-09-07,11055,11829,-774,-6.54,1206
2021-09-08,11055,11855,-800,-6.75,1206
2021-09-09,11055,11874,-819,-6.9,1206
2021-09-10,11399,12384,-985,-7.95,1206
2021-09-11,9916,10895,-979,-8.99,1206
2021-09-12,8245,8632,-387,-4.48,1206
2021-09-13,10806,11662,-856,-7.34,1206
2021-09-14,11055,11947,-892,-7.47,1206
2021-09-15,11055,11946,-891,-7.46,1206
2021-09-16,11055,11942,-887,-7.43,1206
2021-09-17,11399,12433,-1034,-8.32,1206
2021-09-18,9916,10928,-1012,-9.26,1206
2021-09-19,8245,8653,-408,-4.72,1206
2021-09-20,10806,11675,-869,-7.44,1206
2021-09-21,11055,11957,-902,-7.54,1206
2021-09-22,11055,11956,-901,-7.54,1206
2021-09-23,11055,11956,-901,-7.54,1206
2021-09-24,11399,12454,-1055,-8.47,1206
2021-09-25,9916,10959,-1043,-9.52,1206
2021-09-26,8245,8696,-451,-5.19,1206
2021-09-27,10806,11732,-926,-7.89,1206
2021-09-28,11055,12029,-974,-8.1,1206
2021-09-29,11055,12043,-988,-8.2,1206
2021-09-30,11055,12058,-1003,-8.32,1206
2021-10-01,11978,12570,-592,-4.71,1206
2021-10-02,10341,11088,-747,-6.74,1206
2021-10-03,8137,8836,-699,-7.91,1206
2021-10-04,10793,11881,-1088,-9.16,1206
2021-10-05,11189,12184,-995,-8.17,1206
2021-10-06,11189,12201,-1012,-8.29,1206
2021-10-07,11189,12217,-1028,-8.41,1206
2021-10-08,11978,12726,-748,-5.88,1206
2021-10-09,10341,11238,-897,-7.98,1206
2021-10-10,8137,8978,-841,-9.37,1206
2021-10-11,10793,12012,-1219,-10.15,1206
2021-10-12,11189,12302,-1113,-9.05,1206
2021-10-13,11189,12305,-1116,-9.07,1206
2021-10-14,11189,12304,-1115,-9.06,1206
2021-10-15,11978,12796,-818,-6.39,1206
2021-10-16,10341,11290,-949,-8.41,1206
2021-10-17,8137,9013,-876,-9.72,1206
2021-10-18,10793,12029,-1236,-10.28,1206
2021-10-19,11189,12303,-1114,-9.05,1206
2021-10-20,11189,12292,-1103,-8.97,1206
2021-10-21,11189,12279,-1090,-8.88,1206
2021-10-22,11978,12760,-782,-6.13,1206
2021-10-23,10341,11247,-906,-8.06,1206
2021-10-24,8137,8964,-827,-9.23,1206
2021-10-25,10793,11979,-1186,-9.9,1206
2021-10-26,11189,12253,-1064,-8.68,1206
2021-10-27,11189,12245,-1056,-8.62,1206
2021-10-28,11189,12237,-1048,-8.56,1206
2021-10-29,11978,12726,-748,-5.88,1206
2021-10-30,10341,11222,-881,-7.85,1206
2021-10-31,8137,8951,-814,-9.09,1206
2021-11-01,10860,11977,-1117,-9.33,1206
2021-11-02,11284,12263,-979,-7.98,1206
2021-11-03,11284,12268,-984,-8.02,1206
2021-11-04,11284,12272,-988,-8.05,1206
2021-11-05,12022,12772,-750,-5.87,1206
2021-11-06,10241,11278,-1037,-9.19,1206
2021-11-07,8061,9015,-954,-10.58,1206
2021-11-08,10860,12047,-1187,-9.85,1206
2021-11-09,11284,12338,-1054,-8.54,1206
2021-11-10,11284,12343,-1059,-8.58,1206
2021-11-11,11284,12347,-1063,-8.61,1206
2021-11-12,12022,12843,-821,-6.39,1206
2021-11-13,10241,11343,-1102,-9.72,1206
2021-11-14,8061,9070,-1009,-11.12,1206
2021-11-15,10860,12092,-1232,-10.19,1206
2021-11-16,11284,12369,-1085,-8.77,1206
2021-11-17,11284,12360,-1076,-8.71,1206
2021-11-18,11284,12347,-1063,-8.61,1206
2021-11-19,12022,12827,-805,-6.28,1206
2021-11-20,10241,11311,-1070,-9.46,1206
2021-11-21,8061,9022,-961,-10.65,1206
2021-11-22,10860,12028,-1168,-9.71,1206
2021-11-23,11284,12291,-1007,-8.19,1206
2021-11-24,11284,12270,-986,-8.04,1206
2021-11-25,11284,12246,-962,-7.86,1206
2021-11-26,12022,12718,-696,-5.47,1206
2021-11-27,10241,11196,-955,-8.53,1206
2021-11-28,8061,8905,-844,-9.48,1206
2021-11-29,10860,11911,-1051,-8.82,1206
2021-11-30,11284,12177,-893,-7.33,1206
2021-12-01,11103,12161,-1058,-8.7,1206
2021-12-02,11103,12145,-1042,-8.58,1206
2021-12-03,10862,12627,-1765,-13.98,1206
2021-12-04,9612,11117,-1505,-13.54,1206
2021-12-05,7311,8839,-1528,-17.29,1206
2021-12-06,11272,11859,-587,-4.95,1206
2021-12-07,11103,12140,-1037,-8.54,1206
2021-12-08,11103,12138,-1035,-8.53,1206
2021-12-09,11103,12137,-1034,-8.52,1206
2021-12-10,10862,12631,-1769,-14.01,1206
2021-12-11,9612,11131,-1519,-13.65,1206
2021-12-12,7311,8861,-1550,-17.49,1206
2021-12-13,11272,11886,-614,-5.17,1206
2021-12-14,11103,12168,-1065,-8.75,1206
2021-12-15,11103,12165,-1062,-8.73,1206
2021-12-16,11103,12158,-1055,-8.68,1206
2021-12-17,10862,12643,-1781,-14.09,1206
2021-12-18,9612,11130,-1518,-13.64,1206
2021-12-19,7311,8843,-1532,-17.32,1206
2021-12-20,11272,11847,-575,-4.85,1206
2021-12-21,11103,12106,-1003,-8.29,1206
2021-12-22,11103,12077,-974,-8.06,1206
2021-12-23,11103,12042,-939,-7.8,1206
2021-12-24,10862,12497,-1635,-13.08,1206
2021-12-25,9612,10953,-1341,-12.24,1206
2021-12-26,7311,8635,-1324,-15.33,1206
2021-12-27,11272,11609,-337,-2.9,1206
2021-12-28,11103,11839,-736,-6.22,1206
2021-12-29,11103,11782,-679,-5.76,1206
2021-12-30,11103,11721,-618,-5.27,1206
2021-12-31,10862,12155,-1293,-10.64,1206
2022-01-01,9661,10593,-932,-8.8,1206
2022-01-02,7042,8261,-1219,-14.76,1206
2022-01-03,10631,11226,-595,-5.3,1206
2022-01-04,10866,11451,-585,-5.11,1206
2022-01-05,10866,11395,-529,-4.64,1206
2022-01-06,10866,11340,-474,-4.18,1206
2022-01-07,11045,11785,-740,-6.28,1206
2022-01-08,9661,10238,-577,-5.64,1206
2022-01-09,7042,7927,-885,-11.16,1206
2022-01-10,10631,10917,-286,-2.62,1206
2022-01-11,10866,11171,-305,-2.73,1206
2022-01-12,10866,11146,-280,-2.51,1206
2022-01-13,10866,11126,-260,-2.34,1206
2022-01-14,11045,11607,-562,-4.84,1206
2022-01-15,9661,10099,-438,-4.34,1206
2022-01-16,7042,7825,-783,-10.01,1206
2022-01-17,10631,10853,-222,-2.05,1206
2022-01-18,10866,11144,-278,-2.49,1206
2022-01-19,10866,11155,-289,-2.59,1206
2022-01-20,10866,11168,-302,-2.7,1206
2022-01-21,11045,11679,-634,-5.43,1206
2022-01-22,9661,10197,-536,-5.26,1206
2022-01-23,7042,7948,-906,-11.4,1206
2022-01-24,10631,10995,-364,-3.31,1206
2022-01-25,10866,11302,-436,-3.86,1206
2022-01-26,10866,11324,-458,-4.04,1206
2022-01-27,10866,11345,-479,-4.22,1206
2022-01-28,11045,11859,-814,-6.86,1206
2022-01-29,9661,10377,-716,-6.9,1206
2022-01-30,7042,8124,-1082,-13.32,1206
2020-02-01,15754,14903,851,5.71,1627
2020-02-02,13730,13178,552,4.19,1627
2020-02-03,16392,16584,-192,-1.16,1627
2020-02-04,16981,17109,-128,-0.75,1627
2020-02-05,16981,17106,-125,-0.73,1627
2020-02-06,16981,17108,-127,-0.74,1627
2020-02-07,17878,17551,327,1.86,1627
2020-02-08,15754,15020,734,4.89,1627
2020-02-09,13730,13281,449,3.38,1627
2020-02-10,16392,16676,-284,-1.7,1627
2020-02-11,16981,17193,-212,-1.23,1627
2020-02-12,16981,17184,-203,-1.18,1627
2020-02-13,16981,17183,-202,-1.18,1627
2020-02-14,17878,17627,251,1.42,1627
2020-02-15,15754,15100,654,4.33,1627
2020-02-16,13730,13368,362,2.71,1627
2020-02-17,16392,16772,-380,-2.27,1627
2020-02-18,16981,17301,-320,-1.85,1627
2020-02-19,16981,17306,-325,-1.88,1627
2020-02-20,16981,17321,-340,-1.96,1627
2020-02-21,17878,17781,97,0.55,1627
2020-02-22,15754,15272,482,3.16,1627
2020-02-23,13730,13558,172,1.27,1627
2020-02-24,16392,16979,-587,-3.46,1627
2020-02-25,16981,17524,-543,-3.1,1627
2020-02-26,16981,17544,-563,-3.21,1627
2020-02-27,16981,17572,-591,-3.36,1627
2020-02-28,17878,18043,-165,-0.91,1627
2020-02-29,15754,15542,212,1.36,1627
2020-03-01,9620,13832,-4212,-30.45,1627
2020-03-02,13039,17255,-4216,-24.43,1627
2020-03-03,13145,17799,-4654,-26.15,1627
2020-03-04,13145,17815,-4670,-26.21,1627
2020-03-05,13145,17835,-4690,-26.3,1627
2020-03-06,13840,18296,-4456,-24.36,1627
2020-03-07,10353,15782,-5429,-34.4,1627
2020-03-08,9620,14057,-4437,-31.56,1627
2020-03-09,13039,17463,-4424,-25.33,1627
2020-03-10,13145,17988,-4843,-26.92,1627
2020-03-11,13145,17985,-4840,-26.91,1627
2020-03-12,13145,17985,-4840,-26.91,1627
2020-03-13,13840,18425,-4585,-24.88,1627
2020-03-14,10353,15891,-5538,-34.85,1627
2020-03-15,9620,14147,-4527,-32.0,1627
2020-03-16,13039,17535,-4496,-25.64,1627
2020-03-17,13145,18044,-4899,-27.15,1627
2020-03-18,13145,18025,-4880,-27.07,1627
2020-03-19,13145,18012,-4867,-27.02,1627
2020-03-20,13840,18442,-4602,-24.95,1627
2020-03-21,10353,15899,-5546,-34.88,1627
2020-03-22,9620,14148,-4528,-32.0,1627
2020-03-23,13039,17533,-4494,-25.63,1627
2020-03-24,13145,18039,-4894,-27.13,1627
2020-03-25,13145,18020,-4875,-27.05,1627
2020-03-26,13145,18008,-4863,-27.0,1627
2020-03-27,13840,18440,-4600,-24.95,1627
2020-03-28,10353,15901,-5548,-34.89,1627
2020-03-29,9620,14155,-4535,-32.04,1627
2020-03-30,13039,17544,-4505,-25.68,1627
2020-03-31,13145,18054,-4909,-27.19,1627
2020-04-01,12549,18040,-5491,-30.44,1627
2020-04-02,12549,18032,-5483,-30.41,1627
2020-04-03,11924,18468,-6544,-35.43,1627
2020-04-04,9092,15931,-6839,-42.93,1627
2020-04-05,6921,14186,-7265,-51.21,1627
2020-04-06,12328,17575,-5247,-29.85,1627
2020-04-07,12549,18085,-5536,-30.61,1627
2020-04-08,12549,18069,-5520,-30.55,1627
2020-04-09,12549,18059,-5510,-30.51,1627
2020-04-10,11924,18491,-6567,-35.51,1627
2020-04-11,9092,15950,-6858,-43.0,1627
2020-04-12,6921,14200,-7279,-51.26,1627
2020-04-13,12328,17585,-5257,-29.89,1627
2020-04-14,12549,18091,-5542,-30.63,1627
2020-04-15,12549,18071,-5522,-30.56,1627
2020-04-16,12549,18057,-5508,-30.5,1627
2020-04-17,11924,18487,-6563,-35.5,1627
2020-04-18,9092,15945,-6853,-42.98,1627
2020-04-19,6921,14196,-7275,-51.25,1627
2020-04-20,12328,17583,-5255,-29.89,1627
2020-04-21,12549,18093,-5544,-30.64,1627
2020-04-22,12549,18079,-5530,-30.59,1627
2020-04-23,12549,18073,-5524,-30.56,1627
2020-04-24,11924,18511,-6587,-35.58,1627
2020-04-25,9092,15980,-6888,-43.1,1627
2020-04-26,6921,14243,-7322,-51.41,1627
2020-04-27,12328,17643,-5315,-30.13,1627
2020-04-28,12549,18166,-5617,-30.92,1627
2020-04-29,12549,18165,-5616,-30.92,1627
2020-04-30,12549,18172,-5623,-30.94,1627
2020-05-01,16444,18623,-2179,-11.7,1627
2020-05-02,13435,16104,-2669,-16.57,1627
2020-05-03,11015,14377,-3362,-23.38,1627
2020-05-04,15643,17784,-2141,-12.04,1627
2020-05-05,16315,18313,-1998,-10.91,1627
2020-05-06,16315,18315,-2000,-10.92,1627
2020-05-07,16315,18322,-2007,-10.95,1627
2020-05-08,16444,18771,-2327,-12.4,1627
2020-05-09,13435,16245,-2810,-17.3,1627
2020-05-10,11015,14509,-3494,-24.08,1627
2020-05-11,15643,17905,-2262,-12.63,1627
2020-05-12,16315,18418,-2103,-11.42,1627
2020-05-13,16315,18403,-2088,-11.35,1627
2020-05-14,16315,18391,-2076,-11.29,1627
2020-05-15,16444,18818,-2374,-12.62,1627
2020-05-16,13435,16270,-2835,-17.42,1627
2020-05-17,11015,14510,-3495,-24.09,1627
2020-05-18,15643,17882,-2239,-12.52,1627
2020-05-19,16315,18372,-2057,-11.2,1627
2020-05-20,16315,18334,-2019,-11.01,1627
2020-05-21,16315,18300,-1985,-10.85,1627
2020-05-22,16444,18709,-2265,-12.11,1627
2020-05-23,13435,16144,-2709,-16.78,1627
2020-05-24,11015,14371,-3356,-23.35,1627
2020-05-25,15643,17732,-2089,-11.78,1627
2020-05-26,16315,18216,-1901,-10.44,1627
2020-05-27,16315,18175,-1860,-10.23,1627
2020-05-28,16315,18143,-1828,-10.08,1627
2020-05-29,16444,18555,-2111,-11.38,1627
2020-05-30,13435,15999,-2564,-16.03,1627
2020-05-31,11015,14237,-3222,-22.63,1627
2020-06-01,17024,17612,-588,-3.34,1627
2020-06-02,17451,18112,-661,-3.65,1627
2020-06-03,17451,18090,-639,-3.53,1627
2020-06-04,17451,18077,-626,-3.46,1627
2020-06-05,17327,18509,-1182,-6.39,1627
2020-06-06,14752,15971,-1219,-7.63,1627
2020-06-07,12850,14228,-1378,-9.69,1627
2020-06-08,17024,17620,-596,-3.38,1627
2020-06-09,17451,18134,-683,-3.77,1627
2020-06-10,17451,18122,-671,-3.7,1627
2020-06-11,17451,18116,-665,-3.67,1627
2020-06-12,17327,18551,-1224,-6.6,1627
2020-06-13,14752,16012,-1260,-7.87,1627
2020-06-14,12850,14262,-1412,-9.9,1627
2020-06-15,17024,17643,-619,-3.51,1627
2020-06-16,17451,18141,-690,-3.8,1627
2020-06-17,17451,18109,-658,-3.63,1627
2020-06-18,17451,18078,-627,-3.47,1627
2020-06-19,17327,18484,-1157,-6.26,1627
2020-06-20,14752,15913,-1161,-7.3,1627
2020-06-21,12850,14129,-1279,-9.05,1627
2020-06-22,17024,17473,-449,-2.57,1627
2020-06-23,17451,17934,-483,-2.69,1627
2020-06-24,17451,17864,-413,-2.31,1627
2020-06-25,17451,17796,-345,-1.94,1627
2020-06-26,17327,18167,-840,-4.62,1627
2020-06-27,14752,15563,-811,-5.21,1627
2020-06-28,12850,13749,-899,-6.54,1627
2020-06-29,17024,17068,-44,-0.26,1627
2020-06-30,17451,17508,-57,-0.33,1627
2020-07-01,16384,17423,-1039,-5.96,1627
2020-07-02,16384,17346,-962,-5.55,1627
2020-07-03,16346,17714,-1368,-7.72,1627
2020-07-04,14336,15114,-778,-5.15,1627
2020-07-05,12847,13309,-462,-3.47,1627
2020-07-06,15712,16643,-931,-5.59,1627
2020-07-07,16384,17103,-719,-4.2,1627
2020-07-08,16384,17044,-660,-3.87,1627
2020-07-09,16384,16996,-612,-3.6,1627
2020-07-10,16346,17397,-1051,-6.04,1627
2020-07-11,14336,14831,-495,-3.34,1627
2020-07-12,12847,13063,-216,-1.65,1627
2020-07-13,15712,16434,-722,-4.39,1627
2020-07-14,16384,16930,-546,-3.23,1627
2020-07-15,16384,16904,-520,-3.08,1627
2020-07-16,16384,16888,-504,-2.98,1627
2020-07-17,16346,17315,-969,-5.6,1627
2020-07-18,14336,14772,-436,-2.95,1627
2020-07-19,12847,13020,-173,-1.33,1627
2020-07-20,15712,16402,-690,-4.21,1627
2020-07-21,16384,16902,-518,-3.06,1627
2020-07-22,16384,16872,-488,-2.89,1627
2020-07-23,16384,16845,-461,-2.74,1627
2020-07-24,16346,17255,-909,-5.27,1627
2020-07-25,14336,14688,-352,-2.4,1627
2020-07-26,12847,12906,-59,-0.46,1627
2020-07-27,15712,16251,-539,-3.32,1627
2020-07-28,16384,16711,-327,-1.96,1627
2020-07-29,16384,16638,-254,-1.53,1627
2020-07-30,16384,16565,-181,-1.09,1627
2020-07-31,16346,16928,-582,-3.44,1627
2020-08-01,10315,14314,-3999,-27.94,1627
2020-08-02,9214,12487,-3273,-26.21,1627
2020-08-03,10977,15791,-4814,-30.49,1627
2020-08-04,10261,16213,-5952,-36.71,1627
2020-08-05,10261,16109,-5848,-36.3,1627
2020-08-06,10261,16011,-5750,-35.91,1627
2020-08-07,10409,16359,-5950,-36.37,1627
2020-08-08,10315,13737,-3422,-24.91,1627
2020-08-09,9214,11913,-2699,-22.66,1627
2020-08-10,10977,15230,-4253,-27.93,1627
2020-08-11,10261,15676,-5415,-34.54,1627
2020-08-12,10261,15606,-5345,-34.25,1627
2020-08-13,10261,15553,-5292,-34.03,1627
2020-08-14,10409,15955,-5546,-34.76,1627
2020-08-15,10315,13398,-3083,-23.01,1627
2020-08-16,9214,11646,-2432,-20.88,1627
2020-08-17,10977,15042,-4065,-27.02,1627
2020-08-18,10261,15575,-5314,-34.12,1627
2020-08-19,10261,15595,-5334,-34.2,1627
2020-08-20,10261,15636,-5375,-34.38,1627
2020-08-21,10409,16133,-5724,-35.48,1627
2020-08-22,10315,13671,-3356,-24.55,1627
2020-08-23,9214,12013,-2799,-23.3,1627
2020-08-24,10977,15499,-4522,-29.18,1627
2020-08-25,10261,16116,-5855,-36.33,1627
2020-08-26,10261,16215,-5954,-36.72,1627
2020-08-27,10261,16326,-6065,-37.15,1627
2020-08-28,10409,16884,-6475,-38.35,1627
2020-08-29,10315,14472,-4157,-28.72,1627
2020-08-30,9214,12854,-3640,-28.32,1627
2020-08-31,10977,16368,-5391,-32.94,1627
2020-09-01,15513,17002,-1489,-8.76,1627
2020-09-02,15513,17105,-1592,-9.31,1627
2020-09-03,15513,17209,-1696,-9.86,1627
2020-09-04,16430,17749,-1319,-7.43,1627
2020-09-05,14511,15309,-798,-5.21,1627
2020-09-06,13209,13651,-442,-3.24,1627
2020-09-07,15799,17119,-1320,-7.71,1627
2020-09-08,15513,17697,-2184,-12.34,1627
2020-09-09,15513,17740,-2227,-12.55,1627
2020-09-10,15513,17778,-2265,-12.74,1627
2020-09-11,16430,18249,-1819,-9.97,1627
2020-09-12,14511,15738,-1227,-7.8,1627
2020-09-13,13209,14010,-801,-5.72,1627
2020-09-14,15799,17408,-1609,-9.24,1627
2020-09-15,15513,17919,-2406,-13.43,1627
2020-09-16,15513,17898,-2385,-13.33,1627
2020-09-17,15513,17878,-2365,-13.23,1627
2020-09-18,16430,18297,-1867,-10.2,1627
2020-09-19,14511,15740,-1229,-7.81,1627
2020-09-20,13209,13974,-765,-5.47,1627
2020-09-21,15799,17341,-1542,-8.89,1627
2020-09-22,15513,17830,-2317,-12.99,1627
2020-09-23,15513,17794,-2281,-12.82,1627
2020-09-24,15513,17767,-2254,-12.69,1627
2020-09-25,16430,18186,-1756,-9.66,1627
2020-09-26,14511,15636,-1125,-7.19,1627
2020-09-27,13209,13882,-673,-4.85,1627
2020-09-28,15799,17267,-1468,-8.5,1627
2020-09-29,15513,17777,-2264,-12.74,1627
2020-09-30,15513,17767,-2254,-12.69,1627
2020-10-01,16829,17767,-938,-5.28,1627
2020-10-02,17487,18213,-726,-3.99,1627
2020-10-03,15093,15692,-599,-3.82,1627
2020-10-04,12729,13965,-1236,-8.85,1627
2020-10-05,16403,17375,-972,-5.59,1627
2020-10-06,16829,17907,-1078,-6.02,1627
2020-10-07,16829,17915,-1086,-6.06,1627
2020-10-08,16829,17930,-1101,-6.14,1627
2020-10-09,17487,18386,-899,-4.89,1627
2020-10-10,15093,15869,-776,-4.89,1627
2020-10-11,12729,14142,-1413,-9.99,1627
2020-10-12,16403,17546,-1143,-6.51,1627
2020-10-13,16829,18068,-1239,-6.86,1627
2020-10-14,16829,18061,-1232,-6.82,1627
2020-10-15,16829,18055,-1226,-6.79,1627
2020-10-16,17487,18488,-1001,-5.41,1627
2020-10-17,15093,15944,-851,-5.34,1627
2020-10-18,12729,14188,-1459,-10.28,1627
2020-10-19,16403,17560,-1157,-6.59,1627
2020-10-20,16829,18050,-1221,-6.76,1627
2020-10-21,16829,18010,-1181,-6.56,1627
2020-10-22,16829,17972,-1143,-6.36,1627
2020-10-23,17487,18374,-887,-4.83,1627
2020-10-24,15093,15800,-707,-4.47,1627
2020-10-25,12729,14017,-1288,-9.19,1627
2020-10-26,16403,17366,-963,-5.55,1627
2020-10-27,16829,17835,-1006,-5.64,1627
2020-10-28,16829,17777,-948,-5.33,1627
2020-10-29,16829,17726,-897,-5.06,1627
2020-10-30,17487,18119,-632,-3.49,1627
2020-10-31,15093,15541,-448,-2.88,1627
2020-11-01,10467,13756,-3289,-23.91,1627
2020-11-02,15403,17107,-1704,-9.96,1627
2020-11-03,14522,17582,-3060,-17.4,1627
2020-11-04,14522,17535,-3013,-17.18,1627
2020-11-05,14522,17496,-2974,-17.0,1627
2020-11-06,15008,17903,-2895,-16.17,1627
2020-11-07,11778,15341,-3563,-23.23,1627
2020-11-08,10467,13574,-3107,-22.89,1627
2020-11-09,15403,16944,-1541,-9.09,1627
2020-11-10,14522,17439,-2917,-16.73,1627
2020-11-11,14522,17410,-2888,-16.59,1627
2020-11-12,14522,17391,-2869,-16.5,1627
2020-11-13,15008,17816,-2808,-15.76,1627
2020-11-14,11778,15272,-3494,-22.88,1627
2020-11-15,10467,13522,-3055,-22.59,1627
2020-11-16,15403,16908,-1505,-8.9,1627
2020-11-17,14522,17417,-2895,-16.62,1627
2020-11-18,14522,17401,-2879,-16.55,1627
2020-11-19,14522,17393,-2871,-16.51,1627
2020-11-20,15008,17830,-2822,-15.83,1627
2020-11-21,11778,15296,-3518,-23.0,1627
2020-11-22,10467,13554,-3087,-22.78,1627
2020-11-23,15403,16949,-1546,-9.12,1627
2020-11-24,14522,17465,-2943,-16.85,1627
2020-11-25,14522,17458,-2936,-16.82,1627
2020-11-26,14522,17457,-2935,-16.81,1627
2020-11-27,15008,17901,-2893,-16.16,1627
2020-11-28,11778,15375,-3597,-23.4,1627
2020-11-29,10467,13641,-3174,-23.27,1627
2020-11-30,15403,17044,-1641,-9.63,1627
2020-12-01,15113,17569,-2456,-13.98,1627
2020-12-02,15113,17569,-2456,-13.98,1627
2020-12-03,15113,17577,-2464,-14.02,1627
2020-12-04,16552,18029,-1477,-8.19,1627
2020-12-05,13180,15509,-2329,-15.02,1627
2020-12-06,10296,13782,-3486,-25.29,1627
2020-12-07,15285,17189,-1904,-11.08,1627
2020-12-08,15113,17717,-2604,-14.7,1627
2020-12-09,15113,17719,-2606,-14.71,1627
2020-12-10,15113,17725,-2612,-14.74,1627
2020-12-11,16552,18173,-1621,-8.92,1627
2020-12-12,13180,15647,-2467,-15.77,1627
2020-12-13,10296,13910,-3614,-25.98,1627
2020-12-14,15285,17304,-2019,-11.67,1627
2020-12-15,15113,17815,-2702,-15.17,1627
2020-12-16,15113,17797,-2684,-15.08,1627
2020-12-17,15113,17780,-2667,-15.0,1627
2020-12-18,16552,18202,-1650,-9.06,1627
2020-12-19,13180,15646,-2466,-15.76,1627
2020-12-20,10296,13876,-3580,-25.8,1627
2020-12-21,15285,17236,-1951,-11.32,1627
2020-12-22,15113,17711,-2598,-14.67,1627
2020-12-23,15113,17656,-2543,-14.4,1627
2020-12-24,15113,17602,-2489,-14.14,1627
2020-12-25,16552,17985,-1433,-7.97,1627
2020-12-26,13180,15393,-2213,-14.38,1627
2020-12-27,10296,13589,-3293,-24.23,1627
2020-12-28,15285,16916,-1631,-9.64,1627
2020-12-29,15113,17362,-2249,-12.95,1627
2020-12-30,15113,17280,-2167,-12.54,1627
2020-12-31,15113,17204,-2091,-12.15,1627
2021-01-01,14448,17571,-3123,-17.77,1627
2021-01-02,10905,14967,-4062,-27.14,1627
2021-01-03,9262,13157,-3895,-29.6,1627
2021-01-04,13765,16484,-2719,-16.49,1627
2021-01-05,14452,16935,-2483,-14.66,1627
2021-01-06,14452,16866,-2414,-14.31,1627
2021-01-07,14452,16807,-2355,-14.01,1627
2021-01-08,14448,17197,-2749,-15.99,1627
2021-01-09,10905,14621,-3716,-25.42,1627
2021-01-10,9262,12843,-3581,-27.88,1627
2021-01-11,13765,16206,-2441,-15.06,1627
2021-01-12,14452,16697,-2245,-13.45,1627
2021-01-13,14452,16669,-2217,-13.3,1627
2021-01-14,14452,16655,-2203,-13.23,1627
2021-01-15,14448,17090,-2642,-15.46,1627
2021-01-16,10905,14558,-3653,-25.09,1627
2021-01-17,9262,12825,-3563,-27.78,1627
2021-01-18,13765,16231,-2466,-15.19,1627
2021-01-19,14452,16762,-2310,-13.78,1627
2021-01-20,14452,16772,-2320,-13.83,1627
2021-01-21,14452,16792,-2340,-13.94,1627
2021-01-22,14448,17256,-2808,-16.27,1627
2021-01-23,10905,14751,-3846,-26.07,1627
2021-01-24,9262,13038,-3776,-28.96,1627
2021-01-25,13765,16460,-2695,-16.37,1627
2021-01-26,14452,17003,-2551,-15.0,1627
2021-01-27,14452,17019,-2567,-15.08,1627
2021-01-28,14452,17041,-2589,-15.19,1627
2021-01-29,14448,17503,-3055,-17.45,1627
2021-01-30,10905,14991,-4086,-27.26,1627
2021-01-31,9262,13269,-4007,-30.2,1627
2021-02-01,15496,16678,-1182,-7.09,1627
2021-02-02,15704,17206,-1502,-8.73,1627
2021-02-03,15704,17207,-1503,-8.73,1627
2021-02-04,15704,17211,-1507,-8.76,1627
2021-02-05,15869,17656,-1787,-10.12,1627
2021-02-06,13417,15127,-1710,-11.3,1627
2021-02-07,11379,13390,-2011,-15.02,1627
2021-02-08,15496,16785,-1289,-7.68,1627
2021-02-09,15704,17302,-1598,-9.24,1627
2021-02-10,15704,17293,-1589,-9.19,1627
2021-02-11,15704,17290,-1586,-9.17,1627
2021-02-12,15869,17732,-1863,-10.51,1627
2021-02-13,13417,15203,-1786,-11.75,1627
2021-02-14,11379,13468,-2089,-15.51,1627
2021-02-15,15496,16870,-1374,-8.14,1627
2021-02-16,15704,17395,-1691,-9.72,1627
2021-02-17,15704,17397,-1693,-9.73,1627
2021-02-18,15704,17409,-1705,-9.79,1627
2021-02-19,15869,17866,-1997,-11.18,1627
2021-02-20,13417,15353,-1936,-12.61,1627
2021-02-21,11379,13636,-2257,-16.55,1627
2021-02-22,15496,17055,-1559,-9.14,1627
2021-02-23,15704,17598,-1894,-10.76,1627
2021-02-24,15704,17617,-1913,-10.86,1627
2021-02-25,15704,17643,-1939,-10.99,1627
2021-02-26,15869,18113,-2244,-12.39,1627
2021-02-27,13417,15612,-2195,-14.06,1627
2021-02-28,11379,13903,-2524,-18.15,1627
2021-03-01,15934,17328,-1394,-8.04,1627
2021-03-02,16161,17874,-1713,-9.58,1627
2021-03-03,16161,17892,-1731,-9.67,1627
2021-03-04,16161,17915,-1754,-9.79,1627
2021-03-05,16387,18379,-1992,-10.84,1627
2021-03-06,13965,15868,-1903,-11.99,1627
2021-03-07,11621,14147,-2526,-17.86,1627
2021-03-08,15934,17557,-1623,-9.24,1627
2021-03-09,16161,18086,-1925,-10.64,1627
2021-03-10,16161,18086,-1925,-10.64,1627
2021-03-11,16161,18090,-1929,-10.66,1627
2021-03-12,16387,18533,-2146,-11.58,1627
2021-03-13,13965,16002,-2037,-12.73,1627
2021-03-14,11621,14261,-2640,-18.51,1627
2021-03-15,15934,17652,-1718,-9.73,1627
2021-03-16,16161,18162,-2001,-11.02,1627
2021-03-17,16161,18145,-1984,-10.93,1627
2021-03-18,16161,18134,-1973,-10.88,1627
2021-03-19,16387,18564,-2177,-11.73,1627
2021-03-20,13965,16022,-2057,-12.84,1627
2021-03-21,11621,14271,-2650,-18.57,1627
2021-03-22,15934,17655,-1721,-9.75,1627
2021-03-23,16161,18160,-1999,-11.01,1627
2021-03-24,16161,18141,-1980,-10.91,1627
2021-03-25,16161,18128,-1967,-10.85,1627
2021-03-26,16387,18559,-2172,-11.7,1627
2021-03-27,13965,16019,-2054,-12.82,1627
2021-03-28,11621,14272,-2651,-18.57,1627
2021-03-29,15934,17660,-1726,-9.77,1627
2021-03-30,16161,18170,-2009,-11.06,1627
2021-03-31,16161,18155,-1994,-10.98,1627
2021-04-01,15429,18147,-2718,-14.98,1627
2021-04-02,15091,18583,-3492,-18.79,1627
2021-04-03,12145,16046,-3901,-24.31,1627
2021-04-04,10480,14302,-3822,-26.72,1627
2021-04-05,15420,17691,-2271,-12.84,1627
2021-04-06,15429,18202,-2773,-15.23,1627
2021-04-07,15429,18187,-2758,-15.16,1627
2021-04-08,15429,18177,-2748,-15.12,1627
2021-04-09,15091,18610,-3519,-18.91,1627
2021-04-10,12145,16070,-3925,-24.42,1627
2021-04-11,10480,14321,-3841,-26.82,1627
2021-04-12,15420,17707,-2287,-12.92,1627
2021-04-13,15429,18213,-2784,-15.29,1627
2021-04-14,15429,18193,-2764,-15.19,1627
2021-04-15,15429,18179,-2750,-15.13,1627
2021-04-16,15091,18609,-3518,-18.9,1627
2021-04-17,12145,16066,-3921,-24.41,1627
2021-04-18,10480,14317,-3837,-26.8,1627
2021-04-19,15420,17702,-2282,-12.89,1627
2021-04-20,15429,18210,-2781,-15.27,1627
2021-04-21,15429,18194,-2765,-15.2,1627
2021-04-22,15429,18186,-2757,-15.16,1627
2021-04-23,15091,18622,-3531,-18.96,1627
2021-04-24,12145,16089,-3944,-24.51,1627
2021-04-25,10480,14349,-3869,-26.96,1627
2021-04-26,15420,17746,-2326,-13.11,1627
2021-04-27,15429,18267,-2838,-15.54,1627
2021-04-28,15429,18264,-2835,-15.52,1627
2021-04-29,15429,18269,-2840,-15.55,1627
2021-04-30,15091,18719,-3628,-19.38,1627
2021-05-01,14676,16198,-1522,-9.4,1627
2021-05-02,12325,14470,-2145,-14.82,1627
2021-05-03,16529,17877,-1348,-7.54,1627
2021-05-04,17178,18406,-1228,-6.67,1627
2021-05-05,17178,18410,-1232,-6.69,1627
2021-05-06,17178,18418,-1240,-6.73,1627
2021-05-07,17039,18869,-1830,-9.7,1627
2021-05-08,14676,16346,-1670,-10.22,1627
2021-05-09,12325,14613,-2288,-15.66,1627
2021-05-10,16529,18012,-1483,-8.23,1627
2021-05-11,17178,18530,-1352,-7.3,1627
2021-05-12,17178,18519,-1341,-7.24,1627
2021-05-13,17178,18511,-1333,-7.2,1627
2021-05-14,17039,18943,-1904,-10.05,1627
2021-05-15,14676,16399,-1723,-10.51,1627
2021-05-16,12325,14643,-2318,-15.83,1627
2021-05-17,16529,18019,-1490,-8.27,1627
2021-05-18,17178,18513,-1335,-7.21,1627
2021-05-19,17178,18478,-1300,-7.04,1627
2021-05-20,17178,18447,-1269,-6.88,1627
2021-05-21,17039,18857,-1818,-9.64,1627
2021-05-22,14676,16294,-1618,-9.93,1627
2021-05-23,12325,14521,-2196,-15.12,1627
2021-05-24,16529,17883,-1354,-7.57,1627
2021-05-25,17178,18366,-1188,-6.47,1627
2021-05-26,17178,18324,-1146,-6.25,1627
2021-05-27,17178,18289,-1111,-6.07,1627
2021-05-28,17039,18699,-1660,-8.88,1627
2021-05-29,14676,16139,-1463,-9.06,1627
2021-05-30,12325,14374,-2049,-14.25,1627
2021-05-31,16529,17746,-1217,-6.86,1627
2021-06-01,17100,18242,-1142,-6.26,1627
2021-06-02,17100,18216,-1116,-6.13,1627
2021-06-03,17100,18199,-1099,-6.04,1627
2021-06-04,17007,18628,-1621,-8.7,1627
2021-06-05,14771,16088,-1317,-8.19,1627
2021-06-06,13400,14342,-942,-6.57,1627
2021-06-07,16798,17732,-934,-5.27,1627
2021-06-08,17100,18246,-1146,-6.28,1627
2021-06-09,17100,18234,-1134,-6.22,1627
2021-06-10,17100,18229,-1129,-6.19,1627
2021-06-11,17007,18666,-1659,-8.89,1627
2021-06-12,14771,16130,-1359,-8.43,1627
2021-06-13,13400,14384,-984,-6.84,1627
2021-06-14,16798,17769,-971,-5.46,1627
2021-06-15,17100,18272,-1172,-6.41,1627
2021-06-16,17100,18246,-1146,-6.28,1627
2021-06-17,17100,18221,-1121,-6.15,1627
2021-06-18,17007,18635,-1628,-8.74,1627
2021-06-19,14771,16071,-1300,-8.09,1627
2021-06-20,13400,14293,-893,-6.25,1627
2021-06-21,16798,17644,-846,-4.79,1627
2021-06-22,17100,18112,-1012,-5.59,1627
2021-06-23,17100,18048,-948,-5.25,1627
2021-06-24,17100,17985,-885,-4.92,1627
2021-06-25,17007,18361,-1354,-7.37,1627
2021-06-26,14771,15762,-991,-6.29,1627
2021-06-27,13400,13951,-551,-3.95,1627
2021-06-28,16798,17272,-474,-2.74,1627
2021-06-29,17100,17712,-612,-3.46,1627
2021-06-30,17100,17627,-527,-2.99,1627
2021-07-01,15812,17548,-1736,-9.89,1627
2021-07-02,15884,17914,-2030,-11.33,1627
2021-07-03,13328,15309,-1981,-12.94,1627
2021-07-04,12298,13500,-1202,-8.9,1627
2021-07-05,15457,16828,-1371,-8.15,1627
2021-07-06,15812,17283,-1471,-8.51,1627
2021-07-07,15812,17216,-1404,-8.16,1627
2021-07-08,15812,17162,-1350,-7.87,1627
2021-07-09,15884,17556,-1672,-9.52,1627
2021-07-10,13328,14983,-1655,-11.05,1627
2021-07-11,12298,13208,-910,-6.89,1627
2021-07-12,15457,16573,-1116,-6.73,1627
2021-07-13,15812,17064,-1252,-7.34,1627
2021-07-14,15812,17034,-1222,-7.17,1627
2021-07-15,15812,17014,-1202,-7.06,1627
2021-07-16,15884,17440,-1556,-8.92,1627
2021-07-17,13328,14896,-1568,-10.53,1627
2021-07-18,12298,13144,-846,-6.44,1627
2021-07-19,15457,16527,-1070,-6.47,1627
2021-07-20,15812,17030,-1218,-7.15,1627
2021-07-21,15812,17006,-1194,-7.02,1627
2021-07-22,15812,16984,-1172,-6.9,1627
2021-07-23,15884,17401,-1517,-8.72,1627
2021-07-24,13328,14841,-1513,-10.19,1627
2021-07-25,12298,13067,-769,-5.89,1627
2021-07-26,15457,16421,-964,-5.87,1627
2021-07-27,15812,16890,-1078,-6.38,1627
2021-07-28,15812,16826,-1014,-6.03,1627
2021-07-29,15812,16761,-949,-5.66,1627
2021-07-30,15884,17132,-1248,-7.28,1627
2021-07-31,13328,14525,-1197,-8.24,1627
2021-08-01,11985,12705,-720,-5.67,1627
2021-08-02,14883,16013,-1130,-7.06,1627
2021-08-03,15210,16439,-1229,-7.48,1627
2021-08-04,15210,16337,-1127,-6.9,1627
2021-08-05,15210,16239,-1029,-6.34,1627
2021-08-06,15097,16584,-1487,-8.97,1627
2021-08-07,12650,13959,-1309,-9.38,1627
2021-08-08,11985,12129,-144,-1.19,1627
2021-08-09,14883,15438,-555,-3.6,1627
2021-08-10,15210,15874,-664,-4.18,1627
2021-08-11,15210,15792,-582,-3.69,1627
2021-08-12,15210,15726,-516,-3.28,1627
2021-08-13,15097,16114,-1017,-6.31,1627
2021-08-14,12650,13541,-891,-6.58,1627
2021-08-15,11985,11772,213,1.81,1627
2021-08-16,14883,15151,-268,-1.77,1627
2021-08-17,15210,15666,-456,-2.91,1627
2021-08-18,15210,15669,-459,-2.93,1627
2021-08-19,15210,15693,-483,-3.08,1627
2021-08-20,15097,16173,-1076,-6.65,1627
2021-08-21,12650,13695,-1045,-7.63,1627
2021-08-22,11985,12022,-37,-0.31,1627
2021-08-23,14883,15495,-612,-3.95,1627
2021-08-24,15210,16101,-891,-5.53,1627
2021-08-25,15210,16190,-980,-6.05,1627
2021-08-26,15210,16293,-1083,-6.65,1627
2021-08-27,15097,16846,-1749,-10.38,1627
2021-08-28,12650,14431,-1781,-12.34,1627
2021-08-29,11985,12811,-826,-6.45,1627
2021-08-30,14883,16327,-1444,-8.84,1627
2021-08-31,15210,16964,-1754,-10.34,1627
2021-09-01,17287,17072,215,1.26,1627
2021-09-02,17287,17183,104,0.61,1627
2021-09-03,17628,17732,-104,-0.59,1627
2021-09-04,15599,15302,297,1.94,1627
2021-09-05,13740,13656,84,0.62,1627
2021-09-06,16887,17135,-248,-1.45,1627
2021-09-07,17287,17727,-440,-2.48,1627
2021-09-08,17287,17782,-495,-2.78,1627
2021-09-09,17287,17834,-547,-3.07,1627
2021-09-10,17628,18318,-690,-3.77,1627
2021-09-11,15599,15819,-220,-1.39,1627
2021-09-12,13740,14103,-363,-2.57,1627
2021-09-13,16887,17512,-625,-3.57,1627
2021-09-14,17287,18033,-746,-4.14,1627
2021-09-15,17287,18021,-734,-4.07,1627
2021-09-16,17287,18008,-721,-4.0,1627
2021-09-17,17628,18432,-804,-4.36,1627
2021-09-18,15599,15880,-281,-1.77,1627
2021-09-19,13740,14116,-376,-2.66,1627
2021-09-20,16887,17485,-598,-3.42,1627
2021-09-21,17287,17973,-686,-3.82,1627
2021-09-22,17287,17936,-649,-3.62,1627
2021-09-23,17287,17907,-620,-3.46,1627
2021-09-24,17628,18322,-694,-3.79,1627
2021-09-25,15599,15768,-169,-1.07,1627
2021-09-26,13740,14009,-269,-1.92,1627
2021-09-27,16887,17389,-502,-2.89,1627
2021-09-28,17287,17894,-607,-3.39,1627
2021-09-29,17287,17878,-591,-3.31,1627
2021-09-30,17287,17873,-586,-3.28,1627
2021-10-01,17542,18315,-773,-4.22,1627
2021-10-02,15425,15789,-364,-2.31,1627
2021-10-03,13366,14058,-692,-4.92,1627
2021-10-04,16792,17465,-673,-3.85,1627
2021-10-05,16961,17996,-1035,-5.75,1627
2021-10-06,16961,18003,-1042,-5.79,1627
2021-10-07,16961,18017,-1056,-5.86,1627
2021-10-08,17542,18474,-932,-5.04,1627
2021-10-09,15425,15959,-534,-3.35,1627
2021-10-10,13366,14235,-869,-6.1,1627
2021-10-11,16792,17643,-851,-4.82,1627
2021-10-12,16961,18169,-1208,-6.65,1627
2021-10-13,16961,18167,-1206,-6.64,1627
2021-10-14,16961,18167,-1206,-6.64,1627
2021-10-15,17542,18606,-1064,-5.72,1627
2021-10-16,15425,16068,-643,-4.0,1627
2021-10-17,13366,14317,-951,-6.64,1627
2021-10-18,16792,17696,-904,-5.11,1627
2021-10-19,16961,18192,-1231,-6.77,1627
2021-10-20,16961,18157,-1196,-6.59,1627
2021-10-21,16961,18124,-1163,-6.42,1627
2021-10-22,17542,18530,-988,-5.33,1627
2021-10-23,15425,15961,-536,-3.36,1627
2021-10-24,13366,14180,-814,-5.74,1627
2021-10-25,16792,17532,-740,-4.22,1627
2021-10-26,16961,18002,-1041,-5.78,1627
2021-10-27,16961,17946,-985,-5.49,1627
2021-10-28,16961,17895,-934,-5.22,1627
2021-10-29,17542,18287,-745,-4.07,1627
2021-10-30,15425,15708,-283,-1.8,1627
2021-10-31,13366,13921,-555,-3.99,1627
2021-11-01,15435,17271,-1836,-10.63,1627
2021-11-02,16100,17743,-1643,-9.26,1627
2021-11-03,16100,17692,-1592,-9.0,1627
2021-11-04,16100,17650,-1550,-8.78,1627
2021-11-05,16639,18054,-1415,-7.84,1627
2021-11-06,14045,15488,-1443,-9.32,1627
2021-11-07,12553,13718,-1165,-8.49,1627
2021-11-08,15435,17084,-1649,-9.65,1627
2021-11-09,16100,17575,-1475,-8.39,1627
2021-11-10,16100,17544,-1444,-8.23,1627
2021-11-11,16100,17521,-1421,-8.11,1627
2021-11-12,16639,17944,-1305,-7.27,1627
2021-11-13,14045,15397,-1352,-8.78,1627
2021-11-14,12553,13644,-1091,-8.0,1627
2021-11-15,15435,17028,-1593,-9.36,1627
2021-11-16,16100,17535,-1435,-8.18,1627
2021-11-17,16100,17518,-1418,-8.09,1627
2021-11-18,16100,17509,-1409,-8.05,1627
2021-11-19,16639,17944,-1305,-7.27,1627
2021-11-20,14045,15408,-1363,-8.85,1627
2021-11-21,12553,13665,-1112,-8.14,1627
2021-11-22,15435,17058,-1623,-9.51,1627
2021-11-23,16100,17574,-1474,-8.39,1627
2021-11-24,16100,17565,-1465,-8.34,1627
2021-11-25,16100,17563,-1463,-8.33,1627
2021-11-26,16639,18006,-1367,-7.59,1627
2021-11-27,14045,15478,-1433,-9.26,1627
2021-11-28,12553,13743,-1190,-8.66,1627
2021-11-29,15435,17144,-1709,-9.97,1627
2021-11-30,16100,17667,-1567,-8.87,1627
2021-12-01,15339,17666,-2327,-13.17,1627
2021-12-02,15339,17673,-2334,-13.21,1627
2021-12-03,14820,18123,-3303,-18.23,1627
2021-12-04,13242,15603,-2361,-15.13,1627
2021-12-05,11289,13875,-2586,-18.64,1627
2021-12-06,15363,17282,-1919,-11.1,1627
2021-12-07,15339,17811,-2472,-13.88,1627
2021-12-08,15339,17814,-2475,-13.89,1627
2021-12-09,15339,17822,-2483,-13.93,1627
2021-12-10,14820,18272,-3452,-18.89,1627
2021-12-11,13242,15749,-2507,-15.92,1627
2021-12-12,11289,14015,-2726,-19.45,1627
2021-12-13,15363,17413,-2050,-11.77,1627
2021-12-14,15339,17929,-2590,-14.45,1627
2021-12-15,15339,17916,-2577,-14.38,1627
2021-12-16,15339,17906,-2567,-14.34,1627
2021-12-17,14820,18333,-3513,-19.16,1627
2021-12-18,13242,15784,-2542,-16.1,1627
2021-12-19,11289,14022,-2733,-19.49,1627
2021-12-20,15363,17388,-2025,-11.65,1627
2021-12-21,15339,17871,-2532,-14.17,1627
2021-12-22,15339,17822,-2483,-13.93,1627
2021-12-23,15339,17774,-2435,-13.7,1627
2021-12-24,14820,18164,-3344,-18.41,1627
2021-12-25,13242,15577,-2335,-14.99,1627
2021-12-26,11289,13778,-2489,-18.07,1627
2021-12-27,15363,17109,-1746,-10.21,1627
2021-12-28,15339,17558,-2219,-12.64,1627
2021-12-29,15339,17479,-2140,-12.24,1627
2021-12-30,15339,17404,-2065,-11.87,1627
2021-12-31,14820,17772,-2952,-16.61,1627
2022-01-01,13152,15167,-2015,-13.29,1627
2022-01-02,10648,13355,-2707,-20.27,1627
2022-01-03,14502,16678,-2176,-13.05,1627
2022-01-04,14790,17126,-2336,-13.64,1627
2022-01-05,14790,17051,-2261,-13.26,1627
2022-01-06,14790,16986,-2196,-12.93,1627
2022-01-07,15146,17370,-2224,-12.8,1627
2022-01-08,13152,14786,-1634,-11.05,1627
2022-01-09,10648,13000,-2352,-18.09,1627
2022-01-10,14502,16356,-1854,-11.34,1627
2022-01-11,14790,16838,-2048,-12.16,1627
2022-01-12,14790,16802,-2012,-11.97,1627
2022-01-13,14790,16780,-1990,-11.86,1627
2022-01-14,15146,17206,-2060,-11.97,1627
2022-01-15,13152,14668,-1516,-10.34,1627
2022-01-16,10648,12927,-2279,-17.63,1627
2022-01-17,14502,16327,-1825,-11.18,1627
2022-01-18,14790,16853,-2063,-12.24,1627
2022-01-19,14790,16858,-2068,-12.27,1627
2022-01-20,14790,16873,-2083,-12.35,1627
2022-01-21,15146,17335,-2189,-12.63,1627
2022-01-22,13152,14827,-1675,-11.3,1627
2022-01-23,10648,13114,-2466,-18.8,1627
2022-01-24,14502,16535,-2033,-12.3,1627
2022-01-25,14790,17079,-2289,-13.4,1627
2022-01-26,14790,17096,-2306,-13.49,1627
2022-01-27,14790,17119,-2329,-13.6,1627
2022-01-28,15146,17584,-2438,-13.86,1627
2022-01-29,13152,15075,-1923,-12.76,1627
2022-01-30,10648,13356,-2708,-20.28,1627
2020-02-01,16609,9167,7442,81.18,1205
2020-02-02,14148,6962,7186,103.22,1205
2020-02-03,16289,9197,7092,77.11,1205
2020-02-04,16624,9451,7173,75.9,1205
2020-02-05,16624,9442,7182,76.06,1205
2020-02-06,16624,9380,7244,77.23,1205
2020-02-07,17521,9941,7580,76.25,1205
2020-02-08,16609,8625,7984,92.57,1205
2020-02-09,14148,6442,7706,119.62,1205
2020-02-10,16289,8702,7587,87.19,1205
2020-02-11,16624,8988,7636,84.96,1205
2020-02-12,16624,9016,7608,84.38,1205
2020-02-13,16624,8994,7630,84.83,1205
2020-02-14,17521,9600,7921,82.51,1205
2020-02-15,16609,8332,8277,99.34,1205
2020-02-16,14148,6197,7951,128.3,1205
2020-02-17,16289,8508,7781,91.46,1205
2020-02-18,16624,8844,7780,87.97,1205
2020-02-19,16624,8921,7703,86.35,1205
2020-02-20,16624,8947,7677,85.81,1205
2020-02-21,17521,9597,7924,82.57,1205
2020-02-22,16609,8369,8240,98.46,1205
2020-02-23,14148,6271,7877,125.61,1205
2020-02-24,16289,8613,7676,89.12,1205
2020-02-25,16624,8975,7649,85.23,1205
2020-02-26,16624,9072,7552,83.25,1205
2020-02-27,16624,9111,7513,82.46,1205
2020-02-28,17521,9768,7753,79.37,1205
2020-02-29,16609,8542,8067,94.44,1205
2020-03-01,10475,6439,4036,62.68,1205
2020-03-02,12598,8770,3828,43.65,1205
2020-03-03,12923,9116,3807,41.76,1205
2020-03-04,12923,9193,3730,40.57,1205
2020-03-05,12923,9207,3716,40.36,1205
2020-03-06,14035,9837,4198,42.68,1205
2020-03-07,11958,8581,3377,39.35,1205
2020-03-08,10475,6446,4029,62.5,1205
2020-03-09,12598,8746,3852,44.04,1205
2020-03-10,12923,9060,3863,42.64,1205
2020-03-11,12923,9106,3817,41.92,1205
2020-03-12,12923,9093,3830,42.12,1205
2020-03-13,14035,9697,4338,44.74,1205
2020-03-14,11958,8418,3540,42.05,1205
2020-03-15,10475,6265,4210,67.2,1205
2020-03-16,12598,8551,4047,47.33,1205
2020-03-17,12923,8855,4068,45.94,1205
2020-03-18,12923,8896,4027,45.27,1205
2020-03-19,12923,8881,4042,45.51,1205
2020-03-20,14035,9489,4546,47.91,1205
2020-03-21,11958,8217,3741,45.53,1205
2020-03-22,10475,6075,4400,72.43,1205
2020-03-23,12598,8374,4224,50.44,1205
2020-03-24,12923,8694,4229,48.64,1205
2020-03-25,12923,8753,4170,47.64,1205
2020-03-26,12923,8756,4167,47.59,1205
2020-03-27,14035,9382,4653,49.59,1205
2020-03-28,11958,8129,3829,47.1,1205
2020-03-29,10475,6003,4472,74.5,1205
2020-03-30,12598,8317,4281,51.47,1205
2020-03-31,12923,8649,4274,49.42,1205
2020-04-01,12431,8716,3715,42.62,1205
2020-04-02,12431,8725,3706,42.48,1205
2020-04-03,12316,9352,2964,31.69,1205
2020-04-04,11124,8097,3027,37.38,1205
2020-04-05,8435,5965,2470,41.41,1205
2020-04-06,12199,8268,3931,47.54,1205
2020-04-07,12431,8587,3844,44.77,1205
2020-04-08,12431,8638,3793,43.91,1205
2020-04-09,12431,8629,3802,44.06,1205
2020-04-10,12316,9236,3080,33.35,1205
2020-04-11,11124,7959,3165,39.77,1205
2020-04-12,8435,5805,2630,45.31,1205
2020-04-13,12199,8088,4111,50.83,1205
2020-04-14,12431,8387,4044,48.22,1205
2020-04-15,12431,8420,4011,47.64,1205
2020-04-16,12431,8395,4036,48.08,1205
2020-04-17,12316,8991,3325,36.98,1205
2020-04-18,11124,7706,3418,44.36,1205
2020-04-19,8435,5549,2886,52.01,1205
2020-04-20,12199,7834,4365,55.72,1205
2020-04-21,12431,8139,4292,52.73,1205
2020-04-22,12431,8183,4248,51.91,1205
2020-04-23,12431,8175,4256,52.06,1205
2020-04-24,12316,8791,3525,40.1,1205
2020-04-25,11124,7530,3594,47.73,1205
2020-04-26,8435,5401,3034,56.17,1205
2020-04-27,12199,7715,4484,58.12,1205
2020-04-28,12431,8052,4379,54.38,1205
2020-04-29,12431,8129,4302,52.92,1205
2020-04-30,12431,8152,4279,52.49,1205
2020-05-01,16362,8798,7564,85.97,1205
2020-05-02,15177,7566,7611,100.59,1205
2020-05-03,11834,5461,6373,116.7,1205
2020-05-04,15490,7796,7694,98.69,1205
2020-05-05,15878,8148,7730,94.87,1205
2020-05-06,15878,8234,7644,92.83,1205
2020-05-07,15878,8261,7617,92.2,1205
2020-05-08,16362,8903,7459,83.78,1205
2020-05-09,15177,7660,7517,98.13,1205
2020-05-10,11834,5538,6296,113.69,1205
2020-05-11,15490,7848,7642,97.38,1205
2020-05-12,15878,8169,7709,94.37,1205
2020-05-13,15878,8218,7660,93.21,1205
2020-05-14,15878,8202,7676,93.59,1205
2020-05-15,16362,8799,7563,85.95,1205
2020-05-16,15177,7507,7670,102.17,1205
2020-05-17,11834,5333,6501,121.9,1205
2020-05-18,15490,7591,7899,104.06,1205
2020-05-19,15878,7861,8017,101.98,1205
2020-05-20,15878,7861,8017,101.98,1205
2020-05-21,15878,7800,8078,103.56,1205
2020-05-22,16362,8355,8007,95.83,1205
2020-05-23,15177,7027,8150,115.98,1205
2020-05-24,11834,4824,7010,145.32,1205
2020-05-25,15490,7060,8430,119.41,1205
2020-05-26,15878,7316,8562,117.03,1205
2020-05-27,15878,7310,8568,117.21,1205
2020-05-28,15878,7251,8627,118.98,1205
2020-05-29,16362,7817,8545,109.31,1205
2020-05-30,15177,6507,8670,133.24,1205
2020-05-31,11834,4330,7504,173.3,1205
2020-06-01,17092,6599,10493,159.01,1205
2020-06-02,17380,6892,10488,152.18,1205
2020-06-03,17380,6928,10452,150.87,1205
2020-06-04,17380,6914,10466,151.37,1205
2020-06-05,17720,7525,10195,135.48,1205
2020-06-06,16405,6260,10145,162.06,1205
2020-06-07,13744,4125,9619,233.19,1205
2020-06-08,17092,6432,10660,165.73,1205
2020-06-09,17380,6758,10622,157.18,1205
2020-06-10,17380,6819,10561,154.88,1205
2020-06-11,17380,6820,10560,154.84,1205
2020-06-12,17720,7437,10283,138.27,1205
2020-06-13,16405,6168,10237,165.97,1205
2020-06-14,13744,4016,9728,242.23,1205
2020-06-15,17092,6293,10799,171.6,1205
2020-06-16,17380,6577,10803,164.25,1205
2020-06-17,17380,6583,10797,164.01,1205
2020-06-18,17380,6518,10862,166.65,1205
2020-06-19,17720,7058,10662,151.06,1205
2020-06-20,16405,5700,10705,187.81,1205
2020-06-21,13744,3451,10293,298.26,1205
2020-06-22,17092,5625,11467,203.86,1205
2020-06-23,17380,5800,11580,199.66,1205
2020-06-24,17380,5695,11685,205.18,1205
2020-06-25,17380,5517,11863,215.03,1205
2020-06-26,17720,5945,11775,198.07,1205
2020-06-27,16405,4480,11925,266.18,1205
2020-06-28,13744,2131,11613,544.96,1205
2020-06-29,17092,4212,12880,305.79,1205
2020-06-30,17380,4305,13075,303.72,1205
2020-07-01,16614,4130,12484,302.28,1205
2020-07-02,16614,3898,12716,326.22,1205
2020-07-03,17136,4287,12849,299.72,1205
2020-07-04,15428,2801,12627,450.8,1205
2020-07-05,13562,447,13115,2934.0,1205
2020-07-06,16308,2543,13765,541.29,1205
2020-07-07,16614,2669,13945,522.48,1205
2020-07-08,16614,2545,14069,552.81,1205
2020-07-09,16614,2381,14233,597.77,1205
2020-07-10,17136,2856,14280,500.0,1205
2020-07-11,15428,1469,13959,950.24,1205
2020-07-12,13562,804,12758,1586.82,1205
2020-07-13,16308,1450,14858,1024.69,1205
2020-07-14,16614,1710,14904,871.58,1205
2020-07-15,16614,1727,14887,862.02,1205
2020-07-16,16614,1708,14906,872.72,1205
2020-07-17,17136,2329,14807,635.77,1205
2020-07-18,15428,1088,14340,1318.01,1205
2020-07-19,13562,723,12839,1775.8,1205
2020-07-20,16308,1347,14961,1110.69,1205
2020-07-21,16614,1736,14878,857.03,1205
2020-07-22,16614,1871,14743,787.97,1205
2020-07-23,16614,1958,14656,748.52,1205
2020-07-24,17136,2672,14464,541.32,1205
2020-07-25,15428,1509,13919,922.4,1205
2020-07-26,13562,871,12691,1457.06,1205
2020-07-27,16308,1877,14431,768.83,1205
2020-07-28,16614,2295,14319,623.92,1205
2020-07-29,16614,2445,14169,579.51,1205
2020-07-30,16614,2532,14082,556.16,1205
2020-07-31,17136,3231,13905,430.36,1205
2020-08-01,14948,2040,12908,632.75,1205
2020-08-02,13193,1180,12013,1018.05,1205
2020-08-03,15910,2320,13590,585.78,1205
2020-08-04,16039,2682,13357,498.02,1205
2020-08-05,16039,2770,13269,479.03,1205
2020-08-06,16039,2790,13249,474.87,1205
2020-08-07,16398,3422,12976,379.19,1205
2020-08-08,14948,2164,12784,590.76,1205
2020-08-09,13193,25,13168,52672.0,1205
2020-08-10,15910,2320,13590,585.78,1205
2020-08-11,16039,2628,13411,510.31,1205
2020-08-12,16039,2669,13370,500.94,1205
2020-08-13,16039,2652,13387,504.79,1205
2020-08-14,16398,3255,13143,403.78,1205
2020-08-15,14948,1980,12968,654.95,1205
2020-08-16,13193,1108,12085,1090.7,1205
2020-08-17,15910,2131,13779,646.6,1205
2020-08-18,16039,2454,13585,553.59,1205
2020-08-19,16039,2518,13521,536.97,1205
2020-08-20,16039,2533,13506,533.2,1205
2020-08-21,16398,3177,13221,416.15,1205
2020-08-22,14948,1948,13000,667.35,1205
2020-08-23,13193,1111,12082,1087.49,1205
2020-08-24,15910,2208,13702,620.56,1205
2020-08-25,16039,2587,13452,519.98,1205
2020-08-26,16039,2710,13329,491.85,1205
2020-08-27,16039,2782,13257,476.53,1205
2020-08-28,16398,3480,12918,371.21,1205
2020-08-29,14948,2301,12647,549.63,1205
2020-08-30,13193,251,12942,5156.18,1205
2020-08-31,15910,2642,13268,502.2,1205
2020-09-01,16787,3052,13735,450.03,1205
2020-09-02,16787,3196,13591,425.25,1205
2020-09-03,16787,3281,13506,411.64,1205
2020-09-04,17472,3982,13490,338.77,1205
2020-09-05,16482,2797,13685,489.27,1205
2020-09-06,14308,733,13575,1851.98,1205
2020-09-07,16314,3101,13213,426.09,1205
2020-09-08,16787,3480,13307,382.39,1205
2020-09-09,16787,3587,13200,368.0,1205
2020-09-10,16787,3628,13159,362.71,1205
2020-09-11,17472,4282,13190,308.03,1205
2020-09-12,16482,3046,13436,441.1,1205
2020-09-13,14308,928,13380,1441.81,1205
2020-09-14,16314,3242,13072,403.21,1205
2020-09-15,16787,3568,13219,370.49,1205
2020-09-16,16787,3623,13164,363.35,1205
2020-09-17,16787,3616,13171,364.24,1205
2020-09-18,17472,4225,13247,313.54,1205
2020-09-19,16482,2949,13533,458.9,1205
2020-09-20,14308,798,13510,1692.98,1205
2020-09-21,16314,3084,13230,428.99,1205
2020-09-22,16787,3389,13398,395.34,1205
2020-09-23,16787,3430,13357,389.42,1205
2020-09-24,16787,3415,13372,391.57,1205
2020-09-25,17472,4024,13448,334.19,1205
2020-09-26,16482,2754,13728,498.47,1205
2020-09-27,14308,613,13695,2234.09,1205
2020-09-28,16314,2916,13398,459.47,1205
2020-09-29,16787,3240,13547,418.12,1205
2020-09-30,16787,3304,13483,408.08,1205
2020-10-01,16403,3315,13088,394.81,1205
2020-10-02,17166,3950,13216,334.58,1205
2020-10-03,16109,2707,13402,495.09,1205
2020-10-04,13609,593,13016,2194.94,1205
2020-10-05,16255,2920,13335,456.68,1205
2020-10-06,16403,3266,13137,402.24,1205
2020-10-07,16403,3349,13054,389.79,1205
2020-10-08,16403,3375,13028,386.01,1205
2020-10-09,17166,4021,13145,326.91,1205
2020-10-10,16109,2784,13325,478.63,1205
2020-10-11,13609,672,12937,1925.15,1205
2020-10-12,16255,2996,13259,442.56,1205
2020-10-13,16403,3335,13068,391.84,1205
2020-10-14,16403,3407,12996,381.45,1205
2020-10-15,16403,3418,12985,379.9,1205
2020-10-16,17166,4045,13121,324.38,1205
2020-10-17,16109,2788,13321,477.8,1205
2020-10-18,13609,653,12956,1984.07,1205
2020-10-19,16255,2954,13301,450.27,1205
2020-10-20,16403,3270,13133,401.62,1205
2020-10-21,16403,3318,13085,394.36,1205
2020-10-22,16403,3307,13096,396.01,1205
2020-10-23,17166,3915,13251,338.47,1205
2020-10-24,16109,2641,13468,509.96,1205
2020-10-25,13609,492,13117,2666.06,1205
2020-10-26,16255,2783,13472,484.08,1205
2020-10-27,16403,3092,13311,430.5,1205
2020-10-28,16403,3139,13264,422.55,1205
2020-10-29,16403,3130,13273,424.06,1205
2020-10-30,17166,3744,13422,358.49,1205
2020-10-31,16109,2480,13629,549.56,1205
2020-11-01,11722,345,11377,3297.68,1205
2020-11-02,15419,2651,12768,481.63,1205
2020-11-03,14799,2980,11819,396.61,1205
2020-11-04,14799,3047,11752,385.69,1205
2020-11-05,14799,3060,11739,383.63,1205
2020-11-06,15454,3695,11759,318.24,1205
2020-11-07,13624,2452,11172,455.63,1205
2020-11-08,11722,337,11385,3378.34,1205
2020-11-09,15419,2661,12758,479.44,1205
2020-11-10,14799,3005,11794,392.48,1205
2020-11-11,14799,3084,11715,379.86,1205
2020-11-12,14799,3105,11694,376.62,1205
2020-11-13,15454,3745,11709,312.66,1205
2020-11-14,13624,2502,11122,444.52,1205
2020-11-15,11722,382,11340,2968.59,1205
2020-11-16,15419,2698,12721,471.5,1205
2020-11-17,14799,3028,11771,388.74,1205
2020-11-18,14799,3089,11710,379.09,1205
2020-11-19,14799,3089,11710,379.09,1205
2020-11-20,15454,3703,11751,317.34,1205
2020-11-21,13624,2432,11192,460.2,1205
2020-11-22,11722,282,11440,4056.74,1205
2020-11-23,15419,2566,12853,500.9,1205
2020-11-24,14799,2864,11935,416.72,1205
2020-11-25,14799,2892,11907,411.72,1205
2020-11-26,14799,2860,11939,417.45,1205
2020-11-27,15454,3445,12009,348.59,1205
2020-11-28,13624,2146,11478,534.86,1205
2020-11-29,11722,1664,10058,604.45,1205
2020-11-30,15419,2235,13184,589.89,1205
2020-12-01,15263,2516,12747,506.64,1205
2020-12-02,15263,2532,12731,502.8,1205
2020-12-03,15263,2493,12770,512.23,1205
2020-12-04,16461,3075,13386,435.32,1205
2020-12-05,14223,1779,12444,699.49,1205
2020-12-06,11367,1444,9923,687.19,1205
2020-12-07,15238,1888,13350,707.1,1205
2020-12-08,15263,2187,13076,597.9,1205
2020-12-09,15263,2225,13038,585.98,1205
2020-12-10,15263,2212,13051,590.01,1205
2020-12-11,16461,2823,13638,483.1,1205
2020-12-12,14223,1559,12664,812.32,1205
2020-12-13,11367,1452,9915,682.85,1205
2020-12-14,15238,1739,13499,776.25,1205
2020-12-15,15263,2075,13188,635.57,1205
2020-12-16,15263,2151,13112,609.58,1205
2020-12-17,15263,2176,13087,601.42,1205
2020-12-18,16461,2825,13636,482.69,1205
2020-12-19,14223,1597,12626,790.61,1205
2020-12-20,11367,1561,9806,628.19,1205
2020-12-21,15238,1844,13394,726.36,1205
2020-12-22,15263,2210,13053,590.63,1205
2020-12-23,15263,2314,12949,559.59,1205
2020-12-24,15263,2363,12900,545.92,1205
2020-12-25,16461,3034,13427,442.55,1205
2020-12-26,14223,1826,12397,678.92,1205
2020-12-27,11367,1823,9544,523.53,1205
2020-12-28,15238,2102,13136,624.93,1205
2020-12-29,15263,2478,12785,515.94,1205
2020-12-30,15263,2590,12673,489.31,1205
2020-12-31,15263,2644,12619,477.27,1205
2021-01-01,15144,3318,11826,356.42,1205
2021-01-02,12479,2109,10370,491.7,1205
2021-01-03,10538,25,10513,42052.0,1205
2021-01-04,14219,2378,11841,497.94,1205
2021-01-05,14602,2748,11854,431.37,1205
2021-01-06,14602,2850,11752,412.35,1205
2021-01-07,14602,2894,11708,404.56,1205
2021-01-08,15144,3554,11590,326.11,1205
2021-01-09,12479,2330,10149,435.58,1205
2021-01-10,10538,229,10309,4501.75,1205
2021-01-11,14219,2563,11656,454.78,1205
2021-01-12,14602,2911,11691,401.61,1205
2021-01-13,14602,2989,11613,388.52,1205
2021-01-14,14602,3006,11596,385.76,1205
2021-01-15,15144,3638,11506,316.27,1205
2021-01-16,12479,2383,10096,423.67,1205
2021-01-17,10538,249,10289,4132.13,1205
2021-01-18,14219,2548,11671,458.05,1205
2021-01-19,14602,2858,11744,410.92,1205
2021-01-20,14602,2898,11704,403.86,1205
2021-01-21,14602,2875,11727,407.9,1205
2021-01-22,15144,3466,11678,336.93,1205
2021-01-23,12479,2169,10310,475.33,1205
2021-01-24,10538,2072,8466,408.59,1205
2021-01-25,14219,2249,11970,532.24,1205
2021-01-26,14602,2519,12083,479.67,1205
2021-01-27,14602,2520,12082,479.44,1205
2021-01-28,14602,2459,12143,493.82,1205
2021-01-29,15144,3015,12129,402.29,1205
2021-01-30,12479,1688,10791,639.28,1205
2021-01-31,10538,1812,8726,481.57,1205
2021-02-01,15149,1719,13430,781.27,1205
2021-02-02,15203,1971,13232,671.33,1205
2021-02-03,15203,1960,13243,675.66,1205
2021-02-04,15203,1894,13309,702.69,1205
2021-02-05,16066,2450,13616,555.76,1205
2021-02-06,14088,1129,12959,1147.83,1205
2021-02-07,11893,1634,10259,627.85,1205
2021-02-08,15149,1192,13957,1170.89,1205
2021-02-09,15203,1469,13734,934.92,1205
2021-02-10,15203,1489,13714,921.02,1205
2021-02-11,15203,1458,13745,942.73,1205
2021-02-12,16066,2054,14012,682.18,1205
2021-02-13,14088,777,13311,1713.13,1205
2021-02-14,11893,1434,10459,729.36,1205
2021-02-15,15149,935,14214,1520.21,1205
2021-02-16,15203,1263,13940,1103.72,1205
2021-02-17,15203,1332,13871,1041.37,1205
2021-02-18,15203,1351,13852,1025.31,1205
2021-02-19,16066,1995,14071,705.31,1205
2021-02-20,14088,763,13325,1746.4,1205
2021-02-21,11893,1573,10320,656.07,1205
2021-02-22,15149,1000,14149,1414.9,1205
2021-02-23,15203,1360,13843,1017.87,1205
2021-02-24,15203,1457,13746,943.45,1205
2021-02-25,15203,1497,13706,915.56,1205
2021-02-26,16066,2156,13910,645.18,1205
2021-02-27,14088,933,13155,1409.97,1205
2021-02-28,11893,1652,10241,619.92,1205
2021-03-01,15292,1170,14122,1207.01,1205
2021-03-02,15260,1521,13739,903.29,1205
2021-03-03,15260,1603,13657,851.97,1205
2021-03-04,15260,1623,13637,840.23,1205
2021-03-05,16304,2259,14045,621.74,1205
2021-03-06,14676,1009,13667,1354.51,1205
2021-03-07,11790,1866,9924,531.83,1205
2021-03-08,15292,1185,14107,1190.46,1205
2021-03-09,15260,1504,13756,914.63,1205
2021-03-10,15260,1555,13705,881.35,1205
2021-03-11,15260,1545,13715,887.7,1205
2021-03-12,16304,2151,14153,657.97,1205
2021-03-13,14676,875,13801,1577.26,1205
2021-03-14,11790,1819,9971,548.16,1205
2021-03-15,15292,1008,14284,1417.06,1205
2021-03-16,15260,1312,13948,1063.11,1205
2021-03-17,15260,1351,13909,1029.53,1205
2021-03-18,15260,1335,13925,1043.07,1205
2021-03-19,16304,1940,14364,740.41,1205
2021-03-20,14676,665,14011,2106.92,1205
2021-03-21,11790,1701,10089,593.12,1205
2021-03-22,15292,815,14477,1776.32,1205
2021-03-23,15260,1132,14128,1248.06,1205
2021-03-24,15260,1187,14073,1185.59,1205
2021-03-25,15260,1187,14073,1185.59,1205
2021-03-26,16304,1810,14494,800.77,1205
2021-03-27,14676,555,14121,2544.32,1205
2021-03-28,11790,1709,10081,589.88,1205
2021-03-29,15292,739,14553,1969.28,1205
2021-03-30,15260,1071,14189,1324.84,1205
2021-03-31,15260,1138,14122,1240.95,1205
2021-04-01,15451,1149,14302,1244.73,1205
2021-04-02,16624,1778,14846,834.98,1205
2021-04-03,14171,525,13646,2599.24,1205
2021-04-04,11932,1748,10184,582.61,1205
2021-04-05,16267,703,15564,2213.94,1205
2021-04-06,15451,1026,14425,1405.95,1205
2021-04-07,15451,1081,14370,1329.32,1205
2021-04-08,15451,1075,14376,1337.3,1205
2021-04-09,16624,1687,14937,885.42,1205
2021-04-10,14171,413,13758,3331.23,1205
2021-04-11,11932,1725,10207,591.71,1205
2021-04-12,16267,549,15718,2863.02,1205
2021-04-13,15451,850,14601,1717.76,1205
2021-04-14,15451,885,14566,1645.88,1205
2021-04-15,15451,861,14590,1694.54,1205
2021-04-16,16624,1457,15167,1040.97,1205
2021-04-17,14171,171,14000,8187.13,1205
2021-04-18,11932,1568,10364,660.97,1205
2021-04-19,16267,293,15974,5451.88,1205
2021-04-20,15451,595,14856,2496.81,1205
2021-04-21,15451,635,14816,2333.23,1205
2021-04-22,15451,621,14830,2388.08,1205
2021-04-23,16624,1232,15392,1249.35,1205
2021-04-24,14171,2597,11574,445.67,1205
2021-04-25,11932,1634,10298,630.23,1205
2021-04-26,16267,138,16129,11687.68,1205
2021-04-27,15451,469,14982,3194.46,1205
2021-04-28,15451,540,14911,2761.3,1205
2021-04-29,15451,558,14893,2669.0,1205
2021-04-30,16624,1201,15423,1284.18,1205
2021-05-01,17248,2797,14451,516.66,1205
2021-05-02,14004,1557,12447,799.42,1205
2021-05-03,17986,192,17794,9267.71,1205
2021-05-04,18274,545,17729,3253.03,1205
2021-05-05,18274,633,17641,2786.89,1205
2021-05-06,18274,662,17612,2660.42,1205
2021-05-07,18770,1309,17461,1333.92,1205
2021-05-08,17248,72,17176,23855.56,1205
2021-05-09,14004,1792,12212,681.47,1205
2021-05-10,17986,274,17712,6464.23,1205
2021-05-11,18274,604,17670,2925.5,1205
2021-05-12,18274,662,17612,2660.42,1205
2021-05-13,18274,656,17618,2685.67,1205
2021-05-14,18770,1262,17508,1387.32,1205
2021-05-15,17248,2833,14415,508.82,1205
2021-05-16,14004,1777,12227,688.07,1205
2021-05-17,17986,82,17904,21834.15,1205
2021-05-18,18274,360,17914,4976.11,1205
2021-05-19,18274,367,17907,4879.29,1205
2021-05-20,18274,311,17963,5775.88,1205
2021-05-21,18770,871,17899,2054.99,1205
2021-05-22,17248,2830,14418,509.47,1205
2021-05-23,14004,1463,12541,857.21,1205
2021-05-24,17986,2586,15400,595.51,1205
2021-05-25,18274,2896,15378,531.01,1205
2021-05-26,18274,2774,15500,558.76,1205
2021-05-27,18274,2868,15406,537.17,1205
2021-05-28,18770,320,18450,5765.62,1205
2021-05-29,17248,2436,14812,608.05,1205
2021-05-30,14004,1411,12593,892.49,1205
2021-05-31,17986,2744,15242,555.47,1205
2021-06-01,18837,2574,16263,631.82,1205
2021-06-02,18837,2725,16112,591.27,1205
2021-06-03,18837,2857,15980,559.33,1205
2021-06-04,19052,3139,15913,506.94,1205
2021-06-05,17408,2446,14962,611.69,1205
2021-06-06,15591,1347,14244,1057.46,1205
2021-06-07,18374,2471,15903,643.59,1205
2021-06-08,18837,2736,16101,588.49,1205
2021-06-09,18837,2698,16139,598.18,1205
2021-06-10,18837,2716,16121,593.56,1205
2021-06-11,19052,3051,16001,524.45,1205
2021-06-12,17408,2421,14987,619.04,1205
2021-06-13,15591,1403,14188,1011.26,1205
2021-06-14,18374,2541,15833,623.1,1205
2021-06-15,18837,2682,16155,602.35,1205
2021-06-16,18837,2725,16112,591.27,1205
2021-06-17,18837,2692,16145,599.74,1205
2021-06-18,19052,2846,16206,569.43,1205
2021-06-19,17408,2155,15253,707.8,1205
2021-06-20,15591,1223,14368,1174.82,1205
2021-06-21,18374,2186,16188,740.53,1205
2021-06-22,18837,2287,16550,723.66,1205
2021-06-23,18837,2249,16588,737.57,1205
2021-06-24,18837,2324,16513,710.54,1205
2021-06-25,19052,2433,16619,683.07,1205
2021-06-26,17408,1673,15735,940.53,1205
2021-06-27,15591,657,14934,2273.06,1205
2021-06-28,18374,1625,16749,1030.71,1205
2021-06-29,18837,2019,16818,832.99,1205
2021-06-30,18837,1546,17291,1118.43,1205
2021-07-01,16350,1437,14913,1037.79,1205
2021-07-02,16898,1878,15020,799.79,1205
2021-07-03,14503,1070,13433,1255.42,1205
2021-07-04,12861,1070,11791,1101.96,1205
2021-07-05,15894,866,15028,1735.33,1205
2021-07-06,16350,914,15436,1688.84,1205
2021-07-07,16350,918,15432,1681.05,1205
2021-07-08,16350,965,15385,1594.3,1205
2021-07-09,16898,1052,15846,1506.27,1205
2021-07-10,14503,441,14062,3188.66,1205
2021-07-11,12861,441,12420,2816.33,1205
2021-07-12,15894,562,15332,2728.11,1205
2021-07-13,16350,569,15781,2773.46,1205
2021-07-14,16350,431,15919,3693.5,1205
2021-07-15,16350,375,15975,4260.0,1205
2021-07-16,16898,851,16047,1885.66,1205
2021-07-17,14503,851,13652,1604.23,1205
2021-07-18,12861,851,12010,1411.28,1205
2021-07-19,15894,203,15691,7729.56,1205
2021-07-20,16350,379,15971,4213.98,1205
2021-07-21,16350,594,15756,2652.53,1205
2021-07-22,16350,696,15654,2249.14,1205
2021-07-23,16898,982,15916,1620.77,1205
2021-07-24,14503,311,14192,4563.34,1205
2021-07-25,12861,311,12550,4035.37,1205
2021-07-26,15894,689,15205,2206.82,1205
2021-07-27,16350,668,15682,2347.6,1205
2021-07-28,16350,955,15395,1612.04,1205
2021-07-29,16350,859,15491,1803.38,1205
2021-07-30,16898,1141,15757,1380.98,1205
2021-07-31,14503,622,13881,2231.67,1205
2021-08-01,12057,622,11435,1838.42,1205
2021-08-02,15244,833,14411,1730.01,1205
2021-08-03,15509,1087,14422,1326.77,1205
2021-08-04,15509,1202,14307,1190.27,1205
2021-08-05,15509,1144,14365,1255.68,1205
2021-08-06,15800,1515,14285,942.9,1205
2021-08-07,13844,1002,12842,1281.64,1205
2021-08-08,12057,9,12048,133866.67,1205
2021-08-09,15244,1087,14157,1302.39,1205
2021-08-10,15509,1103,14406,1306.07,1205
2021-08-11,15509,1278,14231,1113.54,1205
2021-08-12,15509,1280,14229,1111.64,1205
2021-08-13,15800,1468,14332,976.29,1205
2021-08-14,13844,737,13107,1778.43,1205
2021-08-15,12057,737,11320,1535.96,1205
2021-08-16,15244,839,14405,1716.92,1205
2021-08-17,15509,1073,14436,1345.39,1205
2021-08-18,15509,988,14521,1469.74,1205
2021-08-19,15509,1094,14415,1317.64,1205
2021-08-20,15800,1395,14405,1032.62,1205
2021-08-21,13844,936,12908,1379.06,1205
2021-08-22,12057,936,11121,1188.14,1205
2021-08-23,15244,997,14247,1428.99,1205
2021-08-24,15509,1147,14362,1252.14,1205
2021-08-25,15509,1311,14198,1082.99,1205
2021-08-26,15509,1293,14216,1099.46,1205
2021-08-27,15800,1708,14092,825.06,1205
2021-08-28,13844,1028,12816,1246.69,1205
2021-08-29,12057,74,11983,16193.24,1205
2021-08-30,15244,1370,13874,1012.7,1205
2021-08-31,15509,1523,13986,918.32,1205
2021-09-01,16730,1711,15019,877.79,1205
2021-09-02,16730,1583,15147,956.85,1205
2021-09-03,17327,2034,15293,751.87,1205
2021-09-04,16207,1445,14762,1021.59,1205
2021-09-05,14414,351,14063,4006.55,1205
2021-09-06,16405,1790,14615,816.48,1205
2021-09-07,16730,1785,14945,837.25,1205
2021-09-08,16730,1782,14948,838.83,1205
2021-09-09,16730,1851,14879,803.84,1205
2021-09-10,17327,2196,15131,689.03,1205
2021-09-11,16207,1525,14682,962.75,1205
2021-09-12,14414,718,13696,1907.52,1205
2021-09-13,16405,1755,14650,834.76,1205
2021-09-14,16730,1903,14827,779.14,1205
2021-09-15,16730,2057,14673,713.32,1205
2021-09-16,16730,1982,14748,744.1,1205
2021-09-17,17327,2260,15067,666.68,1205
2021-09-18,16207,1975,14232,720.61,1205
2021-09-19,14414,561,13853,2469.34,1205
2021-09-20,16405,1881,14524,772.14,1205
2021-09-21,16730,1998,14732,737.34,1205
2021-09-22,16730,2187,14543,664.97,1205
2021-09-23,16730,1915,14815,773.63,1205
2021-09-24,17327,2387,14940,625.89,1205
2021-09-25,16207,1752,14455,825.06,1205
2021-09-26,14414,592,13822,2334.8,1205
2021-09-27,16405,1757,14648,833.69,1205
2021-09-28,16730,1880,14850,789.89,1205
2021-09-29,16730,1916,14814,773.17,1205
2021-09-30,16730,1928,14802,767.74,1205
2021-10-01,17578,2578,15000,581.85,1205
2021-10-02,16383,1763,14620,829.27,1205
2021-10-03,14181,720,13461,1869.58,1205
2021-10-04,15999,1646,14353,871.99,1205
2021-10-05,16432,2049,14383,701.95,1205
2021-10-06,16432,1937,14495,748.32,1205
2021-10-07,16432,2023,14409,712.26,1205
2021-10-08,17578,2460,15118,614.55,1205
2021-10-09,16383,1646,14737,895.32,1205
2021-10-10,14181,744,13437,1806.05,1205
2021-10-11,15999,1929,14070,729.39,1205
2021-10-12,16432,1992,14440,724.9,1205
2021-10-13,16432,2173,14259,656.19,1205
2021-10-14,16432,2127,14305,672.54,1205
2021-10-15,17578,2362,15216,644.2,1205
2021-10-16,16383,1618,14765,912.55,1205
2021-10-17,14181,634,13547,2136.75,1205
2021-10-18,15999,2180,13819,633.9,1205
2021-10-19,16432,2225,14207,638.52,1205
2021-10-20,16432,2071,14361,693.43,1205
2021-10-21,16432,2120,14312,675.09,1205
2021-10-22,17578,2591,14987,578.43,1205
2021-10-23,16383,1908,14475,758.65,1205
2021-10-24,14181,781,13400,1715.75,1205
2021-10-25,15999,1867,14132,756.94,1205
2021-10-26,16432,2196,14236,648.27,1205
2021-10-27,16432,2258,14174,627.72,1205
2021-10-28,16432,2106,14326,680.25,1205
2021-10-29,17578,2542,15036,591.5,1205
2021-10-30,16383,1650,14733,892.91,1205
2021-10-31,14181,863,13318,1543.22,1205
2021-11-01,15464,2026,13438,663.28,1205
2021-11-02,16060,2219,13841,623.75,1205
2021-11-03,16060,2184,13876,635.35,1205
2021-11-04,16060,2097,13963,665.86,1205
2021-11-05,16840,2442,14398,589.6,1205
2021-11-06,15638,1916,13722,716.18,1205
2021-11-07,13754,779,12975,1665.6,1205
2021-11-08,15464,2148,13316,619.93,1205
2021-11-09,16060,2146,13914,648.37,1205
2021-11-10,16060,2201,13859,629.67,1205
2021-11-11,16060,2287,13773,602.23,1205
2021-11-12,16840,2528,14312,566.14,1205
2021-11-13,15638,1975,13663,691.8,1205
2021-11-14,13754,971,12783,1316.48,1205
2021-11-15,15464,2238,13226,590.97,1205
2021-11-16,16060,2221,13839,623.1,1205
2021-11-17,16060,2241,13819,616.64,1205
2021-11-18,16060,2381,13679,574.51,1205
2021-11-19,16840,2761,14079,509.92,1205
2021-11-20,15638,2098,13540,645.38,1205
2021-11-21,13754,983,12771,1299.19,1205
2021-11-22,15464,2205,13259,601.32,1205
2021-11-23,16060,2191,13869,633.0,1205
2021-11-24,16060,2330,13730,589.27,1205
2021-11-25,16060,2058,14002,680.37,1205
2021-11-26,16840,2734,14106,515.95,1205
2021-11-27,15638,1994,13644,684.25,1205
2021-11-28,13754,889,12865,1447.13,1205
2021-11-29,15464,2000,13464,673.2,1205
2021-11-30,16060,2155,13905,645.24,1205
2021-12-01,15534,2341,13193,563.56,1205
2021-12-02,15534,2323,13211,568.7,1205
2021-12-03,15660,2531,13129,518.73,1205
2021-12-04,14539,1764,12775,724.21,1205
2021-12-05,12151,826,11325,1371.07,1205
2021-12-06,15414,2003,13411,669.55,1205
2021-12-07,15534,2031,13503,664.84,1205
2021-12-08,15534,2032,13502,664.47,1205
2021-12-09,15534,2284,13250,580.12,1205
2021-12-10,15660,2376,13284,559.09,1205
2021-12-11,14539,1907,12632,662.4,1205
2021-12-12,12151,834,11317,1356.95,1205
2021-12-13,15414,1958,13456,687.23,1205
2021-12-14,15534,2130,13404,629.3,1205
2021-12-15,15534,1987,13547,681.78,1205
2021-12-16,15534,2020,13514,669.01,1205
2021-12-17,15660,2402,13258,551.96,1205
2021-12-18,14539,1808,12731,704.15,1205
2021-12-19,12151,729,11422,1566.8,1205
2021-12-20,15414,2040,13374,655.59,1205
2021-12-21,15534,2109,13425,636.56,1205
2021-12-22,15534,2147,13387,623.52,1205
2021-12-23,15534,2352,13182,560.46,1205
2021-12-24,15660,2656,13004,489.61,1205
2021-12-25,14539,2150,12389,576.23,1205
2021-12-26,12151,1168,10983,940.33,1205
2021-12-27,15414,2239,13175,588.43,1205
2021-12-28,15534,2294,13240,577.16,1205
2021-12-29,15534,2533,13001,513.26,1205
2021-12-30,15534,2550,12984,509.18,1205
2021-12-31,15660,2853,12807,448.9,1205
2022-01-01,14344,2239,12105,540.64,1205
2022-01-02,11783,1126,10657,946.45,1205
2022-01-03,15078,2525,12553,497.15,1205
2022-01-04,15476,2664,12812,480.93,1205
2022-01-05,15476,2886,12590,436.24,1205
2022-01-06,15476,2752,12724,462.35,1205
2022-01-07,15882,3073,12809,416.82,1205
2022-01-08,14344,2247,12097,538.36,1205
2022-01-09,11783,1449,10334,713.18,1205
2022-01-10,15078,2657,12421,467.48,1205
2022-01-11,15476,2914,12562,431.09,1205
2022-01-12,15476,2890,12586,435.5,1205
2022-01-13,15476,2709,12767,471.28,1205
2022-01-14,15882,3333,12549,376.51,1205
2022-01-15,14344,2485,11859,477.22,1205
2022-01-16,11783,1343,10440,777.36,1205
2022-01-17,15078,2588,12490,482.61,1205
2022-01-18,15476,2940,12536,426.39,1205
2022-01-19,15476,3107,12369,398.1,1205
2022-01-20,15476,3002,12474,415.52,1205
2022-01-21,15882,3094,12788,413.32,1205
2022-01-22,14344,2419,11925,492.97,1205
2022-01-23,11783,1630,10153,622.88,1205
2022-01-24,15078,2586,12492,483.06,1205
2022-01-25,15476,2799,12677,452.91,1205
2022-01-26,15476,2821,12655,448.6,1205
2022-01-27,15476,2823,12653,448.21,1205
2022-01-28,15882,3154,12728,403.55,1205
2022-01-29,14344,2374,11970,504.21,1205
2022-01-30,11783,1264,10519,832.2,1205
2020-02-01,14709,14937,-228,-1.53,1616
2020-02-02,11995,12482,-487,-3.9,1616
2020-02-03,16292,18437,-2145,-11.63,1616
2020-02-04,17093,18805,-1712,-9.1,1616
2020-02-05,17093,18804,-1711,-9.1,1616
2020-02-06,17093,18841,-1748,-9.28,1616
2020-02-07,17480,18953,-1473,-7.77,1616
2020-02-08,14709,15014,-305,-2.03,1616
2020-02-09,11995,12530,-535,-4.27,1616
2020-02-10,16292,18466,-2174,-11.77,1616
2020-02-11,17093,18821,-1728,-9.18,1616
2020-02-12,17093,18817,-1724,-9.16,1616
2020-02-13,17093,18859,-1766,-9.36,1616
2020-02-14,17480,18984,-1504,-7.92,1616
2020-02-15,14709,15065,-356,-2.36,1616
2020-02-16,11995,12611,-616,-4.88,1616
2020-02-17,16292,18581,-2289,-12.32,1616
2020-02-18,17093,18977,-1884,-9.93,1616
2020-02-19,17093,19017,-1924,-10.12,1616
2020-02-20,17093,19107,-2014,-10.54,1616
2020-02-21,17480,19281,-1801,-9.34,1616
2020-02-22,14709,15411,-702,-4.56,1616
2020-02-23,11995,13003,-1008,-7.75,1616
2020-02-24,16292,19017,-2725,-14.33,1616
2020-02-25,17093,19451,-2358,-12.12,1616
2020-02-26,17093,19525,-2432,-12.46,1616
2020-02-27,17093,19640,-2547,-12.97,1616
2020-02-28,17480,19832,-2352,-11.86,1616
2020-02-29,14709,15973,-1264,-7.91,1616
2020-03-01,9283,13566,-4283,-31.57,1616
2020-03-02,13418,19573,-6155,-31.45,1616
2020-03-03,13821,19992,-6171,-30.87,1616
2020-03-04,13821,20042,-6221,-31.04,1616
2020-03-05,13821,20126,-6305,-31.33,1616
2020-03-06,14442,20281,-5839,-28.79,1616
2020-03-07,10927,16379,-5452,-33.29,1616
2020-03-08,9283,13926,-4643,-33.34,1616
2020-03-09,13418,19884,-6466,-32.52,1616
2020-03-10,13821,20253,-6432,-31.76,1616
2020-03-11,13821,20253,-6432,-31.76,1616
2020-03-12,13821,20289,-6468,-31.88,1616
2020-03-13,14442,20399,-5957,-29.2,1616
2020-03-14,10927,16456,-5529,-33.6,1616
2020-03-15,9283,13968,-4685,-33.54,1616
2020-03-16,13418,19897,-6479,-32.56,1616
2020-03-17,13821,20244,-6423,-31.73,1616
2020-03-18,13821,20230,-6409,-31.68,1616
2020-03-19,13821,20260,-6439,-31.78,1616
2020-03-20,14442,20371,-5929,-29.11,1616
2020-03-21,10927,16437,-5510,-33.52,1616
2020-03-22,9283,13965,-4682,-33.53,1616
2020-03-23,13418,19917,-6499,-32.63,1616
2020-03-24,13821,20292,-6471,-31.89,1616
2020-03-25,13821,20310,-6489,-31.95,1616
2020-03-26,13821,20375,-6554,-32.17,1616
2020-03-27,14442,20524,-6082,-29.63,1616
2020-03-28,10927,16628,-5701,-34.29,1616
2020-03-29,9283,14193,-4910,-34.59,1616
2020-03-30,13418,20179,-6761,-33.51,1616
2020-03-31,13821,20585,-6764,-32.86,1616
2020-04-01,14044,20630,-6586,-31.92,1616
2020-04-02,14044,20716,-6672,-32.21,1616
2020-04-03,13435,20879,-7444,-35.65,1616
2020-04-04,10784,16991,-6207,-36.53,1616
2020-04-05,8168,14556,-6388,-43.89,1616
2020-04-06,13839,20536,-6697,-32.61,1616
2020-04-07,14044,20927,-6883,-32.89,1616
2020-04-08,14044,20951,-6907,-32.97,1616
2020-04-09,14044,21010,-6966,-33.16,1616
2020-04-10,13435,21141,-7706,-36.45,1616
2020-04-11,10784,17215,-6431,-37.36,1616
2020-04-12,8168,14740,-6572,-44.59,1616
2020-04-13,13839,20676,-6837,-33.07,1616
2020-04-14,14044,21024,-6980,-33.2,1616
2020-04-15,14044,21005,-6961,-33.14,1616
2020-04-16,14044,21022,-6978,-33.19,1616
2020-04-17,13435,21113,-7678,-36.37,1616
2020-04-18,10784,17153,-6369,-37.13,1616
2020-04-19,8168,14647,-6479,-44.23,1616
2020-04-20,13839,20559,-6720,-32.69,1616
2020-04-21,14044,20889,-6845,-32.77,1616
2020-04-22,14044,20858,-6814,-32.67,1616
2020-04-23,14044,20870,-6826,-32.71,1616
2020-04-24,13435,20964,-7529,-35.91,1616
2020-04-25,10784,17012,-6228,-36.61,1616
2020-04-26,8168,14521,-6353,-43.75,1616
2020-04-27,13839,20453,-6614,-32.34,1616
2020-04-28,14044,20807,-6763,-32.5,1616
2020-04-29,14044,20803,-6759,-32.49,1616
2020-04-30,14044,20845,-6801,-32.63,1616
2020-05-01,17187,20969,-3782,-18.04,1616
2020-05-02,14025,17046,-3021,-17.72,1616
2020-05-03,11298,14583,-3285,-22.53,1616
2020-05-04,16576,20540,-3964,-19.3,1616
2020-05-05,17551,20915,-3364,-16.08,1616
2020-05-06,17551,20927,-3376,-16.13,1616
2020-05-07,17551,20980,-3429,-16.34,1616
2020-05-08,17187,21108,-3921,-18.58,1616
2020-05-09,14025,17184,-3159,-18.38,1616
2020-05-10,11298,14712,-3414,-23.21,1616
2020-05-11,16576,20654,-4078,-19.74,1616
2020-05-12,17551,21007,-3456,-16.45,1616
2020-05-13,17551,20993,-3442,-16.4,1616
2020-05-14,17551,21015,-3464,-16.48,1616
2020-05-15,17187,21109,-3922,-18.58,1616
2020-05-16,14025,17148,-3123,-18.21,1616
2020-05-17,11298,14639,-3341,-22.82,1616
2020-05-18,16576,20544,-3968,-19.31,1616
2020-05-19,17551,20864,-3313,-15.88,1616
2020-05-20,17551,20819,-3268,-15.7,1616
2020-05-21,17551,20815,-3264,-15.68,1616
2020-05-22,17187,20890,-3703,-17.73,1616
2020-05-23,14025,16917,-2892,-17.1,1616
2020-05-24,11298,14405,-3107,-21.57,1616
2020-05-25,16576,20315,-3739,-18.41,1616
2020-05-26,17551,20649,-3098,-15.0,1616
2020-05-27,17551,20628,-3077,-14.92,1616
2020-05-28,17551,20656,-3105,-15.03,1616
2020-05-29,17187,20771,-3584,-17.25,1616
2020-05-30,14025,16845,-2820,-16.74,1616
2020-05-31,11298,14386,-3088,-21.47,1616
2020-06-01,17339,20354,-3015,-14.81,1616
2020-06-02,18442,20748,-2306,-11.11,1616
2020-06-03,18442,20788,-2346,-11.29,1616
2020-06-04,18442,20875,-2433,-11.66,1616
2020-06-05,17224,21046,-3822,-18.16,1616
2020-06-06,14012,17170,-3158,-18.39,1616
2020-06-07,11778,14753,-2975,-20.17,1616
2020-06-08,17339,20752,-3413,-16.45,1616
2020-06-09,18442,21166,-2724,-12.87,1616
2020-06-10,18442,21211,-2769,-13.05,1616
2020-06-11,18442,21290,-2848,-13.38,1616
2020-06-12,17224,21436,-4212,-19.65,1616
2020-06-13,14012,17519,-3507,-20.02,1616
2020-06-14,11778,15043,-3265,-21.7,1616
2020-06-15,17339,20969,-3630,-17.31,1616
2020-06-16,18442,21293,-2851,-13.39,1616
2020-06-17,18442,21234,-2792,-13.15,1616
2020-06-18,18442,21196,-2754,-12.99,1616
2020-06-19,17224,21214,-3990,-18.81,1616
2020-06-20,14012,17161,-3149,-18.35,1616
2020-06-21,11778,14544,-2766,-19.02,1616
2020-06-22,17339,20324,-2985,-14.69,1616
2020-06-23,18442,20503,-2061,-10.05,1616
2020-06-24,18442,20302,-1860,-9.16,1616
2020-06-25,18442,20128,-1686,-8.38,1616
2020-06-26,17224,20019,-2795,-13.96,1616
2020-06-27,14012,15850,-1838,-11.6,1616
2020-06-28,11778,13133,-1355,-10.32,1616
2020-06-29,17339,18830,-1491,-7.92,1616
2020-06-30,18442,18944,-502,-2.65,1616
2020-07-01,18213,18699,-486,-2.6,1616
2020-07-02,18213,18502,-289,-1.56,1616
2020-07-03,17871,18392,-521,-2.83,1616
2020-07-04,13374,14244,-870,-6.11,1616
2020-07-05,12243,11568,675,5.84,1616
2020-07-06,17334,17326,8,0.05,1616
2020-07-07,18213,17520,693,3.96,1616
2020-07-08,18213,17370,843,4.85,1616
2020-07-09,18213,17282,931,5.39,1616
2020-07-10,17871,17291,580,3.35,1616
2020-07-11,13374,13269,105,0.79,1616
2020-07-12,12243,10722,1521,14.19,1616
2020-07-13,17334,16609,725,4.37,1616
2020-07-14,18213,16928,1285,7.59,1616
2020-07-15,18213,16896,1317,7.79,1616
2020-07-16,18213,16914,1299,7.68,1616
2020-07-17,17871,17015,856,5.03,1616
2020-07-18,13374,13069,305,2.33,1616
2020-07-19,12243,10578,1665,15.74,1616
2020-07-20,17334,16500,834,5.05,1616
2020-07-21,18213,16832,1381,8.2,1616
2020-07-22,18213,16790,1423,8.48,1616
2020-07-23,18213,16775,1438,8.57,1616
2020-07-24,17871,16821,1050,6.24,1616
2020-07-25,13374,12798,576,4.5,1616
2020-07-26,12243,10211,2032,19.9,1616
2020-07-27,17334,16021,1313,8.2,1616
2020-07-28,18213,16227,1986,12.24,1616
2020-07-29,18213,16048,2165,13.49,1616
2020-07-30,18213,15890,2323,14.62,1616
2020-07-31,17871,15790,2081,13.18,1616
2020-08-01,13756,11624,2132,18.34,1616
2020-08-02,11885,8900,2985,33.54,1616
2020-08-03,16711,14583,2128,14.59,1616
2020-08-04,17609,14676,2933,19.99,1616
2020-08-05,17609,14404,3205,22.25,1616
2020-08-06,17609,14174,3435,24.23,1616
2020-08-07,17300,14028,3272,23.32,1616
2020-08-08,13756,9843,3913,39.75,1616
2020-08-09,11885,7130,4755,66.69,1616
2020-08-10,16711,12855,3856,30.0,1616
2020-08-11,17609,13021,4588,35.24,1616
2020-08-12,17609,12852,4757,37.01,1616
2020-08-13,17609,12757,4852,38.03,1616
2020-08-14,17300,12774,4526,35.43,1616
2020-08-15,13756,8779,4977,56.69,1616
2020-08-16,11885,6279,5606,89.28,1616
2020-08-17,16711,12237,4474,36.56,1616
2020-08-18,17609,12652,4957,39.18,1616
2020-08-19,17609,12744,4865,38.17,1616
2020-08-20,17609,12917,4692,36.32,1616
2020-08-21,17300,13205,4095,31.01,1616
2020-08-22,13756,9477,4279,45.15,1616
2020-08-23,11885,7237,4648,64.23,1616
2020-08-24,16711,13444,3267,24.3,1616
2020-08-25,17609,14091,3518,24.97,1616
2020-08-26,17609,14395,3214,22.33,1616
2020-08-27,17609,14756,2853,19.33,1616
2020-08-28,17300,15204,2096,13.79,1616
2020-08-29,13756,11607,2149,18.51,1616
2020-08-30,11885,9468,2417,25.53,1616
2020-08-31,16711,15742,969,6.16,1616
2020-09-01,18403,16425,1978,12.04,1616
2020-09-02,18403,16733,1670,9.98,1616
2020-09-03,18403,17066,1337,7.83,1616
2020-09-04,18234,17458,776,4.44,1616
2020-09-05,15407,13778,1629,11.82,1616
2020-09-06,12776,11531,1245,10.8,1616
2020-09-07,17718,17677,41,0.23,1616
2020-09-08,18403,18215,188,1.03,1616
2020-09-09,18403,18364,39,0.21,1616
2020-09-10,18403,18529,-126,-0.68,1616
2020-09-11,18234,18747,-513,-2.74,1616
2020-09-12,15407,14893,514,3.45,1616
2020-09-13,12776,12475,301,2.41,1616
2020-09-14,17718,18457,-739,-4.0,1616
2020-09-15,18403,18839,-436,-2.31,1616
2020-09-16,18403,18847,-444,-2.36,1616
2020-09-17,18403,18886,-483,-2.56,1616
2020-09-18,18234,18996,-762,-4.01,1616
2020-09-19,15407,15052,355,2.36,1616
2020-09-20,12776,12564,212,1.69,1616
2020-09-21,17718,18495,-777,-4.2,1616
2020-09-22,18403,18848,-445,-2.36,1616
2020-09-23,18403,18844,-441,-2.34,1616
2020-09-24,18403,18890,-487,-2.58,1616
2020-09-25,18234,19022,-788,-4.14,1616
2020-09-26,15407,15115,292,1.93,1616
2020-09-27,12776,12675,101,0.8,1616
2020-09-28,17718,18663,-945,-5.06,1616
2020-09-29,18403,19079,-676,-3.54,1616
2020-09-30,18403,19142,-739,-3.86,1616
2020-10-01,18146,19254,-1108,-5.75,1616
2020-10-02,18082,19451,-1369,-7.04,1616
2020-10-03,15015,15604,-589,-3.77,1616
2020-10-04,12561,13217,-656,-4.96,1616
2020-10-05,18194,19250,-1056,-5.49,1616
2020-10-06,18146,19699,-1553,-7.88,1616
2020-10-07,18146,19784,-1638,-8.28,1616
2020-10-08,18146,19907,-1761,-8.85,1616
2020-10-09,18082,20102,-2020,-10.05,1616
2020-10-10,15015,16240,-1225,-7.54,1616
2020-10-11,12561,13827,-1266,-9.16,1616
2020-10-12,18194,19822,-1628,-8.21,1616
2020-10-13,18146,20225,-2079,-10.28,1616
2020-10-14,18146,20255,-2109,-10.41,1616
2020-10-15,18146,20317,-2171,-10.69,1616
2020-10-16,18082,20447,-2365,-11.57,1616
2020-10-17,15015,16517,-1502,-9.09,1616
2020-10-18,12561,14037,-1476,-10.52,1616
2020-10-19,18194,19968,-1774,-8.88,1616
2020-10-20,18146,20310,-2164,-10.65,1616
2020-10-21,18146,20286,-2140,-10.55,1616
2020-10-22,18146,20301,-2155,-10.62,1616
2020-10-23,18082,20393,-2311,-11.33,1616
2020-10-24,15015,16437,-1422,-8.65,1616
2020-10-25,12561,13940,-1379,-9.89,1616
2020-10-26,18194,19865,-1671,-8.41,1616
2020-10-27,18146,20214,-2068,-10.23,1616
2020-10-28,18146,20206,-2060,-10.19,1616
2020-10-29,18146,20248,-2102,-10.38,1616
2020-10-30,18082,20375,-2293,-11.25,1616
2020-10-31,15015,16462,-1447,-8.79,1616
2020-11-01,10735,14014,-3279,-23.4,1616
2020-11-02,16794,19992,-3198,-16.0,1616
2020-11-03,16236,20395,-4159,-20.39,1616
2020-11-04,16236,20443,-4207,-20.58,1616
2020-11-05,16236,20537,-4301,-20.94,1616
2020-11-06,16565,20714,-4149,-20.03,1616
2020-11-07,13064,16844,-3780,-22.44,1616
2020-11-08,10735,14432,-3697,-25.62,1616
2020-11-09,16794,20437,-3643,-17.83,1616
2020-11-10,16236,20857,-4621,-22.16,1616
2020-11-11,16236,20911,-4675,-22.36,1616
2020-11-12,16236,21000,-4764,-22.69,1616
2020-11-13,16565,21160,-4595,-21.72,1616
2020-11-14,13064,17261,-4197,-24.31,1616
2020-11-15,10735,14810,-4075,-27.52,1616
2020-11-16,16794,20765,-3971,-19.12,1616
2020-11-17,16236,21127,-4891,-23.15,1616
2020-11-18,16236,21115,-4879,-23.11,1616
2020-11-19,16236,21133,-4897,-23.17,1616
2020-11-20,16565,21217,-4652,-21.93,1616
2020-11-21,13064,17241,-4177,-24.23,1616
2020-11-22,10735,14712,-3977,-27.03,1616
2020-11-23,16794,20593,-3799,-18.45,1616
2020-11-24,16236,20884,-4648,-22.26,1616
2020-11-25,16236,20807,-4571,-21.97,1616
2020-11-26,16236,20767,-4531,-21.82,1616
2020-11-27,16565,20804,-4239,-20.38,1616
2020-11-28,13064,16790,-3726,-22.19,1616
2020-11-29,10735,14236,-3501,-24.59,1616
2020-11-30,16794,20102,-3308,-16.46,1616
2020-12-01,16136,20391,-4255,-20.87,1616
2020-12-02,16136,20323,-4187,-20.6,1616
2020-12-03,16136,20305,-4169,-20.53,1616
2020-12-04,17462,20373,-2911,-14.29,1616
2020-12-05,13430,16400,-2970,-18.11,1616
2020-12-06,10410,13893,-3483,-25.07,1616
2020-12-07,16146,19814,-3668,-18.51,1616
2020-12-08,16136,20161,-4025,-19.96,1616
2020-12-09,16136,20155,-4019,-19.94,1616
2020-12-10,16136,20197,-4061,-20.11,1616
2020-12-11,17462,20324,-2862,-14.08,1616
2020-12-12,13430,16407,-2977,-18.14,1616
2020-12-13,10410,13950,-3540,-25.38,1616
2020-12-14,16146,19913,-3767,-18.92,1616
2020-12-15,16136,20293,-4157,-20.48,1616
2020-12-16,16136,20309,-4173,-20.55,1616
2020-12-17,16136,20364,-4228,-20.76,1616
2020-12-18,17462,20491,-3029,-14.78,1616
2020-12-19,13430,16562,-3132,-18.91,1616
2020-12-20,10410,14082,-3672,-26.08,1616
2020-12-21,16146,20010,-3864,-19.31,1616
2020-12-22,16136,20346,-4210,-20.69,1616
2020-12-23,16136,20308,-4172,-20.54,1616
2020-12-24,16136,20301,-4165,-20.52,1616
2020-12-25,17462,20360,-2898,-14.23,1616
2020-12-26,13430,16359,-2929,-17.9,1616
2020-12-27,10410,13804,-3394,-24.59,1616
2020-12-28,16146,19657,-3511,-17.86,1616
2020-12-29,16136,19920,-3784,-19.0,1616
2020-12-30,16136,19814,-3678,-18.56,1616
2020-12-31,16136,19744,-3608,-18.27,1616
2021-01-01,15082,19748,-4666,-23.63,1616
2021-01-02,11645,15701,-4056,-25.83,1616
2021-01-03,9390,13112,-3722,-28.39,1616
2021-01-04,14506,18943,-4437,-23.42,1616
2021-01-05,15228,19197,-3969,-20.68,1616
2021-01-06,15228,19094,-3866,-20.25,1616
2021-01-07,15228,19041,-3813,-20.03,1616
2021-01-08,15082,19075,-3993,-20.93,1616
2021-01-09,11645,15071,-3426,-22.73,1616
2021-01-10,9390,12535,-3145,-25.09,1616
2021-01-11,14506,18430,-3924,-21.29,1616
2021-01-12,15228,18756,-3528,-18.81,1616
2021-01-13,15228,18733,-3505,-18.71,1616
2021-01-14,15228,18764,-3536,-18.84,1616
2021-01-15,15082,18886,-3804,-20.14,1616
2021-01-16,11645,14970,-3325,-22.21,1616
2021-01-17,9390,12522,-3132,-25.01,1616
2021-01-18,14506,18501,-3995,-21.59,1616
2021-01-19,15228,18907,-3679,-19.46,1616
2021-01-20,15228,18956,-3728,-19.67,1616
2021-01-21,15228,19052,-3824,-20.07,1616
2021-01-22,15082,19229,-4147,-21.57,1616
2021-01-23,11645,15359,-3714,-24.18,1616
2021-01-24,9390,12945,-3555,-27.46,1616
2021-01-25,14506,18947,-4441,-23.44,1616
2021-01-26,15228,19364,-4136,-21.36,1616
2021-01-27,15228,19415,-4187,-21.57,1616
2021-01-28,15228,19502,-4274,-21.92,1616
2021-01-29,15082,19660,-4578,-23.29,1616
2021-01-30,11645,15763,-4118,-26.12,1616
2021-01-31,9390,13316,-3926,-29.48,1616
2021-02-01,16264,19280,-3016,-15.64,1616
2021-02-02,16755,19654,-2899,-14.75,1616
2021-02-03,16755,19661,-2906,-14.78,1616
2021-02-04,16755,19703,-2948,-14.96,1616
2021-02-05,16889,19819,-2930,-14.78,1616
2021-02-06,13400,15882,-2482,-15.63,1616
2021-02-07,10870,13400,-2530,-18.88,1616
2021-02-08,16264,19335,-3071,-15.88,1616
2021-02-09,16755,19687,-2932,-14.89,1616
2021-02-10,16755,19679,-2924,-14.86,1616
2021-02-11,16755,19716,-2961,-15.02,1616
2021-02-12,16889,19834,-2945,-14.85,1616
2021-02-13,13400,15908,-2508,-15.77,1616
2021-02-14,10870,13445,-2575,-19.15,1616
2021-02-15,16264,19407,-3143,-16.2,1616
2021-02-16,16755,19793,-3038,-15.35,1616
2021-02-17,16755,19825,-3070,-15.49,1616
2021-02-18,16755,19905,-3150,-15.83,1616
2021-02-19,16889,20070,-3181,-15.85,1616
2021-02-20,13400,16193,-2793,-17.25,1616
2021-02-21,10870,13779,-2909,-21.11,1616
2021-02-22,16264,19788,-3524,-17.81,1616
2021-02-23,16755,20219,-3464,-17.13,1616
2021-02-24,16755,20290,-3535,-17.42,1616
2021-02-25,16755,20405,-3650,-17.89,1616
2021-02-26,16889,20598,-3709,-18.01,1616
2021-02-27,13400,16741,-3341,-19.96,1616
2021-02-28,10870,14339,-3469,-24.19,1616
2021-03-01,17050,20352,-3302,-16.22,1616
2021-03-02,17720,20777,-3057,-14.71,1616
2021-03-03,17720,20835,-3115,-14.95,1616
2021-03-04,17720,20929,-3209,-15.33,1616
2021-03-05,17159,21093,-3934,-18.65,1616
2021-03-06,14738,17200,-2462,-14.31,1616
2021-03-07,11170,14757,-3587,-24.31,1616
2021-03-08,17050,20724,-3674,-17.73,1616
2021-03-09,17720,21101,-3381,-16.02,1616
2021-03-10,17720,21109,-3389,-16.05,1616
2021-03-11,17720,21152,-3432,-16.23,1616
2021-03-12,17159,21267,-4108,-19.32,1616
2021-03-13,14738,17329,-2591,-14.95,1616
2021-03-14,11170,14843,-3673,-24.75,1616
2021-03-15,17050,20774,-3724,-17.93,1616
2021-03-16,17720,21120,-3400,-16.1,1616
2021-03-17,17720,21105,-3385,-16.04,1616
2021-03-18,17720,21132,-3412,-16.15,1616
2021-03-19,17159,21239,-4080,-19.21,1616
2021-03-20,14738,17300,-2562,-14.81,1616
2021-03-21,11170,14822,-3652,-24.64,1616
2021-03-22,17050,20766,-3716,-17.89,1616
2021-03-23,17720,21134,-3414,-16.15,1616
2021-03-24,17720,21145,-3425,-16.2,1616
2021-03-25,17720,21203,-3483,-16.43,1616
2021-03-26,17159,21345,-4186,-19.61,1616
2021-03-27,14738,17443,-2705,-15.51,1616
2021-03-28,11170,15003,-3833,-25.55,1616
2021-03-29,17050,20985,-3935,-18.75,1616
2021-03-30,17720,21388,-3668,-17.15,1616
2021-03-31,17720,21431,-3711,-17.32,1616
2021-04-01,16703,21517,-4814,-22.37,1616
2021-04-02,16670,21681,-5011,-23.11,1616
2021-04-03,13477,17795,-4318,-24.27,1616
2021-04-04,11409,15364,-3955,-25.74,1616
2021-04-05,16541,21349,-4808,-22.52,1616
2021-04-06,16703,21747,-5044,-23.19,1616
2021-04-07,16703,21777,-5074,-23.3,1616
2021-04-08,16703,21844,-5141,-23.54,1616
2021-04-09,16670,21983,-5313,-24.17,1616
2021-04-10,13477,18065,-4588,-25.4,1616
2021-04-11,11409,15598,-4189,-26.86,1616
2021-04-12,16541,21543,-5002,-23.22,1616
2021-04-13,16703,21898,-5195,-23.72,1616
2021-04-14,16703,21885,-5182,-23.68,1616
2021-04-15,16703,21908,-5205,-23.76,1616
2021-04-16,16670,22005,-5335,-24.24,1616
2021-04-17,13477,18047,-4570,-25.32,1616
2021-04-18,11409,15544,-4135,-26.6,1616
2021-04-19,16541,21457,-4916,-22.91,1616
2021-04-20,16703,21786,-5083,-23.33,1616
2021-04-21,16703,21754,-5051,-23.22,1616
2021-04-22,16703,21764,-5061,-23.25,1616
2021-04-23,16670,21854,-5184,-23.72,1616
2021-04-24,13477,17897,-4420,-24.7,1616
2021-04-25,11409,15401,-3992,-25.92,1616
2021-04-26,16541,21327,-4786,-22.44,1616
2021-04-27,16703,21675,-4972,-22.94,1616
2021-04-28,16703,21665,-4962,-22.9,1616
2021-04-29,16703,21702,-4999,-23.03,1616
2021-04-30,16670,21821,-5151,-23.61,1616
2021-05-01,14840,17894,-3054,-17.07,1616
2021-05-02,11363,15428,-4065,-26.35,1616
2021-05-03,17584,21382,-3798,-17.76,1616
2021-05-04,18243,21756,-3513,-16.15,1616
2021-05-05,18243,21769,-3526,-16.2,1616
2021-05-06,18243,21823,-3580,-16.4,1616
2021-05-07,17538,21954,-4416,-20.11,1616
2021-05-08,14840,18033,-3193,-17.71,1616
2021-05-09,11363,15566,-4203,-27.0,1616
2021-05-10,17584,21514,-3930,-18.27,1616
2021-05-11,18243,21874,-3631,-16.6,1616
2021-05-12,18243,21867,-3624,-16.57,1616
2021-05-13,18243,21896,-3653,-16.68,1616
2021-05-14,17538,21997,-4459,-20.27,1616
2021-05-15,14840,18042,-3202,-17.75,1616
2021-05-16,11363,15539,-4176,-26.87,1616
2021-05-17,17584,21450,-3866,-18.02,1616
2021-05-18,18243,21773,-3530,-16.21,1616
2021-05-19,18243,21731,-3488,-16.05,1616
2021-05-20,18243,21729,-3486,-16.04,1616
2021-05-21,17538,21803,-4265,-19.56,1616
2021-05-22,14840,17828,-2988,-16.76,1616
2021-05-23,11363,15311,-3948,-25.79,1616
2021-05-24,17584,21216,-3632,-17.12,1616
2021-05-25,18243,21542,-3299,-15.31,1616
2021-05-26,18243,21512,-3269,-15.2,1616
2021-05-27,18243,21531,-3288,-15.27,1616
2021-05-28,17538,21635,-4097,-18.94,1616
2021-05-29,14840,17698,-2858,-16.15,1616
2021-05-30,11363,15227,-3864,-25.38,1616
2021-05-31,17584,21184,-3600,-16.99,1616
2021-06-01,18625,21567,-2942,-13.64,1616
2021-06-02,18625,21597,-2972,-13.76,1616
2021-06-03,18625,21676,-3051,-14.08,1616
2021-06-04,17621,21840,-4219,-19.32,1616
2021-06-05,14881,17959,-3078,-17.14,1616
2021-06-06,12746,15540,-2794,-17.98,1616
2021-06-07,18032,21540,-3508,-16.29,1616
2021-06-08,18625,21958,-3333,-15.18,1616
2021-06-09,18625,22010,-3385,-15.38,1616
2021-06-10,18625,22099,-3474,-15.72,1616
2021-06-11,17621,22258,-4637,-20.83,1616
2021-06-12,14881,18357,-3476,-18.94,1616
2021-06-13,12746,15900,-3154,-19.84,1616
2021-06-14,18032,21847,-3815,-17.46,1616
2021-06-15,18625,22195,-3570,-16.08,1616
2021-06-16,18625,22161,-3536,-15.96,1616
2021-06-17,18625,22149,-3524,-15.91,1616
2021-06-18,17621,22194,-4573,-20.6,1616
2021-06-19,14881,18168,-3287,-18.09,1616
2021-06-20,12746,15578,-2832,-18.18,1616
2021-06-21,18032,21383,-3351,-15.67,1616
2021-06-22,18625,21586,-2961,-13.72,1616
2021-06-23,18625,21407,-2782,-13.0,1616
2021-06-24,18625,21252,-2627,-12.36,1616
2021-06-25,17621,21159,-3538,-16.72,1616
2021-06-26,14881,17003,-2122,-12.48,1616
2021-06-27,12746,14294,-1548,-10.83,1616
2021-06-28,18032,19996,-1964,-9.82,1616
2021-06-29,18625,20111,-1486,-7.39,1616
2021-06-30,18625,19863,-1238,-6.23,1616
2021-07-01,16301,19658,-3357,-17.08,1616
2021-07-02,16127,19537,-3410,-17.45,1616
2021-07-03,12414,15375,-2961,-19.26,1616
2021-07-04,10671,12681,-2010,-15.85,1616
2021-07-05,15626,18419,-2793,-15.16,1616
2021-07-06,16301,18591,-2290,-12.32,1616
2021-07-07,16301,18417,-2116,-11.49,1616
2021-07-08,16301,18305,-2004,-10.95,1616
2021-07-09,16127,18289,-2162,-11.82,1616
2021-07-10,12414,14243,-1829,-12.84,1616
2021-07-11,10671,11674,-1003,-8.59,1616
2021-07-12,15626,17541,-1915,-10.92,1616
2021-07-13,16301,17841,-1540,-8.63,1616
2021-07-14,16301,17794,-1493,-8.39,1616
2021-07-15,16301,17801,-1500,-8.43,1616
2021-07-16,16127,17895,-1768,-9.88,1616
2021-07-17,12414,13946,-1532,-10.99,1616
2021-07-18,10671,11456,-785,-6.85,1616
2021-07-19,15626,17384,-1758,-10.11,1616
2021-07-20,16301,17726,-1425,-8.04,1616
2021-07-21,16301,17697,-1396,-7.89,1616
2021-07-22,16301,17700,-1399,-7.9,1616
2021-07-23,16127,17767,-1640,-9.23,1616
2021-07-24,12414,13767,-1353,-9.83,1616
2021-07-25,10671,11207,-536,-4.78,1616
2021-07-26,15626,17044,-1418,-8.32,1616
2021-07-27,16301,17276,-975,-5.64,1616
2021-07-28,16301,17125,-824,-4.81,1616
2021-07-29,16301,16993,-692,-4.07,1616
2021-07-30,16127,16918,-791,-4.68,1616
2021-07-31,12414,12773,-359,-2.81,1616
2021-08-01,10309,10068,241,2.39,1616
2021-08-02,14520,15766,-1246,-7.9,1616
2021-08-03,15037,15869,-832,-5.24,1616
2021-08-04,15037,15601,-564,-3.62,1616
2021-08-05,15037,15371,-334,-2.17,1616
2021-08-06,14622,15218,-596,-3.92,1616
2021-08-07,12194,11021,1173,10.64,1616
2021-08-08,10309,8289,2020,24.37,1616
2021-08-09,14520,13990,530,3.79,1616
2021-08-10,15037,14127,910,6.44,1616
2021-08-11,15037,13924,1113,7.99,1616
2021-08-12,15037,13790,1247,9.04,1616
2021-08-13,14622,13765,857,6.23,1616
2021-08-14,12194,9723,2471,25.41,1616
2021-08-15,10309,7175,3134,43.68,1616
2021-08-16,14520,13084,1436,10.98,1616
2021-08-17,15037,13449,1588,11.81,1616
2021-08-18,15037,13492,1545,11.45,1616
2021-08-19,15037,13616,1421,10.44,1616
2021-08-20,14622,13857,765,5.52,1616
2021-08-21,12194,10086,2108,20.9,1616
2021-08-22,10309,7807,2502,32.05,1616
2021-08-23,14520,13978,542,3.88,1616
2021-08-24,15037,14595,442,3.03,1616
2021-08-25,15037,14875,162,1.09,1616
2021-08-26,15037,15216,-179,-1.18,1616
2021-08-27,14622,15651,-1029,-6.57,1616
2021-08-28,12194,12048,146,1.21,1616
2021-08-29,10309,9907,402,4.06,1616
2021-08-30,14520,16186,-1666,-10.29,1616
2021-08-31,15037,16880,-1843,-10.92,1616
2021-09-01,17272,17203,69,0.4,1616
2021-09-02,17272,17556,-284,-1.62,1616
2021-09-03,17382,17972,-590,-3.28,1616
2021-09-04,14392,14319,73,0.51,1616
2021-09-05,12781,12101,680,5.62,1616
2021-09-06,16609,18279,-1670,-9.14,1616
2021-09-07,17272,18849,-1577,-8.37,1616
2021-09-08,17272,19030,-1758,-9.24,1616
2021-09-09,17272,19227,-1955,-10.17,1616
2021-09-10,17382,19477,-2095,-10.76,1616
2021-09-11,14392,15651,-1259,-8.04,1616
2021-09-12,12781,13260,-479,-3.61,1616
2021-09-13,16609,19265,-2656,-13.79,1616
2021-09-14,17272,19668,-2396,-12.18,1616
2021-09-15,17272,19692,-2420,-12.29,1616
2021-09-16,17272,19744,-2472,-12.52,1616
2021-09-17,17382,19864,-2482,-12.49,1616
2021-09-18,14392,15925,-1533,-9.63,1616
2021-09-19,12781,13439,-658,-4.9,1616
2021-09-20,16609,19369,-2760,-14.25,1616
2021-09-21,17272,19717,-2445,-12.4,1616
2021-09-22,17272,19707,-2435,-12.36,1616
2021-09-23,17272,19743,-2471,-12.52,1616
2021-09-24,17382,19864,-2482,-12.49,1616
2021-09-25,14392,15945,-1553,-9.74,1616
2021-09-26,12781,13492,-711,-5.27,1616
2021-09-27,16609,19467,-2858,-14.68,1616
2021-09-28,17272,19871,-2599,-13.08,1616
2021-09-29,17272,19922,-2650,-13.3,1616
2021-09-30,17272,20024,-2752,-13.74,1616
2021-10-01,17881,20212,-2331,-11.53,1616
2021-10-02,14822,16358,-1536,-9.39,1616
2021-10-03,12633,13966,-1333,-9.54,1616
2021-10-04,17023,19997,-2974,-14.87,1616
2021-10-05,17500,20447,-2947,-14.41,1616
2021-10-06,17500,20534,-3034,-14.78,1616
2021-10-07,17500,20662,-3162,-15.3,1616
2021-10-08,17881,20864,-2983,-14.3,1616
2021-10-09,14822,17010,-2188,-12.86,1616
2021-10-10,12633,14607,-1974,-13.51,1616
2021-10-11,17023,20614,-3591,-17.42,1616
2021-10-12,17500,21030,-3530,-16.79,1616
2021-10-13,17500,21073,-3573,-16.96,1616
2021-10-14,17500,21147,-3647,-17.25,1616
2021-10-15,17881,21289,-3408,-16.01,1616
2021-10-16,14822,17372,-2550,-14.68,1616
2021-10-17,12633,14902,-2269,-15.23,1616
2021-10-18,17023,20841,-3818,-18.32,1616
2021-10-19,17500,21191,-3691,-17.42,1616
2021-10-20,17500,21172,-3672,-17.34,1616
2021-10-21,17500,21191,-3691,-17.42,1616
2021-10-22,17881,21284,-3403,-15.99,1616
2021-10-23,14822,17327,-2505,-14.46,1616
2021-10-24,12633,14827,-2194,-14.8,1616
2021-10-25,17023,20747,-3724,-17.95,1616
2021-10-26,17500,21089,-3589,-17.02,1616
2021-10-27,17500,21073,-3573,-16.96,1616
2021-10-28,17500,21106,-3606,-17.09,1616
2021-10-29,17881,21223,-3342,-15.75,1616
2021-10-30,14822,17299,-2477,-14.32,1616
2021-10-31,12633,14841,-2208,-14.88,1616
2021-11-01,16093,20808,-4715,-22.66,1616
2021-11-02,16901,21202,-4301,-20.29,1616
2021-11-03,16901,21241,-4340,-20.43,1616
2021-11-04,16901,21329,-4428,-20.76,1616
2021-11-05,16415,21500,-5085,-23.65,1616
2021-11-06,14258,17626,-3368,-19.11,1616
2021-11-07,11871,15213,-3342,-21.97,1616
2021-11-08,16093,21219,-5126,-24.16,1616
2021-11-09,16901,21642,-4741,-21.91,1616
2021-11-10,16901,21700,-4799,-22.12,1616
2021-11-11,16901,21797,-4896,-22.46,1616
2021-11-12,16415,21965,-5550,-25.27,1616
2021-11-13,14258,18077,-3819,-21.13,1616
2021-11-14,11871,15638,-3767,-24.09,1616
2021-11-15,16093,21607,-5514,-25.52,1616
2021-11-16,16901,21983,-5082,-23.12,1616
2021-11-17,16901,21985,-5084,-23.12,1616
2021-11-18,16901,22018,-5117,-23.24,1616
2021-11-19,16415,22116,-5701,-25.78,1616
2021-11-20,14258,18153,-3895,-21.46,1616
2021-11-21,11871,15637,-3766,-24.08,1616
2021-11-22,16093,21529,-5436,-25.25,1616
2021-11-23,16901,21829,-4928,-22.58,1616
2021-11-24,16901,21759,-4858,-22.33,1616
2021-11-25,16901,21725,-4824,-22.2,1616
2021-11-26,16415,21764,-5349,-24.58,1616
2021-11-27,14258,17751,-3493,-19.68,1616
2021-11-28,11871,15195,-3324,-21.88,1616
2021-11-29,16093,21058,-4965,-23.58,1616
2021-11-30,16901,21341,-4440,-20.81,1616
2021-12-01,15678,21266,-5588,-26.28,1616
2021-12-02,15678,21238,-5560,-26.18,1616
2021-12-03,15478,21295,-5817,-27.32,1616
2021-12-04,13261,17311,-4050,-23.4,1616
2021-12-05,11059,14793,-3734,-25.24,1616
2021-12-06,15568,20702,-5134,-24.8,1616
2021-12-07,15678,21038,-5360,-25.48,1616
2021-12-08,15678,21021,-5343,-25.42,1616
2021-12-09,15678,21054,-5376,-25.53,1616
2021-12-10,15478,21173,-5695,-26.9,1616
2021-12-11,13261,17248,-3987,-23.12,1616
2021-12-12,11059,14787,-3728,-25.21,1616
2021-12-13,15568,20747,-5179,-24.96,1616
2021-12-14,15678,21127,-5449,-25.79,1616
2021-12-15,15678,21145,-5467,-25.85,1616
2021-12-16,15678,21204,-5526,-26.06,1616
2021-12-17,15478,21338,-5860,-27.46,1616
2021-12-18,13261,17417,-4156,-23.86,1616
2021-12-19,11059,14946,-3887,-26.01,1616
2021-12-20,15568,20886,-5318,-25.46,1616
2021-12-21,15678,21235,-5557,-26.17,1616
2021-12-22,15678,21211,-5533,-26.09,1616
2021-12-23,15678,21217,-5539,-26.11,1616
2021-12-24,15478,21291,-5813,-27.3,1616
2021-12-25,13261,17303,-4042,-23.36,1616
2021-12-26,11059,14761,-3702,-25.08,1616
2021-12-27,15568,20627,-5059,-24.53,1616
2021-12-28,15678,20900,-5222,-24.99,1616
2021-12-29,15678,20803,-5125,-24.64,1616
2021-12-30,15678,20739,-5061,-24.4,1616
2021-12-31,15478,20748,-5270,-25.4,1616
2022-01-01,12450,16704,-4254,-25.47,1616
2022-01-02,10154,14114,-3960,-28.06,1616
2022-01-03,14620,19943,-5323,-26.69,1616
2022-01-04,15400,20191,-4791,-23.73,1616
2022-01-05,15400,20080,-4680,-23.31,1616
2022-01-06,15400,20017,-4617,-23.07,1616
2022-01-07,15486,20040,-4554,-22.72,1616
2022-01-08,12450,16022,-3572,-22.29,1616
2022-01-09,10154,13472,-3318,-24.63,1616
2022-01-10,14620,19351,-4731,-24.45,1616
2022-01-11,15400,19661,-4261,-21.67,1616
2022-01-12,15400,19621,-4221,-21.51,1616
2022-01-13,15400,19636,-4236,-21.57,1616
2022-01-14,15486,19742,-4256,-21.56,1616
2022-01-15,12450,15811,-3361,-21.26,1616
2022-01-16,10154,13349,-3195,-23.93,1616
2022-01-17,14620,19316,-4696,-24.31,1616
2022-01-18,15400,19711,-4311,-21.87,1616
2022-01-19,15400,19752,-4352,-22.03,1616
2022-01-20,15400,19842,-4442,-22.39,1616
2022-01-21,15486,20014,-4528,-22.62,1616
2022-01-22,12450,16141,-3691,-22.87,1616
2022-01-23,10154,13727,-3573,-26.03,1616
2022-01-24,14620,19732,-5112,-25.91,1616
2022-01-25,15400,20152,-4752,-23.58,1616
2022-01-26,15400,20208,-4808,-23.79,1616
2022-01-27,15400,20301,-4901,-24.14,1616
2022-01-28,15486,20467,-4981,-24.34,1616
2022-01-29,12450,16578,-4128,-24.9,1616
2022-01-30,10154,14139,-3985,-28.18,1616
2020-02-01,29121,26448,2673,10.11,1193
2020-02-02,23190,21330,1860,8.72,1193
2020-02-03,34987,34718,269,0.77,1193
2020-02-04,35992,35893,99,0.28,1193
2020-02-05,35992,35895,97,0.27,1193
2020-02-06,35992,35883,109,0.3,1193
2020-02-07,36454,35539,915,2.57,1193
2020-02-08,29121,26381,2740,10.39,1193
2020-02-09,23190,21245,1945,9.16,1193
2020-02-10,34987,34628,359,1.04,1193
2020-02-11,35992,35808,184,0.51,1193
2020-02-12,35992,35828,164,0.46,1193
2020-02-13,35992,35848,144,0.4,1193
2020-02-14,36454,35546,908,2.55,1193
2020-02-15,29121,26444,2677,10.12,1193
2020-02-16,23190,21374,1816,8.5,1193
2020-02-17,34987,34831,156,0.45,1193
2020-02-18,35992,36094,-102,-0.28,1193
2020-02-19,35992,36203,-211,-0.58,1193
2020-02-20,35992,36315,-323,-0.89,1193
2020-02-21,36454,36108,346,0.96,1193
2020-02-22,29121,27099,2022,7.46,1193
2020-02-23,23190,22120,1070,4.84,1193
2020-02-24,34987,35663,-676,-1.9,1193
2020-02-25,35992,37005,-1013,-2.74,1193
2020-02-26,35992,37184,-1192,-3.21,1193
2020-02-27,35992,37355,-1363,-3.65,1193
2020-02-28,36454,37196,-742,-1.99,1193
2020-02-29,29121,28221,900,3.19,1193
2020-03-01,17568,23263,-5695,-24.48,1193
2020-03-02,25989,36813,-10824,-29.4,1193
2020-03-03,27189,38148,-10959,-28.73,1193
2020-03-04,27189,38306,-11117,-29.02,1193
2020-03-05,27189,38444,-11255,-29.28,1193
2020-03-06,28479,38239,-9760,-25.52,1193
2020-03-07,20154,29209,-9055,-31.0,1193
2020-03-08,17568,24187,-6619,-27.37,1193
2020-03-09,25989,37665,-11676,-31.0,1193
2020-03-10,27189,38924,-11735,-30.15,1193
2020-03-11,27189,39003,-11814,-30.29,1193
2020-03-12,27189,39061,-11872,-30.39,1193
2020-03-13,28479,38777,-10298,-26.56,1193
2020-03-14,20154,29672,-9518,-32.08,1193
2020-03-15,17568,24580,-7012,-28.53,1193
2020-03-16,25989,37995,-12006,-31.6,1193
2020-03-17,27189,39199,-12010,-30.64,1193
2020-03-18,27189,39234,-12045,-30.7,1193
2020-03-19,27189,39258,-12069,-30.74,1193
2020-03-20,28479,38951,-10472,-26.89,1193
2020-03-21,20154,29834,-9680,-32.45,1193
2020-03-22,17568,24741,-7173,-28.99,1193
2020-03-23,25989,38167,-12178,-31.91,1193
2020-03-24,27189,39391,-12202,-30.98,1193
2020-03-25,27189,39455,-12266,-31.09,1193
2020-03-26,27189,39516,-12327,-31.19,1193
2020-03-27,28479,39252,-10773,-27.45,1193
2020-03-28,20154,30183,-10029,-33.23,1193
2020-03-29,17568,25140,-7572,-30.12,1193
2020-03-30,25989,38617,-12628,-32.7,1193
2020-03-31,27189,39892,-12703,-31.84,1193
2020-04-01,26161,40003,-13842,-34.6,1193
2020-04-02,26161,40107,-13946,-34.77,1193
2020-04-03,25131,39882,-14751,-36.99,1193
2020-04-04,20289,30843,-10554,-34.22,1193
2020-04-05,15936,25823,-9887,-38.29,1193
2020-04-06,25756,39314,-13558,-34.49,1193
2020-04-07,26161,40593,-14432,-35.55,1193
2020-04-08,26161,40699,-14538,-35.72,1193
2020-04-09,26161,40788,-14627,-35.86,1193
2020-04-10,25131,40538,-15407,-38.01,1193
2020-04-11,20289,31467,-11178,-35.52,1193
2020-04-12,15936,26407,-10471,-39.65,1193
2020-04-13,25756,39851,-14095,-35.37,1193
2020-04-14,26161,41077,-14916,-36.31,1193
2020-04-15,26161,41127,-14966,-36.39,1193
2020-04-16,26161,41158,-14997,-36.44,1193
2020-04-17,25131,40849,-15718,-38.48,1193
2020-04-18,20289,31719,-11430,-36.04,1193
2020-04-19,15936,26602,-10666,-40.09,1193
2020-04-20,25756,39993,-14237,-35.6,1193
2020-04-21,26161,41172,-15011,-36.46,1193
2020-04-22,26161,41180,-15019,-36.47,1193
2020-04-23,26161,41175,-15014,-36.46,1193
2020-04-24,25131,40838,-15707,-38.46,1193
2020-04-25,20289,31688,-11399,-35.97,1193
2020-04-26,15936,26559,-10623,-40.0,1193
2020-04-27,25756,39945,-14189,-35.52,1193
2020-04-28,26161,41127,-14966,-36.39,1193
2020-04-29,26161,41144,-14983,-36.42,1193
2020-04-30,26161,41156,-14995,-36.43,1193
2020-05-01,35425,40839,-5414,-13.26,1193
2020-05-02,28995,31713,-2718,-8.57,1193
2020-05-03,22992,26611,-3619,-13.6,1193
2020-05-04,34335,40027,-5692,-14.22,1193
2020-05-05,33047,41237,-8190,-19.86,1193
2020-05-06,33047,41283,-8236,-19.95,1193
2020-05-07,33047,41320,-8273,-20.02,1193
2020-05-08,35425,41026,-5601,-13.65,1193
2020-05-09,28995,31919,-2924,-9.16,1193
2020-05-10,22992,26830,-3838,-14.3,1193
2020-05-11,34335,40254,-5919,-14.7,1193
2020-05-12,33047,41468,-8421,-20.31,1193
2020-05-13,33047,41511,-8464,-20.39,1193
2020-05-14,33047,41541,-8494,-20.45,1193
2020-05-15,35425,41235,-5810,-14.09,1193
2020-05-16,28995,32111,-3116,-9.7,1193
2020-05-17,22992,27004,-4012,-14.86,1193
2020-05-18,34335,40406,-6071,-15.02,1193
2020-05-19,33047,41597,-8550,-20.55,1193
2020-05-20,33047,41618,-8571,-20.59,1193
2020-05-21,33047,41626,-8579,-20.61,1193
2020-05-22,35425,41301,-5876,-14.23,1193
2020-05-23,28995,32163,-3168,-9.85,1193
2020-05-24,22992,27045,-4053,-14.99,1193
2020-05-25,34335,40443,-6108,-15.1,1193
2020-05-26,33047,41635,-8588,-20.63,1193
2020-05-27,33047,41664,-8617,-20.68,1193
2020-05-28,33047,41688,-8641,-20.73,1193
2020-05-29,35425,41385,-5960,-14.4,1193
2020-05-30,28995,32275,-3280,-10.16,1193
2020-05-31,22992,27191,-4199,-15.44,1193
2020-06-01,37638,40628,-2990,-7.36,1193
2020-06-02,39281,41863,-2582,-6.17,1193
2020-06-03,39281,41936,-2655,-6.33,1193
2020-06-04,39281,42005,-2724,-6.48,1193
2020-06-05,38618,41746,-3128,-7.49,1193
2020-06-06,32956,32676,280,0.86,1193
2020-06-07,26147,27628,-1481,-5.36,1193
2020-06-08,37638,41093,-3455,-8.41,1193
2020-06-09,39281,42348,-3067,-7.24,1193
2020-06-10,39281,42431,-3150,-7.42,1193
2020-06-11,39281,42497,-3216,-7.57,1193
2020-06-12,38618,42222,-3604,-8.54,1193
2020-06-13,32956,33123,-167,-0.5,1193
2020-06-14,26147,28030,-1883,-6.72,1193
2020-06-15,37638,41435,-3797,-9.16,1193
2020-06-16,39281,42615,-3334,-7.82,1193
2020-06-17,39281,42608,-3327,-7.81,1193
2020-06-18,39281,42571,-3290,-7.73,1193
2020-06-19,38618,42181,-3563,-8.45,1193
2020-06-20,32956,32955,1,0.0,1193
2020-06-21,26147,27728,-1581,-5.7,1193
2020-06-22,37638,40992,-3354,-8.18,1193
2020-06-23,39281,42027,-2746,-6.53,1193
2020-06-24,39281,41875,-2594,-6.19,1193
2020-06-25,39281,41694,-2413,-5.79,1193
2020-06-26,38618,41165,-2547,-6.19,1193
2020-06-27,32956,31808,1148,3.61,1193
2020-06-28,26147,26460,-313,-1.18,1193
2020-06-29,37638,39618,-1980,-5.0,1193
2020-06-30,39281,40561,-1280,-3.16,1193
2020-07-01,39810,40336,-526,-1.3,1193
2020-07-02,39810,40100,-290,-0.72,1193
2020-07-03,38900,39538,-638,-1.61,1193
2020-07-04,29530,30169,-639,-2.12,1193
2020-07-05,27715,24831,2884,11.61,1193
2020-07-06,38158,38020,138,0.36,1193
2020-07-07,39810,39016,794,2.04,1193
2020-07-08,39810,38863,947,2.44,1193
2020-07-09,39810,38719,1091,2.82,1193
2020-07-10,38900,38264,636,1.66,1193
2020-07-11,29530,29016,514,1.77,1193
2020-07-12,27715,23810,3905,16.4,1193
2020-07-13,38158,37139,1019,2.74,1193
2020-07-14,39810,38281,1529,3.99,1193
2020-07-15,39810,38275,1535,4.01,1193
2020-07-16,39810,38276,1534,4.01,1193
2020-07-17,38900,37961,939,2.47,1193
2020-07-18,29530,28846,684,2.37,1193
2020-07-19,27715,23761,3954,16.64,1193
2020-07-20,38158,37198,960,2.58,1193
2020-07-21,39810,38433,1377,3.58,1193
2020-07-22,39810,38502,1308,3.4,1193
2020-07-23,39810,38559,1251,3.24,1193
2020-07-24,38900,38281,619,1.62,1193
2020-07-25,29530,29184,346,1.19,1193
2020-07-26,27715,24098,3617,15.01,1193
2020-07-27,38158,37515,643,1.71,1193
2020-07-28,39810,38712,1098,2.84,1193
2020-07-29,39810,38727,1083,2.8,1193
2020-07-30,39810,38718,1092,2.82,1193
2020-07-31,38900,38363,537,1.4,1193
2020-08-01,31615,29180,2435,8.34,1193
2020-08-02,27091,24002,3089,12.87,1193
2020-08-03,36060,37326,-1266,-3.39,1193
2020-08-04,37744,38430,-686,-1.79,1193
2020-08-05,37744,38358,-614,-1.6,1193
2020-08-06,37744,38268,-524,-1.37,1193
2020-08-07,38062,37841,221,0.58,1193
2020-08-08,31615,28599,3016,10.55,1193
2020-08-09,27091,23377,3714,15.89,1193
2020-08-10,36060,36672,-612,-1.67,1193
2020-08-11,37744,37766,-22,-0.06,1193
2020-08-12,37744,37701,43,0.11,1193
2020-08-13,37744,37636,108,0.29,1193
2020-08-14,38062,37254,808,2.17,1193
2020-08-15,31615,28073,3542,12.62,1193
2020-08-16,27091,22930,4161,18.15,1193
2020-08-17,36060,36318,-258,-0.71,1193
2020-08-18,37744,37517,227,0.61,1193
2020-08-19,37744,37567,177,0.47,1193
2020-08-20,37744,37627,117,0.31,1193
2020-08-21,38062,37372,690,1.85,1193
2020-08-22,31615,28322,3293,11.63,1193
2020-08-23,27091,23307,3784,16.24,1193
2020-08-24,36060,36821,-761,-2.07,1193
2020-08-25,37744,38137,-393,-1.03,1193
2020-08-26,37744,38296,-552,-1.44,1193
2020-08-27,37744,38451,-707,-1.84,1193
2020-08-28,38062,38279,-217,-0.57,1193
2020-08-29,31615,29295,2320,7.92,1193
2020-08-30,27091,24329,2762,11.35,1193
2020-08-31,36060,37873,-1813,-4.79,1193
2020-09-01,39599,39202,397,1.01,1193
2020-09-02,39599,39355,244,0.62,1193
2020-09-03,39599,39487,112,0.28,1193
2020-09-04,38972,39274,-302,-0.77,1193
2020-09-05,32911,30235,2676,8.85,1193
2020-09-06,27189,25200,1989,7.89,1193
2020-09-07,37412,38664,-1252,-3.24,1193
2020-09-08,39599,39904,-305,-0.76,1193
2020-09-09,39599,39961,-362,-0.91,1193
2020-09-10,39599,39993,-394,-0.99,1193
2020-09-11,38972,39679,-707,-1.78,1193
2020-09-12,32911,30539,2372,7.77,1193
2020-09-13,27189,25408,1781,7.01,1193
2020-09-14,37412,38782,-1370,-3.53,1193
2020-09-15,39599,39940,-341,-0.85,1193
2020-09-16,39599,39925,-326,-0.82,1193
2020-09-17,39599,39896,-297,-0.74,1193
2020-09-18,38972,39533,-561,-1.42,1193
2020-09-19,32911,30358,2553,8.41,1193
2020-09-20,27189,25205,1984,7.87,1193
2020-09-21,37412,38569,-1157,-3.0,1193
2020-09-22,39599,39729,-130,-0.33,1193
2020-09-23,39599,39729,-130,-0.33,1193
2020-09-24,39599,39725,-126,-0.32,1193
2020-09-25,38972,39396,-424,-1.08,1193
2020-09-26,32911,30262,2649,8.75,1193
2020-09-27,27189,25154,2035,8.09,1193
2020-09-28,37412,38567,-1155,-2.99,1193
2020-09-29,39599,39778,-179,-0.45,1193
2020-09-30,39599,39827,-228,-0.57,1193
2020-10-01,38163,39869,-1706,-4.28,1193
2020-10-02,38077,39582,-1505,-3.8,1193
2020-10-03,30548,30482,66,0.22,1193
2020-10-04,25864,25402,462,1.82,1193
2020-10-05,37156,38833,-1677,-4.32,1193
2020-10-06,38163,40053,-1890,-4.72,1193
2020-10-07,38163,40100,-1937,-4.83,1193
2020-10-08,38163,40131,-1968,-4.9,1193
2020-10-09,38077,39823,-1746,-4.38,1193
2020-10-10,30548,30693,-145,-0.47,1193
2020-10-11,25864,25574,290,1.13,1193
2020-10-12,37156,38960,-1804,-4.63,1193
2020-10-13,38163,40128,-1965,-4.9,1193
2020-10-14,38163,40120,-1957,-4.88,1193
2020-10-15,38163,40094,-1931,-4.82,1193
2020-10-16,38077,39728,-1651,-4.16,1193
2020-10-17,30548,30541,7,0.02,1193
2020-10-18,25864,25370,494,1.95,1193
2020-10-19,37156,38708,-1552,-4.01,1193
2020-10-20,38163,39835,-1672,-4.2,1193
2020-10-21,38163,39794,-1631,-4.1,1193
2020-10-22,38163,39743,-1580,-3.98,1193
2020-10-23,38077,39362,-1285,-3.26,1193
2020-10-24,30548,30172,376,1.25,1193
2020-10-25,25864,25006,858,3.43,1193
2020-10-26,37156,38361,-1205,-3.14,1193
2020-10-27,38163,39514,-1351,-3.42,1193
2020-10-28,38163,39508,-1345,-3.4,1193
2020-10-29,38163,39500,-1337,-3.38,1193
2020-10-30,38077,39168,-1091,-2.79,1193
2020-10-31,30548,30031,517,1.72,1193
2020-11-01,19671,24921,-5250,-21.07,1193
2020-11-02,32746,38332,-5586,-14.57,1193
2020-11-03,31131,39541,-8410,-21.27,1193
2020-11-04,31131,39586,-8455,-21.36,1193
2020-11-05,31131,39624,-8493,-21.43,1193
2020-11-06,31558,39332,-7774,-19.77,1193
2020-11-07,24029,30226,-6197,-20.5,1193
2020-11-08,19671,25137,-5466,-21.74,1193
2020-11-09,32746,38557,-5811,-15.07,1193
2020-11-10,31131,39762,-8631,-21.71,1193
2020-11-11,31131,39793,-8662,-21.77,1193
2020-11-12,31131,39803,-8672,-21.79,1193
2020-11-13,31558,39470,-7912,-20.05,1193
2020-11-14,24029,30311,-6282,-20.73,1193
2020-11-15,19671,25159,-5488,-21.81,1193
2020-11-16,32746,38507,-5761,-14.96,1193
2020-11-17,31131,39632,-8501,-21.45,1193
2020-11-18,31131,39576,-8445,-21.34,1193
2020-11-19,31131,39495,-8364,-21.18,1193
2020-11-20,31558,39070,-7512,-19.23,1193
2020-11-21,24029,29819,-5790,-19.42,1193
2020-11-22,19671,24577,-4906,-19.96,1193
2020-11-23,32746,37840,-5094,-13.46,1193
2020-11-24,31131,38887,-7756,-19.94,1193
2020-11-25,31131,38761,-7630,-19.68,1193
2020-11-26,31131,38622,-7491,-19.4,1193
2020-11-27,31558,38149,-6591,-17.28,1193
2020-11-28,24029,28864,-4835,-16.75,1193
2020-11-29,19671,23602,-3931,-16.66,1193
2020-11-30,32746,36857,-4111,-11.15,1193
2020-12-01,30691,37911,-7220,-19.04,1193
2020-12-02,30691,37806,-7115,-18.82,1193
2020-12-03,30691,37698,-7007,-18.59,1193
2020-12-04,33221,37270,-4049,-10.86,1193
2020-12-05,24226,28038,-3812,-13.6,1193
2020-12-06,18650,22837,-4187,-18.33,1193
2020-12-07,31133,36160,-5027,-13.9,1193
2020-12-08,30691,37285,-6594,-17.69,1193
2020-12-09,30691,37253,-6562,-17.61,1193
2020-12-10,30691,37218,-6527,-17.54,1193
2020-12-11,33221,36859,-3638,-9.87,1193
2020-12-12,24226,27692,-3466,-12.52,1193
2020-12-13,18650,22548,-3898,-17.29,1193
2020-12-14,31133,35920,-4787,-13.33,1193
2020-12-15,30691,37084,-6393,-17.24,1193
2020-12-16,30691,37078,-6387,-17.23,1193
2020-12-17,30691,37058,-6367,-17.18,1193
2020-12-18,33221,36701,-3480,-9.48,1193
2020-12-19,24226,27523,-3297,-11.98,1193
2020-12-20,18650,22355,-3705,-16.57,1193
2020-12-21,31133,35692,-4559,-12.77,1193
2020-12-22,30691,36809,-6118,-16.62,1193
2020-12-23,30691,36748,-6057,-16.48,1193
2020-12-24,30691,36664,-5973,-16.29,1193
2020-12-25,33221,36238,-3017,-8.33,1193
2020-12-26,24226,26986,-2760,-10.23,1193
2020-12-27,18650,21745,-3095,-14.23,1193
2020-12-28,31133,35008,-3875,-11.07,1193
2020-12-29,30691,36055,-5364,-14.88,1193
2020-12-30,30691,35929,-5238,-14.58,1193
2020-12-31,30691,35788,-5097,-14.24,1193
2021-01-01,28362,35313,-6951,-19.68,1193
2021-01-02,20696,26026,-5330,-20.48,1193
2021-01-03,16870,20760,-3890,-18.74,1193
2021-01-04,27213,34013,-6800,-19.99,1193
2021-01-05,28393,35064,-6671,-19.03,1193
2021-01-06,28393,34956,-6563,-18.78,1193
2021-01-07,28393,34849,-6456,-18.53,1193
2021-01-08,28362,34421,-6059,-17.6,1193
2021-01-09,20696,25193,-4497,-17.85,1193
2021-01-10,16870,19999,-3129,-15.65,1193
2021-01-11,27213,33334,-6121,-18.36,1193
2021-01-12,28393,34475,-6082,-17.64,1193
2021-01-13,28393,34464,-6071,-17.62,1193
2021-01-14,28393,34457,-6064,-17.6,1193
2021-01-15,28362,34131,-5769,-16.9,1193
2021-01-16,20696,25006,-4310,-17.24,1193
2021-01-17,16870,19911,-3041,-15.27,1193
2021-01-18,27213,33339,-6126,-18.37,1193
2021-01-19,28393,34567,-6174,-17.86,1193
2021-01-20,28393,34634,-6241,-18.02,1193
2021-01-21,28393,34694,-6301,-18.16,1193
2021-01-22,28362,34425,-6063,-17.61,1193
2021-01-23,20696,25342,-4646,-18.33,1193
2021-01-24,16870,20278,-3408,-16.81,1193
2021-01-25,27213,33723,-6510,-19.3,1193
2021-01-26,28393,34955,-6562,-18.77,1193
2021-01-27,28393,35014,-6621,-18.91,1193
2021-01-28,28393,35055,-6662,-19.0,1193
2021-01-29,28362,34756,-6394,-18.4,1193
2021-01-30,20696,25636,-4940,-19.27,1193
2021-01-31,16870,20527,-3657,-17.82,1193
2021-02-01,30459,33924,-3465,-10.21,1193
2021-02-02,31561,35106,-3545,-10.1,1193
2021-02-03,31561,35114,-3553,-10.12,1193
2021-02-04,31561,35106,-3545,-10.1,1193
2021-02-05,31554,34763,-3209,-9.23,1193
2021-02-06,23982,25605,-1623,-6.34,1193
2021-02-07,19708,20467,-759,-3.71,1193
2021-02-08,30459,33843,-3384,-10.0,1193
2021-02-09,31561,35016,-3455,-9.87,1193
2021-02-10,31561,35027,-3466,-9.9,1193
2021-02-11,31561,35034,-3473,-9.91,1193
2021-02-12,31554,34719,-3165,-9.12,1193
2021-02-13,23982,25601,-1619,-6.32,1193
2021-02-14,19708,20514,-806,-3.93,1193
2021-02-15,30459,33954,-3495,-10.29,1193
2021-02-16,31561,35200,-3639,-10.34,1193
2021-02-17,31561,35291,-3730,-10.57,1193
2021-02-18,31561,35386,-3825,-10.81,1193
2021-02-19,31554,35163,-3609,-10.26,1193
2021-02-20,23982,26139,-2157,-8.25,1193
2021-02-21,19708,21146,-1438,-6.8,1193
2021-02-22,30459,34678,-4219,-12.17,1193
2021-02-23,31561,36011,-4450,-12.36,1193
2021-02-24,31561,36183,-4622,-12.77,1193
2021-02-25,31561,36351,-4790,-13.18,1193
2021-02-26,31554,36189,-4635,-12.81,1193
2021-02-27,23982,27216,-3234,-11.88,1193
2021-02-28,19708,22261,-2553,-11.47,1193
2021-03-01,32518,35818,-3300,-9.21,1193
2021-03-02,33712,37161,-3449,-9.28,1193
2021-03-03,33712,37329,-3617,-9.69,1193
2021-03-04,33712,37479,-3767,-10.05,1193
2021-03-05,33111,37288,-4177,-11.2,1193
2021-03-06,27029,28272,-1243,-4.4,1193
2021-03-07,20643,23264,-2621,-11.27,1193
2021-03-08,32518,36758,-4240,-11.53,1193
2021-03-09,33712,38031,-4319,-11.36,1193
2021-03-10,33712,38125,-4413,-11.58,1193
2021-03-11,33712,38196,-4484,-11.74,1193
2021-03-12,33111,37924,-4813,-12.69,1193
2021-03-13,27029,28829,-1800,-6.24,1193
2021-03-14,20643,23745,-3102,-13.06,1193
2021-03-15,32518,37168,-4650,-12.51,1193
2021-03-16,33712,38376,-4664,-12.15,1193
2021-03-17,33712,38413,-4701,-12.24,1193
2021-03-18,33712,38437,-4725,-12.29,1193
2021-03-19,33111,38129,-5018,-13.16,1193
2021-03-20,27029,29008,-1979,-6.82,1193
2021-03-21,20643,23909,-3266,-13.66,1193
2021-03-22,32518,37328,-4810,-12.89,1193
2021-03-23,33712,38544,-4832,-12.54,1193
2021-03-24,33712,38599,-4887,-12.66,1193
2021-03-25,33712,38650,-4938,-12.78,1193
2021-03-26,33111,38377,-5266,-13.72,1193
2021-03-27,27029,29297,-2268,-7.74,1193
2021-03-28,20643,24245,-3602,-14.86,1193
2021-03-29,32518,37714,-5196,-13.78,1193
2021-03-30,33712,38981,-5269,-13.52,1193
2021-03-31,33712,39087,-5375,-13.75,1193
2021-04-01,31648,39187,-7539,-19.24,1193
2021-04-02,31881,38958,-7077,-18.17,1193
2021-04-03,24940,29918,-4978,-16.64,1193
2021-04-04,21333,24899,-3566,-14.32,1193
2021-04-05,31829,38392,-6563,-17.09,1193
2021-04-06,31648,39676,-8028,-20.23,1193
2021-04-07,31648,39788,-8140,-20.46,1193
2021-04-08,31648,39885,-8237,-20.65,1193
2021-04-09,31881,39643,-7762,-19.58,1193
2021-04-10,24940,30582,-5642,-18.45,1193
2021-04-11,21333,25532,-4199,-16.45,1193
2021-04-12,31829,38987,-7158,-18.36,1193
2021-04-13,31648,40225,-8577,-21.32,1193
2021-04-14,31648,40286,-8638,-21.44,1193
2021-04-15,31648,40327,-8679,-21.52,1193
2021-04-16,31881,40028,-8147,-20.35,1193
2021-04-17,24940,30907,-5967,-19.31,1193
2021-04-18,21333,25798,-4465,-17.31,1193
2021-04-19,31829,39196,-7367,-18.8,1193
2021-04-20,31648,40380,-8732,-21.62,1193
2021-04-21,31648,40392,-8744,-21.65,1193
2021-04-22,31648,40390,-8742,-21.64,1193
2021-04-23,31881,40053,-8172,-20.4,1193
2021-04-24,24940,30903,-5963,-19.3,1193
2021-04-25,21333,25771,-4438,-17.22,1193
2021-04-26,31829,39155,-7326,-18.71,1193
2021-04-27,31648,40333,-8685,-21.53,1193
2021-04-28,31648,40345,-8697,-21.56,1193
2021-04-29,31648,40351,-8703,-21.57,1193
2021-04-30,31881,40029,-8148,-20.36,1193
2021-05-01,29531,30898,-1367,-4.42,1193
2021-05-02,22941,25791,-2850,-11.05,1193
2021-05-03,35138,39201,-4063,-10.36,1193
2021-05-04,36417,40407,-3990,-9.87,1193
2021-05-05,36417,40449,-4032,-9.97,1193
2021-05-06,36417,40483,-4066,-10.04,1193
2021-05-07,36000,40187,-4187,-10.42,1193
2021-05-08,29531,31080,-1549,-4.98,1193
2021-05-09,22941,25992,-3051,-11.74,1193
2021-05-10,35138,39417,-4279,-10.86,1193
2021-05-11,36417,40633,-4216,-10.38,1193
2021-05-12,36417,40679,-4262,-10.48,1193
2021-05-13,36417,40712,-4295,-10.55,1193
2021-05-14,36000,40411,-4411,-10.92,1193
2021-05-15,29531,31292,-1761,-5.63,1193
2021-05-16,22941,26188,-3247,-12.4,1193
2021-05-17,35138,39595,-4457,-11.26,1193
2021-05-18,36417,40790,-4373,-10.72,1193
2021-05-19,36417,40814,-4397,-10.77,1193
2021-05-20,36417,40824,-4407,-10.8,1193
2021-05-21,36000,40501,-4501,-11.11,1193
2021-05-22,29531,31363,-1832,-5.84,1193
2021-05-23,22941,26243,-3302,-12.58,1193
2021-05-24,35138,39639,-4501,-11.35,1193
2021-05-25,36417,40827,-4410,-10.8,1193
2021-05-26,36417,40851,-4434,-10.85,1193
2021-05-27,36417,40868,-4451,-10.89,1193
2021-05-28,36000,40558,-4558,-11.24,1193
2021-05-29,29531,31440,-1909,-6.07,1193
2021-05-30,22941,26348,-3407,-12.93,1193
2021-05-31,35138,39776,-4638,-11.66,1193
2021-06-01,38497,41002,-2505,-6.11,1193
2021-06-02,38497,41068,-2571,-6.26,1193
2021-06-03,38497,41129,-2632,-6.4,1193
2021-06-04,37852,40864,-3012,-7.37,1193
2021-06-05,32737,31790,947,2.98,1193
2021-06-06,29614,26740,2874,10.75,1193
2021-06-07,36938,40205,-3267,-8.13,1193
2021-06-08,38497,41462,-2965,-7.15,1193
2021-06-09,38497,41549,-3052,-7.35,1193
2021-06-10,38497,41623,-3126,-7.51,1193
2021-06-11,37852,41358,-3506,-8.48,1193
2021-06-12,32737,32272,465,1.44,1193
2021-06-13,29614,27195,2419,8.9,1193
2021-06-14,36938,40619,-3681,-9.06,1193
2021-06-15,38497,41820,-3323,-7.95,1193
2021-06-16,38497,41836,-3339,-7.98,1193
2021-06-17,38497,41824,-3327,-7.95,1193
2021-06-18,37852,41459,-3607,-8.7,1193
2021-06-19,32737,32261,476,1.48,1193
2021-06-20,29614,27060,2554,9.44,1193
2021-06-21,36938,40351,-3413,-8.46,1193
2021-06-22,38497,41412,-2915,-7.04,1193
2021-06-23,38497,41285,-2788,-6.75,1193
2021-06-24,38497,41126,-2629,-6.39,1193
2021-06-25,37852,40618,-2766,-6.81,1193
2021-06-26,32737,31279,1458,4.66,1193
2021-06-27,29614,25945,3669,14.14,1193
2021-06-28,36938,39113,-2175,-5.56,1193
2021-06-29,38497,40063,-1566,-3.91,1193
2021-06-30,38497,39840,-1343,-3.37,1193
2021-07-01,35808,39604,-3796,-9.58,1193
2021-07-02,35120,39036,-3916,-10.03,1193
2021-07-03,28805,29658,-853,-2.88,1193
2021-07-04,24203,24307,-104,-0.43,1193
2021-07-05,33868,37479,-3611,-9.63,1193
2021-07-06,35808,38456,-2648,-6.89,1193
2021-07-07,35808,38280,-2472,-6.46,1193
2021-07-08,35808,38111,-2303,-6.04,1193
2021-07-09,35120,37630,-2510,-6.67,1193
2021-07-10,28805,28356,449,1.58,1193
2021-07-11,24203,23122,1081,4.68,1193
2021-07-12,33868,36424,-2556,-7.02,1193
2021-07-13,35808,37539,-1731,-4.61,1193
2021-07-14,35808,37508,-1700,-4.53,1193
2021-07-15,35808,37486,-1678,-4.48,1193
2021-07-16,35120,37151,-2031,-5.47,1193
2021-07-17,28805,28018,787,2.81,1193
2021-07-18,24203,22919,1284,5.6,1193
2021-07-19,33868,36346,-2478,-6.82,1193
2021-07-20,35808,37573,-1765,-4.7,1193
2021-07-21,35808,37638,-1830,-4.86,1193
2021-07-22,35808,37696,-1888,-5.01,1193
2021-07-23,35120,37422,-2302,-6.15,1193
2021-07-24,28805,28332,473,1.67,1193
2021-07-25,24203,23255,948,4.08,1193
2021-07-26,33868,36685,-2817,-7.68,1193
2021-07-27,35808,37896,-2088,-5.51,1193
2021-07-28,35808,37928,-2120,-5.59,1193
2021-07-29,35808,37936,-2128,-5.61,1193
2021-07-30,35120,37599,-2479,-6.59,1193
2021-07-31,28805,28433,372,1.31,1193
2021-08-01,23306,23273,33,0.14,1193
2021-08-02,32581,36612,-4031,-11.01,1193
2021-08-03,33673,37731,-4058,-10.76,1193
2021-08-04,33673,37670,-3997,-10.61,1193
2021-08-05,33673,37588,-3915,-10.42,1193
2021-08-06,33144,37168,-4024,-10.83,1193
2021-08-07,28648,27928,720,2.58,1193
2021-08-08,23306,22706,600,2.64,1193
2021-08-09,32581,35997,-3416,-9.49,1193
2021-08-10,33673,37082,-3409,-9.19,1193
2021-08-11,33673,37006,-3333,-9.01,1193
2021-08-12,33673,36928,-3255,-8.81,1193
2021-08-13,33144,36528,-3384,-9.26,1193
2021-08-14,28648,27328,1320,4.83,1193
2021-08-15,23306,22163,1143,5.16,1193
2021-08-16,32581,35528,-2947,-8.29,1193
2021-08-17,33673,36703,-3030,-8.26,1193
2021-08-18,33673,36730,-3057,-8.32,1193
2021-08-19,33673,36765,-3092,-8.41,1193
2021-08-20,33144,36487,-3343,-9.16,1193
2021-08-21,28648,27414,1234,4.5,1193
2021-08-22,23306,22379,927,4.14,1193
2021-08-23,32581,35874,-3293,-9.18,1193
2021-08-24,33673,37175,-3502,-9.42,1193
2021-08-25,33673,37321,-3648,-9.77,1193
2021-08-26,33673,37467,-3794,-10.13,1193
2021-08-27,33144,37289,-4145,-11.12,1193
2021-08-28,28648,28302,346,1.22,1193
2021-08-29,23306,23337,-31,-0.13,1193
2021-08-30,32581,36885,-4304,-11.67,1193
2021-08-31,33673,38222,-4549,-11.9,1193
2021-09-01,36020,38385,-2365,-6.16,1193
2021-09-02,36020,38529,-2509,-6.51,1193
2021-09-03,36112,38332,-2220,-5.79,1193
2021-09-04,31657,29309,2348,8.01,1193
2021-09-05,27174,24292,2882,11.86,1193
2021-09-06,34642,37775,-3133,-8.29,1193
2021-09-07,36020,39033,-3013,-7.72,1193
2021-09-08,36020,39109,-3089,-7.9,1193
2021-09-09,36020,39160,-3140,-8.02,1193
2021-09-10,36112,38863,-2751,-7.08,1193
2021-09-11,31657,29739,1918,6.45,1193
2021-09-12,27174,24622,2552,10.36,1193
2021-09-13,34642,38007,-3365,-8.85,1193
2021-09-14,36020,39174,-3154,-8.05,1193
2021-09-15,36020,39165,-3145,-8.03,1193
2021-09-16,36020,39141,-3121,-7.97,1193
2021-09-17,36112,38780,-2668,-6.88,1193
2021-09-18,31657,29604,2053,6.93,1193
2021-09-19,27174,24448,2726,11.15,1193
2021-09-20,34642,37807,-3165,-8.37,1193
2021-09-21,36020,38961,-2941,-7.55,1193
2021-09-22,36020,38953,-2933,-7.53,1193
2021-09-23,36020,38940,-2920,-7.5,1193
2021-09-24,36112,38602,-2490,-6.45,1193
2021-09-25,31657,29458,2199,7.46,1193
2021-09-26,27174,24341,2833,11.64,1193
2021-09-27,34642,37745,-3103,-8.22,1193
2021-09-28,36020,38948,-2928,-7.52,1193
2021-09-29,36020,38989,-2969,-7.61,1193
2021-09-30,36020,39026,-3006,-7.7,1193
2021-10-01,35561,38735,-3174,-8.19,1193
2021-10-02,30236,29633,603,2.03,1193
2021-10-03,25000,24553,447,1.82,1193
2021-10-04,33911,37986,-4075,-10.73,1193
2021-10-05,35219,39210,-3991,-10.18,1193
2021-10-06,35219,39263,-4044,-10.3,1193
2021-10-07,35219,39301,-4082,-10.39,1193
2021-10-08,35561,39001,-3440,-8.82,1193
2021-10-09,30236,29881,355,1.19,1193
2021-10-10,25000,24772,228,0.92,1193
2021-10-11,33911,38169,-4258,-11.16,1193
2021-10-12,35219,39349,-4130,-10.5,1193
2021-10-13,35219,39351,-4132,-10.5,1193
2021-10-14,35219,39335,-4116,-10.46,1193
2021-10-15,35561,38978,-3417,-8.77,1193
2021-10-16,30236,29800,436,1.46,1193
2021-10-17,25000,24635,365,1.48,1193
2021-10-18,33911,37977,-4066,-10.71,1193
2021-10-19,35219,39108,-3889,-9.94,1193
2021-10-20,35219,39068,-3849,-9.85,1193
2021-10-21,35219,39016,-3797,-9.73,1193
2021-10-22,35561,38632,-3071,-7.95,1193
2021-10-23,30236,29437,799,2.71,1193
2021-10-24,25000,24265,735,3.03,1193
2021-10-25,33911,37612,-3701,-9.84,1193
2021-10-26,35219,38756,-3537,-9.13,1193
2021-10-27,35219,38740,-3521,-9.09,1193
2021-10-28,35219,38720,-3501,-9.04,1193
2021-10-29,35561,38378,-2817,-7.34,1193
2021-10-30,30236,29230,1006,3.44,1193
2021-10-31,25000,24110,890,3.69,1193
2021-11-01,31509,37512,-6003,-16.0,1193
2021-11-02,33151,38713,-5562,-14.37,1193
2021-11-03,33151,38752,-5601,-14.45,1193
2021-11-04,33151,38786,-5635,-14.53,1193
2021-11-05,33447,38492,-5045,-13.11,1193
2021-11-06,27058,29385,-2327,-7.92,1193
2021-11-07,22086,24299,-2213,-9.11,1193
2021-11-08,31509,37724,-6215,-16.47,1193
2021-11-09,33151,38936,-5785,-14.86,1193
2021-11-10,33151,38976,-5825,-14.95,1193
2021-11-11,33151,38998,-5847,-14.99,1193
2021-11-12,33447,38678,-5231,-13.52,1193
2021-11-13,27058,29534,-2476,-8.38,1193
2021-11-14,22086,24398,-2312,-9.48,1193
2021-11-15,31509,37763,-6254,-16.56,1193
2021-11-16,33151,38905,-5754,-14.79,1193
2021-11-17,33151,38866,-5715,-14.7,1193
2021-11-18,33151,38803,-5652,-14.57,1193
2021-11-19,33447,38393,-4946,-12.88,1193
2021-11-20,27058,29157,-2099,-7.2,1193
2021-11-21,22086,23929,-1843,-7.7,1193
2021-11-22,31509,37203,-5694,-15.31,1193
2021-11-23,33151,38259,-5108,-13.35,1193
2021-11-24,33151,38140,-4989,-13.08,1193
2021-11-25,33151,38005,-4854,-12.77,1193
2021-11-26,33447,37534,-4087,-10.89,1193
2021-11-27,27058,28248,-1190,-4.21,1193
2021-11-28,22086,22982,-896,-3.9,1193
2021-11-29,31509,36231,-4722,-13.03,1193
2021-11-30,33151,37277,-4126,-11.07,1193
2021-12-01,30200,37161,-6961,-18.73,1193
2021-12-02,30200,37043,-6843,-18.47,1193
2021-12-03,28676,36601,-7925,-21.65,1193
2021-12-04,23756,27356,-3600,-13.16,1193
2021-12-05,19669,22141,-2472,-11.16,1193
2021-12-06,30462,35450,-4988,-14.07,1193
2021-12-07,30200,36562,-6362,-17.4,1193
2021-12-08,30200,36517,-6317,-17.3,1193
2021-12-09,30200,36472,-6272,-17.2,1193
2021-12-10,28676,36103,-7427,-20.57,1193
2021-12-11,23756,26928,-3172,-11.78,1193
2021-12-12,19669,21779,-2110,-9.69,1193
2021-12-13,30462,35148,-4686,-13.33,1193
2021-12-14,30200,36311,-6111,-16.83,1193
2021-12-15,30200,36308,-6108,-16.82,1193
2021-12-16,30200,36292,-6092,-16.79,1193
2021-12-17,28676,35941,-7265,-20.21,1193
2021-12-18,23756,26771,-3015,-11.26,1193
2021-12-19,19669,21614,-1945,-9.0,1193
2021-12-20,30462,34963,-4501,-12.87,1193
2021-12-21,30200,36093,-5893,-16.33,1193
2021-12-22,30200,36045,-5845,-16.22,1193
2021-12-23,30200,35976,-5776,-16.06,1193
2021-12-24,28676,35563,-6887,-19.37,1193
2021-12-25,23756,26326,-2570,-9.76,1193
2021-12-26,19669,21096,-1427,-6.76,1193
2021-12-27,30462,34370,-3908,-11.37,1193
2021-12-28,30200,35427,-5227,-14.75,1193
2021-12-29,30200,35308,-5108,-14.47,1193
2021-12-30,30200,35172,-4972,-14.14,1193
2021-12-31,28676,34700,-6024,-17.36,1193
2022-01-01,24342,25412,-1070,-4.21,1193
2022-01-02,18704,20144,-1440,-7.15,1193
2022-01-03,29149,33391,-4242,-12.7,1193
2022-01-04,30282,34433,-4151,-12.06,1193
2022-01-05,30282,34315,-4033,-11.75,1193
2022-01-06,30282,34194,-3912,-11.44,1193
2022-01-07,30375,33751,-3376,-10.0,1193
2022-01-08,24342,24507,-165,-0.67,1193
2022-01-09,18704,19295,-591,-3.06,1193
2022-01-10,29149,32611,-3462,-10.62,1193
2022-01-11,30282,33733,-3451,-10.23,1193
2022-01-12,30282,33703,-3421,-10.15,1193
2022-01-13,30282,33677,-3395,-10.08,1193
2022-01-14,30375,33334,-2959,-8.88,1193
2022-01-15,24342,24192,150,0.62,1193
2022-01-16,18704,19082,-378,-1.98,1193
2022-01-17,29149,32498,-3349,-10.31,1193
2022-01-18,30282,33715,-3433,-10.18,1193
2022-01-19,30282,33774,-3492,-10.34,1193
2022-01-20,30282,33829,-3547,-10.49,1193
2022-01-21,30375,33556,-3181,-9.48,1193
2022-01-22,24342,24472,-130,-0.53,1193
2022-01-23,18704,19409,-705,-3.63,1193
2022-01-24,29149,32858,-3709,-11.29,1193
2022-01-25,30282,34096,-3814,-11.19,1193
2022-01-26,30282,34162,-3880,-11.36,1193
2022-01-27,30282,34212,-3930,-11.49,1193
2022-01-28,30375,33922,-3547,-10.46,1193
2022-01-29,24342,24812,-470,-1.89,1193
2022-01-30,18704,19713,-1009,-5.12,1193
2020-02-01,18582,17685,897,5.07,1219
2020-02-02,14878,14792,86,0.58,1219
2020-02-03,21218,21018,200,0.95,1219
2020-02-04,21664,21791,-127,-0.58,1219
2020-02-05,21664,21823,-159,-0.73,1219
2020-02-06,21664,21829,-165,-0.76,1219
2020-02-07,22287,22124,163,0.74,1219
2020-02-08,18582,17910,672,3.75,1219
2020-02-09,14878,15003,-125,-0.83,1219
2020-02-10,21218,21216,2,0.01,1219
2020-02-11,21664,21979,-315,-1.43,1219
2020-02-12,21664,22005,-341,-1.55,1219
2020-02-13,21664,22009,-345,-1.57,1219
2020-02-14,22287,22305,-18,-0.08,1219
2020-02-15,18582,18096,486,2.69,1219
2020-02-16,14878,15199,-321,-2.11,1219
2020-02-17,21218,21425,-207,-0.97,1219
2020-02-18,21664,22206,-542,-2.44,1219
2020-02-19,21664,22252,-588,-2.64,1219
2020-02-20,21664,22280,-616,-2.76,1219
2020-02-21,22287,22601,-314,-1.39,1219
2020-02-22,18582,18420,162,0.88,1219
2020-02-23,14878,15551,-673,-4.33,1219
2020-02-24,21218,21806,-588,-2.7,1219
2020-02-25,21664,22614,-950,-4.2,1219
2020-02-26,21664,22687,-1023,-4.51,1219
2020-02-27,21664,22739,-1075,-4.73,1219
2020-02-28,22287,23082,-795,-3.44,1219
2020-02-29,18582,18919,-337,-1.78,1219
2020-03-01,11303,16064,-4761,-29.64,1219
2020-03-02,16260,22329,-6069,-27.18,1219
2020-03-03,16806,23142,-6336,-27.38,1219
2020-03-04,16806,23215,-6409,-27.61,1219
2020-03-05,16806,23262,-6456,-27.75,1219
2020-03-06,17720,23595,-5875,-24.9,1219
2020-03-07,13244,19417,-6173,-31.79,1219
2020-03-08,11303,16542,-5239,-31.67,1219
2020-03-09,16260,22783,-6523,-28.63,1219
2020-03-10,16806,23569,-6763,-28.69,1219
2020-03-11,16806,23611,-6805,-28.82,1219
2020-03-12,16806,23625,-6819,-28.86,1219
2020-03-13,17720,23923,-6203,-25.93,1219
2020-03-14,13244,19709,-6465,-32.8,1219
2020-03-15,11303,16797,-5494,-32.71,1219
2020-03-16,16260,23002,-6742,-29.31,1219
2020-03-17,16806,23753,-6947,-29.25,1219
2020-03-18,16806,23762,-6956,-29.27,1219
2020-03-19,16806,23744,-6938,-29.22,1219
2020-03-20,17720,24014,-6294,-26.21,1219
2020-03-21,13244,19775,-6531,-33.03,1219
2020-03-22,11303,16842,-5539,-32.89,1219
2020-03-23,16260,23029,-6769,-29.39,1219
2020-03-24,16806,23766,-6960,-29.29,1219
2020-03-25,16806,23765,-6959,-29.28,1219
2020-03-26,16806,23742,-6936,-29.21,1219
2020-03-27,17720,24010,-6290,-26.2,1219
2020-03-28,13244,19772,-6528,-33.02,1219
2020-03-29,11303,16844,-5541,-32.9,1219
2020-03-30,16260,23039,-6779,-29.42,1219
2020-03-31,16806,23785,-6979,-29.34,1219
2020-04-01,16989,23795,-6806,-28.6,1219
2020-04-02,16989,23785,-6796,-28.57,1219
2020-04-03,15920,24066,-8146,-33.85,1219
2020-04-04,12762,19842,-7080,-35.68,1219
2020-04-05,9335,16927,-7592,-44.85,1219
2020-04-06,16991,23134,-6143,-26.55,1219
2020-04-07,16989,23892,-6903,-28.89,1219
2020-04-08,16989,23912,-6923,-28.95,1219
2020-04-09,16989,23910,-6921,-28.95,1219
2020-04-10,15920,24198,-8278,-34.21,1219
2020-04-11,12762,19978,-7216,-36.12,1219
2020-04-12,9335,17066,-7731,-45.3,1219
2020-04-13,16991,23274,-6283,-27.0,1219
2020-04-14,16989,24030,-7041,-29.3,1219
2020-04-15,16989,24048,-7059,-29.35,1219
2020-04-16,16989,24041,-7052,-29.33,1219
2020-04-17,15920,24323,-8403,-34.55,1219
2020-04-18,12762,20096,-7334,-36.49,1219
2020-04-19,9335,17177,-7842,-45.65,1219
2020-04-20,16991,23377,-6386,-27.32,1219
2020-04-21,16989,24126,-7137,-29.58,1219
2020-04-22,16989,24136,-7147,-29.61,1219
2020-04-23,16989,24123,-7134,-29.57,1219
2020-04-24,15920,24399,-8479,-34.75,1219
2020-04-25,12762,20168,-7406,-36.72,1219
2020-04-26,9335,17245,-7910,-45.87,1219
2020-04-27,16991,23444,-6453,-27.53,1219
2020-04-28,16989,24192,-7203,-29.77,1219
2020-04-29,16989,24203,-7214,-29.81,1219
2020-04-30,16989,24191,-7202,-29.77,1219
2020-05-01,22360,24470,-2110,-8.62,1219
2020-05-02,18410,20243,-1833,-9.05,1219
2020-05-03,14511,17324,-2813,-16.24,1219
2020-05-04,21706,23527,-1821,-7.74,1219
2020-05-05,22497,24281,-1784,-7.35,1219
2020-05-06,22497,24296,-1799,-7.4,1219
2020-05-07,22497,24290,-1793,-7.38,1219
2020-05-08,22360,24573,-2213,-9.01,1219
2020-05-09,18410,20348,-1938,-9.52,1219
2020-05-10,14511,17432,-2921,-16.76,1219
2020-05-11,21706,23636,-1930,-8.17,1219
2020-05-12,22497,24389,-1892,-7.76,1219
2020-05-13,22497,24403,-1906,-7.81,1219
2020-05-14,22497,24394,-1897,-7.78,1219
2020-05-15,22360,24673,-2313,-9.37,1219
2020-05-16,18410,20443,-2033,-9.94,1219
2020-05-17,14511,17521,-3010,-17.18,1219
2020-05-18,21706,23718,-2012,-8.48,1219
2020-05-19,22497,24465,-1968,-8.04,1219
2020-05-20,22497,24472,-1975,-8.07,1219
2020-05-21,22497,24456,-1959,-8.01,1219
2020-05-22,22360,24728,-2368,-9.58,1219
2020-05-23,18410,20494,-2084,-10.17,1219
2020-05-24,14511,17567,-3056,-17.4,1219
2020-05-25,21706,23762,-2056,-8.65,1219
2020-05-26,22497,24507,-2010,-8.2,1219
2020-05-27,22497,24515,-2018,-8.23,1219
2020-05-28,22497,24502,-2005,-8.18,1219
2020-05-29,22360,24779,-2419,-9.76,1219
2020-05-30,18410,20551,-2141,-10.42,1219
2020-05-31,14511,17633,-3122,-17.71,1219
2020-06-01,23171,23838,-667,-2.8,1219
2020-06-02,23972,24594,-622,-2.53,1219
2020-06-03,23972,24614,-642,-2.61,1219
2020-06-04,23972,24613,-641,-2.6,1219
2020-06-05,23658,24903,-1245,-5.0,1219
2020-06-06,20034,20687,-653,-3.16,1219
2020-06-07,16194,17780,-1586,-8.92,1219
2020-06-08,23171,23994,-823,-3.43,1219
2020-06-09,23972,24758,-786,-3.17,1219
2020-06-10,23972,24783,-811,-3.27,1219
2020-06-11,23972,24784,-812,-3.28,1219
2020-06-12,23658,25073,-1415,-5.64,1219
2020-06-13,20034,20852,-818,-3.92,1219
2020-06-14,16194,17936,-1742,-9.71,1219
2020-06-15,23171,24137,-966,-4.0,1219
2020-06-16,23972,24884,-912,-3.67,1219
2020-06-17,23972,24887,-915,-3.68,1219
2020-06-18,23972,24862,-890,-3.58,1219
2020-06-19,23658,25122,-1464,-5.83,1219
2020-06-20,20034,20868,-834,-4.0,1219
2020-06-21,16194,17917,-1723,-9.62,1219
2020-06-22,23171,24080,-909,-3.77,1219
2020-06-23,23972,24788,-816,-3.29,1219
2020-06-24,23972,24751,-779,-3.15,1219
2020-06-25,23972,24687,-715,-2.9,1219
2020-06-26,23658,24907,-1249,-5.01,1219
2020-06-27,20034,20616,-582,-2.82,1219
2020-06-28,16194,17629,-1435,-8.14,1219
2020-06-29,23171,23761,-590,-2.48,1219
2020-06-30,23972,24440,-468,-1.91,1219
2020-07-01,23726,24380,-654,-2.68,1219
2020-07-02,23726,24297,-571,-2.35,1219
2020-07-03,23572,24504,-932,-3.8,1219
2020-07-04,19246,20206,-960,-4.75,1219
2020-07-05,17046,17219,-173,-1.0,1219
2020-07-06,22838,23355,-517,-2.21,1219
2020-07-07,23726,24046,-320,-1.33,1219
2020-07-08,23726,24002,-276,-1.15,1219
2020-07-09,23726,23941,-215,-0.9,1219
2020-07-10,23572,24175,-603,-2.49,1219
2020-07-11,19246,19908,-662,-3.33,1219
2020-07-12,17046,16955,91,0.54,1219
2020-07-13,22838,23128,-290,-1.25,1219
2020-07-14,23726,23856,-130,-0.54,1219
2020-07-15,23726,23852,-126,-0.53,1219
2020-07-16,23726,23830,-104,-0.44,1219
2020-07-17,23572,24101,-529,-2.19,1219
2020-07-18,19246,19869,-623,-3.14,1219
2020-07-19,17046,16948,98,0.58,1219
2020-07-20,22838,23150,-312,-1.35,1219
2020-07-21,23726,23903,-177,-0.74,1219
2020-07-22,23726,23917,-191,-0.8,1219
2020-07-23,23726,23909,-183,-0.77,1219
2020-07-24,23572,24189,-617,-2.55,1219
2020-07-25,19246,19959,-713,-3.57,1219
2020-07-26,17046,17035,11,0.06,1219
2020-07-27,22838,23228,-390,-1.68,1219
2020-07-28,23726,23968,-242,-1.01,1219
2020-07-29,23726,23965,-239,-1.0,1219
2020-07-30,23726,23934,-208,-0.87,1219
2020-07-31,23572,24189,-617,-2.55,1219
2020-08-01,18399,19933,-1534,-7.7,1219
2020-08-02,16163,16980,-817,-4.81,1219
2020-08-03,21789,23145,-1356,-5.86,1219
2020-08-04,21814,23856,-2042,-8.56,1219
2020-08-05,21814,23827,-2013,-8.45,1219
2020-08-06,21814,23773,-1959,-8.24,1219
2020-08-07,22197,24007,-1810,-7.54,1219
2020-08-08,18399,19735,-1336,-6.77,1219
2020-08-09,16163,16771,-608,-3.63,1219
2020-08-10,21789,22930,-1141,-4.98,1219
2020-08-11,21814,23642,-1828,-7.73,1219
2020-08-12,21814,23619,-1805,-7.64,1219
2020-08-13,21814,23577,-1763,-7.48,1219
2020-08-14,22197,23830,-1633,-6.85,1219
2020-08-15,18399,19582,-1183,-6.04,1219
2020-08-16,16163,16648,-485,-2.91,1219
2020-08-17,21789,22842,-1053,-4.61,1219
2020-08-18,21814,23592,-1778,-7.54,1219
2020-08-19,21814,23611,-1797,-7.61,1219
2020-08-20,21814,23614,-1800,-7.62,1219
2020-08-21,22197,23913,-1716,-7.18,1219
2020-08-22,18399,19711,-1312,-6.66,1219
2020-08-23,16163,16823,-660,-3.92,1219
2020-08-24,21789,23060,-1271,-5.51,1219
2020-08-25,21814,23851,-2037,-8.54,1219
2020-08-26,21814,23907,-2093,-8.75,1219
2020-08-27,21814,23943,-2129,-8.89,1219
2020-08-28,22197,24269,-2072,-8.54,1219
2020-08-29,18399,20088,-1689,-8.41,1219
2020-08-30,16163,17215,-1052,-6.11,1219
2020-08-31,21789,23460,-1671,-7.12,1219
2020-09-01,23572,24253,-681,-2.81,1219
2020-09-02,23572,24304,-732,-3.01,1219
2020-09-03,23572,24328,-756,-3.11,1219
2020-09-04,24135,24636,-501,-2.03,1219
2020-09-05,20346,20432,-86,-0.42,1219
2020-09-06,17116,17530,-414,-2.36,1219
2020-09-07,22810,23743,-933,-3.93,1219
2020-09-08,23572,24500,-928,-3.79,1219
2020-09-09,23572,24513,-941,-3.84,1219
2020-09-10,23572,24498,-926,-3.78,1219
2020-09-11,24135,24766,-631,-2.55,1219
2020-09-12,20346,20524,-178,-0.87,1219
2020-09-13,17116,17584,-468,-2.66,1219
2020-09-14,22810,23763,-953,-4.01,1219
2020-09-15,23572,24489,-917,-3.74,1219
2020-09-16,23572,24475,-903,-3.69,1219
2020-09-17,23572,24437,-865,-3.54,1219
2020-09-18,24135,24689,-554,-2.24,1219
2020-09-19,20346,20434,-88,-0.43,1219
2020-09-20,17116,17489,-373,-2.13,1219
2020-09-21,22810,23667,-857,-3.62,1219
2020-09-22,23572,24398,-826,-3.39,1219
2020-09-23,23572,24394,-822,-3.37,1219
2020-09-24,23572,24371,-799,-3.28,1219
2020-09-25,24135,24642,-507,-2.06,1219
2020-09-26,20346,20410,-64,-0.31,1219
2020-09-27,17116,17489,-373,-2.13,1219
2020-09-28,22810,23693,-883,-3.73,1219
2020-09-29,23572,24451,-879,-3.59,1219
2020-09-30,23572,24473,-901,-3.68,1219
2020-10-01,23020,24475,-1455,-5.94,1219
2020-10-02,23387,24769,-1382,-5.58,1219
2020-10-03,19561,20557,-996,-4.85,1219
2020-10-04,16172,17653,-1481,-8.39,1219
2020-10-05,22727,23870,-1143,-4.79,1219
2020-10-06,23020,24636,-1616,-6.56,1219
2020-10-07,23020,24661,-1641,-6.65,1219
2020-10-08,23020,24661,-1641,-6.65,1219
2020-10-09,23387,24947,-1560,-6.25,1219
2020-10-10,19561,20723,-1162,-5.61,1219
2020-10-11,16172,17802,-1630,-9.16,1219
2020-10-12,22727,23997,-1270,-5.29,1219
2020-10-13,23020,24737,-1717,-6.94,1219
2020-10-14,23020,24733,-1713,-6.93,1219
2020-10-15,23020,24701,-1681,-6.81,1219
2020-10-16,23387,24954,-1567,-6.28,1219
2020-10-17,19561,20695,-1134,-5.48,1219
2020-10-18,16172,17740,-1568,-8.84,1219
2020-10-19,22727,23901,-1174,-4.91,1219
2020-10-20,23020,24608,-1588,-6.45,1219
2020-10-21,23020,24575,-1555,-6.33,1219
2020-10-22,23020,24516,-1496,-6.1,1219
2020-10-23,23387,24746,-1359,-5.49,1219
2020-10-24,19561,20467,-906,-4.43,1219
2020-10-25,16172,17497,-1325,-7.57,1219
2020-10-26,22727,23648,-921,-3.89,1219
2020-10-27,23020,24350,-1330,-5.46,1219
2020-10-28,23020,24315,-1295,-5.33,1219
2020-10-29,23020,24260,-1240,-5.11,1219
2020-10-30,23387,24498,-1111,-4.54,1219
2020-10-31,19561,20231,-670,-3.31,1219
2020-11-01,13253,17275,-4022,-23.28,1219
2020-11-02,20878,23444,-2566,-10.95,1219
2020-11-03,20063,24166,-4103,-16.98,1219
2020-11-04,20063,24152,-4089,-16.93,1219
2020-11-05,20063,24118,-4055,-16.81,1219
2020-11-06,20344,24376,-4032,-16.54,1219
2020-11-07,16367,20129,-3762,-18.69,1219
2020-11-08,13253,17192,-3939,-22.91,1219
2020-11-09,20878,23375,-2497,-10.68,1219
2020-11-10,20063,24109,-4046,-16.78,1219
2020-11-11,20063,24104,-4041,-16.76,1219
2020-11-12,20063,24075,-4012,-16.66,1219
2020-11-13,20344,24335,-3991,-16.4,1219
2020-11-14,16367,20084,-3717,-18.51,1219
2020-11-15,13253,17139,-3886,-22.67,1219
2020-11-16,20878,23312,-2434,-10.44,1219
2020-11-17,20063,24031,-3968,-16.51,1219
2020-11-18,20063,24008,-3945,-16.43,1219
2020-11-19,20063,23958,-3895,-16.26,1219
2020-11-20,20344,24195,-3851,-15.92,1219
2020-11-21,16367,19920,-3553,-17.84,1219
2020-11-22,13253,16950,-3697,-21.81,1219
2020-11-23,20878,23098,-2220,-9.61,1219
2020-11-24,20063,23794,-3731,-15.68,1219
2020-11-25,20063,23749,-3686,-15.52,1219
2020-11-26,20063,23679,-3616,-15.27,1219
2020-11-27,20344,23899,-3555,-14.88,1219
2020-11-28,16367,19611,-3244,-16.54,1219
2020-11-29,13253,16631,-3378,-20.31,1219
2020-11-30,20878,22773,-1895,-8.32,1219
2020-12-01,19933,23467,-3534,-15.06,1219
2020-12-02,19933,23425,-3492,-14.91,1219
2020-12-03,19933,23363,-3430,-14.68,1219
2020-12-04,21706,23594,-1888,-8.0,1219
2020-12-05,16728,19321,-2593,-13.42,1219
2020-12-06,12941,16360,-3419,-20.9,1219
2020-12-07,19938,22523,-2585,-11.48,1219
2020-12-08,19933,23241,-3308,-14.23,1219
2020-12-09,19933,23223,-3290,-14.17,1219
2020-12-10,19933,23186,-3253,-14.03,1219
2020-12-11,21706,23442,-1736,-7.41,1219
2020-12-12,16728,19192,-2464,-12.84,1219
2020-12-13,12941,16253,-3312,-20.38,1219
2020-12-14,19938,22436,-2498,-11.13,1219
2020-12-15,19933,23169,-3236,-13.97,1219
2020-12-16,19933,23164,-3231,-13.95,1219
2020-12-17,19933,23135,-3202,-13.84,1219
2020-12-18,21706,23394,-1688,-7.22,1219
2020-12-19,16728,19143,-2415,-12.62,1219
2020-12-20,12941,16197,-3256,-20.1,1219
2020-12-21,19938,22369,-2431,-10.87,1219
2020-12-22,19933,23086,-3153,-13.66,1219
2020-12-23,19933,23061,-3128,-13.56,1219
2020-12-24,19933,23008,-3075,-13.36,1219
2020-12-25,21706,23240,-1534,-6.6,1219
2020-12-26,16728,18960,-2232,-11.77,1219
2020-12-27,12941,15983,-3042,-19.03,1219
2020-12-28,19938,22123,-2185,-9.88,1219
2020-12-29,19933,22809,-2876,-12.61,1219
2020-12-30,19933,22754,-2821,-12.4,1219
2020-12-31,19933,22672,-2739,-12.08,1219
2021-01-01,19267,22879,-3612,-15.79,1219
2021-01-02,14369,18577,-4208,-22.65,1219
2021-01-03,11446,15584,-4138,-26.55,1219
2021-01-04,17924,21711,-3787,-17.44,1219
2021-01-05,19098,22391,-3293,-14.71,1219
2021-01-06,19098,22335,-3237,-14.49,1219
2021-01-07,19098,22259,-3161,-14.2,1219
2021-01-08,19267,22478,-3211,-14.29,1219
2021-01-09,14369,18195,-3826,-21.03,1219
2021-01-10,11446,15226,-3780,-24.83,1219
2021-01-11,17924,21384,-3460,-16.18,1219
2021-01-12,19098,22098,-3000,-13.58,1219
2021-01-13,19098,22082,-2984,-13.51,1219
2021-01-14,19098,22050,-2952,-13.39,1219
2021-01-15,19267,22315,-3048,-13.66,1219
2021-01-16,14369,18081,-3712,-20.53,1219
2021-01-17,11446,15161,-3715,-24.5,1219
2021-01-18,17924,21369,-3445,-16.12,1219
2021-01-19,19098,22133,-3035,-13.71,1219
2021-01-20,19098,22164,-3066,-13.83,1219
2021-01-21,19098,22177,-3079,-13.88,1219
2021-01-22,19267,22484,-3217,-14.31,1219
2021-01-23,14369,18287,-3918,-21.43,1219
2021-01-24,11446,15401,-3955,-25.68,1219
2021-01-25,17924,21637,-3713,-17.16,1219
2021-01-26,19098,22423,-3325,-14.83,1219
2021-01-27,19098,22472,-3374,-15.01,1219
2021-01-28,19098,22497,-3399,-15.11,1219
2021-01-29,19267,22810,-3543,-15.53,1219
2021-01-30,14369,18615,-4246,-22.81,1219
2021-01-31,11446,15725,-4279,-27.21,1219
2021-02-01,20490,21954,-1464,-6.67,1219
2021-02-02,21178,22730,-1552,-6.83,1219
2021-02-03,21178,22765,-1587,-6.97,1219
2021-02-04,21178,22775,-1597,-7.01,1219
2021-02-05,21459,23072,-1613,-6.99,1219
2021-02-06,16767,18860,-2093,-11.1,1219
2021-02-07,13598,15954,-2356,-14.77,1219
2021-02-08,20490,22168,-1678,-7.57,1219
2021-02-09,21178,22931,-1753,-7.64,1219
2021-02-10,21178,22956,-1778,-7.75,1219
2021-02-11,21178,22959,-1781,-7.76,1219
2021-02-12,21459,23252,-1793,-7.71,1219
2021-02-13,16767,19040,-2273,-11.94,1219
2021-02-14,13598,16139,-2541,-15.74,1219
2021-02-15,20490,22361,-1871,-8.37,1219
2021-02-16,21178,23137,-1959,-8.47,1219
2021-02-17,21178,23178,-2000,-8.63,1219
2021-02-18,21178,23200,-2022,-8.72,1219
2021-02-19,21459,23516,-2057,-8.75,1219
2021-02-20,16767,19330,-2563,-13.26,1219
2021-02-21,13598,16455,-2857,-17.36,1219
2021-02-22,20490,22706,-2216,-9.76,1219
2021-02-23,21178,23510,-2332,-9.92,1219
2021-02-24,21178,23579,-2401,-10.18,1219
2021-02-25,21178,23629,-2451,-10.37,1219
2021-02-26,21459,23970,-2511,-10.48,1219
2021-02-27,16767,19806,-3039,-15.34,1219
2021-02-28,13598,16950,-3352,-19.78,1219
2021-03-01,21693,23216,-1523,-6.56,1219
2021-03-02,22480,24031,-1551,-6.45,1219
2021-03-03,22480,24106,-1626,-6.75,1219
2021-03-04,22480,24157,-1677,-6.94,1219
2021-03-05,22575,24494,-1919,-7.83,1219
2021-03-06,19086,20321,-1235,-6.08,1219
2021-03-07,14348,17452,-3104,-17.79,1219
2021-03-08,21693,23699,-2006,-8.46,1219
2021-03-09,22480,24492,-2012,-8.21,1219
2021-03-10,22480,24540,-2060,-8.39,1219
2021-03-11,22480,24561,-2081,-8.47,1219
2021-03-12,22575,24866,-2291,-9.21,1219
2021-03-13,19086,20658,-1572,-7.61,1219
2021-03-14,14348,17753,-3405,-19.18,1219
2021-03-15,21693,23964,-2271,-9.48,1219
2021-03-16,22480,24720,-2240,-9.06,1219
2021-03-17,22480,24733,-2253,-9.11,1219
2021-03-18,22480,24720,-2240,-9.06,1219
2021-03-19,22575,24993,-2418,-9.67,1219
2021-03-20,19086,20756,-1670,-8.05,1219
2021-03-21,14348,17825,-3477,-19.51,1219
2021-03-22,21693,24014,-2321,-9.67,1219
2021-03-23,22480,24751,-2271,-9.18,1219
2021-03-24,22480,24750,-2270,-9.17,1219
2021-03-25,22480,24726,-2246,-9.08,1219
2021-03-26,22575,24992,-2417,-9.67,1219
2021-03-27,19086,20752,-1666,-8.03,1219
2021-03-28,14348,17822,-3474,-19.49,1219
2021-03-29,21693,24014,-2321,-9.67,1219
2021-03-30,22480,24758,-2278,-9.2,1219
2021-03-31,22480,24766,-2286,-9.23,1219
2021-04-01,21078,24753,-3675,-14.85,1219
2021-04-02,21306,25031,-3725,-14.88,1219
2021-04-03,17396,20805,-3409,-16.39,1219
2021-04-04,14479,17888,-3409,-19.06,1219
2021-04-05,20695,24094,-3399,-14.11,1219
2021-04-06,21078,24850,-3772,-15.18,1219
2021-04-07,21078,24870,-3792,-15.25,1219
2021-04-08,21078,24867,-3789,-15.24,1219
2021-04-09,21306,25155,-3849,-15.3,1219
2021-04-10,17396,20935,-3539,-16.9,1219
2021-04-11,14479,18024,-3545,-19.67,1219
2021-04-12,20695,24232,-3537,-14.6,1219
2021-04-13,21078,24990,-3912,-15.65,1219
2021-04-14,21078,25009,-3931,-15.72,1219
2021-04-15,21078,25003,-3925,-15.7,1219
2021-04-16,21306,25287,-3981,-15.74,1219
2021-04-17,17396,21062,-3666,-17.41,1219
2021-04-18,14479,18143,-3664,-20.2,1219
2021-04-19,20695,24345,-3650,-14.99,1219
2021-04-20,21078,25095,-4017,-16.01,1219
2021-04-21,21078,25106,-4028,-16.04,1219
2021-04-22,21078,25094,-4016,-16.0,1219
2021-04-23,21306,25371,-4065,-16.02,1219
2021-04-24,17396,21140,-3744,-17.71,1219
2021-04-25,14479,18217,-3738,-20.52,1219
2021-04-26,20695,24414,-3719,-15.23,1219
2021-04-27,21078,25162,-4084,-16.23,1219
2021-04-28,21078,25172,-4094,-16.26,1219
2021-04-29,21078,25160,-4082,-16.22,1219
2021-04-30,21306,25438,-4132,-16.24,1219
2021-05-01,21038,21210,-172,-0.81,1219
2021-05-02,15720,18290,-2570,-14.05,1219
2021-05-03,23741,24492,-751,-3.07,1219
2021-05-04,24665,25245,-580,-2.3,1219
2021-05-05,24665,25260,-595,-2.36,1219
2021-05-06,24665,25253,-588,-2.33,1219
2021-05-07,24258,25535,-1277,-5.0,1219
2021-05-08,21038,21311,-273,-1.28,1219
2021-05-09,15720,18395,-2675,-14.54,1219
2021-05-10,23741,24599,-858,-3.49,1219
2021-05-11,24665,25353,-688,-2.71,1219
2021-05-12,24665,25368,-703,-2.77,1219
2021-05-13,24665,25360,-695,-2.74,1219
2021-05-14,24258,25640,-1382,-5.39,1219
2021-05-15,21038,21412,-374,-1.75,1219
2021-05-16,15720,18491,-2771,-14.99,1219
2021-05-17,23741,24690,-949,-3.84,1219
2021-05-18,24665,25437,-772,-3.03,1219
2021-05-19,24665,25446,-781,-3.07,1219
2021-05-20,24665,25430,-765,-3.01,1219
2021-05-21,24258,25704,-1446,-5.63,1219
2021-05-22,21038,21470,-432,-2.01,1219
2021-05-23,15720,18543,-2823,-15.22,1219
2021-05-24,23741,24737,-996,-4.03,1219
2021-05-25,24665,25482,-817,-3.21,1219
2021-05-26,24665,25489,-824,-3.23,1219
2021-05-27,24665,25473,-808,-3.17,1219
2021-05-28,24258,25749,-1491,-5.79,1219
2021-05-29,21038,21519,-481,-2.24,1219
2021-05-30,15720,18598,-2878,-15.47,1219
2021-05-31,23741,24801,-1060,-4.27,1219
2021-07-01,21824,25355,-3531,-13.93,1219
2021-07-02,21838,25562,-3724,-14.57,1219
2021-07-03,17606,21262,-3656,-17.19,1219
2021-07-04,14916,18271,-3355,-18.36,1219
2021-07-05,21150,24404,-3254,-13.33,1219
2021-07-06,21824,25089,-3265,-13.01,1219
2021-07-07,21824,25040,-3216,-12.84,1219
2021-07-08,21824,24973,-3149,-12.61,1219
2021-07-09,21838,25200,-3362,-13.34,1219
2021-07-10,17606,20926,-3320,-15.87,1219
2021-07-11,14916,17965,-3049,-16.97,1219
2021-07-12,21150,24131,-2981,-12.35,1219
2021-07-13,21824,24852,-3028,-12.18,1219
2021-07-14,21824,24841,-3017,-12.15,1219
2021-07-15,21824,24813,-2989,-12.05,1219
2021-07-16,21838,25079,-3241,-12.92,1219
2021-07-17,17606,20842,-3236,-15.53,1219
2021-07-18,14916,17917,-3001,-16.75,1219
2021-07-19,21150,24116,-2966,-12.3,1219
2021-07-20,21824,24868,-3044,-12.24,1219
2021-07-21,21824,24882,-3058,-12.29,1219
2021-07-22,21824,24874,-3050,-12.26,1219
2021-07-23,21838,25155,-3317,-13.19,1219
2021-07-24,17606,20928,-3322,-15.87,1219
2021-07-25,14916,18007,-3091,-17.17,1219
2021-07-26,21150,24205,-3055,-12.62,1219
2021-07-27,21824,24949,-3125,-12.53,1219
2021-07-28,21824,24951,-3127,-12.53,1219
2021-07-29,21824,24926,-3102,-12.44,1219
2021-07-30,21838,25186,-3348,-13.29,1219
2021-07-31,17606,20935,-3329,-15.9,1219
2021-08-01,14744,17988,-3244,-18.03,1219
2021-08-02,20117,24157,-4040,-16.72,1219
2021-08-03,20632,24872,-4240,-17.05,1219
2021-08-04,20632,24846,-4214,-16.96,1219
2021-08-05,20632,24794,-4162,-16.79,1219
2021-08-06,20518,25030,-4512,-18.03,1219
2021-08-07,17353,20758,-3405,-16.4,1219
2021-08-08,14744,17793,-3049,-17.14,1219
2021-08-09,20117,23950,-3833,-16.0,1219
2021-08-10,20632,24659,-4027,-16.33,1219
2021-08-11,20632,24631,-3999,-16.24,1219
2021-08-12,20632,24584,-3952,-16.08,1219
2021-08-13,20518,24831,-4313,-17.37,1219
2021-08-14,17353,20576,-3223,-15.66,1219
2021-08-15,14744,17634,-2890,-16.39,1219
2021-08-16,20117,23819,-3702,-15.54,1219
2021-08-17,20632,24561,-3929,-16.0,1219
2021-08-18,20632,24571,-3939,-16.03,1219
2021-08-19,20632,24566,-3934,-16.01,1219
2021-08-20,20518,24857,-4339,-17.46,1219
2021-08-21,17353,20647,-3294,-15.95,1219
2021-08-22,14744,17751,-3007,-16.94,1219
2021-08-23,20117,23982,-3865,-16.12,1219
2021-08-24,20632,24768,-4136,-16.7,1219
2021-08-25,20632,24820,-4188,-16.87,1219
2021-08-26,20632,24853,-4221,-16.98,1219
2021-08-27,20518,25178,-4660,-18.51,1219
2021-08-28,17353,20997,-3644,-17.35,1219
2021-08-29,14744,18124,-3380,-18.65,1219
2021-08-30,20117,24372,-4255,-17.46,1219
2021-08-31,20632,25168,-4536,-18.02,1219
2021-09-01,22901,25223,-2322,-9.21,1219
2021-09-02,22901,25252,-2351,-9.31,1219
2021-09-03,23052,25566,-2514,-9.83,1219
2021-09-04,20245,21369,-1124,-5.26,1219
2021-09-05,17940,18474,-534,-2.89,1219
2021-09-06,22158,24695,-2537,-10.27,1219
2021-09-07,22901,25459,-2558,-10.05,1219
2021-09-08,22901,25479,-2578,-10.12,1219
2021-09-09,22901,25471,-2570,-10.09,1219
2021-09-10,23052,25746,-2694,-10.46,1219
2021-09-11,20245,21509,-1264,-5.88,1219
2021-09-12,17940,18575,-635,-3.42,1219
2021-09-13,22158,24758,-2600,-10.5,1219
2021-09-14,22901,25487,-2586,-10.15,1219
2021-09-15,22901,25475,-2574,-10.1,1219
2021-09-16,22901,25438,-2537,-9.97,1219
2021-09-17,23052,25690,-2638,-10.27,1219
2021-09-18,20245,21435,-1190,-5.55,1219
2021-09-19,17940,18488,-548,-2.96,1219
2021-09-20,22158,24664,-2506,-10.16,1219
2021-09-21,22901,25391,-2490,-9.81,1219
2021-09-22,22901,25383,-2482,-9.78,1219
2021-09-23,22901,25355,-2454,-9.68,1219
2021-09-24,23052,25621,-2569,-10.03,1219
2021-09-25,20245,21383,-1138,-5.32,1219
2021-09-26,17940,18458,-518,-2.81,1219
2021-09-27,22158,24657,-2499,-10.14,1219
2021-09-28,22901,25410,-2509,-9.87,1219
2021-09-29,22901,25429,-2528,-9.94,1219
2021-09-30,22901,25428,-2527,-9.94,1219
2021-10-01,23521,25719,-2198,-8.55,1219
2021-10-02,18537,21505,-2968,-13.8,1219
2021-10-03,15920,18600,-2680,-14.41,1219
2021-10-04,22244,24817,-2573,-10.37,1219
2021-10-05,22847,25584,-2737,-10.7,1219
2021-10-06,22847,25612,-2765,-10.8,1219
2021-10-07,22847,25615,-2768,-10.81,1219
2021-10-08,23521,25905,-2384,-9.2,1219
2021-10-09,18537,21685,-3148,-14.52,1219
2021-10-10,15920,18770,-2850,-15.18,1219
2021-10-11,22244,24971,-2727,-10.92,1219
2021-10-12,22847,25717,-2870,-11.16,1219
2021-10-13,22847,25720,-2873,-11.17,1219
2021-10-14,22847,25695,-2848,-11.08,1219
2021-10-15,23521,25954,-2433,-9.37,1219
2021-10-16,18537,21701,-3164,-14.58,1219
2021-10-17,15920,18751,-2831,-15.1,1219
2021-10-18,22244,24917,-2673,-10.73,1219
2021-10-19,22847,25629,-2782,-10.85,1219
2021-10-20,22847,25599,-2752,-10.75,1219
2021-10-21,22847,25544,-2697,-10.56,1219
2021-10-22,23521,25775,-2254,-8.74,1219
2021-10-23,18537,21498,-2961,-13.77,1219
2021-10-24,15920,18527,-2607,-14.07,1219
2021-10-25,22244,24678,-2434,-9.86,1219
2021-10-26,22847,25378,-2531,-9.97,1219
2021-10-27,22847,25341,-2494,-9.84,1219
2021-10-28,22847,25284,-2437,-9.64,1219
2021-10-29,23521,25518,-1997,-7.83,1219
2021-10-30,18537,21247,-2710,-12.75,1219
2021-10-31,15920,18288,-2368,-12.95,1219
2021-11-01,20880,24452,-3572,-14.61,1219
2021-11-02,21950,25170,-3220,-12.79,1219
2021-11-03,21950,25152,-3202,-12.73,1219
2021-11-04,21950,25115,-3165,-12.6,1219
2021-11-05,22397,25370,-2973,-11.72,1219
2021-11-06,18563,21121,-2558,-12.11,1219
2021-11-07,15147,18181,-3034,-16.69,1219
2021-11-08,20880,24364,-3484,-14.3,1219
2021-11-09,21950,25098,-3148,-12.54,1219
2021-11-10,21950,25093,-3143,-12.53,1219
2021-11-11,21950,25066,-3116,-12.43,1219
2021-11-12,22397,25327,-2930,-11.57,1219
2021-11-13,18563,21079,-2516,-11.94,1219
2021-11-14,15147,18137,-2990,-16.49,1219
2021-11-15,20880,24314,-3434,-14.12,1219
2021-11-16,21950,25037,-3087,-12.33,1219
2021-11-17,21950,25019,-3069,-12.27,1219
2021-11-18,21950,24974,-3024,-12.11,1219
2021-11-19,22397,25215,-2818,-11.18,1219
2021-11-20,18563,20945,-2382,-11.37,1219
2021-11-21,15147,17980,-2833,-15.76,1219
2021-11-22,20880,24131,-3251,-13.47,1219
2021-11-23,21950,24830,-2880,-11.6,1219
2021-11-24,21950,24788,-2838,-11.45,1219
2021-11-25,21950,24720,-2770,-11.21,1219
2021-11-26,22397,24941,-2544,-10.2,1219
2021-11-27,18563,20653,-2090,-10.12,1219
2021-11-28,15147,17673,-2526,-14.29,1219
2021-11-29,20880,23814,-2934,-12.32,1219
2021-11-30,21950,24506,-2556,-10.43,1219
2021-12-01,20276,24461,-4185,-17.11,1219
2021-12-02,20276,24396,-4120,-16.89,1219
2021-12-03,20010,24623,-4613,-18.73,1219
2021-12-04,17273,20345,-3072,-15.1,1219
2021-12-05,13770,17379,-3609,-20.77,1219
2021-12-06,20361,23538,-3177,-13.5,1219
2021-12-07,20276,24251,-3975,-16.39,1219
2021-12-08,20276,24228,-3952,-16.31,1219
2021-12-09,20276,24187,-3911,-16.17,1219
2021-12-10,20010,24439,-4429,-18.12,1219
2021-12-11,17273,20187,-2914,-14.44,1219
2021-12-12,13770,17245,-3475,-20.15,1219
2021-12-13,20361,23426,-3065,-13.08,1219
2021-12-14,20276,24158,-3882,-16.07,1219
2021-12-15,20276,24153,-3877,-16.05,1219
2021-12-16,20276,24125,-3849,-15.95,1219
2021-12-17,20010,24386,-4376,-17.94,1219
2021-12-18,17273,20138,-2865,-14.23,1219
2021-12-19,13770,17196,-3426,-19.92,1219
2021-12-20,20361,23372,-3011,-12.88,1219
2021-12-21,20276,24095,-3819,-15.85,1219
2021-12-22,20276,24075,-3799,-15.78,1219
2021-12-23,20276,24028,-3752,-15.62,1219
2021-12-24,20010,24266,-4256,-17.54,1219
2021-12-25,17273,19992,-2719,-13.6,1219
2021-12-26,13770,17021,-3251,-19.1,1219
2021-12-27,20361,23166,-2805,-12.11,1219
2021-12-28,20276,23857,-3581,-15.01,1219
2021-12-29,20276,23806,-3530,-14.83,1219
2021-12-30,20276,23728,-3452,-14.55,1219
2021-12-31,20010,23937,-3927,-16.41,1219
2022-01-01,16582,19637,-3055,-15.56,1219
2022-01-02,12804,16643,-3839,-23.07,1219
2022-01-03,19227,22770,-3543,-15.56,1219
2022-01-04,20042,23448,-3406,-14.53,1219
2022-01-05,20042,23388,-3346,-14.31,1219
2022-01-06,20042,23309,-3267,-14.02,1219
2022-01-07,20293,23522,-3229,-13.73,1219
2022-01-08,16582,19232,-2650,-13.78,1219
2022-01-09,12804,16256,-3452,-21.24,1219
2022-01-10,19227,22406,-3179,-14.19,1219
2022-01-11,20042,23112,-3070,-13.28,1219
2022-01-12,20042,23086,-3044,-13.19,1219
2022-01-13,20042,23045,-3003,-13.03,1219
2022-01-14,20293,23301,-3008,-12.91,1219
2022-01-15,16582,19058,-2476,-12.99,1219
2022-01-16,12804,16129,-3325,-20.62,1219
2022-01-17,19227,22329,-3102,-13.89,1219
2022-01-18,20042,23085,-3043,-13.18,1219
2022-01-19,20042,23109,-3067,-13.27,1219
2022-01-20,20042,23116,-3074,-13.3,1219
2022-01-21,20293,23418,-3125,-13.34,1219
2022-01-22,16582,19216,-2634,-13.71,1219
2022-01-23,12804,16327,-3523,-21.58,1219
2022-01-24,19227,22560,-3333,-14.77,1219
2022-01-25,20042,23346,-3304,-14.15,1219
2022-01-26,20042,23394,-3352,-14.33,1219
2022-01-27,20042,23420,-3378,-14.42,1219
2022-01-28,20293,23734,-3441,-14.5,1219
2022-01-29,16582,19541,-2959,-15.14,1219
2022-01-30,12804,16654,-3850,-23.12,1219
2020-02-01,25107,21215,3892,18.35,1089
2020-02-02,20334,17050,3284,19.26,1089
2020-02-03,28191,27127,1064,3.92,1089
2020-02-04,29429,28155,1274,4.52,1089
2020-02-05,29429,28182,1247,4.42,1089
2020-02-06,29429,28212,1217,4.31,1089
2020-02-07,29912,28766,1146,3.98,1089
2020-02-08,25107,21363,3744,17.53,1089
2020-02-09,20334,17156,3178,18.52,1089
2020-02-10,28191,27201,990,3.64,1089
2020-02-11,29429,28208,1221,4.33,1089
2020-02-12,29429,28225,1204,4.27,1089
2020-02-13,29429,28258,1171,4.14,1089
2020-02-14,29912,28828,1084,3.76,1089
2020-02-15,25107,21453,3654,17.03,1089
2020-02-16,20334,17286,3048,17.63,1089
2020-02-17,28191,27383,808,2.95,1089
2020-02-18,29429,28450,979,3.44,1089
2020-02-19,29429,28536,893,3.13,1089
2020-02-20,29429,28645,784,2.74,1089
2020-02-21,29912,29295,617,2.11,1089
2020-02-22,25107,22002,3105,14.11,1089
2020-02-23,20334,17917,2417,13.49,1089
2020-02-24,28191,28092,99,0.35,1089
2020-02-25,29429,29234,195,0.67,1089
2020-02-26,29429,29388,41,0.14,1089
2020-02-27,29429,29556,-127,-0.43,1089
2020-02-28,29912,30255,-343,-1.13,1089
2020-02-29,25107,22999,2108,9.17,1089
2020-03-01,14670,18939,-4269,-22.54,1089
2020-03-02,21869,29125,-7256,-24.91,1089
2020-03-03,22542,30265,-7723,-25.52,1089
2020-03-04,22542,30403,-7861,-25.86,1089
2020-03-05,22542,30542,-8000,-26.19,1089
2020-03-06,23964,31200,-7236,-23.19,1089
2020-03-07,17490,23892,-6402,-26.8,1089
2020-03-08,14670,19769,-5099,-25.79,1089
2020-03-09,21869,29886,-8017,-26.83,1089
2020-03-10,22542,30950,-8408,-27.17,1089
2020-03-11,22542,31008,-8466,-27.3,1089
2020-03-12,22542,31065,-8523,-27.44,1089
2020-03-13,23964,31642,-7678,-24.27,1089
2020-03-14,17490,24255,-6765,-27.89,1089
2020-03-15,14670,20058,-5388,-26.86,1089
2020-03-16,21869,30107,-8238,-27.36,1089
2020-03-17,22542,31110,-8568,-27.54,1089
2020-03-18,22542,31118,-8576,-27.56,1089
2020-03-19,22542,31134,-8592,-27.6,1089
2020-03-20,23964,31681,-7717,-24.36,1089
2020-03-21,17490,24276,-6786,-27.95,1089
2020-03-22,14670,20072,-5402,-26.91,1089
2020-03-23,21869,30125,-8256,-27.41,1089
2020-03-24,22542,31144,-8602,-27.62,1089
2020-03-25,22542,31176,-8634,-27.69,1089
2020-03-26,22542,31225,-8683,-27.81,1089
2020-03-27,23964,31811,-7847,-24.67,1089
2020-03-28,17490,24451,-6961,-28.47,1089
2020-03-29,14670,20296,-5626,-27.72,1089
2020-03-30,21869,30399,-8530,-28.06,1089
2020-03-31,22542,31468,-8926,-28.37,1089
2020-04-01,21613,31548,-9935,-31.49,1089
2020-04-02,21613,31641,-10028,-31.69,1089
2020-04-03,20781,32266,-11485,-35.59,1089
2020-04-04,17311,24937,-7626,-30.58,1089
2020-04-05,13172,20805,-7633,-36.69,1089
2020-04-06,21516,30923,-9407,-30.42,1089
2020-04-07,21613,31997,-10384,-32.45,1089
2020-04-08,21613,32071,-10458,-32.61,1089
2020-04-09,21613,32150,-10537,-32.77,1089
2020-04-10,20781,32751,-11970,-36.55,1089
2020-04-11,17311,25389,-8078,-31.82,1089
2020-04-12,13172,21216,-8044,-37.91,1089
2020-04-13,21516,31286,-9770,-31.23,1089
2020-04-14,21613,32307,-10694,-33.1,1089
2020-04-15,21613,32324,-10711,-33.14,1089
2020-04-16,21613,32343,-10730,-33.18,1089
2020-04-17,20781,32883,-12102,-36.8,1089
2020-04-18,17311,25462,-8151,-32.01,1089
2020-04-19,13172,21233,-8061,-37.96,1089
2020-04-20,21516,31250,-9734,-31.15,1089
2020-04-21,21613,32223,-10610,-32.93,1089
2020-04-22,21613,32200,-10587,-32.88,1089
2020-04-23,21613,32186,-10573,-32.85,1089
2020-04-24,20781,32702,-11921,-36.45,1089
2020-04-25,17311,25265,-7954,-31.48,1089
2020-04-26,13172,21028,-7856,-37.36,1089
2020-04-27,21516,31046,-9530,-30.7,1089
2020-04-28,21613,32028,-10415,-32.52,1089
2020-04-29,21613,32021,-10408,-32.5,1089
2020-04-30,21613,32030,-10417,-32.52,1089
2020-05-01,28815,32574,-3759,-11.54,1089
2020-05-02,23923,25169,-1246,-4.95,1089
2020-05-03,19048,20966,-1918,-9.15,1089
2020-05-04,27687,31020,-3333,-10.74,1089
2020-05-05,28620,32037,-3417,-10.67,1089
2020-05-06,28620,32063,-3443,-10.74,1089
2020-05-07,28620,32102,-3482,-10.85,1089
2020-05-08,28815,32670,-3855,-11.8,1089
2020-05-09,23923,25285,-1362,-5.39,1089
2020-05-10,19048,21095,-2047,-9.7,1089
2020-05-11,27687,31155,-3468,-11.13,1089
2020-05-12,28620,32171,-3551,-11.04,1089
2020-05-13,28620,32189,-3569,-11.09,1089
2020-05-14,28620,32212,-3592,-11.15,1089
2020-05-15,28815,32758,-3943,-12.04,1089
2020-05-16,23923,25345,-1422,-5.61,1089
2020-05-17,19048,21123,-2075,-9.82,1089
2020-05-18,27687,31148,-3461,-11.11,1089
2020-05-19,28620,32126,-3506,-10.91,1089
2020-05-20,28620,32105,-3485,-10.86,1089
2020-05-21,28620,32091,-3471,-10.82,1089
2020-05-22,28815,32603,-3788,-11.62,1089
2020-05-23,23923,25160,-1237,-4.92,1089
2020-05-24,19048,20913,-1865,-8.92,1089
2020-05-25,27687,30919,-3232,-10.45,1089
2020-05-26,28620,31887,-3267,-10.25,1089
2020-05-27,28620,31865,-3245,-10.18,1089
2020-05-28,28620,31857,-3237,-10.16,1089
2020-05-29,28815,32385,-3570,-11.02,1089
2020-05-30,23923,24966,-1043,-4.18,1089
2020-05-31,19048,20753,-1705,-8.22,1089
2020-06-01,30252,30799,-547,-1.78,1089
2020-06-02,31540,31812,-272,-0.86,1089
2020-06-03,31540,31840,-300,-0.94,1089
2020-06-04,31540,31886,-346,-1.09,1089
2020-06-05,31361,32468,-1107,-3.41,1089
2020-06-06,26678,25101,1577,6.28,1089
2020-06-07,21344,20936,408,1.95,1089
2020-06-08,30252,31024,-772,-2.49,1089
2020-06-09,31540,32072,-532,-1.66,1089
2020-06-10,31540,32123,-583,-1.81,1089
2020-06-11,31540,32179,-639,-1.99,1089
2020-06-12,31361,32758,-1397,-4.26,1089
2020-06-13,26678,25372,1306,5.15,1089
2020-06-14,21344,21171,173,0.82,1089
2020-06-15,30252,31207,-955,-3.06,1089
2020-06-16,31540,32184,-644,-2.0,1089
2020-06-17,31540,32148,-608,-1.89,1089
2020-06-18,31540,32101,-561,-1.75,1089
2020-06-19,31361,32561,-1200,-3.69,1089
2020-06-20,26678,25043,1635,6.53,1089
2020-06-21,21344,20699,645,3.12,1089
2020-06-22,30252,30583,-331,-1.08,1089
2020-06-23,31540,31403,137,0.44,1089
2020-06-24,31540,31207,333,1.07,1089
2020-06-25,31540,31000,540,1.74,1089
2020-06-26,31361,31305,56,0.18,1089
2020-06-27,26678,23639,3039,12.86,1089
2020-06-28,21344,19157,2187,11.42,1089
2020-06-29,30252,28917,1335,4.62,1089
2020-06-30,31540,29630,1910,6.45,1089
2020-07-01,31744,29346,2398,8.17,1089
2020-07-02,31744,29074,2670,9.18,1089
2020-07-03,32338,29335,3003,10.24,1089
2020-07-04,24799,21651,3148,14.54,1089
2020-07-05,22860,17176,5684,33.09,1089
2020-07-06,30060,26968,3092,11.47,1089
2020-07-07,31744,27737,4007,14.45,1089
2020-07-08,31744,27533,4211,15.29,1089
2020-07-09,31744,27363,4381,16.01,1089
2020-07-10,32338,27745,4593,16.55,1089
2020-07-11,24799,20199,4600,22.77,1089
2020-07-12,22860,15877,6983,43.98,1089
2020-07-13,30060,25831,4229,16.37,1089
2020-07-14,31744,26770,4974,18.58,1089
2020-07-15,31744,26738,5006,18.72,1089
2020-07-16,31744,26738,5006,18.72,1089
2020-07-17,32338,27287,5051,18.51,1089
2020-07-18,24799,19898,4901,24.63,1089
2020-07-19,22860,15720,7140,45.42,1089
2020-07-20,30060,25804,4256,16.49,1089
2020-07-21,31744,26854,4890,18.21,1089
2020-07-22,31744,26914,4830,17.95,1089
2020-07-23,31744,26983,4761,17.64,1089
2020-07-24,32338,27578,4760,17.26,1089
2020-07-25,24799,20212,4587,22.69,1089
2020-07-26,22860,16033,6827,42.58,1089
2020-07-27,30060,26094,3966,15.2,1089
2020-07-28,31744,27099,4645,17.14,1089
2020-07-29,31744,27095,4649,17.16,1089
2020-07-30,31744,27084,4660,17.21,1089
2020-07-31,32338,27584,4754,17.23,1089
2020-08-01,25467,20113,5354,26.62,1089
2020-08-02,21884,15824,6060,38.3,1089
2020-08-03,27949,25770,2179,8.46,1089
2020-08-04,29397,26662,2735,10.26,1089
2020-08-05,29397,26550,2847,10.72,1089
2020-08-06,29397,26439,2958,11.19,1089
2020-08-07,30530,26853,3677,13.69,1089
2020-08-08,25467,19310,6157,31.89,1089
2020-08-09,21884,14967,6917,46.22,1089
2020-08-10,27949,24881,3068,12.33,1089
2020-08-11,29397,25764,3633,14.1,1089
2020-08-12,29397,25665,3732,14.54,1089
2020-08-13,29397,25592,3805,14.87,1089
2020-08-14,30530,26069,4461,17.11,1089
2020-08-15,25467,18612,6855,36.83,1089
2020-08-16,21884,14378,7506,52.2,1089
2020-08-17,27949,24420,3529,14.45,1089
2020-08-18,29397,25450,3947,15.51,1089
2020-08-19,29397,25513,3884,15.22,1089
2020-08-20,29397,25613,3784,14.77,1089
2020-08-21,30530,26270,4260,16.22,1089
2020-08-22,25467,18999,6468,34.04,1089
2020-08-23,21884,14950,6934,46.38,1089
2020-08-24,27949,25174,2775,11.02,1089
2020-08-25,29397,26377,3020,11.45,1089
2020-08-26,29397,26601,2796,10.51,1089
2020-08-27,29397,26849,2548,9.49,1089
2020-08-28,30530,27635,2895,10.48,1089
2020-08-29,25467,20473,4994,24.39,1089
2020-08-30,21884,16509,5375,32.56,1089
2020-08-31,27949,26795,1154,4.31,1089
2020-09-01,31820,28034,3786,13.51,1089
2020-09-02,31820,28270,3550,12.56,1089
2020-09-03,31820,28504,3316,11.63,1089
2020-09-04,32314,29252,3062,10.47,1089
2020-09-05,26552,22029,4523,20.53,1089
2020-09-06,21847,17983,3864,21.49,1089
2020-09-07,30784,28169,2615,9.28,1089
2020-09-08,31820,29293,2527,8.63,1089
2020-09-09,31820,29402,2418,8.22,1089
2020-09-10,31820,29499,2321,7.87,1089
2020-09-11,32314,30106,2208,7.33,1089
2020-09-12,26552,22739,3813,16.77,1089
2020-09-13,21847,18552,3295,17.76,1089
2020-09-14,30784,28600,2184,7.64,1089
2020-09-15,31820,29596,2224,7.51,1089
2020-09-16,31820,29586,2234,7.55,1089
2020-09-17,31820,29578,2242,7.58,1089
2020-09-18,32314,30095,2219,7.37,1089
2020-09-19,26552,22654,3898,17.21,1089
2020-09-20,21847,18411,3436,18.66,1089
2020-09-21,30784,28422,2362,8.31,1089
2020-09-22,31820,29396,2424,8.25,1089
2020-09-23,31820,29383,2437,8.29,1089
2020-09-24,31820,29388,2432,8.28,1089
2020-09-25,32314,29932,2382,7.96,1089
2020-09-26,26552,22531,4021,17.85,1089
2020-09-27,21847,18338,3509,19.14,1089
2020-09-28,30784,28407,2377,8.37,1089
2020-09-29,31820,29445,2375,8.07,1089
2020-09-30,31820,29498,2322,7.87,1089
2020-10-01,30896,29569,1327,4.49,1089
2020-10-02,31137,30175,962,3.19,1089
2020-10-03,24492,22832,1660,7.27,1089
2020-10-04,19985,18690,1295,6.93,1089
2020-10-05,29517,28800,717,2.49,1089
2020-10-06,30896,29868,1028,3.44,1089
2020-10-07,30896,29940,956,3.19,1089
2020-10-08,30896,30016,880,2.93,1089
2020-10-09,31137,30616,521,1.7,1089
2020-10-10,24492,23253,1239,5.33,1089
2020-10-11,19985,19078,907,4.75,1089
2020-10-12,29517,29144,373,1.28,1089
2020-10-13,30896,30159,737,2.44,1089
2020-10-14,30896,30168,728,2.41,1089
2020-10-15,30896,30176,720,2.39,1089
2020-10-16,31137,30702,435,1.42,1089
2020-10-17,24492,23264,1228,5.28,1089
2020-10-18,19985,19014,971,5.11,1089
2020-10-19,29517,29008,509,1.75,1089
2020-10-20,30896,29954,942,3.14,1089
2020-10-21,30896,29902,994,3.32,1089
2020-10-22,30896,29857,1039,3.48,1089
2020-10-23,31137,30340,797,2.63,1089
2020-10-24,24492,22869,1623,7.1,1089
2020-10-25,19985,18599,1386,7.45,1089
2020-10-26,29517,28584,933,3.26,1089
2020-10-27,30896,29534,1362,4.61,1089
2020-10-28,30896,29497,1399,4.74,1089
2020-10-29,30896,29479,1417,4.81,1089
2020-10-30,31137,29998,1139,3.8,1089
2020-10-31,24492,22573,1919,8.5,1089
2020-11-01,16187,18354,-2167,-11.81,1089
2020-11-02,26900,28396,-1496,-5.27,1089
2020-11-03,24509,29405,-4896,-16.65,1089
2020-11-04,24509,29428,-4919,-16.72,1089
2020-11-05,24509,29467,-4958,-16.83,1089
2020-11-06,26192,30040,-3848,-12.81,1089
2020-11-07,20283,22662,-2379,-10.5,1089
2020-11-08,16187,18482,-2295,-12.42,1089
2020-11-09,26900,28553,-1653,-5.79,1089
2020-11-10,24509,29581,-5072,-17.15,1089
2020-11-11,24509,29610,-5101,-17.23,1089
2020-11-12,24509,29642,-5133,-17.32,1089
2020-11-13,26192,30195,-4003,-13.26,1089
2020-11-14,20283,22784,-2501,-10.98,1089
2020-11-15,16187,18559,-2372,-12.78,1089
2020-11-16,26900,28573,-1673,-5.86,1089
2020-11-17,24509,29533,-5024,-17.01,1089
2020-11-18,24509,29486,-4977,-16.88,1089
2020-11-19,24509,29435,-4926,-16.74,1089
2020-11-20,26192,29901,-3709,-12.4,1089
2020-11-21,20283,22399,-2116,-9.45,1089
2020-11-22,16187,18085,-1898,-10.49,1089
2020-11-23,26900,28011,-1111,-3.97,1089
2020-11-24,24509,28889,-4380,-15.16,1089
2020-11-25,24509,28766,-4257,-14.8,1089
2020-11-26,24509,28648,-4139,-14.45,1089
2020-11-27,26192,29058,-2866,-9.86,1089
2020-11-28,20283,21513,-1230,-5.72,1089
2020-11-29,16187,17167,-980,-5.71,1089
2020-11-30,26900,27077,-177,-0.65,1089
2020-12-01,25801,27952,-2151,-7.7,1089
2020-12-02,25801,27841,-2040,-7.33,1089
2020-12-03,25801,27749,-1948,-7.02,1089
2020-12-04,27501,28197,-696,-2.47,1089
2020-12-05,20935,20702,233,1.13,1089
2020-12-06,15527,16416,-889,-5.42,1089
2020-12-07,24922,26393,-1471,-5.57,1089
2020-12-08,25801,27341,-1540,-5.63,1089
2020-12-09,25801,27305,-1504,-5.51,1089
2020-12-10,25801,27290,-1489,-5.46,1089
2020-12-11,27501,27813,-312,-1.12,1089
2020-12-12,20935,20388,547,2.68,1089
2020-12-13,15527,16166,-639,-3.95,1089
2020-12-14,24922,26199,-1277,-4.87,1089
2020-12-15,25801,27192,-1391,-5.12,1089
2020-12-16,25801,27189,-1388,-5.11,1089
2020-12-17,25801,27193,-1392,-5.12,1089
2020-12-18,27501,27720,-219,-0.79,1089
2020-12-19,20935,20286,649,3.2,1089
2020-12-20,15527,16040,-513,-3.2,1089
2020-12-21,24922,26034,-1112,-4.27,1089
2020-12-22,25801,26975,-1174,-4.35,1089
2020-12-23,25801,26909,-1108,-4.12,1089
2020-12-24,25801,26839,-1038,-3.87,1089
2020-12-25,27501,27285,216,0.79,1089
2020-12-26,20935,19763,1172,5.93,1089
2020-12-27,15527,15425,102,0.66,1089
2020-12-28,24922,25328,-406,-1.6,1089
2020-12-29,25801,26179,-378,-1.44,1089
2020-12-30,25801,26028,-227,-0.87,1089
2020-12-31,25801,25881,-80,-0.31,1089
2021-01-01,23214,26258,-3044,-11.59,1089
2021-01-02,17427,18681,-1254,-6.71,1089
2021-01-03,13712,14301,-589,-4.12,1089
2021-01-04,21835,24177,-2342,-9.69,1089
2021-01-05,22846,25019,-2173,-8.69,1089
2021-01-06,22846,24875,-2029,-8.16,1089
2021-01-07,22846,24753,-1907,-7.7,1089
2021-01-08,23214,25173,-1959,-7.78,1089
2021-01-09,17427,17655,-228,-1.29,1089
2021-01-10,13712,13350,362,2.71,1089
2021-01-11,21835,23316,-1481,-6.35,1089
2021-01-12,22846,24259,-1413,-5.82,1089
2021-01-13,22846,24228,-1382,-5.7,1089
2021-01-14,22846,24226,-1380,-5.7,1089
2021-01-15,23214,24772,-1558,-6.29,1089
2021-01-16,17427,17381,46,0.26,1089
2021-01-17,13712,13205,507,3.84,1089
2021-01-18,21835,23295,-1460,-6.27,1089
2021-01-19,22846,24358,-1512,-6.21,1089
2021-01-20,22846,24438,-1592,-6.51,1089
2021-01-21,22846,24537,-1691,-6.89,1089
2021-01-22,23214,25172,-1958,-7.78,1089
2021-01-23,17427,17857,-430,-2.41,1089
2021-01-24,13712,13741,-29,-0.21,1089
2021-01-25,21835,23877,-2042,-8.55,1089
2021-01-26,22846,24969,-2123,-8.5,1089
2021-01-27,22846,25063,-2217,-8.85,1089
2021-01-28,22846,25161,-2315,-9.2,1089
2021-01-29,23214,25782,-2568,-9.96,1089
2021-01-30,17427,18439,-1012,-5.49,1089
2021-01-31,13712,14286,-574,-4.02,1089
2021-02-01,26527,24374,2153,8.83,1089
2021-02-02,27029,25413,1616,6.36,1089
2021-02-03,27029,25449,1580,6.21,1089
2021-02-04,27029,25487,1542,6.05,1089
2021-02-05,27919,26049,1870,7.18,1089
2021-02-06,21958,18650,3308,17.74,1089
2021-02-07,17650,14445,3205,22.19,1089
2021-02-08,26527,24490,2037,8.32,1089
2021-02-09,27029,25494,1535,6.02,1089
2021-02-10,27029,25506,1523,5.97,1089
2021-02-11,27029,25532,1497,5.86,1089
2021-02-12,27919,26093,1826,7.0,1089
2021-02-13,21958,18707,3251,17.38,1089
2021-02-14,17650,14527,3123,21.5,1089
2021-02-15,26527,24609,1918,7.79,1089
2021-02-16,27029,25662,1367,5.33,1089
2021-02-17,27029,25732,1297,5.04,1089
2021-02-18,27029,25825,1204,4.66,1089
2021-02-19,27919,26460,1459,5.51,1089
2021-02-20,21958,19153,2805,14.65,1089
2021-02-21,17650,15055,2595,17.24,1089
2021-02-22,26527,25219,1308,5.19,1089
2021-02-23,27029,26352,677,2.57,1089
2021-02-24,27029,26498,531,2.0,1089
2021-02-25,27029,26661,368,1.38,1089
2021-02-26,27919,27358,561,2.05,1089
2021-02-27,21958,20102,1856,9.23,1089
2021-02-28,17650,16044,1606,10.01,1089
2021-03-01,28527,26236,2291,8.73,1089
2021-03-02,28905,27383,1522,5.56,1089
2021-03-03,28905,27531,1374,4.99,1089
2021-03-04,28905,27681,1224,4.42,1089
2021-03-05,29444,28352,1092,3.85,1089
2021-03-06,24387,21058,3329,15.81,1089
2021-03-07,18140,16951,1189,7.01,1089
2021-03-08,28527,27083,1444,5.33,1089
2021-03-09,28905,28162,743,2.64,1089
2021-03-10,28905,28235,670,2.37,1089
2021-03-11,28905,28307,598,2.11,1089
2021-03-12,29444,28896,548,1.9,1089
2021-03-13,24387,21520,2867,13.32,1089
2021-03-14,18140,17333,807,4.66,1089
2021-03-15,28527,27390,1137,4.15,1089
2021-03-16,28905,28399,506,1.78,1089
2021-03-17,28905,28410,495,1.74,1089
2021-03-18,28905,28428,477,1.68,1089
2021-03-19,29444,28974,470,1.62,1089
2021-03-20,24387,21566,2821,13.08,1089
2021-03-21,18140,17358,782,4.51,1089
2021-03-22,28527,27404,1123,4.1,1089
2021-03-23,28905,28416,489,1.72,1089
2021-03-24,28905,28439,466,1.64,1089
2021-03-25,28905,28479,426,1.5,1089
2021-03-26,29444,29056,388,1.34,1089
2021-03-27,24387,21686,2701,12.46,1089
2021-03-28,18140,17522,618,3.53,1089
2021-03-29,28527,27616,911,3.3,1089
2021-03-30,28905,28677,228,0.8,1089
2021-03-31,28905,28751,154,0.54,1089
2021-04-01,26166,28839,-2673,-9.27,1089
2021-04-02,27543,29461,-1918,-6.51,1089
2021-04-03,21882,22131,-249,-1.13,1089
2021-04-04,18098,18000,98,0.54,1089
2021-04-05,26836,28120,-1284,-4.57,1089
2021-04-06,26166,29198,-3032,-10.38,1089
2021-04-07,26166,29279,-3113,-10.63,1089
2021-04-08,26166,29365,-3199,-10.89,1089
2021-04-09,27543,29975,-2432,-8.11,1089
2021-04-10,21882,22623,-741,-3.28,1089
2021-04-11,18098,18461,-363,-1.97,1089
2021-04-12,26836,28542,-1706,-5.98,1089
2021-04-13,26166,29574,-3408,-11.52,1089
2021-04-14,26166,29603,-3437,-11.61,1089
2021-04-15,26166,29632,-3466,-11.7,1089
2021-04-16,27543,30183,-2640,-8.75,1089
2021-04-17,21882,22771,-889,-3.9,1089
2021-04-18,18098,18549,-451,-2.43,1089
2021-04-19,26836,28573,-1737,-6.08,1089
2021-04-20,26166,29551,-3385,-11.45,1089
2021-04-21,26166,29531,-3365,-11.39,1089
2021-04-22,26166,29518,-3352,-11.36,1089
2021-04-23,27543,30033,-2490,-8.29,1089
2021-04-24,21882,22595,-713,-3.16,1089
2021-04-25,18098,18355,-257,-1.4,1089
2021-04-26,26836,28369,-1533,-5.4,1089
2021-04-27,26166,29345,-3179,-10.83,1089
2021-04-28,26166,29332,-3166,-10.79,1089
2021-04-29,26166,29334,-3168,-10.8,1089
2021-04-30,27543,29871,-2328,-7.79,1089
2021-05-01,25401,22459,2942,13.1,1089
2021-05-02,20506,18250,2256,12.36,1089
2021-05-03,30838,28298,2540,8.98,1089
2021-05-04,31665,29310,2355,8.03,1089
2021-05-05,31665,29333,2332,7.95,1089
2021-05-06,31665,29368,2297,7.82,1089
2021-05-07,30971,29936,1035,3.46,1089
2021-05-08,25401,22550,2851,12.64,1089
2021-05-09,20506,18362,2144,11.68,1089
2021-05-10,30838,28425,2413,8.49,1089
2021-05-11,31665,29445,2220,7.54,1089
2021-05-12,31665,29468,2197,7.46,1089
2021-05-13,31665,29497,2168,7.35,1089
2021-05-14,30971,30050,921,3.06,1089
2021-05-15,25401,22644,2757,12.18,1089
2021-05-16,20506,18430,2076,11.26,1089
2021-05-17,30838,28461,2377,8.35,1089
2021-05-18,31665,29446,2219,7.54,1089
2021-05-19,31665,29432,2233,7.59,1089
2021-05-20,31665,29423,2242,7.62,1089
2021-05-21,30971,29939,1032,3.45,1089
2021-05-22,25401,22497,2904,12.91,1089
2021-05-23,20506,18252,2254,12.35,1089
2021-05-24,30838,28257,2581,9.13,1089
2021-05-25,31665,29222,2443,8.36,1089
2021-05-26,31665,29195,2470,8.46,1089
2021-05-27,31665,29181,2484,8.51,1089
2021-05-28,30971,29702,1269,4.27,1089
2021-05-29,25401,22275,3126,14.03,1089
2021-05-30,20506,18051,2455,13.6,1089
2021-05-31,30838,28087,2751,9.79,1089
2021-06-01,33508,29091,4417,15.18,1089
2021-06-02,33508,29108,4400,15.12,1089
2021-06-03,33508,29144,4364,14.97,1089
2021-06-04,32526,29718,2808,9.45,1089
2021-06-05,27868,22344,5524,24.72,1089
2021-06-06,24613,18173,6440,35.44,1089
2021-06-07,31912,28259,3653,12.93,1089
2021-06-08,33508,29306,4202,14.34,1089
2021-06-09,33508,29360,4148,14.13,1089
2021-06-10,33508,29422,4086,13.89,1089
2021-06-11,32526,30010,2516,8.38,1089
2021-06-12,27868,22636,5232,23.11,1089
2021-06-13,24613,18451,6162,33.4,1089
2021-06-14,31912,28505,3407,11.95,1089
2021-06-15,33508,29504,4004,13.57,1089
2021-06-16,33508,29492,4016,13.62,1089
2021-06-17,33508,29471,4037,13.7,1089
2021-06-18,32526,29959,2567,8.57,1089
2021-06-19,27868,22470,5398,24.02,1089
2021-06-20,24613,18156,6457,35.56,1089
2021-06-21,31912,28070,3842,13.69,1089
2021-06-22,33508,28919,4589,15.87,1089
2021-06-23,33508,28751,4757,16.55,1089
2021-06-24,33508,28570,4938,17.28,1089
2021-06-25,32526,28898,3628,12.55,1089
2021-06-26,27868,21252,6616,31.13,1089
2021-06-27,24613,16788,7825,46.61,1089
2021-06-28,31912,26560,5352,20.15,1089
2021-06-29,33508,27282,6226,22.82,1089
2021-06-30,33508,27002,6506,24.09,1089
2021-07-01,29742,26729,3013,11.27,1089
2021-07-02,29887,26985,2902,10.75,1089
2021-07-03,26686,19291,7395,38.33,1089
2021-07-04,22014,14802,7212,48.72,1089
2021-07-05,28640,24575,4065,16.54,1089
2021-07-06,29742,25322,4420,17.46,1089
2021-07-07,29742,25093,4649,18.53,1089
2021-07-08,29742,24894,4848,19.47,1089
2021-07-09,29887,25247,4640,18.38,1089
2021-07-10,26686,17669,9017,51.03,1089
2021-07-11,22014,13315,8699,65.33,1089
2021-07-12,28640,23237,5403,23.25,1089
2021-07-13,29742,24144,5598,23.19,1089
2021-07-14,29742,24083,5659,23.5,1089
2021-07-15,29742,24056,5686,23.64,1089
2021-07-16,29887,24580,5307,21.59,1089
2021-07-17,26686,17170,9516,55.42,1089
2021-07-18,22014,12975,9039,69.66,1089
2021-07-19,28640,23045,5595,24.28,1089
2021-07-20,29742,24087,5655,23.48,1089
2021-07-21,29742,24141,5601,23.2,1089
2021-07-22,29742,24211,5531,22.84,1089
2021-07-23,29887,24810,5077,20.46,1089
2021-07-24,26686,17452,9234,52.91,1089
2021-07-25,22014,13285,8729,65.71,1089
2021-07-26,28640,23361,5279,22.6,1089
2021-07-27,29742,24384,5358,21.97,1089
2021-07-28,29742,24400,5342,21.89,1089
2021-07-29,29742,24409,5333,21.85,1089
2021-07-30,29887,24932,4955,19.87,1089
2021-07-31,26686,17483,9203,52.64,1089
2021-08-01,19971,13214,6757,51.14,1089
2021-08-02,27075,23179,3896,16.81,1089
2021-08-03,26974,24089,2885,11.98,1089
2021-08-04,26974,23991,2983,12.43,1089
2021-08-05,26974,23891,3083,12.9,1089
2021-08-06,27545,24311,3234,13.3,1089
2021-08-07,23466,16771,6695,39.92,1089
2021-08-08,19971,12427,7544,60.71,1089
2021-08-09,27075,22334,4741,21.23,1089
2021-08-10,26974,23206,3768,16.24,1089
2021-08-11,26974,23092,3882,16.81,1089
2021-08-12,26974,23000,3974,17.28,1089
2021-08-13,27545,23453,4092,17.45,1089
2021-08-14,23466,15970,7496,46.94,1089
2021-08-15,19971,11705,8266,70.62,1089
2021-08-16,27075,21716,5359,24.68,1089
2021-08-17,26974,22711,4263,18.77,1089
2021-08-18,26974,22740,4234,18.62,1089
2021-08-19,26974,22806,4168,18.28,1089
2021-08-20,27545,23429,4116,17.57,1089
2021-08-21,23466,16125,7341,45.53,1089
2021-08-22,19971,12046,7925,65.79,1089
2021-08-23,27075,22242,4833,21.73,1089
2021-08-24,26974,23420,3554,15.18,1089
2021-08-25,26974,23624,3350,14.18,1089
2021-08-26,26974,23856,3118,13.07,1089
2021-08-27,27545,24630,2915,11.84,1089
2021-08-28,23466,17460,6006,34.4,1089
2021-08-29,19971,13494,6477,48.0,1089
2021-08-30,27075,23782,3293,13.85,1089
2021-08-31,26974,25028,1946,7.78,1089
2021-09-01,32573,25275,7298,28.87,1089
2021-09-02,32573,25524,7049,27.62,1089
2021-09-03,32821,26291,6530,24.84,1089
2021-09-04,27516,19088,8428,44.15,1089
2021-09-05,24210,15067,9143,60.68,1089
2021-09-06,31388,25278,6110,24.17,1089
2021-09-07,32573,26429,6144,23.25,1089
2021-09-08,32573,26565,6008,22.62,1089
2021-09-09,32573,26689,5884,22.05,1089
2021-09-10,32821,27321,5500,20.13,1089
2021-09-11,27516,19978,7538,37.73,1089
2021-09-12,24210,15813,8397,53.1,1089
2021-09-13,31388,25882,5506,21.27,1089
2021-09-14,32573,26894,5679,21.12,1089
2021-09-15,32573,26898,5675,21.1,1089
2021-09-16,32573,26901,5672,21.08,1089
2021-09-17,32821,27424,5397,19.68,1089
2021-09-18,27516,19988,7528,37.66,1089
2021-09-19,24210,15745,8465,53.76,1089
2021-09-20,31388,25753,5635,21.88,1089
2021-09-21,32573,26723,5850,21.89,1089
2021-09-22,32573,26702,5871,21.99,1089
2021-09-23,32573,26698,5875,22.01,1089
2021-09-24,32821,27230,5591,20.53,1089
2021-09-25,27516,19817,7699,38.85,1089
2021-09-26,24210,15611,8599,55.08,1089
2021-09-27,31388,25667,5721,22.29,1089
2021-09-28,32573,26693,5880,22.03,1089
2021-09-29,32573,26735,5838,21.84,1089
2021-09-30,32573,26796,5777,21.56,1089
2021-10-01,33305,27394,5911,21.58,1089
2021-10-02,34480,20045,14435,72.01,1089
2021-10-03,27562,15899,11663,73.36,1089
2021-10-04,30848,26007,4841,18.61,1089
2021-10-05,32087,27077,5010,18.5,1089
2021-10-06,32087,27152,4935,18.18,1089
2021-10-07,32087,27234,4853,17.82,1089
2021-10-08,33305,27842,5463,19.62,1089
2021-10-09,34480,20489,13991,68.29,1089
2021-10-10,27562,16325,11237,68.83,1089
2021-10-11,30848,26404,4444,16.83,1089
2021-10-12,32087,27433,4654,16.96,1089
2021-10-13,32087,27456,4631,16.87,1089
2021-10-14,32087,27479,4608,16.77,1089
2021-10-15,33305,28019,5286,18.87,1089
2021-10-16,34480,20594,13886,67.43,1089
2021-10-17,27562,16356,11206,68.51,1089
2021-10-18,30848,26359,4489,17.03,1089
2021-10-19,32087,27314,4773,17.47,1089
2021-10-20,32087,27268,4819,17.67,1089
2021-10-21,32087,27227,4860,17.85,1089
2021-10-22,33305,27712,5593,20.18,1089
2021-10-23,34480,20241,14239,70.35,1089
2021-10-24,27562,15968,11594,72.61,1089
2021-10-25,30848,25948,4900,18.88,1089
2021-10-26,32087,26891,5196,19.32,1089
2021-10-27,32087,26846,5241,19.52,1089
2021-10-28,32087,26817,5270,19.65,1089
2021-10-29,33305,27326,5979,21.88,1089
2021-10-30,34480,19889,14591,73.36,1089
2021-10-31,27562,15659,11903,76.01,1089
2021-11-01,26981,25690,1291,5.03,1089
2021-11-02,29525,26689,2836,10.63,1089
2021-11-03,29525,26702,2823,10.57,1089
2021-11-04,29525,26733,2792,10.44,1089
2021-11-05,30466,27300,3166,11.6,1089
2021-11-06,24148,19918,4230,21.24,1089
2021-11-07,21909,15737,6172,39.22,1089
2021-11-08,26981,25809,1172,4.54,1089
2021-11-09,29525,26840,2685,10.0,1089
2021-11-10,29525,26875,2650,9.86,1089
2021-11-11,29525,26915,2610,9.7,1089
2021-11-12,30466,27478,2988,10.87,1089
2021-11-13,24148,20080,4068,20.26,1089
2021-11-14,21909,15869,6040,38.06,1089
2021-11-15,26981,25898,1083,4.18,1089
2021-11-16,29525,26875,2650,9.86,1089
2021-11-17,29525,26844,2681,9.99,1089
2021-11-18,29525,26810,2715,10.13,1089
2021-11-19,30466,27293,3173,11.63,1089
2021-11-20,24148,19807,4341,21.92,1089
2021-11-21,21909,15507,6402,41.28,1089
2021-11-22,26981,25446,1535,6.03,1089
2021-11-23,29525,26335,3190,12.11,1089
2021-11-24,29525,26220,3305,12.6,1089
2021-11-25,29525,26109,3416,13.08,1089
2021-11-26,30466,26522,3944,14.87,1089
2021-11-27,24148,18977,5171,27.25,1089
2021-11-28,21909,14630,7279,49.75,1089
2021-11-29,26981,24535,2446,9.97,1089
2021-11-30,29525,25403,4122,16.23,1089
2021-12-01,26583,25283,1300,5.14,1089
2021-12-02,26583,25180,1403,5.57,1089
2021-12-03,25258,25615,-357,-1.39,1089
2021-12-04,21719,18106,3613,19.95,1089
2021-12-05,17054,13805,3249,23.53,1089
2021-12-06,26178,23768,2410,10.14,1089
2021-12-07,26583,24702,1881,7.61,1089
2021-12-08,26583,24653,1930,7.83,1089
2021-12-09,26583,24625,1958,7.95,1089
2021-12-10,25258,25137,121,0.48,1089
2021-12-11,21719,17703,4016,22.69,1089
2021-12-12,17054,13475,3579,26.56,1089
2021-12-13,26178,23503,2675,11.38,1089
2021-12-14,26583,24495,2088,8.52,1089
2021-12-15,26583,24494,2089,8.53,1089
2021-12-16,26583,24502,2081,8.49,1089
2021-12-17,25258,25036,222,0.89,1089
2021-12-18,21719,17611,4108,23.33,1089
2021-12-19,17054,13377,3677,27.49,1089
2021-12-20,26178,23384,2794,11.95,1089
2021-12-21,26583,24341,2242,9.21,1089
2021-12-22,26583,24291,2292,9.44,1089
2021-12-23,26583,24238,2345,9.67,1089
2021-12-24,25258,24702,556,2.25,1089
2021-12-25,21719,17197,4522,26.3,1089
2021-12-26,17054,12875,4179,32.46,1089
2021-12-27,26178,22793,3385,14.85,1089
2021-12-28,26583,23657,2926,12.37,1089
2021-12-29,26583,23517,3066,13.04,1089
2021-12-30,26583,23378,3205,13.71,1089
2021-12-31,25258,23762,1496,6.3,1089
2022-01-01,21382,16186,5196,32.1,1089
2022-01-02,16396,11806,4590,38.88,1089
2022-01-03,24406,21678,2728,12.58,1089
2022-01-04,25015,22512,2503,11.12,1089
2022-01-05,25015,22358,2657,11.88,1089
2022-01-06,25015,22222,2793,12.57,1089
2022-01-07,25699,22626,3073,13.58,1089
2022-01-08,21382,15089,6293,41.71,1089
2022-01-09,16396,10764,5632,52.32,1089
2022-01-10,24406,20707,3699,17.86,1089
2022-01-11,25015,21627,3388,15.67,1089
2022-01-12,25015,21572,3443,15.96,1089
2022-01-13,25015,21546,3469,16.1,1089
2022-01-14,25699,22068,3631,16.45,1089
2022-01-15,21382,14656,6726,45.89,1089
2022-01-16,16396,10458,5938,56.78,1089
2022-01-17,24406,20529,3877,18.89,1089
2022-01-18,25015,21575,3440,15.94,1089
2022-01-19,25015,21641,3374,15.59,1089
2022-01-20,25015,21729,3286,15.12,1089
2022-01-21,25699,22355,3344,14.96,1089
2022-01-22,21382,15035,6347,42.21,1089
2022-01-23,16396,10916,5480,50.2,1089
2022-01-24,24406,21052,3354,15.93,1089
2022-01-25,25015,22147,2868,12.95,1089
2022-01-26,25015,22247,2768,12.44,1089
2022-01-27,25015,22352,2663,11.91,1089
2022-01-28,25699,22981,2718,11.83,1089
2022-01-29,21382,15649,5733,36.63,1089
2022-01-30,16396,11507,4889,42.49,1089
2020-02-01,19356,18022,1334,7.4,1096
2020-02-02,15915,15198,717,4.72,1096
2020-02-03,26350,26418,-68,-0.26,1096
2020-02-04,27270,27158,112,0.41,1096
2020-02-05,27270,27224,46,0.17,1096
2020-02-06,27270,27232,38,0.14,1096
2020-02-07,27506,27140,366,1.35,1096
2020-02-08,19356,18302,1054,5.76,1096
2020-02-09,15915,15474,441,2.85,1096
2020-02-10,26350,26690,-340,-1.27,1096
2020-02-11,27270,27426,-156,-0.57,1096
2020-02-12,27270,27488,-218,-0.79,1096
2020-02-13,27270,27493,-223,-0.81,1096
2020-02-14,27506,27398,108,0.39,1096
2020-02-15,19356,18557,799,4.31,1096
2020-02-16,15915,15725,190,1.21,1096
2020-02-17,26350,26938,-588,-2.18,1096
2020-02-18,27270,27669,-399,-1.44,1096
2020-02-19,27270,27725,-455,-1.64,1096
2020-02-20,27270,27724,-454,-1.64,1096
2020-02-21,27506,27621,-115,-0.42,1096
2020-02-22,19356,18771,585,3.12,1096
2020-02-23,15915,15927,-12,-0.08,1096
2020-02-24,26350,27128,-778,-2.87,1096
2020-02-25,27270,27845,-575,-2.07,1096
2020-02-26,27270,27887,-617,-2.21,1096
2020-02-27,27270,27869,-599,-2.15,1096
2020-02-28,27506,27749,-243,-0.88,1096
2020-02-29,19356,18881,475,2.52,1096
2020-03-01,11188,16021,-4833,-30.17,1096
2020-03-02,19821,27204,-7383,-27.14,1096
2020-03-03,20214,27905,-7691,-27.56,1096
2020-03-04,20214,27932,-7718,-27.63,1096
2020-03-05,20214,27901,-7687,-27.55,1096
2020-03-06,20318,27770,-7452,-26.83,1096
2020-03-07,12857,18894,-6037,-31.95,1096
2020-03-08,11188,16029,-4841,-30.2,1096
2020-03-09,19821,27210,-7389,-27.16,1096
2020-03-10,20214,27914,-7700,-27.58,1096
2020-03-11,20214,27947,-7733,-27.67,1096
2020-03-12,20214,27927,-7713,-27.62,1096
2020-03-13,20318,27811,-7493,-26.94,1096
2020-03-14,12857,18954,-6097,-32.17,1096
2020-03-15,11188,16112,-4924,-30.56,1096
2020-03-16,19821,27320,-7499,-27.45,1096
2020-03-17,20214,28054,-7840,-27.95,1096
2020-03-18,20214,28120,-7906,-28.12,1096
2020-03-19,20214,28136,-7922,-28.16,1096
2020-03-20,20318,28057,-7739,-27.58,1096
2020-03-21,12857,19239,-6382,-33.17,1096
2020-03-22,11188,16436,-5248,-31.93,1096
2020-03-23,19821,27684,-7863,-28.4,1096
2020-03-24,20214,28455,-8241,-28.96,1096
2020-03-25,20214,28557,-8343,-29.22,1096
2020-03-26,20214,28607,-8393,-29.34,1096
2020-03-27,20318,28559,-8241,-28.86,1096
2020-03-28,12857,19768,-6911,-34.96,1096
2020-03-29,11188,16987,-5799,-34.14,1096
2020-03-30,19821,28253,-8432,-29.84,1096
2020-03-31,20214,29037,-8823,-30.39,1096
2020-04-01,17142,29147,-12005,-41.19,1096
2020-04-02,17142,29199,-12057,-41.29,1096
2020-04-03,16185,29149,-12964,-44.47,1096
2020-04-04,11636,20350,-8714,-42.82,1096
2020-04-05,8990,17557,-8567,-48.8,1096
2020-04-06,17498,28806,-11308,-39.26,1096
2020-04-07,17142,29569,-12427,-42.03,1096
2020-04-08,17142,29655,-12513,-42.2,1096
2020-04-09,17142,29680,-12538,-42.24,1096
2020-04-10,16185,29600,-13415,-45.32,1096
2020-04-11,11636,20770,-9134,-43.98,1096
2020-04-12,8990,17945,-8955,-49.9,1096
2020-04-13,17498,29162,-11664,-40.0,1096
2020-04-14,17142,29894,-12752,-42.66,1096
2020-04-15,17142,29949,-12807,-42.76,1096
2020-04-16,17142,29945,-12803,-42.76,1096
2020-04-17,16185,29838,-13653,-45.76,1096
2020-04-18,11636,20984,-9348,-44.55,1096
2020-04-19,8990,18138,-9148,-50.44,1096
2020-04-20,17498,29336,-11838,-40.35,1096
2020-04-21,17142,30053,-12911,-42.96,1096
2020-04-22,17142,30096,-12954,-43.04,1096
2020-04-23,17142,30082,-12940,-43.02,1096
2020-04-24,16185,29969,-13784,-45.99,1096
2020-04-25,11636,21111,-9475,-44.88,1096
2020-04-26,8990,18263,-9273,-50.77,1096
2020-04-27,17498,29461,-11963,-40.61,1096
2020-04-28,17142,30180,-13038,-43.2,1096
2020-04-29,17142,30225,-13083,-43.29,1096
2020-04-30,17142,30214,-13072,-43.26,1096
2020-05-01,23596,30104,-6508,-21.62,1096
2020-05-02,17452,21249,-3797,-17.87,1096
2020-05-03,13805,18403,-4598,-24.99,1096
2020-05-04,23424,29602,-6178,-20.87,1096
2020-05-05,24400,30321,-5921,-19.53,1096
2020-05-06,24400,30365,-5965,-19.64,1096
2020-05-07,24400,30352,-5952,-19.61,1096
2020-05-08,23596,30239,-6643,-21.97,1096
2020-05-09,17452,21379,-3927,-18.37,1096
2020-05-10,13805,18528,-4723,-25.49,1096
2020-05-11,23424,29723,-6299,-21.19,1096
2020-05-12,24400,30436,-6036,-19.83,1096
2020-05-13,24400,30476,-6076,-19.94,1096
2020-05-14,24400,30461,-6061,-19.9,1096
2020-05-15,23596,30347,-6751,-22.25,1096
2020-05-16,17452,21489,-4037,-18.79,1096
2020-05-17,13805,18643,-4838,-25.95,1096
2020-05-18,23424,29845,-6421,-21.51,1096
2020-05-19,24400,30571,-6171,-20.19,1096
2020-05-20,24400,30628,-6228,-20.33,1096
2020-05-21,24400,30634,-6234,-20.35,1096
2020-05-22,23596,30545,-6949,-22.75,1096
2020-05-23,17452,21718,-4266,-19.64,1096
2020-05-24,13805,18907,-5102,-26.98,1096
2020-05-25,23424,30148,-6724,-22.3,1096
2020-05-26,24400,30917,-6517,-21.08,1096
2020-05-27,24400,31019,-6619,-21.34,1096
2020-05-28,24400,31073,-6673,-21.48,1096
2020-05-29,23596,31034,-7438,-23.97,1096
2020-05-30,17452,22256,-4804,-21.59,1096
2020-05-31,13805,19494,-5689,-29.18,1096
2020-06-01,26038,30782,-4744,-15.41,1096
2020-06-02,27478,31594,-4116,-13.03,1096
2020-06-03,27478,31735,-4257,-13.41,1096
2020-06-04,27478,31821,-4343,-13.65,1096
2020-06-05,25641,31807,-6166,-19.39,1096
2020-06-06,19398,23046,-3648,-15.83,1096
2020-06-07,15968,20291,-4323,-21.31,1096
2020-06-08,26038,31576,-5538,-17.54,1096
2020-06-09,27478,32374,-4896,-15.12,1096
2020-06-10,27478,32489,-5011,-15.42,1096
2020-06-11,27478,32538,-5060,-15.55,1096
2020-06-12,25641,32475,-6834,-21.04,1096
2020-06-13,19398,23653,-4255,-17.99,1096
2020-06-14,15968,20825,-4857,-23.32,1096
2020-06-15,26038,32028,-5990,-18.7,1096
2020-06-16,27478,32733,-5255,-16.05,1096
2020-06-17,27478,32747,-5269,-16.09,1096
2020-06-18,27478,32688,-5210,-15.94,1096
2020-06-19,25641,32511,-6870,-21.13,1096
2020-06-20,19398,23572,-4174,-17.71,1096
2020-06-21,15968,20625,-4657,-22.58,1096
2020-06-22,26038,31708,-5670,-17.88,1096
2020-06-23,27478,32296,-4818,-14.92,1096
2020-06-24,27478,32197,-4719,-14.66,1096
2020-06-25,27478,32030,-4552,-14.21,1096
2020-06-26,25641,31754,-6113,-19.25,1096
2020-06-27,19398,22724,-3326,-14.64,1096
2020-06-28,15968,19699,-3731,-18.94,1096
2020-06-29,26038,30715,-4677,-15.23,1096
2020-06-30,27478,31251,-3773,-12.07,1096
2020-07-01,27813,31113,-3300,-10.61,1096
2020-07-02,27813,30924,-3111,-10.06,1096
2020-07-03,26963,30639,-3676,-12.0,1096
2020-07-04,18589,21618,-3029,-14.01,1096
2020-07-05,16894,18615,-1721,-9.25,1096
2020-07-06,26252,29668,-3416,-11.51,1096
2020-07-07,27813,30254,-2441,-8.07,1096
2020-07-08,27813,30180,-2367,-7.84,1096
2020-07-09,27813,30064,-2251,-7.49,1096
2020-07-10,26963,29863,-2900,-9.71,1096
2020-07-11,18589,20932,-2343,-11.19,1096
2020-07-12,16894,18025,-1131,-6.27,1096
2020-07-13,26252,29178,-2926,-10.03,1096
2020-07-14,27813,29865,-2052,-6.87,1096
2020-07-15,27813,29891,-2078,-6.95,1096
2020-07-16,27813,29873,-2060,-6.9,1096
2020-07-17,26963,29765,-2802,-9.41,1096
2020-07-18,18589,20920,-2331,-11.14,1096
2020-07-19,16894,18092,-1198,-6.62,1096
2020-07-20,26252,29314,-3062,-10.45,1096
2020-07-21,27813,30060,-2247,-7.48,1096
2020-07-22,27813,30134,-2321,-7.7,1096
2020-07-23,27813,30151,-2338,-7.75,1096
2020-07-24,26963,30066,-3103,-10.32,1096
2020-07-25,18589,21233,-2644,-12.45,1096
2020-07-26,16894,18405,-1511,-8.21,1096
2020-07-27,26252,29616,-3364,-11.36,1096
2020-07-28,27813,30340,-2527,-8.33,1096
2020-07-29,27813,30382,-2569,-8.46,1096
2020-07-30,27813,30360,-2547,-8.39,1096
2020-07-31,26963,30230,-3267,-10.81,1096
2020-08-01,19602,21347,-1745,-8.17,1096
2020-08-02,16686,18465,-1779,-9.63,1096
2020-08-03,24927,29622,-4695,-15.85,1096
2020-08-04,25916,30292,-4376,-14.45,1096
2020-08-05,25916,30283,-4367,-14.42,1096
2020-08-06,25916,30214,-4298,-14.23,1096
2020-08-07,26006,30043,-4037,-13.44,1096
2020-08-08,19602,21125,-1523,-7.21,1096
2020-08-09,16686,18218,-1532,-8.41,1096
2020-08-10,24927,29358,-4431,-15.09,1096
2020-08-11,25916,30021,-4105,-13.67,1096
2020-08-12,25916,30016,-4100,-13.66,1096
2020-08-13,25916,29961,-4045,-13.5,1096
2020-08-14,26006,29815,-3809,-12.78,1096
2020-08-15,19602,20933,-1331,-6.36,1096
2020-08-16,16686,18071,-1385,-7.66,1096
2020-08-17,24927,29265,-4338,-14.82,1096
2020-08-18,25916,29991,-4075,-13.59,1096
2020-08-19,25916,30056,-4140,-13.77,1096
2020-08-20,25916,30076,-4160,-13.83,1096
2020-08-21,26006,30008,-4002,-13.34,1096
2020-08-22,19602,21207,-1605,-7.57,1096
2020-08-23,16686,18427,-1741,-9.45,1096
2020-08-24,24927,29702,-4775,-16.08,1096
2020-08-25,25916,30506,-4590,-15.05,1096
2020-08-26,25916,30644,-4728,-15.43,1096
2020-08-27,25916,30732,-4816,-15.67,1096
2020-08-28,26006,30726,-4720,-15.36,1096
2020-08-29,19602,21977,-2375,-10.81,1096
2020-08-30,16686,19240,-2554,-13.27,1096
2020-08-31,24927,30549,-5622,-18.4,1096
2020-09-01,27968,31375,-3407,-10.86,1096
2020-09-02,27968,31525,-3557,-11.28,1096
2020-09-03,27968,31614,-3646,-11.53,1096
2020-09-04,27024,31598,-4574,-14.48,1096
2020-09-05,19921,22828,-2907,-12.73,1096
2020-09-06,16874,20060,-3186,-15.88,1096
2020-09-07,26510,31328,-4818,-15.38,1096
2020-09-08,27968,32106,-4138,-12.89,1096
2020-09-09,27968,32199,-4231,-13.14,1096
2020-09-10,27968,32225,-4257,-13.21,1096
2020-09-11,27024,32140,-5116,-15.92,1096
2020-09-12,19921,23298,-3377,-14.49,1096
2020-09-13,16874,20455,-3581,-17.51,1096
2020-09-14,26510,31647,-5137,-16.23,1096
2020-09-15,27968,32348,-4380,-13.54,1096
2020-09-16,27968,32366,-4398,-13.59,1096
2020-09-17,27968,32319,-4351,-13.46,1096
2020-09-18,27024,32165,-5141,-15.98,1096
2020-09-19,19921,23258,-3337,-14.35,1096
2020-09-20,16874,20355,-3481,-17.1,1096
2020-09-21,26510,31493,-4983,-15.82,1096
2020-09-22,27968,32147,-4179,-13.0,1096
2020-09-23,27968,32124,-4156,-12.94,1096
2020-09-24,27968,32043,-4075,-12.72,1096
2020-09-25,27024,31861,-4837,-15.18,1096
2020-09-26,19921,22934,-3013,-13.14,1096
2020-09-27,16874,20016,-3142,-15.7,1096
2020-09-28,26510,31146,-4636,-14.88,1096
2020-09-29,27968,31798,-3830,-12.04,1096
2020-09-30,27968,31778,-3810,-11.99,1096
2020-10-01,27536,31705,-4169,-13.15,1096
2020-10-02,26564,31535,-4971,-15.76,1096
2020-10-03,18792,22624,-3832,-16.94,1096
2020-10-04,15436,19725,-4289,-21.74,1096
2020-10-05,26520,30876,-4356,-14.11,1096
2020-10-06,27536,31550,-4014,-12.72,1096
2020-10-07,27536,31554,-4018,-12.73,1096
2020-10-08,27536,31505,-3969,-12.6,1096
2020-10-09,26564,31360,-4796,-15.29,1096
2020-10-10,18792,22472,-3680,-16.38,1096
2020-10-11,15436,19597,-4161,-21.23,1096
2020-10-12,26520,30770,-4250,-13.81,1096
2020-10-13,27536,31465,-3929,-12.49,1096
2020-10-14,27536,31489,-3953,-12.55,1096
2020-10-15,27536,31459,-3923,-12.47,1096
2020-10-16,26564,31330,-4766,-15.21,1096
2020-10-17,18792,22458,-3666,-16.32,1096
2020-10-18,15436,19597,-4161,-21.23,1096
2020-10-19,26520,30782,-4262,-13.85,1096
2020-10-20,27536,31489,-3953,-12.55,1096
2020-10-21,27536,31522,-3986,-12.65,1096
2020-10-22,27536,31500,-3964,-12.58,1096
2020-10-23,26564,31379,-4815,-15.34,1096
2020-10-24,18792,22513,-3721,-16.53,1096
2020-10-25,15436,19657,-4221,-21.47,1096
2020-10-26,26520,30846,-4326,-14.02,1096
2020-10-27,27536,31556,-4020,-12.74,1096
2020-10-28,27536,31592,-4056,-12.84,1096
2020-10-29,27536,31571,-4035,-12.78,1096
2020-10-30,26564,31450,-4886,-15.54,1096
2020-10-31,18792,22583,-3791,-16.79,1096
2020-11-01,12345,19725,-7380,-37.41,1096
2020-11-02,23248,30912,-7664,-24.79,1096
2020-11-03,21517,31618,-10101,-31.95,1096
2020-11-04,21517,31649,-10132,-32.01,1096
2020-11-05,21517,31623,-10106,-31.96,1096
2020-11-06,21770,31495,-9725,-30.88,1096
2020-11-07,15000,22622,-7622,-33.69,1096
2020-11-08,12345,19756,-7411,-37.51,1096
2020-11-09,23248,30935,-7687,-24.85,1096
2020-11-10,21517,31632,-10115,-31.98,1096
2020-11-11,21517,31654,-10137,-32.02,1096
2020-11-12,21517,31619,-10102,-31.95,1096
2020-11-13,21770,31484,-9714,-30.85,1096
2020-11-14,15000,22602,-7602,-33.63,1096
2020-11-15,12345,19730,-7385,-37.43,1096
2020-11-16,23248,30903,-7655,-24.77,1096
2020-11-17,21517,31596,-10079,-31.9,1096
2020-11-18,21517,31616,-10099,-31.94,1096
2020-11-19,21517,31581,-10064,-31.87,1096
2020-11-20,21770,31447,-9677,-30.77,1096
2020-11-21,15000,22570,-7570,-33.54,1096
2020-11-22,12345,19704,-7359,-37.35,1096
2020-11-23,23248,30886,-7638,-24.73,1096
2020-11-24,21517,31591,-10074,-31.89,1096
2020-11-25,21517,31624,-10107,-31.96,1096
2020-11-26,21517,31604,-10087,-31.92,1096
2020-11-27,21770,31488,-9718,-30.86,1096
2020-11-28,15000,22629,-7629,-33.71,1096
2020-11-29,12345,19783,-7438,-37.6,1096
2020-11-30,23248,30986,-7738,-24.97,1096
2020-12-01,22315,31711,-9396,-29.63,1096
2020-12-02,22315,31765,-9450,-29.75,1096
2020-12-03,22315,31765,-9450,-29.75,1096
2020-12-04,23768,31666,-7898,-24.94,1096
2020-12-05,16157,22824,-6667,-29.21,1096
2020-12-06,12110,19991,-7881,-39.42,1096
2020-12-07,21978,31204,-9226,-29.57,1096
2020-12-08,22315,31936,-9621,-30.13,1096
2020-12-09,22315,31993,-9678,-30.25,1096
2020-12-10,22315,31992,-9677,-30.25,1096
2020-12-11,23768,31887,-8119,-25.46,1096
2020-12-12,16157,23034,-6877,-29.86,1096
2020-12-13,12110,20187,-8077,-40.01,1096
2020-12-14,21978,31380,-9402,-29.96,1096
2020-12-15,22315,32087,-9772,-30.45,1096
2020-12-16,22315,32116,-9801,-30.52,1096
2020-12-17,22315,32082,-9767,-30.44,1096
2020-12-18,23768,31942,-8174,-25.59,1096
2020-12-19,16157,23050,-6893,-29.9,1096
2020-12-20,12110,20162,-8052,-39.94,1096
2020-12-21,21978,31313,-9335,-29.81,1096
2020-12-22,22315,31978,-9663,-30.22,1096
2020-12-23,22315,31964,-9649,-30.19,1096
2020-12-24,22315,31888,-9573,-30.02,1096
2020-12-25,23768,31708,-7940,-25.04,1096
2020-12-26,16157,22779,-6622,-29.07,1096
2020-12-27,12110,19857,-7747,-39.01,1096
2020-12-28,21978,30978,-9000,-29.05,1096
2020-12-29,22315,31617,-9302,-29.42,1096
2020-12-30,22315,31582,-9267,-29.34,1096
2020-12-31,22315,31491,-9176,-29.14,1096
2021-01-01,20680,31301,-10621,-33.93,1096
2021-01-02,13439,22369,-8930,-39.92,1096
2021-01-03,10986,19448,-8462,-43.51,1096
2021-01-04,19614,30577,-10963,-35.85,1096
2021-01-05,20697,31231,-10534,-33.73,1096
2021-01-06,20697,31215,-10518,-33.7,1096
2021-01-07,20697,31149,-10452,-33.55,1096
2021-01-08,20680,30989,-10309,-33.27,1096
2021-01-09,13439,22091,-8652,-39.17,1096
2021-01-10,10986,19207,-8221,-42.8,1096
2021-01-11,19614,30377,-10763,-35.43,1096
2021-01-12,20697,31072,-10375,-33.39,1096
2021-01-13,20697,31100,-10403,-33.45,1096
2021-01-14,20697,31078,-10381,-33.4,1096
2021-01-15,20680,30962,-10282,-33.21,1096
2021-01-16,13439,22106,-8667,-39.21,1096
2021-01-17,10986,19264,-8278,-42.97,1096
2021-01-18,19614,30472,-10858,-35.63,1096
2021-01-19,20697,31205,-10508,-33.67,1096
2021-01-20,20697,31266,-10569,-33.8,1096
2021-01-21,20697,31275,-10578,-33.82,1096
2021-01-22,20680,31186,-10506,-33.69,1096
2021-01-23,13439,22353,-8914,-39.88,1096
2021-01-24,10986,19531,-8545,-43.75,1096
2021-01-25,19614,30756,-11142,-36.23,1096
2021-01-26,20697,31501,-10804,-34.3,1096
2021-01-27,20697,31572,-10875,-34.45,1096
2021-01-28,20697,31586,-10889,-34.47,1096
2021-01-29,20680,31501,-10821,-34.35,1096
2021-01-30,13439,22669,-9230,-40.72,1096
2021-01-31,10986,19846,-8860,-44.64,1096
2021-02-01,22879,31068,-8189,-26.36,1096
2021-02-02,23520,31809,-8289,-26.06,1096
2021-02-03,23520,31875,-8355,-26.21,1096
2021-02-04,23520,31885,-8365,-26.23,1096
2021-02-05,23622,31793,-8171,-25.7,1096
2021-02-06,16129,22956,-6827,-29.74,1096
2021-02-07,13265,20128,-6863,-34.1,1096
2021-02-08,22879,31345,-8466,-27.01,1096
2021-02-09,23520,32082,-8562,-26.69,1096
2021-02-10,23520,32144,-8624,-26.83,1096
2021-02-11,23520,32150,-8630,-26.84,1096
2021-02-12,23622,32055,-8433,-26.31,1096
2021-02-13,16129,23215,-7086,-30.52,1096
2021-02-14,13265,20384,-7119,-34.92,1096
2021-02-15,22879,31598,-8719,-27.59,1096
2021-02-16,23520,32330,-8810,-27.25,1096
2021-02-17,23520,32388,-8868,-27.38,1096
2021-02-18,23520,32389,-8869,-27.38,1096
2021-02-19,23622,32288,-8666,-26.84,1096
2021-02-20,16129,23440,-7311,-31.19,1096
2021-02-21,13265,20600,-7335,-35.61,1096
2021-02-22,22879,31803,-8924,-28.06,1096
2021-02-23,23520,32524,-9004,-27.68,1096
2021-02-24,23520,32568,-9048,-27.78,1096
2021-02-25,23520,32554,-9034,-27.75,1096
2021-02-26,23622,32437,-8815,-27.18,1096
2021-02-27,16129,23573,-7444,-31.58,1096
2021-02-28,13265,20715,-7450,-35.96,1096
2021-03-01,24910,31901,-6991,-21.91,1096
2021-03-02,25342,32604,-7262,-22.27,1096
2021-03-03,25342,32632,-7290,-22.34,1096
2021-03-04,25342,32603,-7261,-22.27,1096
2021-03-05,24985,32472,-7487,-23.06,1096
2021-03-06,18553,23596,-5043,-21.37,1096
2021-03-07,14221,20730,-6509,-31.4,1096
2021-03-08,24910,31910,-7000,-21.94,1096
2021-03-09,25342,32611,-7269,-22.29,1096
2021-03-10,25342,32640,-7298,-22.36,1096
2021-03-11,25342,32616,-7274,-22.3,1096
2021-03-12,24985,32495,-7510,-23.11,1096
2021-03-13,18553,23633,-5080,-21.5,1096
2021-03-14,14221,20784,-6563,-31.58,1096
2021-03-15,24910,31986,-7076,-22.12,1096
2021-03-16,25342,32713,-7371,-22.53,1096
2021-03-17,25342,32772,-7430,-22.67,1096
2021-03-18,25342,32780,-7438,-22.69,1096
2021-03-19,24985,32695,-7710,-23.58,1096
2021-03-20,18553,23870,-5317,-22.27,1096
2021-03-21,14221,21060,-6839,-32.47,1096
2021-03-22,24910,32301,-7391,-22.88,1096
2021-03-23,25342,33067,-7725,-23.36,1096
2021-03-24,25342,33164,-7822,-23.59,1096
2021-03-25,25342,33209,-7867,-23.69,1096
2021-03-26,24985,33158,-8173,-24.65,1096
2021-03-27,18553,24364,-5811,-23.85,1096
2021-03-28,14221,21582,-7361,-34.11,1096
2021-03-29,24910,32847,-7937,-24.16,1096
2021-03-30,25342,33632,-8290,-24.65,1096
2021-03-31,25342,33743,-8401,-24.9,1096
2021-04-01,23931,33797,-9866,-29.19,1096
2021-04-02,23708,33750,-10042,-29.75,1096
2021-04-03,16349,24955,-8606,-34.49,1096
2021-04-04,14005,22167,-8162,-36.82,1096
2021-04-05,24067,33420,-9353,-27.99,1096
2021-04-06,23931,34190,-10259,-30.01,1096
2021-04-07,23931,34281,-10350,-30.19,1096
2021-04-08,23931,34311,-10380,-30.25,1096
2021-04-09,23708,34238,-10530,-30.76,1096
2021-04-10,16349,25414,-9065,-35.67,1096
2021-04-11,14005,22594,-8589,-38.01,1096
2021-04-12,24067,33816,-9749,-28.83,1096
2021-04-13,23931,34554,-10623,-30.74,1096
2021-04-14,23931,34613,-10682,-30.86,1096
2021-04-15,23931,34613,-10682,-30.86,1096
2021-04-16,23708,34510,-10802,-31.3,1096
2021-04-17,16349,25659,-9310,-36.28,1096
2021-04-18,14005,22815,-8810,-38.61,1096
2021-04-19,24067,34014,-9947,-29.24,1096
2021-04-20,23931,34732,-10801,-31.1,1096
2021-04-21,23931,34776,-10845,-31.19,1096
2021-04-22,23931,34763,-10832,-31.16,1096
2021-04-23,23708,34649,-10941,-31.58,1096
2021-04-24,16349,25791,-9442,-36.61,1096
2021-04-25,14005,22942,-8937,-38.95,1096
2021-04-26,24067,34140,-10073,-29.5,1096
2021-04-27,23931,34858,-10927,-31.35,1096
2021-04-28,23931,34902,-10971,-31.43,1096
2021-04-29,23931,34891,-10960,-31.41,1096
2021-04-30,23708,34781,-11073,-31.84,1096
2021-05-01,19707,25925,-6218,-23.98,1096
2021-05-02,15786,23079,-7293,-31.6,1096
2021-05-03,28524,34279,-5755,-16.79,1096
2021-05-04,28904,34998,-6094,-17.41,1096
2021-05-05,28904,35043,-6139,-17.52,1096
2021-05-06,28904,35031,-6127,-17.49,1096
2021-05-07,27028,34919,-7891,-22.6,1096
2021-05-08,19707,26060,-6353,-24.38,1096
2021-05-09,15786,23211,-7425,-31.99,1096
2021-05-10,28524,34406,-5882,-17.1,1096
2021-05-11,28904,35120,-6216,-17.7,1096
2021-05-12,28904,35160,-6256,-17.79,1096
2021-05-13,28904,35144,-6240,-17.76,1096
2021-05-14,27028,35028,-8000,-22.84,1096
2021-05-15,19707,26169,-6462,-24.69,1096
2021-05-16,15786,23320,-7534,-32.31,1096
2021-05-17,28524,34519,-5995,-17.37,1096
2021-05-18,28904,35240,-6336,-17.98,1096
2021-05-19,28904,35291,-6387,-18.1,1096
2021-05-20,28904,35291,-6387,-18.1,1096
2021-05-21,27028,35195,-8167,-23.21,1096
2021-05-22,19707,26360,-6653,-25.24,1096
2021-05-23,15786,23540,-7754,-32.94,1096
2021-05-24,28524,34773,-6249,-17.97,1096
2021-05-25,28904,35533,-6629,-18.66,1096
2021-05-26,28904,35626,-6722,-18.87,1096
2021-05-27,28904,35670,-6766,-18.97,1096
2021-05-28,27028,35622,-8594,-24.13,1096
2021-05-29,19707,26836,-7129,-26.57,1096
2021-05-30,15786,24066,-8280,-34.41,1096
2021-05-31,28524,35348,-6824,-19.31,1096
2021-06-01,30072,36155,-6083,-16.82,1096
2021-06-02,30072,36292,-6220,-17.14,1096
2021-06-03,30072,36376,-6304,-17.33,1096
2021-06-04,28136,36363,-8227,-22.62,1096
2021-06-05,21356,27604,-6248,-22.63,1096
2021-06-06,19266,24853,-5587,-22.48,1096
2021-06-07,29107,36144,-7037,-19.47,1096
2021-06-08,30072,36951,-6879,-18.62,1096
2021-06-09,30072,37077,-7005,-18.89,1096
2021-06-10,30072,37139,-7067,-19.03,1096
2021-06-11,28136,37090,-8954,-24.14,1096
2021-06-12,21356,28285,-6929,-24.5,1096
2021-06-13,19266,25476,-6210,-24.38,1096
2021-06-14,29107,36698,-7591,-20.69,1096
2021-06-15,30072,37424,-7352,-19.65,1096
2021-06-16,30072,37460,-7388,-19.72,1096
2021-06-17,30072,37423,-7351,-19.64,1096
2021-06-18,28136,37268,-9132,-24.5,1096
2021-06-19,21356,28350,-6994,-24.67,1096
2021-06-20,19266,25425,-6159,-24.22,1096
2021-06-21,29107,36528,-7421,-20.32,1096
2021-06-22,30072,37134,-7062,-19.02,1096
2021-06-23,30072,37052,-6980,-18.84,1096
2021-06-24,30072,36900,-6828,-18.5,1096
2021-06-25,28136,36637,-8501,-23.2,1096
2021-06-26,21356,27617,-6261,-22.67,1096
2021-06-27,19266,24599,-5333,-21.68,1096
2021-06-28,29107,35620,-6513,-18.28,1096
2021-06-29,30072,36157,-6085,-16.83,1096
2021-06-30,30072,36019,-5947,-16.51,1096
2021-07-01,27853,35825,-7972,-22.25,1096
2021-07-02,26681,35534,-8853,-24.91,1096
2021-07-03,20844,26503,-5659,-21.35,1096
2021-07-04,16857,23489,-6632,-28.23,1096
2021-07-05,26441,34529,-8088,-23.42,1096
2021-07-06,27853,35100,-7247,-20.65,1096
2021-07-07,27853,35009,-7156,-20.44,1096
2021-07-08,27853,34875,-7022,-20.13,1096
2021-07-09,26681,34655,-7974,-23.01,1096
2021-07-10,20844,25705,-4861,-18.91,1096
2021-07-11,16857,22780,-5923,-26.0,1096
2021-07-12,26441,33915,-7474,-22.04,1096
2021-07-13,27853,34584,-6731,-19.46,1096
2021-07-14,27853,34594,-6741,-19.49,1096
2021-07-15,27853,34561,-6708,-19.41,1096
2021-07-16,26681,34440,-7759,-22.53,1096
2021-07-17,20844,25584,-4740,-18.53,1096
2021-07-18,16857,22747,-5890,-25.89,1096
2021-07-19,26441,33963,-7522,-22.15,1096
2021-07-20,27853,34704,-6851,-19.74,1096
2021-07-21,27853,34776,-6923,-19.91,1096
2021-07-22,27853,34793,-6940,-19.95,1096
2021-07-23,26681,34710,-8029,-23.13,1096
2021-07-24,20844,25881,-5037,-19.46,1096
2021-07-25,16857,23058,-6201,-26.89,1096
2021-07-26,26441,34277,-7836,-22.86,1096
2021-07-27,27853,35009,-7156,-20.44,1096
2021-07-28,27853,35061,-7208,-20.56,1096
2021-07-29,27853,35049,-7196,-20.53,1096
2021-07-30,26681,34930,-8249,-23.62,1096
2021-07-31,20844,26057,-5213,-20.01,1096
2021-08-01,15562,23185,-7623,-32.88,1096
2021-08-02,24650,34351,-9701,-28.24,1096
2021-08-03,25546,35029,-9483,-27.07,1096
2021-08-04,25546,35027,-9481,-27.07,1096
2021-08-05,25546,34963,-9417,-26.93,1096
2021-08-06,24621,34796,-10175,-29.24,1096
2021-08-07,18664,25880,-7216,-27.88,1096
2021-08-08,15562,22971,-7409,-32.25,1096
2021-08-09,24650,34109,-9459,-27.73,1096
2021-08-10,25546,34768,-9222,-26.52,1096
2021-08-11,25546,34757,-9211,-26.5,1096
2021-08-12,25546,34694,-9148,-26.37,1096
2021-08-13,24621,34538,-9917,-28.71,1096
2021-08-14,18664,25644,-6980,-27.22,1096
2021-08-15,15562,22769,-7207,-31.65,1096
2021-08-16,24650,33950,-9300,-27.39,1096
2021-08-17,25546,34661,-9115,-26.3,1096
2021-08-18,25546,34711,-9165,-26.4,1096
2021-08-19,25546,34716,-9170,-26.41,1096
2021-08-20,24621,34633,-10012,-28.91,1096
2021-08-21,18664,25818,-7154,-27.71,1096
2021-08-22,15562,23023,-7461,-32.41,1096
2021-08-23,24650,34285,-9635,-28.1,1096
2021-08-24,25546,35078,-9532,-27.17,1096
2021-08-25,25546,35206,-9660,-27.44,1096
2021-08-26,25546,35286,-9740,-27.6,1096
2021-08-27,24621,35273,-10652,-30.2,1096
2021-08-28,18664,26520,-7856,-29.62,1096
2021-08-29,15562,23781,-8219,-34.56,1096
2021-08-30,24650,35089,-10439,-29.75,1096
2021-08-31,25546,35917,-10371,-28.87,1096
2021-09-01,29229,36071,-6842,-18.97,1096
2021-09-02,29229,36166,-6937,-19.18,1096
2021-09-03,28300,36156,-7856,-21.73,1096
2021-09-04,20957,27396,-6439,-23.5,1096
2021-09-05,19618,24638,-5020,-20.38,1096
2021-09-06,28636,35918,-7282,-20.27,1096
2021-09-07,29229,36708,-7479,-20.37,1096
2021-09-08,29229,36814,-7585,-20.6,1096
2021-09-09,29229,36854,-7625,-20.69,1096
2021-09-10,28300,36783,-8483,-23.06,1096
2021-09-11,20957,27955,-6998,-25.03,1096
2021-09-12,19618,25126,-5508,-21.92,1096
2021-09-13,28636,36331,-7695,-21.18,1096
2021-09-14,29229,37045,-7816,-21.1,1096
2021-09-15,29229,37075,-7846,-21.16,1096
2021-09-16,29229,37040,-7811,-21.09,1096
2021-09-17,28300,36895,-8595,-23.3,1096
2021-09-18,20957,27998,-7041,-25.15,1096
2021-09-19,19618,25102,-5484,-21.85,1096
2021-09-20,28636,36246,-7610,-21.0,1096
2021-09-21,29229,36905,-7676,-20.8,1096
2021-09-22,29229,36886,-7657,-20.76,1096
2021-09-23,29229,36807,-7578,-20.59,1096
2021-09-24,28300,36627,-8327,-22.73,1096
2021-09-25,20957,27700,-6743,-24.34,1096
2021-09-26,19618,24782,-5164,-20.84,1096
2021-09-27,28636,35910,-7274,-20.26,1096
2021-09-28,29229,36559,-7330,-20.05,1096
2021-09-29,29229,36537,-7308,-20.0,1096
2021-09-30,29229,36460,-7231,-19.83,1096
2021-10-01,28723,36286,-7563,-20.84,1096
2021-10-02,23268,27371,-4103,-14.99,1096
2021-10-03,18658,24468,-5810,-23.75,1096
2021-10-04,27622,35614,-7992,-22.44,1096
2021-10-05,30171,36283,-6112,-16.85,1096
2021-10-06,30171,36283,-6112,-16.85,1096
2021-10-07,30171,36230,-6059,-16.72,1096
2021-10-08,28723,36080,-7357,-20.39,1096
2021-10-09,23268,27189,-3921,-14.42,1096
2021-10-10,18658,24310,-5652,-23.25,1096
2021-10-11,27622,35480,-7858,-22.15,1096
2021-10-12,30171,36172,-6001,-16.59,1096
2021-10-13,30171,36193,-6022,-16.64,1096
2021-10-14,30171,36160,-5989,-16.56,1096
2021-10-15,28723,36030,-7307,-20.28,1096
2021-10-16,23268,27156,-3888,-14.32,1096
2021-10-17,18658,24293,-5635,-23.2,1096
2021-10-18,27622,35477,-7855,-22.14,1096
2021-10-19,30171,36182,-6011,-16.61,1096
2021-10-20,30171,36214,-6043,-16.69,1096
2021-10-21,30171,36191,-6020,-16.63,1096
2021-10-22,28723,36069,-7346,-20.37,1096
2021-10-23,23268,27203,-3935,-14.47,1096
2021-10-24,18658,24346,-5688,-23.36,1096
2021-10-25,27622,35535,-7913,-22.27,1096
2021-10-26,30171,36245,-6074,-16.76,1096
2021-10-27,30171,36280,-6109,-16.84,1096
2021-10-28,30171,36260,-6089,-16.79,1096
2021-10-29,28723,36139,-7416,-20.52,1096
2021-10-30,23268,27274,-4006,-14.69,1096
2021-10-31,18658,24416,-5758,-23.58,1096
2021-11-01,25333,35604,-10271,-28.85,1096
2021-11-02,27821,36311,-8490,-23.38,1096
2021-11-03,27821,36344,-8523,-23.45,1096
2021-11-04,27821,36319,-8498,-23.4,1096
2021-11-05,27326,36193,-8867,-24.5,1096
2021-11-06,19303,27321,-8018,-29.35,1096
2021-11-07,16268,24457,-8189,-33.48,1096
2021-11-08,25333,35637,-10304,-28.91,1096
2021-11-09,27821,36336,-8515,-23.43,1096
2021-11-10,27821,36360,-8539,-23.48,1096
2021-11-11,27821,36326,-8505,-23.41,1096
2021-11-12,27326,36192,-8866,-24.5,1096
2021-11-13,19303,27311,-8008,-29.32,1096
2021-11-14,16268,24439,-8171,-33.43,1096
2021-11-15,25333,35613,-10280,-28.87,1096
2021-11-16,27821,36306,-8485,-23.37,1096
2021-11-17,27821,36325,-8504,-23.41,1096
2021-11-18,27821,36289,-8468,-23.33,1096
2021-11-19,27326,36153,-8827,-24.42,1096
2021-11-20,19303,27274,-7971,-29.23,1096
2021-11-21,16268,24406,-8138,-33.34,1096
2021-11-22,25333,35585,-10252,-28.81,1096
2021-11-23,27821,36286,-8465,-23.33,1096
2021-11-24,27821,36316,-8495,-23.39,1096
2021-11-25,27821,36293,-8472,-23.34,1096
2021-11-26,27326,36173,-8847,-24.46,1096
2021-11-27,19303,27310,-8007,-29.32,1096
2021-11-28,16268,24460,-8192,-33.49,1096
2021-11-29,25333,35659,-10326,-28.96,1096
2021-11-30,27821,36381,-8560,-23.53,1096
2021-12-01,24109,36432,-12323,-33.82,1096
2021-12-02,24109,36429,-12320,-33.82,1096
2021-12-03,21841,36328,-14487,-39.88,1096
2021-12-04,17102,27484,-10382,-37.77,1096
2021-12-05,13927,24651,-10724,-43.5,1096
2021-12-06,24412,35864,-11452,-31.93,1096
2021-12-07,24109,36597,-12488,-34.12,1096
2021-12-08,24109,36655,-12546,-34.23,1096
2021-12-09,24109,36656,-12547,-34.23,1096
2021-12-10,21841,36556,-14715,-40.25,1096
2021-12-11,17102,27707,-10605,-38.28,1096
2021-12-12,13927,24864,-10937,-43.99,1096
2021-12-13,24412,36063,-11651,-32.31,1096
2021-12-14,24109,36778,-12669,-34.45,1096
2021-12-15,24109,36813,-12704,-34.51,1096
2021-12-16,24109,36787,-12678,-34.46,1096
2021-12-17,21841,36654,-14813,-40.41,1096
2021-12-18,17102,27771,-10669,-38.42,1096
2021-12-19,13927,24890,-10963,-44.05,1096
2021-12-20,24412,36049,-11637,-32.28,1096
2021-12-21,24109,36722,-12613,-34.35,1096
2021-12-22,24109,36714,-12605,-34.33,1096
2021-12-23,24109,36645,-12536,-34.21,1096
2021-12-24,21841,36471,-14630,-40.11,1096
2021-12-25,17102,27547,-10445,-37.92,1096
2021-12-26,13927,24628,-10701,-43.45,1096
2021-12-27,24412,35752,-11340,-31.72,1096
2021-12-28,24109,36393,-12284,-33.75,1096
2021-12-29,24109,36359,-12250,-33.69,1096
2021-12-30,24109,36268,-12159,-33.53,1096
2021-12-31,21841,36077,-14236,-39.46,1096
2022-01-01,17364,27142,-9778,-36.03,1096
2022-01-02,13581,24218,-10637,-43.92,1096
2022-01-03,22979,35343,-12364,-34.98,1096
2022-01-04,23468,35991,-12523,-34.79,1096
2022-01-05,23468,35969,-12501,-34.75,1096
2022-01-06,23468,35896,-12428,-34.62,1096
2022-01-07,23478,35729,-12251,-34.29,1096
2022-01-08,17364,26822,-9458,-35.26,1096
2022-01-09,13581,23931,-10350,-43.25,1096
2022-01-10,22979,35092,-12113,-34.52,1096
2022-01-11,23468,35779,-12311,-34.41,1096
2022-01-12,23468,35799,-12331,-34.45,1096
2022-01-13,23468,35770,-12302,-34.39,1096
2022-01-14,23478,35646,-12168,-34.14,1096
2022-01-15,17364,26783,-9419,-35.17,1096
2022-01-16,13581,23936,-10355,-43.26,1096
2022-01-17,22979,35138,-12159,-34.6,1096
2022-01-18,23468,35866,-12398,-34.57,1096
2022-01-19,23468,35923,-12455,-34.67,1096
2022-01-20,23468,35928,-12460,-34.68,1096
2022-01-21,23478,35836,-12358,-34.48,1096
2022-01-22,17364,27001,-9637,-35.69,1096
2022-01-23,13581,24178,-10597,-43.83,1096
2022-01-24,22979,35401,-12422,-35.09,1096
2022-01-25,23468,36146,-12678,-35.07,1096
2022-01-26,23468,36216,-12748,-35.2,1096
2022-01-27,23468,36231,-12763,-35.23,1096
2022-01-28,23478,36146,-12668,-35.05,1096
2022-01-29,17364,27316,-9952,-36.43,1096
2022-01-30,13581,24494,-10913,-44.55,1096
2020-02-01,19033,16279,2754,16.92,1223
2020-02-02,15642,12086,3556,29.42,1223
2020-02-03,20201,18341,1860,10.14,1223
2020-02-04,20874,19012,1862,9.79,1223
2020-02-05,20874,18682,2192,11.73,1223
2020-02-06,20874,18448,2426,13.15,1223
2020-02-07,21006,18320,2686,14.66,1223
2020-02-08,19033,14558,4475,30.74,1223
2020-02-09,15642,10332,5310,51.39,1223
2020-02-10,20201,16591,3610,21.76,1223
2020-02-11,20874,17305,3569,20.62,1223
2020-02-12,20874,17058,3816,22.37,1223
2020-02-13,20874,16949,3925,23.16,1223
2020-02-14,21006,16985,4021,23.67,1223
2020-02-15,19033,13424,5609,41.78,1223
2020-02-16,15642,9434,6208,65.8,1223
2020-02-17,20201,15959,4242,26.58,1223
2020-02-18,20874,16966,3908,23.03,1223
2020-02-19,20874,17031,3843,22.56,1223
2020-02-20,20874,17246,3628,21.04,1223
2020-02-21,21006,17613,3393,19.26,1223
2020-02-22,19033,14381,4652,32.35,1223
2020-02-23,15642,10712,4930,46.02,1223
2020-02-24,20201,17540,2661,15.17,1223
2020-02-25,20874,18825,2049,10.88,1223
2020-02-26,20874,19138,1736,9.07,1223
2020-02-27,20874,19562,1312,6.71,1223
2020-02-28,21006,20094,912,4.54,1223
2020-02-29,19033,16980,2053,12.09,1223
2020-03-01,11467,13375,-1908,-14.27,1223
2020-03-02,15887,20213,-4326,-21.4,1223
2020-03-03,16823,21452,-4629,-21.58,1223
2020-03-04,16823,21662,-4839,-22.34,1223
2020-03-05,16823,21929,-5106,-23.28,1223
2020-03-06,17641,22252,-4611,-20.72,1223
2020-03-07,14220,18880,-4660,-24.68,1223
2020-03-08,11467,14976,-3509,-23.43,1223
2020-03-09,15887,21478,-5591,-26.03,1223
2020-03-10,16823,22353,-5530,-24.74,1223
2020-03-11,16823,22177,-5354,-24.14,1223
2020-03-12,16823,22047,-5224,-23.69,1223
2020-03-13,17641,21969,-4328,-19.7,1223
2020-03-14,14220,18203,-3983,-21.88,1223
2020-03-15,11467,13920,-2453,-17.62,1223
2020-03-16,15887,20067,-4180,-20.83,1223
2020-03-17,16823,20619,-3796,-18.41,1223
2020-03-18,16823,20161,-3338,-16.56,1223
2020-03-19,16823,19795,-2972,-15.01,1223
2020-03-20,17641,19534,-1893,-9.69,1223
2020-03-21,14220,15641,-1421,-9.09,1223
2020-03-22,11467,11289,178,1.58,1223
2020-03-23,15887,17428,-1541,-8.84,1223
2020-03-24,16823,18033,-1210,-6.71,1223
2020-03-25,16823,17686,-863,-4.88,1223
2020-03-26,16823,17487,-664,-3.8,1223
2020-03-27,17641,17443,198,1.14,1223
2020-03-28,14220,13813,407,2.95,1223
2020-03-29,11467,9763,1704,17.45,1223
2020-03-30,15887,16235,-348,-2.14,1223
2020-03-31,16823,17194,-371,-2.16,1223
2020-04-01,16287,17215,-928,-5.39,1223
2020-04-02,16287,17386,-1099,-6.32,1223
2020-04-03,15791,17708,-1917,-10.83,1223
2020-04-04,13398,14427,-1029,-7.13,1223
2020-04-05,10031,10703,-672,-6.28,1223
2020-04-06,16260,17467,-1207,-6.91,1223
2020-04-07,16287,18679,-2392,-12.81,1223
2020-04-08,16287,18907,-2620,-13.86,1223
2020-04-09,16287,19234,-2947,-15.32,1223
2020-04-10,15791,19656,-3865,-19.66,1223
2020-04-11,13398,16420,-3022,-18.4,1223
2020-04-12,10031,12681,-2650,-20.9,1223
2020-04-13,16260,19374,-3114,-16.07,1223
2020-04-14,16287,20460,-4173,-20.4,1223
2020-04-15,16287,20510,-4223,-20.59,1223
2020-04-16,16287,20614,-4327,-20.99,1223
2020-04-17,15791,20773,-4982,-23.98,1223
2020-04-18,13398,17241,-3843,-22.29,1223
2020-04-19,10031,13182,-3151,-23.9,1223
2020-04-20,16260,19540,-3280,-16.79,1223
2020-04-21,16287,20283,-3996,-19.7,1223
2020-04-22,16287,19994,-3707,-18.54,1223
2020-04-23,16287,19770,-3483,-17.62,1223
2020-04-24,15791,19622,-3831,-19.52,1223
2020-04-25,13398,15810,-2412,-15.26,1223
2020-04-26,10031,11508,-1477,-12.83,1223
2020-04-27,16260,17665,-1405,-7.95,1223
2020-04-28,16287,18255,-1968,-10.78,1223
2020-04-29,16287,17864,-1577,-8.83,1223
2020-04-30,16287,17591,-1304,-7.41,1223
2020-05-01,20572,17449,3123,17.9,1223
2020-05-02,18131,13698,4433,32.36,1223
2020-05-03,14312,9509,4803,50.51,1223
2020-05-04,19909,15828,4081,25.78,1223
2020-05-05,20513,16624,3889,23.39,1223
2020-05-06,20513,16476,4037,24.5,1223
2020-05-07,20513,16479,4034,24.48,1223
2020-05-08,20572,16637,3935,23.65,1223
2020-05-09,18131,13201,4930,37.35,1223
2020-05-10,14312,9333,4979,53.35,1223
2020-05-11,19909,15971,3938,24.66,1223
2020-05-12,20513,17075,3438,20.13,1223
2020-05-13,20513,17217,3296,19.14,1223
2020-05-14,20513,17482,3031,17.34,1223
2020-05-15,20572,17867,2705,15.14,1223
2020-05-16,18131,14618,3513,24.03,1223
2020-05-17,14312,10893,3419,31.39,1223
2020-05-18,19909,17624,2285,12.97,1223
2020-05-19,20513,18770,1743,9.29,1223
2020-05-20,20513,18902,1611,8.52,1223
2020-05-21,20513,19105,1408,7.37,1223
2020-05-22,20572,19378,1194,6.16,1223
2020-05-23,18131,15972,2159,13.52,1223
2020-05-24,14312,12046,2266,18.81,1223
2020-05-25,19909,18541,1368,7.38,1223
2020-05-26,20513,19421,1092,5.62,1223
2020-05-27,20513,19264,1249,6.48,1223
2020-05-28,20513,19165,1348,7.03,1223
2020-05-29,20572,19131,1441,7.53,1223
2020-05-30,18131,15419,2712,17.59,1223
2020-05-31,14312,11199,3113,27.8,1223
2020-06-01,21330,17420,3910,22.45,1223
2020-06-02,22060,18052,4008,22.2,1223
2020-06-03,22060,17681,4379,24.77,1223
2020-06-04,22060,17408,4652,26.72,1223
2020-06-05,21690,17242,4448,25.8,1223
2020-06-06,19398,13447,5951,44.26,1223
2020-06-07,15664,9194,6470,70.37,1223
2020-06-08,21330,15431,5899,38.23,1223
2020-06-09,22060,16131,5929,36.76,1223
2020-06-10,22060,15875,6185,38.96,1223
2020-06-11,22060,15760,6300,39.97,1223
2020-06-12,21690,15794,5896,37.33,1223
2020-06-13,19398,12233,7165,58.57,1223
2020-06-14,15664,8242,7422,90.05,1223
2020-06-15,21330,14761,6569,44.5,1223
2020-06-16,22060,15756,6304,40.01,1223
2020-06-17,22060,15800,6260,39.62,1223
2020-06-18,22060,15982,6078,38.03,1223
2020-06-19,21690,16301,5389,33.06,1223
2020-06-20,19398,13006,6392,49.15,1223
2020-06-21,15664,9253,6411,69.29,1223
2020-06-22,21330,15979,5351,33.49,1223
2020-06-23,22060,17141,4919,28.7,1223
2020-06-24,22060,17308,4752,27.46,1223
2020-06-25,22060,17568,4492,25.57,1223
2020-06-26,21690,17916,3774,21.06,1223
2020-06-27,19398,14600,4798,32.86,1223
2020-06-28,15664,10779,4885,45.32,1223
2020-06-29,21330,17389,3941,22.66,1223
2020-06-30,22060,18392,3668,19.94,1223
2020-07-01,21276,18361,2915,15.88,1223
2020-07-02,21276,18390,2886,15.69,1223
2020-07-03,22018,18479,3539,19.15,1223
2020-07-04,17965,14884,3081,20.7,1223
2020-07-05,16180,10771,5409,50.22,1223
2020-07-06,20254,17084,3170,18.56,1223
2020-07-07,21276,17794,3482,19.57,1223
2020-07-08,21276,17481,3795,21.71,1223
2020-07-09,21276,17246,4030,23.37,1223
2020-07-10,22018,17097,4921,28.78,1223
2020-07-11,17965,13295,4670,35.13,1223
2020-07-12,16180,9013,7167,79.52,1223
2020-07-13,20254,15200,5054,33.25,1223
2020-07-14,21276,15827,5449,34.43,1223
2020-07-15,21276,15480,5796,37.44,1223
2020-07-16,21276,15257,6019,39.45,1223
2020-07-17,22018,15169,6849,45.15,1223
2020-07-18,17965,11474,6491,56.57,1223
2020-07-19,16180,7341,8839,120.41,1223
2020-07-20,20254,13716,6538,47.67,1223
2020-07-21,21276,14566,6710,46.07,1223
2020-07-22,21276,14469,6807,47.05,1223
2020-07-23,21276,14519,6757,46.54,1223
2020-07-24,22018,14717,7301,49.61,1223
2020-07-25,17965,11316,6649,58.76,1223
2020-07-26,16180,7477,8703,116.4,1223
2020-07-27,20254,14137,6117,43.27,1223
2020-07-28,21276,15257,6019,39.45,1223
2020-07-29,21276,15409,5867,38.08,1223
2020-07-30,21276,15678,5598,35.71,1223
2020-07-31,22018,16063,5955,37.07,1223
2020-08-01,18497,12811,5686,44.38,1223
2020-08-02,15580,9078,6502,71.62,1223
2020-08-03,19378,15801,3577,22.64,1223
2020-08-04,20104,16939,3165,18.68,1223
2020-08-05,20104,17062,3042,17.83,1223
2020-08-06,20104,17259,2845,16.48,1223
2020-08-07,20637,17528,3109,17.74,1223
2020-08-08,18497,14121,4376,30.99,1223
2020-08-09,15580,10199,5381,52.76,1223
2020-08-10,19378,16701,2677,16.03,1223
2020-08-11,20104,17593,2511,14.27,1223
2020-08-12,20104,17451,2653,15.2,1223
2020-08-13,20104,17371,2733,15.73,1223
2020-08-14,20637,17356,3281,18.9,1223
2020-08-15,18497,13666,4831,35.35,1223
2020-08-16,15580,9467,6113,64.57,1223
2020-08-17,19378,15706,3672,23.38,1223
2020-08-18,20104,16353,3751,22.94,1223
2020-08-19,20104,15990,4114,25.73,1223
2020-08-20,20104,15717,4387,27.91,1223
2020-08-21,20637,15541,5096,32.79,1223
2020-08-22,18497,11724,6773,57.77,1223
2020-08-23,15580,7434,8146,109.58,1223
2020-08-24,19378,13619,5759,42.29,1223
2020-08-25,20104,14248,5856,41.1,1223
2020-08-26,20104,13905,6199,44.58,1223
2020-08-27,20104,13684,6420,46.92,1223
2020-08-28,20637,13593,7044,51.82,1223
2020-08-29,18497,9889,8608,87.05,1223
2020-08-30,15580,5737,9843,171.57,1223
2020-08-31,19378,12080,7298,60.41,1223
2020-09-01,22264,12884,9380,72.8,1223
2020-09-02,22264,12726,9538,74.95,1223
2020-09-03,22264,12697,9567,75.35,1223
2020-09-04,22269,12800,9469,73.98,1223
2020-09-05,19455,9287,10168,109.49,1223
2020-09-06,16262,5318,10944,205.79,1223
2020-09-07,21567,11835,9732,82.23,1223
2020-09-08,22264,12798,9466,73.96,1223
2020-09-09,22264,12781,9483,74.2,1223
2020-09-10,22264,12876,9388,72.91,1223
2020-09-11,22269,13081,9188,70.24,1223
2020-09-12,19455,9649,9806,101.63,1223
2020-09-13,16262,5741,10521,183.26,1223
2020-09-14,21567,12296,9271,75.4,1223
2020-09-15,22264,13278,8986,67.68,1223
2020-09-16,22264,13262,9002,67.88,1223
2020-09-17,22264,13340,8924,66.9,1223
2020-09-18,22269,13514,8755,64.78,1223
2020-09-19,19455,10039,9416,93.79,1223
2020-09-20,16262,6078,10184,167.56,1223
2020-09-21,21567,12574,8993,71.52,1223
2020-09-22,22264,13493,8771,65.0,1223
2020-09-23,22264,13413,8851,65.99,1223
2020-09-24,22264,13428,8836,65.8,1223
2020-09-25,22269,13543,8726,64.43,1223
2020-09-26,19455,10013,9442,94.3,1223
2020-09-27,16262,6005,10257,170.81,1223
2020-09-28,21567,12462,9105,73.06,1223
2020-09-29,22264,13351,8913,66.76,1223
2020-09-30,22264,13250,9014,68.03,1223
2020-10-01,22130,13254,8876,66.97,1223
2020-10-02,22232,13367,8865,66.32,1223
2020-10-03,18743,9844,8899,90.4,1223
2020-10-04,15168,5850,9318,159.28,1223
2020-10-05,20988,12327,8661,70.26,1223
2020-10-06,22130,13240,8890,67.15,1223
2020-10-07,22130,13167,8963,68.07,1223
2020-10-08,22130,13201,8929,67.64,1223
2020-10-09,22232,13343,8889,66.62,1223
2020-10-10,18743,9849,8894,90.3,1223
2020-10-11,15168,5881,9287,157.92,1223
2020-10-12,20988,12380,8608,69.53,1223
2020-10-13,22130,13311,8819,66.25,1223
2020-10-14,22130,13251,8879,67.01,1223
2020-10-15,22130,13291,8839,66.5,1223
2020-10-16,22232,13434,8798,65.49,1223
2020-10-17,18743,9935,8808,88.66,1223
2020-10-18,15168,5956,9212,154.67,1223
2020-10-19,20988,12441,8547,68.7,1223
2020-10-20,22130,13353,8777,65.73,1223
2020-10-21,22130,13271,8859,66.75,1223
2020-10-22,22130,13287,8843,66.55,1223
2020-10-23,22232,13407,8825,65.82,1223
2020-10-24,18743,9884,8859,89.63,1223
2020-10-25,15168,5884,9284,157.78,1223
2020-10-26,20988,12350,8638,69.94,1223
2020-10-27,22130,13248,8882,67.04,1223
2020-10-28,22130,13157,8973,68.2,1223
2020-10-29,22130,13169,8961,68.05,1223
2020-10-30,22232,13290,8942,67.28,1223
2020-10-31,18743,9775,8968,91.74,1223
2020-11-01,12414,5788,6626,114.48,1223
2020-11-02,19263,12272,6991,56.97,1223
2020-11-03,17768,13193,4575,34.68,1223
2020-11-04,17768,13127,4641,35.35,1223
2020-11-05,17768,13168,4600,34.93,1223
2020-11-06,18690,13319,5371,40.33,1223
2020-11-07,15259,9834,5425,55.17,1223
2020-11-08,12414,5875,6539,111.3,1223
2020-11-09,19263,12385,6878,55.53,1223
2020-11-10,17768,13327,4441,33.32,1223
2020-11-11,17768,13277,4491,33.83,1223
2020-11-12,17768,13327,4441,33.32,1223
2020-11-13,18690,13479,5211,38.66,1223
2020-11-14,15259,9987,5272,52.79,1223
2020-11-15,12414,6013,6401,106.45,1223
2020-11-16,19263,12499,6764,54.12,1223
2020-11-17,17768,13408,4360,32.52,1223
2020-11-18,17768,13318,4450,33.41,1223
2020-11-19,17768,13320,4448,33.39,1223
2020-11-20,18690,13419,5271,39.28,1223
2020-11-21,15259,9868,5391,54.63,1223
2020-11-22,12414,5832,6582,112.86,1223
2020-11-23,19263,12254,7009,57.2,1223
2020-11-24,17768,13100,4668,35.63,1223
2020-11-25,17768,12948,4820,37.23,1223
2020-11-26,17768,12893,4875,37.81,1223
2020-11-27,18690,12940,5750,44.44,1223
2020-11-28,15259,9345,5914,63.29,1223
2020-11-29,12414,5274,7140,135.38,1223
2020-11-30,19263,11670,7593,65.06,1223
2020-12-01,18418,12501,5917,47.33,1223
2020-12-02,18418,12346,6072,49.18,1223
2020-12-03,18418,12298,6120,49.76,1223
2020-12-04,19057,12364,6693,54.13,1223
2020-12-05,14998,8799,6199,70.45,1223
2020-12-06,11602,4767,6835,143.38,1223
2020-12-07,17845,11211,6634,59.17,1223
2020-12-08,18418,12096,6322,52.27,1223
2020-12-09,18418,12001,6417,53.47,1223
2020-12-10,18418,12017,6401,53.27,1223
2020-12-11,19057,12146,6911,56.9,1223
2020-12-12,14998,8643,6355,73.53,1223
2020-12-13,11602,4670,6932,148.44,1223
2020-12-14,17845,11167,6678,59.8,1223
2020-12-15,18418,12098,6320,52.24,1223
2020-12-16,18418,12038,6380,53.0,1223
2020-12-17,18418,12079,6339,52.48,1223
2020-12-18,19057,12221,6836,55.94,1223
2020-12-19,14998,8718,6280,72.03,1223
2020-12-20,11602,4731,6871,145.23,1223
2020-12-21,17845,11202,6643,59.3,1223
2020-12-22,18418,12094,6324,52.29,1223
2020-12-23,18418,11984,6434,53.69,1223
2020-12-24,18418,11965,6453,53.93,1223
2020-12-25,19057,12039,7018,58.29,1223
2020-12-26,14998,8461,6537,77.26,1223
2020-12-27,11602,4397,7205,163.86,1223
2020-12-28,17845,10788,7057,65.42,1223
2020-12-29,18418,11603,6815,58.73,1223
2020-12-30,18418,11420,6998,61.28,1223
2020-12-31,18418,11334,7084,62.5,1223
2021-01-01,17231,11351,5880,51.8,1223
2021-01-02,13698,7728,5970,77.25,1223
2021-01-03,10699,3632,7067,194.58,1223
2021-01-04,15984,10007,5977,59.73,1223
2021-01-05,16820,10821,5999,55.44,1223
2021-01-06,16820,10653,6167,57.89,1223
2021-01-07,16820,10600,6220,58.68,1223
2021-01-08,17231,10666,6565,61.55,1223
2021-01-09,13698,7106,6592,92.77,1223
2021-01-10,10699,3086,7613,246.69,1223
2021-01-11,15984,9548,6436,67.41,1223
2021-01-12,16820,10457,6363,60.85,1223
2021-01-13,16820,10390,6430,61.89,1223
2021-01-14,16820,10438,6382,61.14,1223
2021-01-15,17231,10603,6628,62.51,1223
2021-01-16,13698,7138,6560,91.9,1223
2021-01-17,10699,3202,7497,234.13,1223
2021-01-18,15984,9737,6247,64.16,1223
2021-01-19,16820,10702,6118,57.17,1223
2021-01-20,16820,10673,6147,57.59,1223
2021-01-21,16820,10737,6083,56.65,1223
2021-01-22,17231,10896,6335,58.14,1223
2021-01-23,13698,7400,6298,85.11,1223
2021-01-24,10699,3410,7289,213.75,1223
2021-01-25,15984,9865,6119,62.03,1223
2021-01-26,16820,10729,6091,56.77,1223
2021-01-27,16820,10576,6244,59.04,1223
2021-01-28,16820,10499,6321,60.21,1223
2021-01-29,17231,10501,6730,64.09,1223
2021-01-30,13698,6837,6861,100.35,1223
2021-01-31,10699,2673,8026,300.26,1223
2021-02-01,19214,8952,10262,114.63,1223
2021-02-02,19353,9643,9710,100.69,1223
2021-02-03,19353,9327,10026,107.49,1223
2021-02-04,19353,9101,10252,112.65,1223
2021-02-05,19731,8974,10757,119.87,1223
2021-02-06,17038,5205,11833,227.34,1223
2021-02-07,13518,965,12553,1300.83,1223
2021-02-08,19214,7202,12012,166.79,1223
2021-02-09,19353,7888,11465,145.35,1223
2021-02-10,19353,7605,11748,154.48,1223
2021-02-11,19353,7453,11900,159.67,1223
2021-02-12,19731,7440,12291,165.2,1223
2021-02-13,17038,3825,13213,345.44,1223
2021-02-14,13518,103,13415,13024.27,1223
2021-02-15,19214,6243,12971,207.77,1223
2021-02-16,19353,7188,12165,169.24,1223
2021-02-17,19353,7191,12162,169.13,1223
2021-02-18,19353,7346,12007,163.45,1223
2021-02-19,19731,7655,12076,157.75,1223
2021-02-20,17038,4371,12667,289.8,1223
2021-02-21,13518,654,12864,1966.97,1223
2021-02-22,19214,7441,11773,158.22,1223
2021-02-23,19353,8694,10659,122.6,1223
2021-02-24,19353,8983,10370,115.44,1223
2021-02-25,19353,9394,9959,106.01,1223
2021-02-26,19731,9923,9808,98.84,1223
2021-02-27,17038,6815,10223,150.01,1223
2021-02-28,13518,3228,10290,318.77,1223
2021-03-01,20209,10093,10116,100.23,1223
2021-03-02,20517,11370,9147,80.45,1223
2021-03-03,20517,11626,8891,76.48,1223
2021-03-04,20517,11949,8568,71.7,1223
2021-03-05,20849,12333,8516,69.05,1223
2021-03-06,18378,9030,9348,103.52,1223
2021-03-07,13919,5197,8722,167.83,1223
2021-03-08,20209,11773,8436,71.66,1223
2021-03-09,20517,12722,7795,61.27,1223
2021-03-10,20517,12621,7896,62.56,1223
2021-03-11,20517,12562,7955,63.33,1223
2021-03-12,20849,12551,8298,66.11,1223
2021-03-13,18378,8847,9531,107.73,1223
2021-03-14,13919,4617,9302,201.47,1223
2021-03-15,20209,10810,9399,86.95,1223
2021-03-16,20517,11397,9120,80.02,1223
2021-03-17,20517,10965,9552,87.11,1223
2021-03-18,20517,10613,9904,93.32,1223
2021-03-19,20849,10354,10495,101.36,1223
2021-03-20,18378,6452,11926,184.84,1223
2021-03-21,13919,2081,11838,568.86,1223
2021-03-22,20209,8190,12019,146.75,1223
2021-03-23,20517,8755,11762,134.35,1223
2021-03-24,20517,8359,12158,145.45,1223
2021-03-25,20517,8104,12413,153.17,1223
2021-03-26,20849,7999,12850,160.65,1223
2021-03-27,18378,4303,14075,327.1,1223
2021-03-28,13919,184,13735,7464.67,1223
2021-03-29,20209,6586,13623,206.85,1223
2021-03-30,20517,7476,13041,174.44,1223
2021-03-31,20517,7430,13087,176.14,1223
2021-04-01,19298,7540,11758,155.94,1223
2021-04-02,19939,7806,12133,155.43,1223
2021-04-03,16770,4477,12293,274.58,1223
2021-04-04,13416,712,12704,1784.27,1223
2021-04-05,19490,7447,12043,161.72,1223
2021-04-06,19298,8639,10659,123.38,1223
2021-04-07,19298,8856,10442,117.91,1223
2021-04-08,19298,9185,10113,110.1,1223
2021-04-09,19939,9620,10319,107.27,1223
2021-04-10,16770,6406,10364,161.79,1223
2021-04-11,13416,2699,10717,397.07,1223
2021-04-12,19490,9434,10056,106.59,1223
2021-04-13,19298,10568,8730,82.61,1223
2021-04-14,19298,10674,8624,80.79,1223
2021-04-15,19298,10838,8460,78.06,1223
2021-04-16,19939,11060,8879,80.28,1223
2021-04-17,16770,7592,9178,120.89,1223
2021-04-18,13416,3597,9819,272.98,1223
2021-04-19,19490,10017,9473,94.57,1223
2021-04-20,19298,10819,8479,78.37,1223
2021-04-21,19298,10583,8715,82.35,1223
2021-04-22,19298,10406,8892,85.45,1223
2021-04-23,19939,10296,9643,93.66,1223
2021-04-24,16770,6515,10255,157.41,1223
2021-04-25,13416,2233,11183,500.81,1223
2021-04-26,19490,8400,11090,132.02,1223
2021-04-27,19298,8990,10308,114.66,1223
2021-04-28,19298,8588,10710,124.71,1223
2021-04-29,19298,8296,11002,132.62,1223
2021-04-30,19939,8124,11815,145.43,1223
2021-05-01,19570,4336,15234,351.34,1223
2021-05-02,15247,101,15146,14996.04,1223
2021-05-03,22485,6368,16117,253.09,1223
2021-05-04,22951,7108,15843,222.89,1223
2021-05-05,22951,6901,16050,232.57,1223
2021-05-06,22951,6844,16107,235.34,1223
2021-05-07,22398,6941,15457,222.69,1223
2021-05-08,19570,3446,16124,467.9,1223
2021-05-09,15247,3446,11801,342.46,1223
2021-05-10,22485,6111,16374,267.94,1223
2021-05-11,22951,7172,15779,220.01,1223
2021-05-12,22951,7277,15674,215.39,1223
2021-05-13,22951,7515,15436,205.4,1223
2021-05-14,22398,7881,14517,184.2,1223
2021-05-15,19570,4623,14947,323.32,1223
2021-05-16,15247,898,14349,1597.88,1223
2021-05-17,22485,7640,14845,194.31,1223
2021-05-18,22951,8807,14144,160.6,1223
2021-05-19,22951,8967,13984,155.95,1223
2021-05-20,22951,9207,13744,149.28,1223
2021-05-21,22398,9524,12874,135.17,1223
2021-05-22,19570,6167,13403,217.33,1223
2021-05-23,15247,2295,12952,564.36,1223
2021-05-24,22485,8847,13638,154.15,1223
2021-05-25,22951,9785,13166,134.55,1223
2021-05-26,22951,9686,13265,136.95,1223
2021-05-27,22951,9643,13308,138.01,1223
2021-05-28,22398,9661,12737,131.84,1223
2021-05-29,19570,5997,13573,226.33,1223
2021-05-30,15247,1818,13429,738.67,1223
2021-05-31,22485,8072,14413,178.56,1223
2021-06-01,24235,8731,15504,177.57,1223
2021-06-02,24235,8377,15858,189.3,1223
2021-06-03,24235,8110,16125,198.83,1223
2021-06-04,22807,7943,14864,187.13,1223
2021-06-05,20439,4137,16302,394.05,1223
2021-06-06,17596,135,17461,12934.07,1223
2021-06-07,22970,6071,16899,278.36,1223
2021-06-08,24235,6734,17501,259.89,1223
2021-06-09,24235,6434,17801,276.67,1223
2021-06-10,24235,6271,17964,286.46,1223
2021-06-11,22807,6252,16555,264.8,1223
2021-06-12,20439,2635,17804,675.67,1223
2021-06-13,17596,2635,14961,567.78,1223
2021-06-14,22970,5051,17919,354.76,1223
2021-06-15,24235,5991,18244,304.52,1223
2021-06-16,24235,5985,18250,304.93,1223
2021-06-17,24235,6121,18114,295.93,1223
2021-06-18,22807,6401,16406,256.3,1223
2021-06-19,20439,3073,17366,565.12,1223
2021-06-20,17596,3073,14523,472.6,1223
2021-06-21,22970,6006,16964,282.45,1223
2021-06-22,24235,7161,17074,238.43,1223
2021-06-23,24235,7331,16904,230.58,1223
2021-06-24,24235,7603,16632,218.76,1223
2021-06-25,22807,7971,14836,186.12,1223
2021-06-26,20439,4684,15755,336.36,1223
2021-06-27,17596,900,16696,1855.11,1223
2021-06-28,22970,7553,15417,204.12,1223
2021-06-29,24235,8604,15631,181.67,1223
2021-06-30,24235,8626,15609,180.95,1223
2021-07-01,24155,8709,15446,177.36,1223
2021-07-02,22606,8854,13752,155.32,1223
2021-07-03,19016,5314,13702,257.85,1223
2021-07-04,16313,1255,15058,1199.84,1223
2021-07-05,22916,7618,15298,200.81,1223
2021-07-06,24155,8374,15781,188.45,1223
2021-07-07,24155,8101,16054,198.17,1223
2021-07-08,24155,7898,16257,205.84,1223
2021-07-09,22606,7774,14832,190.79,1223
2021-07-10,19016,3989,15027,376.71,1223
2021-07-11,16313,61,16252,26642.62,1223
2021-07-12,22916,5900,17016,288.41,1223
2021-07-13,24155,6517,17638,270.65,1223
2021-07-14,24155,6150,18005,292.76,1223
2021-07-15,24155,5900,18255,309.41,1223
2021-07-16,22606,5777,16829,291.31,1223
2021-07-17,19016,2041,16975,831.7,1223
2021-07-18,16313,2041,14272,699.27,1223
2021-07-19,22916,4186,18730,447.44,1223
2021-07-20,24155,4982,19173,384.85,1223
2021-07-21,24155,4831,19324,400.0,1223
2021-07-22,24155,4825,19330,400.62,1223
2021-07-23,22606,4969,17637,354.94,1223
2021-07-24,19016,1517,17499,1153.53,1223
2021-07-25,16313,1517,14796,975.35,1223
2021-07-26,22916,4249,18667,439.33,1223
2021-07-27,24155,5333,18822,352.93,1223
2021-07-28,24155,5456,18699,342.72,1223
2021-07-29,24155,5705,18450,323.4,1223
2021-07-30,22606,6077,16529,271.99,1223
2021-07-31,19016,2820,16196,574.33,1223
2021-08-01,14853,2820,12033,426.7,1223
2021-08-02,21119,5828,15291,262.37,1223
2021-08-03,21840,6986,14854,212.63,1223
2021-08-04,21840,7137,14703,206.01,1223
2021-08-05,21840,7369,14471,196.38,1223
2021-08-06,20446,7680,12766,166.22,1223
2021-08-07,17012,4318,12694,293.98,1223
2021-08-08,14853,445,14408,3237.75,1223
2021-08-09,21119,6999,14120,201.74,1223
2021-08-10,21840,7943,13897,174.96,1223
2021-08-11,21840,7855,13985,178.04,1223
2021-08-12,21840,7826,14014,179.07,1223
2021-08-13,20446,7861,12585,160.09,1223
2021-08-14,17012,4217,12795,303.41,1223
2021-08-15,14853,60,14793,24655.0,1223
2021-08-16,21119,6335,14784,233.37,1223
2021-08-17,21840,7013,14827,211.42,1223
2021-08-18,21840,6674,15166,227.24,1223
2021-08-19,21840,6418,15422,240.29,1223
2021-08-20,20446,6253,14193,226.98,1223
2021-08-21,17012,2439,14573,597.5,1223
2021-08-22,14853,2439,12414,508.98,1223
2021-08-23,21119,4321,16798,388.75,1223
2021-08-24,21840,4935,16905,342.55,1223
2021-08-25,21840,4571,17269,377.79,1223
2021-08-26,21840,4324,17516,405.09,1223
2021-08-27,20446,4204,16242,386.35,1223
2021-08-28,17012,467,16545,3542.83,1223
2021-08-29,14853,467,14386,3080.51,1223
2021-08-30,21119,2588,18531,716.04,1223
2021-08-31,21840,3356,18484,550.77,1223
2021-09-01,23344,3162,20182,638.27,1223
2021-09-02,23344,3099,20245,653.28,1223
2021-09-03,23058,3169,19889,627.61,1223
2021-09-04,20030,29,20001,68968.97,1223
2021-09-05,17475,29,17446,60158.62,1223
2021-09-06,22622,2124,20498,965.07,1223
2021-09-07,23344,3068,20276,660.89,1223
2021-09-08,23344,3037,20307,668.65,1223
2021-09-09,23344,3120,20224,648.21,1223
2021-09-10,23058,3319,19739,594.73,1223
2021-09-11,20030,158,19872,12577.22,1223
2021-09-12,17475,158,17317,10960.13,1223
2021-09-13,22622,2534,20088,792.74,1223
2021-09-14,23344,3522,19822,562.81,1223
2021-09-15,23344,3514,19830,564.31,1223
2021-09-16,23344,3603,19741,547.9,1223
2021-09-17,23058,3788,19270,508.71,1223
2021-09-18,20030,325,19705,6063.08,1223
2021-09-19,17475,325,17150,5276.92,1223
2021-09-20,22622,2885,19737,684.12,1223
2021-09-21,23344,3815,19529,511.9,1223
2021-09-22,23344,3745,19599,523.34,1223
2021-09-23,23344,3769,19575,519.37,1223
2021-09-24,23058,3892,19166,492.45,1223
2021-09-25,20030,368,19662,5342.93,1223
2021-09-26,17475,368,17107,4648.64,1223
2021-09-27,22622,2823,19799,701.35,1223
2021-09-28,23344,3712,19632,528.88,1223
2021-09-29,23344,3610,19734,546.65,1223
2021-09-30,23344,3611,19733,546.47,1223
2021-10-01,23675,3720,19955,536.42,1223
2021-10-02,25709,192,25517,13290.1,1223
2021-10-03,20414,192,20222,10532.29,1223
2021-10-04,22346,2663,19683,739.13,1223
2021-10-05,23493,3571,19922,557.88,1223
2021-10-06,23493,3492,20001,572.77,1223
2021-10-07,23493,3521,19972,567.23,1223
2021-10-08,23675,3659,20016,547.03,1223
2021-10-09,25709,161,25548,15868.32,1223
2021-10-10,20414,161,20253,12579.5,1223
2021-10-11,22346,2688,19658,731.32,1223
2021-10-12,23493,3619,19874,549.16,1223
2021-10-13,23493,3560,19933,559.92,1223
2021-10-14,23493,3602,19891,552.22,1223
2021-10-15,23675,3748,19927,531.67,1223
2021-10-16,25709,252,25457,10101.98,1223
2021-10-17,20414,252,20162,8000.79,1223
2021-10-18,22346,2767,19579,707.59,1223
2021-10-19,23493,3684,19809,537.7,1223
2021-10-20,23493,3606,19887,551.5,1223
2021-10-21,23493,3627,19866,547.73,1223
2021-10-22,23675,3750,19925,531.33,1223
2021-10-23,25709,231,25478,11029.44,1223
2021-10-24,20414,231,20183,8737.23,1223
2021-10-25,22346,2700,19646,727.63,1223
2021-10-26,23493,3598,19895,552.95,1223
2021-10-27,23493,3505,19988,570.27,1223
2021-10-28,23493,3515,19978,568.36,1223
2021-10-29,23675,3633,20042,551.67,1223
2021-10-30,25709,113,25596,22651.33,1223
2021-10-31,20414,113,20301,17965.49,1223
2021-11-01,19343,2600,16743,643.96,1223
2021-11-02,21300,3515,17785,505.97,1223
2021-11-03,21300,3443,17857,518.65,1223
2021-11-04,21300,3479,17821,512.24,1223
2021-11-05,21417,3624,17793,490.98,1223
2021-11-06,18238,135,18103,13409.63,1223
2021-11-07,16605,135,16470,12200.0,1223
2021-11-08,19343,2680,16663,621.75,1223
2021-11-09,21300,3621,17679,488.24,1223
2021-11-10,21300,3572,17728,496.3,1223
2021-11-11,21300,3625,17675,487.59,1223
2021-11-12,21417,3782,17635,466.29,1223
2021-11-13,18238,295,17943,6082.37,1223
2021-11-14,16605,295,16310,5528.81,1223
2021-11-15,19343,2823,16520,585.19,1223
2021-11-16,21300,3742,17558,469.21,1223
2021-11-17,21300,3663,17637,481.49,1223
2021-11-18,21300,3677,17623,479.28,1223
2021-11-19,21417,3787,17630,465.54,1223
2021-11-20,18238,248,17990,7254.03,1223
2021-11-21,16605,248,16357,6595.56,1223
2021-11-22,19343,2657,16686,628.0,1223
2021-11-23,21300,3513,17787,506.32,1223
2021-11-24,21300,3370,17930,532.05,1223
2021-11-25,21300,3322,17978,541.18,1223
2021-11-26,21417,3374,18043,534.77,1223
2021-11-27,18238,118,18120,15355.93,1223
2021-11-28,16605,118,16487,13972.03,1223
2021-11-29,19343,2107,17236,818.04,1223
2021-11-30,21300,2935,18365,625.72,1223
2021-12-01,19070,2774,16296,587.45,1223
2021-12-02,19070,2720,16350,601.1,1223
2021-12-03,17939,2776,15163,546.22,1223
2021-12-04,16685,2776,13909,501.04,1223
2021-12-05,12695,2776,9919,357.31,1223
2021-12-06,18712,1589,17123,1077.6,1223
2021-12-07,19070,2463,16607,674.26,1223
2021-12-08,19070,2355,16715,709.77,1223
2021-12-09,19070,2360,16710,708.05,1223
2021-12-10,17939,2479,15460,623.64,1223
2021-12-11,16685,2479,14206,573.05,1223
2021-12-12,12695,2479,10216,412.1,1223
2021-12-13,18712,1478,17234,1166.04,1223
2021-12-14,19070,2406,16664,692.6,1223
2021-12-15,19070,2346,16724,712.87,1223
2021-12-16,19070,2389,16681,698.24,1223
2021-12-17,17939,2536,15403,607.37,1223
2021-12-18,16685,2536,14149,557.93,1223
2021-12-19,12695,2536,10159,400.59,1223
2021-12-20,18712,1544,17168,1111.92,1223
2021-12-21,19070,2449,16621,678.69,1223
2021-12-22,19070,2353,16717,710.45,1223
2021-12-23,19070,2349,16721,711.83,1223
2021-12-24,17939,2438,15501,635.81,1223
2021-12-25,16685,2438,14247,584.37,1223
2021-12-26,12695,2438,10257,420.71,1223
2021-12-27,18712,1229,17483,1422.54,1223
2021-12-28,19070,2055,17015,827.98,1223
2021-12-29,19070,1881,17189,913.82,1223
2021-12-30,19070,1802,17268,958.27,1223
2021-12-31,17939,1822,16117,884.58,1223
2022-01-01,16610,1822,14788,811.64,1223
2022-01-02,12366,1822,10544,578.7,1223
2022-01-03,17483,471,17012,3611.89,1223
2022-01-04,17890,1276,16614,1302.04,1223
2022-01-05,17890,1097,16793,1530.81,1223
2022-01-06,17890,1030,16860,1636.89,1223
2022-01-07,18527,1079,17448,1617.05,1223
2022-01-08,16610,1079,15531,1439.39,1223
2022-01-09,12366,1079,11287,1046.06,1223
2022-01-10,17483,164,17319,10560.37,1223
2022-01-11,17890,795,17095,2150.31,1223
2022-01-12,17890,709,17181,2423.27,1223
2022-01-13,17890,741,17149,2314.3,1223
2022-01-14,18527,892,17635,1977.02,1223
2022-01-15,16610,892,15718,1762.11,1223
2022-01-16,12366,892,11474,1286.32,1223
2022-01-17,17483,1,17482,1748200.0,1223
2022-01-18,17890,967,16923,1750.05,1223
2022-01-19,17890,942,16948,1799.15,1223
2022-01-20,17890,1016,16874,1660.83,1223
2022-01-21,18527,1189,17338,1458.2,1223
2022-01-22,16610,1189,15421,1296.97,1223
2022-01-23,12366,1189,11177,940.03,1223
2022-01-24,17483,225,17258,7670.22,1223
2022-01-25,17890,1118,16772,1500.18,1223
2022-01-26,17890,996,16894,1696.18,1223
2022-01-27,17890,952,16938,1779.2,1223
2022-01-28,18527,988,17539,1775.2,1223
2022-01-29,16610,988,15622,1581.17,1223
2022-01-30,12366,988,11378,1151.62,1223
2020-02-01,16100,15343,757,4.93,1189
2020-02-02,11274,10557,717,6.79,1189
2020-02-03,21428,21452,-24,-0.11,1189
2020-02-04,21581,21566,15,0.07,1189
2020-02-05,21581,21595,-14,-0.06,1189
2020-02-06,21581,21620,-39,-0.18,1189
2020-02-07,21603,21378,225,1.05,1189
2020-02-08,16100,15495,605,3.9,1189
2020-02-09,11274,10694,580,5.42,1189
2020-02-10,21428,21576,-148,-0.69,1189
2020-02-11,21581,21681,-100,-0.46,1189
2020-02-12,21581,21703,-122,-0.56,1189
2020-02-13,21581,21725,-144,-0.66,1189
2020-02-14,21603,21483,120,0.56,1189
2020-02-15,16100,15603,497,3.19,1189
2020-02-16,11274,10809,465,4.3,1189
2020-02-17,21428,21703,-275,-1.27,1189
2020-02-18,21581,21821,-240,-1.1,1189
2020-02-19,21581,21859,-278,-1.27,1189
2020-02-20,21581,21899,-318,-1.45,1189
2020-02-21,21603,21677,-74,-0.34,1189
2020-02-22,16100,15819,281,1.78,1189
2020-02-23,11274,11046,228,2.06,1189
2020-02-24,21428,21961,-533,-2.43,1189
2020-02-25,21581,22098,-517,-2.34,1189
2020-02-26,21581,22155,-574,-2.59,1189
2020-02-27,21581,22212,-631,-2.84,1189
2020-02-28,21603,22003,-400,-1.82,1189
2020-02-29,16100,16155,-55,-0.34,1189
2020-03-01,8350,11389,-3039,-26.68,1189
2020-03-02,16436,22307,-5871,-26.32,1189
2020-03-03,16470,22444,-5974,-26.62,1189
2020-03-04,16470,22496,-6026,-26.79,1189
2020-03-05,16470,22544,-6074,-26.94,1189
2020-03-06,16736,22323,-5587,-25.03,1189
2020-03-07,11453,16460,-5007,-30.42,1189
2020-03-08,8350,11676,-3326,-28.49,1189
2020-03-09,16436,22573,-6137,-27.19,1189
2020-03-10,16470,22687,-6217,-27.4,1189
2020-03-11,16470,22716,-6246,-27.5,1189
2020-03-12,16470,22739,-6269,-27.57,1189
2020-03-13,16736,22494,-5758,-25.6,1189
2020-03-14,11453,16607,-5154,-31.04,1189
2020-03-15,8350,11800,-3450,-29.24,1189
2020-03-16,16436,22676,-6240,-27.52,1189
2020-03-17,16470,22772,-6302,-27.67,1189
2020-03-18,16470,22784,-6314,-27.71,1189
2020-03-19,16470,22795,-6325,-27.75,1189
2020-03-20,16736,22540,-5804,-25.75,1189
2020-03-21,11453,16646,-5193,-31.2,1189
2020-03-22,8350,11837,-3487,-29.46,1189
2020-03-23,16436,22714,-6278,-27.64,1189
2020-03-24,16470,22814,-6344,-27.81,1189
2020-03-25,16470,22833,-6363,-27.87,1189
2020-03-26,16470,22853,-6383,-27.93,1189
2020-03-27,16736,22611,-5875,-25.98,1189
2020-03-28,11453,16731,-5278,-31.55,1189
2020-03-29,8350,11937,-3587,-30.05,1189
2020-03-30,16436,22829,-6393,-28.0,1189
2020-03-31,16470,22945,-6475,-28.22,1189
2020-04-01,15736,22980,-7244,-31.52,1189
2020-04-02,15736,23014,-7278,-31.62,1189
2020-04-03,14818,22785,-7967,-34.97,1189
2020-04-04,10470,16916,-6446,-38.11,1189
2020-04-05,6849,12130,-5281,-43.54,1189
2020-04-06,15815,23028,-7213,-31.32,1189
2020-04-07,15736,23146,-7410,-32.01,1189
2020-04-08,15736,23181,-7445,-32.12,1189
2020-04-09,15736,23212,-7476,-32.21,1189
2020-04-10,14818,22975,-8157,-35.5,1189
2020-04-11,10470,17096,-6626,-38.76,1189
2020-04-12,6849,12298,-5449,-44.31,1189
2020-04-13,15815,23181,-7366,-31.78,1189
2020-04-14,15736,23283,-7547,-32.41,1189
2020-04-15,15736,23298,-7562,-32.46,1189
2020-04-16,15736,23309,-7573,-32.49,1189
2020-04-17,14818,23052,-8234,-35.72,1189
2020-04-18,10470,17153,-6683,-38.96,1189
2020-04-19,6849,12334,-5485,-44.47,1189
2020-04-20,15815,23197,-7382,-31.82,1189
2020-04-21,15736,23280,-7544,-32.41,1189
2020-04-22,15736,23279,-7543,-32.4,1189
2020-04-23,15736,23275,-7539,-32.39,1189
2020-04-24,14818,23006,-8188,-35.59,1189
2020-04-25,10470,17096,-6626,-38.76,1189
2020-04-26,6849,12270,-5421,-44.18,1189
2020-04-27,15815,23128,-7313,-31.62,1189
2020-04-28,15736,23209,-7473,-32.2,1189
2020-04-29,15736,23208,-7472,-32.2,1189
2020-04-30,15736,23207,-7471,-32.19,1189
2020-05-01,21253,22942,-1689,-7.36,1189
2020-05-02,16543,17038,-495,-2.91,1189
2020-05-03,10683,12219,-1536,-12.57,1189
2020-05-04,21269,23086,-1817,-7.87,1189
2020-05-05,21446,23176,-1730,-7.46,1189
2020-05-06,21446,23184,-1738,-7.5,1189
2020-05-07,21446,23191,-1745,-7.52,1189
2020-05-08,21253,22934,-1681,-7.33,1189
2020-05-09,16543,17037,-494,-2.9,1189
2020-05-10,10683,12224,-1541,-12.61,1189
2020-05-11,21269,23094,-1825,-7.9,1189
2020-05-12,21446,23186,-1740,-7.5,1189
2020-05-13,21446,23195,-1749,-7.54,1189
2020-05-14,21446,23202,-1756,-7.57,1189
2020-05-15,21253,22942,-1689,-7.36,1189
2020-05-16,16543,17041,-498,-2.92,1189
2020-05-17,10683,12223,-1540,-12.6,1189
2020-05-18,21269,23088,-1819,-7.88,1189
2020-05-19,21446,23173,-1727,-7.45,1189
2020-05-20,21446,23175,-1729,-7.46,1189
2020-05-21,21446,23174,-1728,-7.46,1189
2020-05-22,21253,22908,-1655,-7.22,1189
2020-05-23,16543,17002,-459,-2.7,1189
2020-05-24,10683,12180,-1497,-12.29,1189
2020-05-25,21269,23042,-1773,-7.69,1189
2020-05-26,21446,23127,-1681,-7.27,1189
2020-05-27,21446,23129,-1683,-7.28,1189
2020-05-28,21446,23133,-1687,-7.29,1189
2020-05-29,21253,22872,-1619,-7.08,1189
2020-05-30,16543,16973,-430,-2.53,1189
2020-05-31,10683,12160,-1477,-12.15,1189
2020-06-01,22593,23033,-440,-1.91,1189
2020-06-02,22880,23130,-250,-1.08,1189
2020-06-03,22880,23145,-265,-1.14,1189
2020-06-04,22880,23162,-282,-1.22,1189
2020-06-05,22073,22914,-841,-3.67,1189
2020-06-06,17014,17028,-14,-0.08,1189
2020-06-07,11645,12226,-581,-4.75,1189
2020-06-08,22593,23109,-516,-2.23,1189
2020-06-09,22880,23213,-333,-1.43,1189
2020-06-10,22880,23233,-353,-1.52,1189
2020-06-11,22880,23250,-370,-1.59,1189
2020-06-12,22073,22999,-926,-4.03,1189
2020-06-13,17014,17105,-91,-0.53,1189
2020-06-14,11645,12291,-646,-5.26,1189
2020-06-15,22593,23156,-563,-2.43,1189
2020-06-16,22880,23239,-359,-1.54,1189
2020-06-17,22880,23233,-353,-1.52,1189
2020-06-18,22880,23220,-340,-1.46,1189
2020-06-19,22073,22935,-862,-3.76,1189
2020-06-20,17014,17004,10,0.06,1189
2020-06-21,11645,12150,-505,-4.16,1189
2020-06-22,22593,22974,-381,-1.66,1189
2020-06-23,22880,23013,-133,-0.58,1189
2020-06-24,22880,22964,-84,-0.37,1189
2020-06-25,22880,22909,-29,-0.13,1189
2020-06-26,22073,22583,-510,-2.26,1189
2020-06-27,17014,16613,401,2.41,1189
2020-06-28,11645,11724,-79,-0.67,1189
2020-06-29,22593,22517,76,0.34,1189
2020-06-30,22880,22531,349,1.55,1189
2020-07-01,22300,22461,-161,-0.72,1189
2020-07-02,22300,22392,-92,-0.41,1189
2020-07-03,21846,22058,-212,-0.96,1189
2020-07-04,16488,16088,400,2.49,1189
2020-07-05,12082,11205,877,7.83,1189
2020-07-06,22105,22010,95,0.43,1189
2020-07-07,22300,22042,258,1.17,1189
2020-07-08,22300,21998,302,1.37,1189
2020-07-09,22300,21958,342,1.56,1189
2020-07-10,21846,21660,186,0.86,1189
2020-07-11,16488,15728,760,4.83,1189
2020-07-12,12082,10887,1195,10.98,1189
2020-07-13,22105,21735,370,1.7,1189
2020-07-14,22300,21812,488,2.24,1189
2020-07-15,22300,21811,489,2.24,1189
2020-07-16,22300,21813,487,2.23,1189
2020-07-17,21846,21554,292,1.35,1189
2020-07-18,16488,15658,830,5.3,1189
2020-07-19,12082,10847,1235,11.39,1189
2020-07-20,22105,21722,383,1.76,1189
2020-07-21,22300,21818,482,2.21,1189
2020-07-22,22300,21830,470,2.15,1189
2020-07-23,22300,21839,461,2.11,1189
2020-07-24,21846,21579,267,1.24,1189
2020-07-25,16488,15676,812,5.18,1189
2020-07-26,12082,10851,1231,11.34,1189
2020-07-27,22105,21705,400,1.84,1189
2020-07-28,22300,21775,525,2.41,1189
2020-07-29,22300,21756,544,2.5,1189
2020-07-30,22300,21731,569,2.62,1189
2020-07-31,21846,21434,412,1.92,1189
2020-08-01,16194,15491,703,4.54,1189
2020-08-02,11735,10627,1108,10.43,1189
2020-08-03,21609,21444,165,0.77,1189
2020-08-04,21643,21478,165,0.77,1189
2020-08-05,21643,21427,216,1.01,1189
2020-08-06,21643,21374,269,1.26,1189
2020-08-07,21056,21056,0,0.0,1189
2020-08-08,16194,15099,1095,7.25,1189
2020-08-09,11735,10228,1507,14.73,1189
2020-08-10,21609,21046,563,2.68,1189
2020-08-11,21643,21090,553,2.62,1189
2020-08-12,21643,21058,585,2.78,1189
2020-08-13,21643,21033,610,2.9,1189
2020-08-14,21056,20751,305,1.47,1189
2020-08-15,16194,14840,1354,9.12,1189
2020-08-16,11735,10022,1713,17.09,1189
2020-08-17,21609,20899,710,3.4,1189
2020-08-18,21643,21009,634,3.02,1189
2020-08-19,21643,21048,595,2.83,1189
2020-08-20,21643,21097,546,2.59,1189
2020-08-21,21056,20891,165,0.79,1189
2020-08-22,16194,15056,1138,7.56,1189
2020-08-23,11735,10313,1422,13.79,1189
2020-08-24,21609,21264,345,1.62,1189
2020-08-25,21643,21444,199,0.93,1189
2020-08-26,21643,21547,96,0.45,1189
2020-08-27,21643,21655,-12,-0.06,1189
2020-08-28,21056,21500,-444,-2.07,1189
2020-08-29,16194,15708,486,3.09,1189
2020-08-30,11735,10999,736,6.69,1189
2020-08-31,21609,21974,-365,-1.66,1189
2020-09-01,23138,22169,969,4.37,1189
2020-09-02,23138,22277,861,3.86,1189
2020-09-03,23138,22379,759,3.39,1189
2020-09-04,22672,22209,463,2.08,1189
2020-09-05,17663,16393,1270,7.75,1189
2020-09-06,12582,11653,929,7.97,1189
2020-09-07,22630,22588,42,0.19,1189
2020-09-08,23138,22737,401,1.76,1189
2020-09-09,23138,22794,344,1.51,1189
2020-09-10,23138,22841,297,1.3,1189
2020-09-11,22672,22614,58,0.26,1189
2020-09-12,17663,16739,924,5.52,1189
2020-09-13,12582,11940,642,5.38,1189
2020-09-14,22630,22817,-187,-0.82,1189
2020-09-15,23138,22910,228,1.0,1189
2020-09-16,23138,22915,223,0.97,1189
2020-09-17,23138,22914,224,0.98,1189
2020-09-18,22672,22643,29,0.13,1189
2020-09-19,17663,16731,932,5.57,1189
2020-09-20,12582,11900,682,5.73,1189
2020-09-21,22630,22752,-122,-0.54,1189
2020-09-22,23138,22827,311,1.36,1189
2020-09-23,23138,22819,319,1.4,1189
2020-09-24,23138,22812,326,1.43,1189
2020-09-25,22672,22541,131,0.58,1189
2020-09-26,17663,16634,1029,6.19,1189
2020-09-27,12582,11812,770,6.52,1189
2020-09-28,22630,22678,-48,-0.21,1189
2020-09-29,23138,22769,369,1.62,1189
2020-09-30,23138,22779,359,1.58,1189
2020-10-01,22498,22792,-294,-1.29,1189
2020-10-02,22518,22541,-23,-0.1,1189
2020-10-03,17293,16653,640,3.84,1189
2020-10-04,11927,11850,77,0.65,1189
2020-10-05,22477,22732,-255,-1.12,1189
2020-10-06,22498,22836,-338,-1.48,1189
2020-10-07,22498,22858,-360,-1.57,1189
2020-10-08,22498,22879,-381,-1.67,1189
2020-10-09,22518,22632,-114,-0.5,1189
2020-10-10,17293,16745,548,3.27,1189
2020-10-11,11927,11940,-13,-0.11,1189
2020-10-12,22477,22816,-339,-1.49,1189
2020-10-13,22498,22912,-414,-1.81,1189
2020-10-14,22498,22923,-425,-1.85,1189
2020-10-15,22498,22930,-432,-1.88,1189
2020-10-16,22518,22670,-152,-0.67,1189
2020-10-17,17293,16768,525,3.13,1189
2020-10-18,11927,11947,-20,-0.17,1189
2020-10-19,22477,22810,-333,-1.46,1189
2020-10-20,22498,22892,-394,-1.72,1189
2020-10-21,22498,22892,-394,-1.72,1189
2020-10-22,22498,22890,-392,-1.71,1189
2020-10-23,22518,22623,-105,-0.46,1189
2020-10-24,17293,16718,575,3.44,1189
2020-10-25,11927,11897,30,0.25,1189
2020-10-26,22477,22763,-286,-1.26,1189
2020-10-27,22498,22852,-354,-1.55,1189
2020-10-28,22498,22861,-363,-1.59,1189
2020-10-29,22498,22872,-374,-1.64,1189
2020-10-30,22518,22621,-103,-0.46,1189
2020-10-31,17293,16733,560,3.35,1189
2020-11-01,9697,11931,-2234,-18.72,1189
2020-11-02,20553,22816,-2263,-9.92,1189
2020-11-03,19142,22925,-3783,-16.5,1189
2020-11-04,19142,22953,-3811,-16.6,1189
2020-11-05,19142,22982,-3840,-16.71,1189
2020-11-06,19585,22746,-3161,-13.9,1189
2020-11-07,13825,16871,-3046,-18.05,1189
2020-11-08,9697,12079,-2382,-19.72,1189
2020-11-09,20553,22970,-2417,-10.52,1189
2020-11-10,19142,23080,-3938,-17.06,1189
2020-11-11,19142,23106,-3964,-17.16,1189
2020-11-12,19142,23127,-3985,-17.23,1189
2020-11-13,19585,22878,-3293,-14.39,1189
2020-11-14,13825,16985,-3160,-18.6,1189
2020-11-15,9697,12171,-2474,-20.33,1189
2020-11-16,20553,23036,-2483,-10.78,1189
2020-11-17,19142,23117,-3975,-17.2,1189
2020-11-18,19142,23110,-3968,-17.17,1189
2020-11-19,19142,23095,-3953,-17.12,1189
2020-11-20,19585,22810,-3225,-14.14,1189
2020-11-21,13825,16879,-3054,-18.09,1189
2020-11-22,9697,12028,-2331,-19.38,1189
2020-11-23,20553,22856,-2303,-10.08,1189
2020-11-24,19142,22902,-3760,-16.42,1189
2020-11-25,19142,22862,-3720,-16.27,1189
2020-11-26,19142,22818,-3676,-16.11,1189
2020-11-27,19585,22508,-2923,-12.99,1189
2020-11-28,13825,16557,-2732,-16.5,1189
2020-11-29,9697,11690,-1993,-17.05,1189
2020-11-30,20553,22508,-1955,-8.69,1189
2020-12-01,19122,22549,-3427,-15.2,1189
2020-12-02,19122,22510,-3388,-15.05,1189
2020-12-03,19122,22473,-3351,-14.91,1189
2020-12-04,20970,22175,-1205,-5.43,1189
2020-12-05,15409,16240,-831,-5.12,1189
2020-12-06,10123,11394,-1271,-11.15,1189
2020-12-07,19848,22236,-2388,-10.74,1189
2020-12-08,19122,22305,-3183,-14.27,1189
2020-12-09,19122,22295,-3173,-14.23,1189
2020-12-10,19122,22289,-3167,-14.21,1189
2020-12-11,20970,22021,-1051,-4.77,1189
2020-12-12,15409,16117,-708,-4.39,1189
2020-12-13,10123,11299,-1176,-10.41,1189
2020-12-14,19848,22168,-2320,-10.47,1189
2020-12-15,19122,22260,-3138,-14.1,1189
2020-12-16,19122,22270,-3148,-14.14,1189
2020-12-17,19122,22279,-3157,-14.17,1189
2020-12-18,20970,22022,-1052,-4.78,1189
2020-12-19,15409,16124,-715,-4.43,1189
2020-12-20,10123,11307,-1184,-10.47,1189
2020-12-21,19848,22172,-2324,-10.48,1189
2020-12-22,19122,22255,-3133,-14.08,1189
2020-12-23,19122,22252,-3130,-14.07,1189
2020-12-24,19122,22244,-3122,-14.04,1189
2020-12-25,20970,21966,-996,-4.53,1189
2020-12-26,15409,16044,-635,-3.96,1189
2020-12-27,10123,11201,-1078,-9.62,1189
2020-12-28,19848,22038,-2190,-9.94,1189
2020-12-29,19122,22094,-2972,-13.45,1189
2020-12-30,19122,22064,-2942,-13.33,1189
2020-12-31,19122,22030,-2908,-13.2,1189
2021-01-01,18492,21728,-3236,-14.89,1189
2021-01-02,11973,15786,-3813,-24.15,1189
2021-01-03,8613,10926,-2313,-21.17,1189
2021-01-04,17633,21751,-4118,-18.93,1189
2021-01-05,18554,21799,-3245,-14.89,1189
2021-01-06,18554,21767,-3213,-14.76,1189
2021-01-07,18554,21736,-3182,-14.64,1189
2021-01-08,18492,21443,-2951,-13.76,1189
2021-01-09,11973,15514,-3541,-22.82,1189
2021-01-10,8613,10674,-2061,-19.31,1189
2021-01-11,17633,21524,-3891,-18.08,1189
2021-01-12,18554,21600,-3046,-14.1,1189
2021-01-13,18554,21600,-3046,-14.1,1189
2021-01-14,18554,21605,-3051,-14.12,1189
2021-01-15,18492,21350,-2858,-13.39,1189
2021-01-16,11973,15462,-3489,-22.56,1189
2021-01-17,8613,10662,-2049,-19.22,1189
2021-01-18,17633,21552,-3919,-18.18,1189
2021-01-19,18554,21668,-3114,-14.37,1189
2021-01-20,18554,21706,-3152,-14.52,1189
2021-01-21,18554,21746,-3192,-14.68,1189
2021-01-22,18492,21523,-3031,-14.08,1189
2021-01-23,11973,15663,-3690,-23.56,1189
2021-01-24,8613,10887,-2274,-20.89,1189
2021-01-25,17633,21797,-4164,-19.1,1189
2021-01-26,18554,21927,-3373,-15.38,1189
2021-01-27,18554,21975,-3421,-15.57,1189
2021-01-28,18554,22020,-3466,-15.74,1189
2021-01-29,18492,21798,-3306,-15.17,1189
2021-01-30,11973,15934,-3961,-24.86,1189
2021-01-31,8613,11151,-2538,-22.76,1189
2021-02-01,20514,22049,-1535,-6.96,1189
2021-02-02,20388,22167,-1779,-8.03,1189
2021-02-03,20388,22199,-1811,-8.16,1189
2021-02-04,20388,22227,-1839,-8.27,1189
2021-02-05,20435,21987,-1552,-7.06,1189
2021-02-06,15160,16106,-946,-5.87,1189
2021-02-07,10182,11306,-1124,-9.94,1189
2021-02-08,20514,22189,-1675,-7.55,1189
2021-02-09,20388,22294,-1906,-8.55,1189
2021-02-10,20388,22315,-1927,-8.64,1189
2021-02-11,20388,22336,-1948,-8.72,1189
2021-02-12,20435,22092,-1657,-7.5,1189
2021-02-13,15160,16210,-1050,-6.48,1189
2021-02-14,10182,11413,-1231,-10.79,1189
2021-02-15,20514,22303,-1789,-8.02,1189
2021-02-16,20388,22417,-2029,-9.05,1189
2021-02-17,20388,22452,-2064,-9.19,1189
2021-02-18,20388,22488,-2100,-9.34,1189
2021-02-19,20435,22262,-1827,-8.21,1189
2021-02-20,15160,16400,-1240,-7.56,1189
2021-02-21,10182,11624,-1442,-12.41,1189
2021-02-22,20514,22535,-2021,-8.97,1189
2021-02-23,20388,22670,-2282,-10.07,1189
2021-02-24,20388,22725,-2337,-10.28,1189
2021-02-25,20388,22780,-2392,-10.5,1189
2021-02-26,20435,22570,-2135,-9.46,1189
2021-02-27,15160,16722,-1562,-9.34,1189
2021-02-28,10182,11957,-1775,-14.84,1189
2021-03-01,21277,22876,-1599,-6.99,1189
2021-03-02,21478,23015,-1537,-6.68,1189
2021-03-03,21478,23070,-1592,-6.9,1189
2021-03-04,21478,23122,-1644,-7.11,1189
2021-03-05,21256,22905,-1649,-7.2,1189
2021-03-06,16485,17046,-561,-3.29,1189
2021-03-07,10608,12267,-1659,-13.52,1189
2021-03-08,21277,23168,-1891,-8.16,1189
2021-03-09,21478,23287,-1809,-7.77,1189
2021-03-10,21478,23320,-1842,-7.9,1189
2021-03-11,21478,23348,-1870,-8.01,1189
2021-03-12,21256,23107,-1851,-8.01,1189
2021-03-13,16485,17223,-738,-4.28,1189
2021-03-14,10608,12419,-1811,-14.58,1189
2021-03-15,21277,23298,-2021,-8.67,1189
2021-03-16,21478,23395,-1917,-8.19,1189
2021-03-17,21478,23409,-1931,-8.25,1189
2021-03-18,21478,23420,-1942,-8.29,1189
2021-03-19,21256,23165,-1909,-8.24,1189
2021-03-20,16485,17271,-786,-4.55,1189
2021-03-21,10608,12460,-1852,-14.86,1189
2021-03-22,21277,23335,-2058,-8.82,1189
2021-03-23,21478,23433,-1955,-8.34,1189
2021-03-24,21478,23449,-1971,-8.41,1189
2021-03-25,21478,23467,-1989,-8.48,1189
2021-03-26,21256,23221,-1965,-8.46,1189
2021-03-27,16485,17338,-853,-4.92,1189
2021-03-28,10608,12541,-1933,-15.41,1189
2021-03-29,21277,23431,-2154,-9.19,1189
2021-03-30,21478,23544,-2066,-8.78,1189
2021-03-31,21478,23576,-2098,-8.9,1189
2021-04-01,20050,23610,-3560,-15.08,1189
2021-04-02,19851,23379,-3528,-15.09,1189
2021-04-03,14082,17509,-3427,-19.57,1189
2021-04-04,10433,12723,-2290,-18.0,1189
2021-04-05,20498,23622,-3124,-13.22,1189
2021-04-06,20050,23741,-3691,-15.55,1189
2021-04-07,20050,23778,-3728,-15.68,1189
2021-04-08,20050,23811,-3761,-15.8,1189
2021-04-09,19851,23577,-3726,-15.8,1189
2021-04-10,14082,17702,-3620,-20.45,1189
2021-04-11,10433,12907,-2474,-19.17,1189
2021-04-12,20498,23794,-3296,-13.85,1189
2021-04-13,20050,23899,-3849,-16.11,1189
2021-04-14,20050,23918,-3868,-16.17,1189
2021-04-15,20050,23933,-3883,-16.22,1189
2021-04-16,19851,23680,-3829,-16.17,1189
2021-04-17,14082,17784,-3702,-20.82,1189
2021-04-18,10433,12968,-2535,-19.55,1189
2021-04-19,20498,23834,-3336,-14.0,1189
2021-04-20,20050,23920,-3870,-16.18,1189
2021-04-21,20050,23920,-3870,-16.18,1189
2021-04-22,20050,23918,-3868,-16.17,1189
2021-04-23,19851,23649,-3798,-16.06,1189
2021-04-24,14082,17740,-3658,-20.62,1189
2021-04-25,10433,12914,-2481,-19.21,1189
2021-04-26,20498,23772,-3274,-13.77,1189
2021-04-27,20050,23852,-3802,-15.94,1189
2021-04-28,20050,23850,-3800,-15.93,1189
2021-04-29,20050,23847,-3797,-15.92,1189
2021-04-30,19851,23580,-3729,-15.81,1189
2021-05-01,17900,17675,225,1.27,1189
2021-05-02,11922,12854,-932,-7.25,1189
2021-05-03,22696,23720,-1024,-4.32,1189
2021-05-04,23001,23808,-807,-3.39,1189
2021-05-05,23001,23814,-813,-3.41,1189
2021-05-06,23001,23820,-819,-3.44,1189
2021-05-07,22796,23562,-766,-3.25,1189
2021-05-08,17900,17665,235,1.33,1189
2021-05-09,11922,12852,-930,-7.24,1189
2021-05-10,22696,23723,-1027,-4.33,1189
2021-05-11,23001,23815,-814,-3.42,1189
2021-05-12,23001,23824,-823,-3.45,1189
2021-05-13,23001,23832,-831,-3.49,1189
2021-05-14,22796,23573,-777,-3.3,1189
2021-05-15,17900,17674,226,1.28,1189
2021-05-16,11922,12857,-935,-7.27,1189
2021-05-17,22696,23723,-1027,-4.33,1189
2021-05-18,23001,23810,-809,-3.4,1189
2021-05-19,23001,23812,-811,-3.41,1189
2021-05-20,23001,23813,-812,-3.41,1189
2021-05-21,22796,23548,-752,-3.19,1189
2021-05-22,17900,17642,258,1.46,1189
2021-05-23,11922,12819,-897,-7.0,1189
2021-05-24,22696,23681,-985,-4.16,1189
2021-05-25,23001,23765,-764,-3.21,1189
2021-05-26,23001,23766,-765,-3.22,1189
2021-05-27,23001,23768,-767,-3.23,1189
2021-05-28,22796,23505,-709,-3.02,1189
2021-05-29,17900,17604,296,1.68,1189
2021-05-30,11922,12788,-866,-6.77,1189
2021-05-31,22696,23658,-962,-4.07,1189
2021-06-01,23298,23753,-455,-1.92,1189
2021-06-02,23298,23766,-468,-1.97,1189
2021-06-03,23298,23780,-482,-2.03,1189
2021-06-04,22701,23531,-830,-3.53,1189
2021-06-05,17551,17643,-92,-0.52,1189
2021-06-06,13218,12840,378,2.94,1189
2021-06-07,22905,23722,-817,-3.44,1189
2021-06-08,23298,23827,-529,-2.22,1189
2021-06-09,23298,23848,-550,-2.31,1189
2021-06-10,23298,23867,-569,-2.38,1189
2021-06-11,22701,23619,-918,-3.89,1189
2021-06-12,17551,17729,-178,-1.0,1189
2021-06-13,13218,12919,299,2.31,1189
2021-06-14,22905,23790,-885,-3.72,1189
2021-06-15,23298,23879,-581,-2.43,1189
2021-06-16,23298,23879,-581,-2.43,1189
2021-06-17,23298,23874,-576,-2.41,1189
2021-06-18,22701,23597,-896,-3.8,1189
2021-06-19,17551,17674,-123,-0.7,1189
2021-06-20,13218,12828,390,3.04,1189
2021-06-21,22905,23660,-755,-3.19,1189
2021-06-22,23298,23707,-409,-1.73,1189
2021-06-23,23298,23665,-367,-1.55,1189
2021-06-24,23298,23616,-318,-1.35,1189
2021-06-25,22701,23296,-595,-2.55,1189
2021-06-26,17551,17332,219,1.26,1189
2021-06-27,13218,12447,771,6.19,1189
2021-06-28,22905,23242,-337,-1.45,1189
2021-06-29,23298,23257,41,0.18,1189
2021-06-30,23298,23188,110,0.47,1189
2021-07-01,21552,23118,-1566,-6.77,1189
2021-07-02,21073,22782,-1709,-7.5,1189
2021-07-03,15165,16808,-1643,-9.78,1189
2021-07-04,11256,11921,-665,-5.58,1189
2021-07-05,21363,22721,-1358,-5.98,1189
2021-07-06,21552,22746,-1194,-5.25,1189
2021-07-07,21552,22695,-1143,-5.04,1189
2021-07-08,21552,22647,-1095,-4.84,1189
2021-07-09,21073,22341,-1268,-5.68,1189
2021-07-10,15165,16401,-1236,-7.54,1189
2021-07-11,11256,11551,-295,-2.55,1189
2021-07-12,21363,22392,-1029,-4.6,1189
2021-07-13,21552,22461,-909,-4.05,1189
2021-07-14,21552,22453,-901,-4.01,1189
2021-07-15,21552,22449,-897,-4.0,1189
2021-07-16,21073,22185,-1112,-5.01,1189
2021-07-17,15165,16285,-1120,-6.88,1189
2021-07-18,11256,11472,-216,-1.88,1189
2021-07-19,21363,22345,-982,-4.39,1189
2021-07-20,21552,22441,-889,-3.96,1189
2021-07-21,21552,22455,-903,-4.02,1189
2021-07-22,21552,22466,-914,-4.07,1189
2021-07-23,21073,22210,-1137,-5.12,1189
2021-07-24,15165,16311,-1146,-7.03,1189
2021-07-25,11256,11492,-236,-2.05,1189
2021-07-26,21363,22353,-990,-4.43,1189
2021-07-27,21552,22430,-878,-3.91,1189
2021-07-28,21552,22419,-867,-3.87,1189
2021-07-29,21552,22400,-848,-3.79,1189
2021-07-30,21073,22111,-1038,-4.69,1189
2021-07-31,15165,16175,-1010,-6.24,1189
2021-08-01,10986,11318,-332,-2.93,1189
2021-08-02,20576,22139,-1563,-7.06,1189
2021-08-03,20733,22178,-1445,-6.52,1189
2021-08-04,20733,22130,-1397,-6.31,1189
2021-08-05,20733,22079,-1346,-6.1,1189
2021-08-06,20019,21761,-1742,-8.01,1189
2021-08-07,15028,15802,-774,-4.9,1189
2021-08-08,10986,10928,58,0.53,1189
2021-08-09,20576,21741,-1165,-5.36,1189
2021-08-10,20733,21779,-1046,-4.8,1189
2021-08-11,20733,21739,-1006,-4.63,1189
2021-08-12,20733,21704,-971,-4.47,1189
2021-08-13,20019,21412,-1393,-6.51,1189
2021-08-14,15028,15488,-460,-2.97,1189
2021-08-15,10986,10657,329,3.09,1189
2021-08-16,20576,21521,-945,-4.39,1189
2021-08-17,20733,21617,-884,-4.09,1189
2021-08-18,20733,21641,-908,-4.2,1189
2021-08-19,20733,21676,-943,-4.35,1189
2021-08-20,20019,21456,-1437,-6.7,1189
2021-08-21,15028,15608,-580,-3.72,1189
2021-08-22,10986,10854,132,1.22,1189
2021-08-23,20576,21794,-1218,-5.59,1189
2021-08-24,20733,21964,-1231,-5.6,1189
2021-08-25,20733,22059,-1326,-6.01,1189
2021-08-26,20733,22160,-1427,-6.44,1189
2021-08-27,20019,22000,-1981,-9.0,1189
2021-08-28,15028,16205,-1177,-7.26,1189
2021-08-29,10986,11496,-510,-4.44,1189
2021-08-30,20576,22472,-1896,-8.44,1189
2021-08-31,20733,22669,-1936,-8.54,1189
2021-09-01,22475,22781,-306,-1.34,1189
2021-09-02,22475,22889,-414,-1.81,1189
2021-09-03,22211,22727,-516,-2.27,1189
2021-09-04,17043,16919,124,0.73,1189
2021-09-05,12606,12188,418,3.43,1189
2021-09-06,22404,23134,-730,-3.16,1189
2021-09-07,22475,23293,-818,-3.51,1189
2021-09-08,22475,23361,-886,-3.79,1189
2021-09-09,22475,23420,-945,-4.04,1189
2021-09-10,22211,23203,-992,-4.28,1189
2021-09-11,17043,17339,-296,-1.71,1189
2021-09-12,12606,12549,57,0.45,1189
2021-09-13,22404,23436,-1032,-4.4,1189
2021-09-14,22475,23537,-1062,-4.51,1189
2021-09-15,22475,23548,-1073,-4.56,1189
2021-09-16,22475,23553,-1078,-4.58,1189
2021-09-17,22211,23287,-1076,-4.62,1189
2021-09-18,17043,17378,-335,-1.93,1189
2021-09-19,12606,12549,57,0.45,1189
2021-09-20,22404,23403,-999,-4.27,1189
2021-09-21,22475,23477,-1002,-4.27,1189
2021-09-22,22475,23469,-994,-4.24,1189
2021-09-23,22475,23460,-985,-4.2,1189
2021-09-24,22211,23187,-976,-4.21,1189
2021-09-25,17043,17276,-233,-1.35,1189
2021-09-26,12606,12451,155,1.24,1189
2021-09-27,22404,23313,-909,-3.9,1189
2021-09-28,22475,23399,-924,-3.95,1189
2021-09-29,22475,23406,-931,-3.98,1189
2021-09-30,22475,23415,-940,-4.01,1189
2021-10-01,22647,23161,-514,-2.22,1189
2021-10-02,16888,17271,-383,-2.22,1189
2021-10-03,12132,12465,-333,-2.67,1189
2021-10-04,21905,23346,-1441,-6.17,1189
2021-10-05,22404,23449,-1045,-4.46,1189
2021-10-06,22404,23471,-1067,-4.55,1189
2021-10-07,22404,23492,-1088,-4.63,1189
2021-10-08,22647,23247,-600,-2.58,1189
2021-10-09,16888,17361,-473,-2.72,1189
2021-10-10,12132,12558,-426,-3.39,1189
2021-10-11,21905,23437,-1532,-6.54,1189
2021-10-12,22404,23535,-1131,-4.81,1189
2021-10-13,22404,23549,-1145,-4.86,1189
2021-10-14,22404,23559,-1155,-4.9,1189
2021-10-15,22647,23302,-655,-2.81,1189
2021-10-16,16888,17402,-514,-2.95,1189
2021-10-17,12132,12584,-452,-3.59,1189
2021-10-18,21905,23448,-1543,-6.58,1189
2021-10-19,22404,23532,-1128,-4.79,1189
2021-10-20,22404,23533,-1129,-4.8,1189
2021-10-21,22404,23531,-1127,-4.79,1189
2021-10-22,22647,23264,-617,-2.65,1189
2021-10-23,16888,17357,-469,-2.7,1189
2021-10-24,12132,12534,-402,-3.21,1189
2021-10-25,21905,23398,-1493,-6.38,1189
2021-10-26,22404,23484,-1080,-4.6,1189
2021-10-27,22404,23490,-1086,-4.62,1189
2021-10-28,22404,23498,-1094,-4.66,1189
2021-10-29,22647,23242,-595,-2.56,1189
2021-10-30,16888,17350,-462,-2.66,1189
2021-10-31,12132,12545,-413,-3.29,1189
2021-11-01,20555,23426,-2871,-12.26,1189
2021-11-02,21219,23532,-2313,-9.83,1189
2021-11-03,21219,23558,-2339,-9.93,1189
2021-11-04,21219,23585,-2366,-10.03,1189
2021-11-05,21696,23348,-1652,-7.08,1189
2021-11-06,16630,17472,-842,-4.82,1189
2021-11-07,11810,12680,-870,-6.86,1189
2021-11-08,20555,23572,-3017,-12.8,1189
2021-11-09,21219,23685,-2466,-10.41,1189
2021-11-10,21219,23714,-2495,-10.52,1189
2021-11-11,21219,23738,-2519,-10.61,1189
2021-11-12,21696,23495,-1799,-7.66,1189
2021-11-13,16630,17608,-978,-5.55,1189
2021-11-14,11810,12800,-990,-7.73,1189
2021-11-15,20555,23671,-3116,-13.16,1189
2021-11-16,21219,23759,-2540,-10.69,1189
2021-11-17,21219,23758,-2539,-10.69,1189
2021-11-18,21219,23751,-2532,-10.66,1189
2021-11-19,21696,23472,-1776,-7.57,1189
2021-11-20,16630,17549,-919,-5.24,1189
2021-11-21,11810,12703,-893,-7.03,1189
2021-11-22,20555,23536,-2981,-12.67,1189
2021-11-23,21219,23587,-2368,-10.04,1189
2021-11-24,21219,23551,-2332,-9.9,1189
2021-11-25,21219,23511,-2292,-9.75,1189
2021-11-26,21696,23202,-1506,-6.49,1189
2021-11-27,16630,17252,-622,-3.61,1189
2021-11-28,11810,12385,-575,-4.64,1189
2021-11-29,20555,23202,-2647,-11.41,1189
2021-11-30,21219,23241,-2022,-8.7,1189
2021-12-01,19463,23199,-3736,-16.1,1189
2021-12-02,19463,23159,-3696,-15.96,1189
2021-12-03,18637,22855,-4218,-18.46,1189
2021-12-04,14902,16916,-2014,-11.91,1189
2021-12-05,11089,12064,-975,-8.08,1189
2021-12-06,20324,22901,-2577,-11.25,1189
2021-12-07,19463,22963,-3500,-15.24,1189
2021-12-08,19463,22948,-3485,-15.19,1189
2021-12-09,19463,22936,-3473,-15.14,1189
2021-12-10,18637,22663,-4026,-17.76,1189
2021-12-11,14902,16754,-1852,-11.05,1189
2021-12-12,11089,11933,-844,-7.07,1189
2021-12-13,20324,22799,-2475,-10.86,1189
2021-12-14,19463,22888,-3425,-14.96,1189
2021-12-15,19463,22897,-3434,-15.0,1189
2021-12-16,19463,22906,-3443,-15.03,1189
2021-12-17,18637,22650,-4013,-17.72,1189
2021-12-18,14902,16753,-1851,-11.05,1189
2021-12-19,11089,11939,-850,-7.12,1189
2021-12-20,20324,22807,-2483,-10.89,1189
2021-12-21,19463,22894,-3431,-14.99,1189
2021-12-22,19463,22895,-3432,-14.99,1189
2021-12-23,19463,22892,-3429,-14.98,1189
2021-12-24,18637,22619,-3982,-17.6,1189
2021-12-25,14902,16702,-1800,-10.78,1189
2021-12-26,11089,11865,-776,-6.54,1189
2021-12-27,20324,22707,-2383,-10.49,1189
2021-12-28,19463,22768,-3305,-14.52,1189
2021-12-29,19463,22741,-3278,-14.41,1189
2021-12-30,19463,22711,-3248,-14.3,1189
2021-12-31,18637,22412,-3775,-16.84,1189
2022-01-01,15419,16471,-1052,-6.39,1189
2022-01-02,10373,11612,-1239,-10.67,1189
2022-01-03,19761,22437,-2676,-11.93,1189
2022-01-04,19761,22483,-2722,-12.11,1189
2022-01-05,19761,22448,-2687,-11.97,1189
2022-01-06,19761,22414,-2653,-11.84,1189
2022-01-07,20046,22116,-2070,-9.36,1189
2022-01-08,15419,16183,-764,-4.72,1189
2022-01-09,10373,11337,-964,-8.5,1189
2022-01-10,19761,22179,-2418,-10.9,1189
2022-01-11,19761,22249,-2488,-11.18,1189
2022-01-12,19761,22242,-2481,-11.15,1189
2022-01-13,19761,22239,-2478,-11.14,1189
2022-01-14,20046,21976,-1930,-8.78,1189
2022-01-15,15419,16080,-661,-4.11,1189
2022-01-16,10373,11274,-901,-7.99,1189
2022-01-17,19761,22157,-2396,-10.81,1189
2022-01-18,19761,22267,-2506,-11.25,1189
2022-01-19,19761,22300,-2539,-11.39,1189
2022-01-20,19761,22335,-2574,-11.52,1189
2022-01-21,20046,22109,-2063,-9.33,1189
2022-01-22,15419,16245,-826,-5.08,1189
2022-01-23,10373,11468,-1095,-9.55,1189
2022-01-24,19761,22376,-2615,-11.69,1189
2022-01-25,19761,22507,-2746,-12.2,1189
2022-01-26,19761,22556,-2795,-12.39,1189
2022-01-27,19761,22602,-2841,-12.57,1189
2022-01-28,20046,22382,-2336,-10.44,1189
2022-01-29,15419,16521,-1102,-6.67,1189
2022-01-30,10373,11741,-1368,-11.65,1189
2020-02-01,11156,10341,815,7.88,1190
2020-02-02,7068,6221,847,13.62,1190
2020-02-03,12022,12017,5,0.04,1190
2020-02-04,12277,12219,58,0.47,1190
2020-02-05,12277,12223,54,0.44,1190
2020-02-06,12277,12225,52,0.43,1190
2020-02-07,13186,12912,274,2.12,1190
2020-02-08,11156,10357,799,7.71,1190
2020-02-09,7068,6225,843,13.54,1190
2020-02-10,12022,12011,11,0.09,1190
2020-02-11,12277,12206,71,0.58,1190
2020-02-12,12277,12206,71,0.58,1190
2020-02-13,12277,12208,69,0.57,1190
2020-02-14,13186,12898,288,2.23,1190
2020-02-15,11156,10351,805,7.78,1190
2020-02-16,7068,6229,839,13.47,1190
2020-02-17,12022,12028,-6,-0.05,1190
2020-02-18,12277,12239,38,0.31,1190
2020-02-19,12277,12257,20,0.16,1190
2020-02-20,12277,12279,-2,-0.02,1190
2020-02-21,13186,12990,196,1.51,1190
2020-02-22,11156,10464,692,6.61,1190
2020-02-23,7068,6363,705,11.08,1190
2020-02-24,12022,12183,-161,-1.32,1190
2020-02-25,12277,12412,-135,-1.09,1190
2020-02-26,12277,12448,-171,-1.37,1190
2020-02-27,12277,12484,-207,-1.66,1190
2020-02-28,13186,13207,-21,-0.16,1190
2020-02-29,11156,10689,467,4.37,1190
2020-03-01,5098,6594,-1496,-22.69,1190
2020-03-02,8926,12415,-3489,-28.1,1190
2020-03-03,9159,12643,-3484,-27.56,1190
2020-03-04,9159,12673,-3514,-27.73,1190
2020-03-05,9159,12701,-3542,-27.89,1190
2020-03-06,10033,13413,-3380,-25.2,1190
2020-03-07,7394,10880,-3486,-32.04,1190
2020-03-08,5098,6768,-1670,-24.67,1190
2020-03-09,8926,12571,-3645,-29.0,1190
2020-03-10,9159,12779,-3620,-28.33,1190
2020-03-11,9159,12788,-3629,-28.38,1190
2020-03-12,9159,12795,-3636,-28.42,1190
2020-03-13,10033,13486,-3453,-25.6,1190
2020-03-14,7394,10934,-3540,-32.38,1190
2020-03-15,5098,6804,-1706,-25.07,1190
2020-03-16,8926,12590,-3664,-29.1,1190
2020-03-17,9159,12784,-3625,-28.36,1190
2020-03-18,9159,12783,-3624,-28.35,1190
2020-03-19,9159,12781,-3622,-28.34,1190
2020-03-20,10033,13467,-3434,-25.5,1190
2020-03-21,7394,10914,-3520,-32.25,1190
2020-03-22,5098,6785,-1687,-24.86,1190
2020-03-23,8926,12576,-3650,-29.02,1190
2020-03-24,9159,12777,-3618,-28.32,1190
2020-03-25,9159,12785,-3626,-28.36,1190
2020-03-26,9159,12795,-3636,-28.42,1190
2020-03-27,10033,13495,-3462,-25.65,1190
2020-03-28,7394,10956,-3562,-32.51,1190
2020-03-29,5098,6843,-1745,-25.5,1190
2020-03-30,8926,12650,-3724,-29.44,1190
2020-03-31,9159,12866,-3707,-28.81,1190
2020-04-01,8513,12889,-4376,-33.95,1190
2020-04-02,8513,12912,-4399,-34.07,1190
2020-04-03,8308,13624,-5316,-39.02,1190
2020-04-04,6605,11094,-4489,-40.46,1190
2020-04-05,3978,6987,-3009,-43.07,1190
2020-04-06,8482,12798,-4316,-33.72,1190
2020-04-07,8513,13017,-4504,-34.6,1190
2020-04-08,8513,13037,-4524,-34.7,1190
2020-04-09,8513,13057,-4544,-34.8,1190
2020-04-10,8308,13761,-5453,-39.63,1190
2020-04-11,6605,11221,-4616,-41.14,1190
2020-04-12,3978,7102,-3124,-43.99,1190
2020-04-13,8482,12899,-4417,-34.24,1190
2020-04-14,8513,13101,-4588,-35.02,1190
2020-04-15,8513,13105,-4592,-35.04,1190
2020-04-16,8513,13107,-4594,-35.05,1190
2020-04-17,8308,13793,-5485,-39.77,1190
2020-04-18,6605,11236,-4631,-41.22,1190
2020-04-19,3978,7100,-3122,-43.97,1190
2020-04-20,8482,12881,-4399,-34.15,1190
2020-04-21,8513,13069,-4556,-34.86,1190
2020-04-22,8513,13060,-4547,-34.82,1190
2020-04-23,8513,13051,-4538,-34.77,1190
2020-04-24,8308,13730,-5422,-39.49,1190
2020-04-25,6605,11167,-4562,-40.85,1190
2020-04-26,3978,7028,-3050,-43.4,1190
2020-04-27,8482,12809,-4327,-33.78,1190
2020-04-28,8513,12999,-4486,-34.51,1190
2020-04-29,8513,12995,-4482,-34.49,1190
2020-04-30,8513,12993,-4480,-34.48,1190
2020-05-01,12968,13679,-711,-5.2,1190
2020-05-02,10685,11125,-440,-3.96,1190
2020-05-03,6389,6997,-608,-8.69,1190
2020-05-04,12178,12788,-610,-4.77,1190
2020-05-05,12445,12988,-543,-4.18,1190
2020-05-06,12445,12994,-549,-4.23,1190
2020-05-07,12445,13001,-556,-4.28,1190
2020-05-08,12968,13695,-727,-5.31,1190
2020-05-09,10685,11148,-463,-4.15,1190
2020-05-10,6389,7023,-634,-9.03,1190
2020-05-11,12178,12817,-639,-4.99,1190
2020-05-12,12445,13018,-573,-4.4,1190
2020-05-13,12445,13022,-577,-4.43,1190
2020-05-14,12445,13024,-579,-4.45,1190
2020-05-15,12968,13712,-744,-5.43,1190
2020-05-16,10685,11157,-472,-4.23,1190
2020-05-17,6389,7023,-634,-9.03,1190
2020-05-18,12178,12806,-628,-4.9,1190
2020-05-19,12445,12994,-549,-4.23,1190
2020-05-20,12445,12985,-540,-4.16,1190
2020-05-21,12445,12975,-530,-4.08,1190
2020-05-22,12968,13650,-682,-5.0,1190
2020-05-23,10685,11083,-398,-3.59,1190
2020-05-24,6389,6938,-549,-7.91,1190
2020-05-25,12178,12711,-533,-4.19,1190
2020-05-26,12445,12892,-447,-3.47,1190
2020-05-27,12445,12878,-433,-3.36,1190
2020-05-28,12445,12864,-419,-3.26,1190
2020-05-29,12968,13539,-571,-4.22,1190
2020-05-30,10685,10974,-289,-2.63,1190
2020-05-31,6389,6833,-444,-6.5,1190
2020-06-01,12978,12613,365,2.89,1190
2020-06-02,13445,12803,642,5.01,1190
2020-06-03,13445,12800,645,5.04,1190
2020-06-04,13445,12799,646,5.05,1190
2020-06-05,13372,13487,-115,-0.85,1190
2020-06-06,11123,10936,187,1.71,1190
2020-06-07,7101,6809,292,4.29,1190
2020-06-08,12978,12603,375,2.98,1190
2020-06-09,13445,12805,640,5.0,1190
2020-06-10,13445,12813,632,4.93,1190
2020-06-11,13445,12821,624,4.87,1190
2020-06-12,13372,13515,-143,-1.06,1190
2020-06-13,11123,10967,156,1.42,1190
2020-06-14,7101,6840,261,3.82,1190
2020-06-15,12978,12629,349,2.76,1190
2020-06-16,13445,12824,621,4.84,1190
2020-06-17,13445,12819,626,4.88,1190
2020-06-18,13445,12811,634,4.95,1190
2020-06-19,13372,13486,-114,-0.85,1190
2020-06-20,11123,10915,208,1.91,1190
2020-06-21,7101,6762,339,5.01,1190
2020-06-22,12978,12523,455,3.63,1190
2020-06-23,13445,12687,758,5.97,1190
2020-06-24,13445,12651,794,6.28,1190
2020-06-25,13445,12610,835,6.62,1190
2020-06-26,13372,13252,120,0.91,1190
2020-06-27,11123,10649,474,4.45,1190
2020-06-28,7101,6465,636,9.84,1190
2020-06-29,12978,12198,780,6.39,1190
2020-06-30,13445,12337,1108,8.98,1190
2020-07-01,13071,12279,792,6.45,1190
2020-07-02,13071,12221,850,6.96,1190
2020-07-03,13469,12850,619,4.82,1190
2020-07-04,11031,10240,791,7.72,1190
2020-07-05,7626,6054,1572,25.97,1190
2020-07-06,12577,11790,787,6.68,1190
2020-07-07,13071,11938,1133,9.49,1190
2020-07-08,13071,11894,1177,9.9,1190
2020-07-09,13071,11855,1216,10.26,1190
2020-07-10,13469,12508,961,7.68,1190
2020-07-11,11031,9926,1105,11.13,1190
2020-07-12,7626,5772,1854,32.12,1190
2020-07-13,12577,11543,1034,8.96,1190
2020-07-14,13071,11727,1344,11.46,1190
2020-07-15,13071,11721,1350,11.52,1190
2020-07-16,13071,11721,1350,11.52,1190
2020-07-17,13469,12413,1056,8.51,1190
2020-07-18,11031,9868,1163,11.79,1190
2020-07-19,7626,5749,1877,32.65,1190
2020-07-20,12577,11553,1024,8.86,1190
2020-07-21,13071,11767,1304,11.08,1190
2020-07-22,13071,11787,1284,10.89,1190
2020-07-23,13071,11808,1263,10.7,1190
2020-07-24,13469,12517,952,7.61,1190
2020-07-25,11031,9984,1047,10.49,1190
2020-07-26,7626,5873,1753,29.85,1190
2020-07-27,12577,11678,899,7.7,1190
2020-07-28,13071,11889,1182,9.94,1190
2020-07-29,13071,11902,1169,9.82,1190
2020-07-30,13071,11913,1158,9.72,1190
2020-07-31,13469,12606,863,6.85,1190
2020-08-01,11301,10056,1245,12.38,1190
2020-08-02,7711,5925,1786,30.14,1190
2020-08-03,12588,11709,879,7.51,1190
2020-08-04,12550,11898,652,5.48,1190
2020-08-05,12550,11889,661,5.56,1190
2020-08-06,12550,11878,672,5.66,1190
2020-08-07,13089,12553,536,4.27,1190
2020-08-08,11301,9985,1316,13.18,1190
2020-08-09,7711,5840,1871,32.04,1190
2020-08-10,12588,11613,975,8.4,1190
2020-08-11,12550,11796,754,6.39,1190
2020-08-12,12550,11784,766,6.5,1190
2020-08-13,12550,11775,775,6.58,1190
2020-08-14,13089,12456,633,5.08,1190
2020-08-15,11301,9899,1402,14.16,1190
2020-08-16,7711,5769,1942,33.66,1190
2020-08-17,12588,11561,1027,8.88,1190
2020-08-18,12550,11767,783,6.65,1190
2020-08-19,12550,11781,769,6.53,1190
2020-08-20,12550,11800,750,6.36,1190
2020-08-21,13089,12510,579,4.63,1190
2020-08-22,11301,9985,1316,13.18,1190
2020-08-23,7711,5886,1825,31.01,1190
2020-08-24,12588,11710,878,7.5,1190
2020-08-25,12550,11945,605,5.06,1190
2020-08-26,12550,11987,563,4.7,1190
2020-08-27,12550,12032,518,4.31,1190
2020-08-28,13089,12765,324,2.54,1190
2020-08-29,11301,10259,1042,10.16,1190
2020-08-30,7711,6175,1536,24.87,1190
2020-08-31,12588,12010,578,4.81,1190
2020-09-01,13522,12251,1271,10.37,1190
2020-09-02,13522,12296,1226,9.97,1190
2020-09-03,13522,12338,1184,9.6,1190
2020-09-04,13764,13065,699,5.35,1190
2020-09-05,11674,10547,1127,10.69,1190
2020-09-06,7782,6449,1333,20.67,1190
2020-09-07,13080,12266,814,6.64,1190
2020-09-08,13522,12487,1035,8.29,1190
2020-09-09,13522,12508,1014,8.11,1190
2020-09-10,13522,12526,996,7.95,1190
2020-09-11,13764,13227,537,4.06,1190
2020-09-12,11674,10683,991,9.28,1190
2020-09-13,7782,6560,1222,18.63,1190
2020-09-14,13080,12352,728,5.89,1190
2020-09-15,13522,12550,972,7.75,1190
2020-09-16,13522,12550,972,7.75,1190
2020-09-17,13522,12549,973,7.75,1190
2020-09-18,13764,13234,530,4.0,1190
2020-09-19,11674,10677,997,9.34,1190
2020-09-20,7782,6544,1238,18.92,1190
2020-09-21,13080,12329,751,6.09,1190
2020-09-22,13522,12523,999,7.98,1190
2020-09-23,13522,12523,999,7.98,1190
2020-09-24,13522,12524,998,7.97,1190
2020-09-25,13764,13214,550,4.16,1190
2020-09-26,11674,10664,1010,9.47,1190
2020-09-27,7782,6539,1243,19.01,1190
2020-09-28,13080,12335,745,6.04,1190
2020-09-29,13522,12540,982,7.83,1190
2020-09-30,13522,12550,972,7.75,1190
2020-10-01,13272,12563,709,5.64,1190
2020-10-02,13862,13263,599,4.52,1190
2020-10-03,11816,10723,1093,10.19,1190
2020-10-04,7544,6606,938,14.2,1190
2020-10-05,13013,12408,605,4.88,1190
2020-10-06,13272,12618,654,5.18,1190
2020-10-07,13272,12631,641,5.07,1190
2020-10-08,13272,12644,628,4.97,1190
2020-10-09,13862,13342,520,3.9,1190
2020-10-10,11816,10798,1018,9.43,1190
2020-10-11,7544,6675,869,13.02,1190
2020-10-12,13013,12469,544,4.36,1190
2020-10-13,13272,12670,602,4.75,1190
2020-10-14,13272,12673,599,4.73,1190
2020-10-15,13272,12674,598,4.72,1190
2020-10-16,13862,13361,501,3.75,1190
2020-10-17,11816,10805,1011,9.36,1190
2020-10-18,7544,6671,873,13.09,1190
2020-10-19,13013,12454,559,4.49,1190
2020-10-20,13272,12645,627,4.96,1190
2020-10-21,13272,12640,632,5.0,1190
2020-10-22,13272,12635,637,5.04,1190
2020-10-23,13862,13317,545,4.09,1190
2020-10-24,11816,10759,1057,9.82,1190
2020-10-25,7544,6624,920,13.89,1190
2020-10-26,13013,12409,604,4.87,1190
2020-10-27,13272,12604,668,5.3,1190
2020-10-28,13272,12604,668,5.3,1190
2020-10-29,13272,12606,666,5.28,1190
2020-10-30,13862,13296,566,4.26,1190
2020-10-31,11816,10747,1069,9.95,1190
2020-11-01,6090,6622,-532,-8.03,1190
2020-11-02,11568,12417,-849,-6.84,1190
2020-11-03,10639,12622,-1983,-15.71,1190
2020-11-04,10639,12632,-1993,-15.78,1190
2020-11-05,10639,12642,-2003,-15.84,1190
2020-11-06,11432,13340,-1908,-14.3,1190
2020-11-07,9346,10797,-1451,-13.44,1190
2020-11-08,6090,6677,-587,-8.79,1190
2020-11-09,11568,12474,-906,-7.26,1190
2020-11-10,10639,12678,-2039,-16.08,1190
2020-11-11,10639,12686,-2047,-16.14,1190
2020-11-12,10639,12692,-2053,-16.18,1190
2020-11-13,11432,13384,-1952,-14.58,1190
2020-11-14,9346,10832,-1486,-13.72,1190
2020-11-15,6090,6702,-612,-9.13,1190
2020-11-16,11568,12487,-919,-7.36,1190
2020-11-17,10639,12679,-2040,-16.09,1190
2020-11-18,10639,12674,-2035,-16.06,1190
2020-11-19,10639,12666,-2027,-16.0,1190
2020-11-20,11432,13345,-1913,-14.33,1190
2020-11-21,9346,10780,-1434,-13.3,1190
2020-11-22,6090,6638,-548,-8.26,1190
2020-11-23,11568,12414,-846,-6.81,1190
2020-11-24,10639,12598,-1959,-15.55,1190
2020-11-25,10639,12586,-1947,-15.47,1190
2020-11-26,10639,12575,-1936,-15.4,1190
2020-11-27,11432,13252,-1820,-13.73,1190
2020-11-28,9346,10689,-1343,-12.56,1190
2020-11-29,6090,6551,-461,-7.04,1190
2020-11-30,11568,12334,-766,-6.21,1190
2020-12-01,11515,12526,-1011,-8.07,1190
2020-12-02,11515,12526,-1011,-8.07,1190
2020-12-03,11515,12527,-1012,-8.08,1190
2020-12-04,12622,13218,-596,-4.51,1190
2020-12-05,10414,10670,-256,-2.4,1190
2020-12-06,6225,6547,-322,-4.92,1190
2020-12-07,12028,12344,-316,-2.56,1190
2020-12-08,11515,12551,-1036,-8.25,1190
2020-12-09,11515,12562,-1047,-8.33,1190
2020-12-10,11515,12574,-1059,-8.42,1190
2020-12-11,12622,13272,-650,-4.9,1190
2020-12-12,10414,10728,-314,-2.93,1190
2020-12-13,6225,6606,-381,-5.77,1190
2020-12-14,12028,12400,-372,-3.0,1190
2020-12-15,11515,12599,-1084,-8.6,1190
2020-12-16,11515,12600,-1085,-8.61,1190
2020-12-17,11515,12596,-1081,-8.58,1190
2020-12-18,12622,13275,-653,-4.92,1190
2020-12-19,10414,10708,-294,-2.75,1190
2020-12-20,6225,6558,-333,-5.08,1190
2020-12-21,12028,12322,-294,-2.39,1190
2020-12-22,11515,12489,-974,-7.8,1190
2020-12-23,11515,12454,-939,-7.54,1190
2020-12-24,11515,12414,-899,-7.24,1190
2020-12-25,12622,13056,-434,-3.32,1190
2020-12-26,10414,10453,-39,-0.37,1190
2020-12-27,6225,6268,-43,-0.69,1190
2020-12-28,12028,11998,30,0.25,1190
2020-12-29,11515,12134,-619,-5.1,1190
2020-12-30,11515,12071,-556,-4.61,1190
2020-12-31,11515,12008,-493,-4.11,1190
2021-01-01,10796,12631,-1835,-14.53,1190
2021-01-02,8059,10014,-1955,-19.52,1190
2021-01-03,5392,5820,-428,-7.35,1190
2021-01-04,9714,11548,-1834,-15.88,1190
2021-01-05,10144,11686,-1542,-13.2,1190
2021-01-06,10144,11633,-1489,-12.8,1190
2021-01-07,10144,11584,-1440,-12.43,1190
2021-01-08,10796,12228,-1432,-11.71,1190
2021-01-09,8059,9636,-1577,-16.37,1190
2021-01-10,5392,5472,-80,-1.46,1190
2021-01-11,9714,11234,-1520,-13.53,1190
2021-01-12,10144,11410,-1266,-11.1,1190
2021-01-13,10144,11396,-1252,-10.99,1190
2021-01-14,10144,11389,-1245,-10.93,1190
2021-01-15,10796,12075,-1279,-10.59,1190
2021-01-16,8059,9525,-1466,-15.39,1190
2021-01-17,5392,5404,-12,-0.22,1190
2021-01-18,9714,11205,-1491,-13.31,1190
2021-01-19,10144,11419,-1275,-11.17,1190
2021-01-20,10144,11440,-1296,-11.33,1190
2021-01-21,10144,11464,-1320,-11.51,1190
2021-01-22,10796,12176,-1380,-11.33,1190
2021-01-23,8059,9649,-1590,-16.48,1190
2021-01-24,5392,5545,-153,-2.76,1190
2021-01-25,9714,11360,-1646,-14.49,1190
2021-01-26,10144,11581,-1437,-12.41,1190
2021-01-27,10144,11605,-1461,-12.59,1190
2021-01-28,10144,11628,-1484,-12.76,1190
2021-01-29,10796,12335,-1539,-12.48,1190
2021-01-30,8059,9799,-1740,-17.76,1190
2021-01-31,5392,5682,-290,-5.1,1190
2021-02-01,11636,11482,154,1.34,1190
2021-02-02,11799,11687,112,0.96,1190
2021-02-03,11799,11693,106,0.91,1190
2021-02-04,11799,11698,101,0.86,1190
2021-02-05,12518,12387,131,1.06,1190
2021-02-06,10442,9833,609,6.19,1190
2021-02-07,6453,5702,751,13.17,1190
2021-02-08,11636,11488,148,1.29,1190
2021-02-09,11799,11682,117,1.0,1190
2021-02-10,11799,11681,118,1.01,1190
2021-02-11,11799,11681,118,1.01,1190
2021-02-12,12518,12370,148,1.2,1190
2021-02-13,10442,9819,623,6.34,1190
2021-02-14,6453,5694,759,13.33,1190
2021-02-15,11636,11489,147,1.28,1190
2021-02-16,11799,11696,103,0.88,1190
2021-02-17,11799,11710,89,0.76,1190
2021-02-18,11799,11728,71,0.61,1190
2021-02-19,12518,12436,82,0.66,1190
2021-02-20,10442,9906,536,5.41,1190
2021-02-21,6453,5801,652,11.24,1190
2021-02-22,11636,11618,18,0.15,1190
2021-02-23,11799,11846,-47,-0.4,1190
2021-02-24,11799,11879,-80,-0.67,1190
2021-02-25,11799,11914,-115,-0.97,1190
2021-02-26,12518,12637,-119,-0.94,1190
2021-02-27,10442,10120,322,3.18,1190
2021-02-28,6453,6025,428,7.1,1190
2021-03-01,12343,11848,495,4.18,1190
2021-03-02,12484,12078,406,3.36,1190
2021-03-03,12484,12111,373,3.08,1190
2021-03-04,12484,12142,342,2.82,1190
2021-03-05,12982,12857,125,0.97,1190
2021-03-06,11062,10328,734,7.11,1190
2021-03-07,6576,6220,356,5.72,1190
2021-03-08,12343,12027,316,2.63,1190
2021-03-09,12484,12239,245,2.0,1190
2021-03-10,12484,12252,232,1.89,1190
2021-03-11,12484,12262,222,1.81,1190
2021-03-12,12982,12956,26,0.2,1190
2021-03-13,11062,10407,655,6.29,1190
2021-03-14,6576,6278,298,4.75,1190
2021-03-15,12343,12067,276,2.29,1190
2021-03-16,12484,12262,222,1.81,1190
2021-03-17,12484,12260,224,1.83,1190
2021-03-18,12484,12259,225,1.84,1190
2021-03-19,12982,12944,38,0.29,1190
2021-03-20,11062,10389,673,6.48,1190
2021-03-21,6576,6258,318,5.08,1190
2021-03-22,12343,12047,296,2.46,1190
2021-03-23,12484,12246,238,1.94,1190
2021-03-24,12484,12251,233,1.9,1190
2021-03-25,12484,12259,225,1.84,1190
2021-03-26,12982,12955,27,0.21,1190
2021-03-27,11062,10413,649,6.23,1190
2021-03-28,6576,6297,279,4.43,1190
2021-03-29,12343,12101,242,2.0,1190
2021-03-30,12484,12316,168,1.36,1190
2021-03-31,12484,12336,148,1.2,1190
2021-04-01,11319,12359,-1040,-8.41,1190
2021-04-02,11984,13069,-1085,-8.3,1190
2021-04-03,9454,10539,-1085,-10.3,1190
2021-04-04,6433,6433,0,0.0,1190
2021-04-05,11369,12245,-876,-7.15,1190
2021-04-06,11319,12464,-1145,-9.19,1190
2021-04-07,11319,12487,-1168,-9.35,1190
2021-04-08,11319,12508,-1189,-9.51,1190
2021-04-09,11984,13215,-1231,-9.32,1190
2021-04-10,9454,10678,-1224,-11.46,1190
2021-04-11,6433,6562,-129,-1.97,1190
2021-04-12,11369,12363,-994,-8.04,1190
2021-04-13,11319,12568,-1249,-9.94,1190
2021-04-14,11319,12575,-1256,-9.99,1190
2021-04-15,11319,12580,-1261,-10.02,1190
2021-04-16,11984,13269,-1285,-9.68,1190
2021-04-17,9454,10715,-1261,-11.77,1190
2021-04-18,6433,6581,-148,-2.25,1190
2021-04-19,11369,12364,-995,-8.05,1190
2021-04-20,11319,12554,-1235,-9.84,1190
2021-04-21,11319,12546,-1227,-9.78,1190
2021-04-22,11319,12538,-1219,-9.72,1190
2021-04-23,11984,13216,-1232,-9.32,1190
2021-04-24,9454,10653,-1199,-11.26,1190
2021-04-25,6433,6514,-81,-1.24,1190
2021-04-26,11369,12293,-924,-7.52,1190
2021-04-27,11319,12482,-1163,-9.32,1190
2021-04-28,11319,12476,-1157,-9.27,1190
2021-04-29,11319,12472,-1153,-9.24,1190
2021-04-30,11984,13156,-1172,-8.91,1190
2021-05-01,12137,10600,1537,14.5,1190
2021-05-02,7248,6470,778,12.02,1190
2021-05-03,13703,12259,1444,11.78,1190
2021-05-04,13966,12458,1508,12.1,1190
2021-05-05,13966,12462,1504,12.07,1190
2021-05-06,13966,12468,1498,12.01,1190
2021-05-07,14438,13162,1276,9.69,1190
2021-05-08,12137,10615,1522,14.34,1190
2021-05-09,7248,6491,757,11.66,1190
2021-05-10,13703,12285,1418,11.54,1190
2021-05-11,13966,12487,1479,11.84,1190
2021-05-12,13966,12492,1474,11.8,1190
2021-05-13,13966,12497,1469,11.75,1190
2021-05-14,14438,13187,1251,9.49,1190
2021-05-15,12137,10634,1503,14.13,1190
2021-05-16,7248,6502,746,11.47,1190
2021-05-17,13703,12287,1416,11.52,1190
2021-05-18,13966,12478,1488,11.92,1190
2021-05-19,13966,12472,1494,11.98,1190
2021-05-20,13966,12463,1503,12.06,1190
2021-05-21,14438,13140,1298,9.88,1190
2021-05-22,12137,10575,1562,14.77,1190
2021-05-23,7248,6431,817,12.7,1190
2021-05-24,13703,12205,1498,12.27,1190
2021-05-25,13966,12386,1580,12.76,1190
2021-05-26,13966,12371,1595,12.89,1190
2021-05-27,13966,12357,1609,13.02,1190
2021-05-28,14438,13030,1408,10.81,1190
2021-05-29,12137,10463,1674,16.0,1190
2021-05-30,7248,6321,927,14.67,1190
2021-05-31,13703,12099,1604,13.26,1190
2021-06-01,14037,12286,1751,14.25,1190
2021-06-02,14037,12280,1757,14.31,1190
2021-06-03,14037,12276,1761,14.35,1190
2021-06-04,14723,12962,1761,13.59,1190
2021-06-05,11949,10408,1541,14.81,1190
2021-06-06,8223,6279,1944,30.96,1190
2021-06-07,13643,12071,1572,13.02,1190
2021-06-08,14037,12272,1765,14.38,1190
2021-06-09,14037,12279,1758,14.32,1190
2021-06-10,14037,12287,1750,14.24,1190
2021-06-11,14723,12981,1742,13.42,1190
2021-06-12,11949,10435,1514,14.51,1190
2021-06-13,8223,6310,1913,30.32,1190
2021-06-14,13643,12102,1541,12.73,1190
2021-06-15,14037,12300,1737,14.12,1190
2021-06-16,14037,12300,1737,14.12,1190
2021-06-17,14037,12297,1740,14.15,1190
2021-06-18,14723,12976,1747,13.46,1190
2021-06-19,11949,10411,1538,14.77,1190
2021-06-20,8223,6264,1959,31.27,1190
2021-06-21,13643,12031,1612,13.4,1190
2021-06-22,14037,12201,1836,15.05,1190
2021-06-23,14037,12171,1866,15.33,1190
2021-06-24,14037,12136,1901,15.66,1190
2021-06-25,14723,12783,1940,15.18,1190
2021-06-26,11949,10185,1764,17.32,1190
2021-06-27,8223,6006,2217,36.91,1190
2021-06-28,13643,11742,1901,16.19,1190
2021-06-29,14037,11883,2154,18.13,1190
2021-06-30,14037,11827,2210,18.69,1190
2021-07-01,13583,11769,1814,15.41,1190
2021-07-02,14037,12398,1639,13.22,1190
2021-07-03,11944,9786,2158,22.05,1190
2021-07-04,8188,5598,2590,46.27,1190
2021-07-05,12863,11331,1532,13.52,1190
2021-07-06,13583,11474,2109,18.38,1190
2021-07-07,13583,11425,2158,18.89,1190
2021-07-08,13583,11380,2203,19.36,1190
2021-07-09,14037,12027,2010,16.71,1190
2021-07-10,11944,9438,2506,26.55,1190
2021-07-11,8188,5277,2911,55.16,1190
2021-07-12,12863,11040,1823,16.51,1190
2021-07-13,13583,11217,2366,21.09,1190
2021-07-14,13583,11205,2378,21.22,1190
2021-07-15,13583,11198,2385,21.3,1190
2021-07-16,14037,11883,2154,18.13,1190
2021-07-17,11944,9333,2611,27.98,1190
2021-07-18,8188,5210,2978,57.16,1190
2021-07-19,12863,11009,1854,16.84,1190
2021-07-20,13583,11220,2363,21.06,1190
2021-07-21,13583,11238,2345,20.87,1190
2021-07-22,13583,11258,2325,20.65,1190
2021-07-23,14037,11966,2071,17.31,1190
2021-07-24,11944,9433,2511,26.62,1190
2021-07-25,8188,5323,2865,53.82,1190
2021-07-26,12863,11131,1732,15.56,1190
2021-07-27,13583,11345,2238,19.73,1190
2021-07-28,13583,11361,2222,19.56,1190
2021-07-29,13583,11375,2208,19.41,1190
2021-07-30,14037,12073,1964,16.27,1190
2021-07-31,11944,9527,2417,25.37,1190
2021-08-01,7883,5400,2483,45.98,1190
2021-08-02,12994,11188,1806,16.14,1190
2021-08-03,13066,11381,1685,14.81,1190
2021-08-04,13066,11376,1690,14.86,1190
2021-08-05,13066,11368,1698,14.94,1190
2021-08-06,13337,12044,1293,10.74,1190
2021-08-07,11194,9478,1716,18.11,1190
2021-08-08,7883,5333,2550,47.82,1190
2021-08-09,12994,11107,1887,16.99,1190
2021-08-10,13066,11288,1778,15.75,1190
2021-08-11,13066,11275,1791,15.88,1190
2021-08-12,13066,11263,1803,16.01,1190
2021-08-13,13337,11940,1397,11.7,1190
2021-08-14,11194,9379,1815,19.35,1190
2021-08-15,7883,5244,2639,50.32,1190
2021-08-16,12994,11031,1963,17.8,1190
2021-08-17,13066,11231,1835,16.34,1190
2021-08-18,13066,11239,1827,16.26,1190
2021-08-19,13066,11253,1813,16.11,1190
2021-08-20,13337,11957,1380,11.54,1190
2021-08-21,11194,9426,1768,18.76,1190
2021-08-22,7883,5322,2561,48.12,1190
2021-08-23,12994,11141,1853,16.63,1190
2021-08-24,13066,11371,1695,14.91,1190
2021-08-25,13066,11410,1656,14.51,1190
2021-08-26,13066,11452,1614,14.09,1190
2021-08-27,13337,12183,1154,9.47,1190
2021-08-28,11194,9675,1519,15.7,1190
2021-08-29,7883,5591,2292,40.99,1190
2021-08-30,12994,11426,1568,13.72,1190
2021-08-31,13066,11669,1397,11.97,1190
2021-09-01,13384,11716,1668,14.24,1190
2021-09-02,13384,11761,1623,13.8,1190
2021-09-03,13937,12491,1446,11.58,1190
2021-09-04,11786,9977,1809,18.13,1190
2021-09-05,8506,5883,2623,44.59,1190
2021-09-06,13104,11704,1400,11.96,1190
2021-09-07,13384,11930,1454,12.19,1190
2021-09-08,13384,11956,1428,11.94,1190
2021-09-09,13384,11979,1405,11.73,1190
2021-09-10,13937,12684,1253,9.88,1190
2021-09-11,11786,10145,1641,16.18,1190
2021-09-12,8506,6026,2480,41.15,1190
2021-09-13,13104,11821,1283,10.85,1190
2021-09-14,13384,12022,1362,11.33,1190
2021-09-15,13384,12025,1359,11.3,1190
2021-09-16,13384,12026,1358,11.29,1190
2021-09-17,13937,12712,1225,9.64,1190
2021-09-18,11786,10156,1630,16.05,1190
2021-09-19,8506,6022,2484,41.25,1190
2021-09-20,13104,11807,1297,10.99,1190
2021-09-21,13384,12001,1383,11.52,1190
2021-09-22,13384,11999,1385,11.54,1190
2021-09-23,13384,11998,1386,11.55,1190
2021-09-24,13937,12686,1251,9.86,1190
2021-09-25,11786,10135,1651,16.29,1190
2021-09-26,8506,6007,2499,41.6,1190
2021-09-27,13104,11801,1303,11.04,1190
2021-09-28,13384,12004,1380,11.5,1190
2021-09-29,13384,12013,1371,11.41,1190
2021-09-30,13384,12023,1361,11.32,1190
2021-10-01,12883,12722,161,1.27,1190
2021-10-02,11845,10181,1664,16.34,1190
2021-10-03,7634,6064,1570,25.89,1190
2021-10-04,12032,11866,166,1.4,1190
2021-10-05,12356,12076,280,2.32,1190
2021-10-06,12356,12090,266,2.2,1190
2021-10-07,12356,12104,252,2.08,1190
2021-10-08,12883,12803,80,0.62,1190
2021-10-09,11845,10261,1584,15.44,1190
2021-10-10,7634,6140,1494,24.33,1190
2021-10-11,12032,11936,96,0.8,1190
2021-10-12,12356,12139,217,1.79,1190
2021-10-13,12356,12144,212,1.75,1190
2021-10-14,12356,12148,208,1.71,1190
2021-10-15,12883,12837,46,0.36,1190
2021-10-16,11845,10283,1562,15.19,1190
2021-10-17,7634,6150,1484,24.13,1190
2021-10-18,12032,11935,97,0.81,1190
2021-10-19,12356,12127,229,1.89,1190
2021-10-20,12356,12122,234,1.93,1190
2021-10-21,12356,12117,239,1.97,1190
2021-10-22,12883,12799,84,0.66,1190
2021-10-23,11845,10240,1605,15.67,1190
2021-10-24,7634,6104,1530,25.07,1190
2021-10-25,12032,11888,144,1.21,1190
2021-10-26,12356,12081,275,2.28,1190
2021-10-27,12356,12079,277,2.29,1190
2021-10-28,12356,12079,277,2.29,1190
2021-10-29,12883,12768,115,0.9,1190
2021-10-30,11845,10217,1628,15.93,1190
2021-10-31,7634,6090,1544,25.35,1190
2021-11-01,10918,11884,-966,-8.13,1190
2021-11-02,11519,12087,-568,-4.7,1190
2021-11-03,11519,12095,-576,-4.76,1190
2021-11-04,11519,12105,-586,-4.84,1190
2021-11-05,12199,12802,-603,-4.71,1190
2021-11-06,10310,10259,51,0.5,1190
2021-11-07,7031,6139,892,14.53,1190
2021-11-08,10918,11937,-1019,-8.54,1190
2021-11-09,11519,12143,-624,-5.14,1190
2021-11-10,11519,12152,-633,-5.21,1190
2021-11-11,11519,12160,-641,-5.27,1190
2021-11-12,12199,12853,-654,-5.09,1190
2021-11-13,10310,10304,6,0.06,1190
2021-11-14,7031,6176,855,13.84,1190
2021-11-15,10918,11965,-1047,-8.75,1190
2021-11-16,11519,12159,-640,-5.26,1190
2021-11-17,11519,12156,-637,-5.24,1190
2021-11-18,11519,12151,-632,-5.2,1190
2021-11-19,12199,12831,-632,-4.93,1190
2021-11-20,10310,10269,41,0.4,1190
2021-11-21,7031,6128,903,14.74,1190
2021-11-22,10918,11904,-986,-8.28,1190
2021-11-23,11519,12088,-569,-4.71,1190
2021-11-24,11519,12076,-557,-4.61,1190
2021-11-25,11519,12065,-546,-4.53,1190
2021-11-26,12199,12740,-541,-4.25,1190
2021-11-27,10310,10176,134,1.32,1190
2021-11-28,7031,6036,995,16.48,1190
2021-11-29,10918,11816,-898,-7.6,1190
2021-11-30,11519,12006,-487,-4.06,1190
2021-12-01,11637,12003,-366,-3.05,1190
2021-12-02,11637,12001,-364,-3.03,1190
2021-12-03,11102,12689,-1587,-12.51,1190
2021-12-04,9621,10139,-518,-5.11,1190
2021-12-05,7051,6013,1038,17.26,1190
2021-12-06,12048,11808,240,2.03,1190
2021-12-07,11637,12013,-376,-3.13,1190
2021-12-08,11637,12023,-386,-3.21,1190
2021-12-09,11637,12035,-398,-3.31,1190
2021-12-10,11102,12733,-1631,-12.81,1190
2021-12-11,9621,10191,-570,-5.59,1190
2021-12-12,7051,6071,980,16.14,1190
2021-12-13,12048,11867,181,1.53,1190
2021-12-14,11637,12070,-433,-3.59,1190
2021-12-15,11637,12074,-437,-3.62,1190
2021-12-16,11637,12076,-439,-3.64,1190
2021-12-17,11102,12760,-1658,-12.99,1190
2021-12-18,9621,10199,-578,-5.67,1190
2021-12-19,7051,6056,995,16.43,1190
2021-12-20,12048,11827,221,1.87,1190
2021-12-21,11637,12000,-363,-3.02,1190
2021-12-22,11637,11972,-335,-2.8,1190
2021-12-23,11637,11939,-302,-2.53,1190
2021-12-24,11102,12587,-1485,-11.8,1190
2021-12-25,9621,9990,-369,-3.69,1190
2021-12-26,7051,5810,1241,21.36,1190
2021-12-27,12048,11545,503,4.36,1190
2021-12-28,11637,11684,-47,-0.4,1190
2021-12-29,11637,11625,12,0.1,1190
2021-12-30,11637,11563,74,0.64,1190
2021-12-31,11102,12187,-1085,-8.9,1190
2022-01-01,11144,9569,1575,16.46,1190
2022-01-02,7073,5374,1699,31.62,1190
2022-01-03,12017,11099,918,8.27,1190
2022-01-04,12088,11234,854,7.6,1190
2022-01-05,12088,11176,912,8.16,1190
2022-01-06,12088,11122,966,8.69,1190
2022-01-07,12914,11759,1155,9.82,1190
2022-01-08,11144,9160,1984,21.66,1190
2022-01-09,7073,4989,2084,41.77,1190
2022-01-10,12017,10743,1274,11.86,1190
2022-01-11,12088,10911,1177,10.79,1190
2022-01-12,12088,10890,1198,11.0,1190
2022-01-13,12088,10875,1213,11.15,1190
2022-01-14,12914,11553,1361,11.78,1190
2022-01-15,11144,8996,2148,23.88,1190
2022-01-16,7073,4868,2205,45.3,1190
2022-01-17,12017,10664,1353,12.69,1190
2022-01-18,12088,10873,1215,11.17,1190
2022-01-19,12088,10890,1198,11.0,1190
2022-01-20,12088,10910,1178,10.8,1190
2022-01-21,12914,11620,1294,11.14,1190
2022-01-22,11144,9092,2052,22.57,1190
2022-01-23,7073,4987,2086,41.83,1190
2022-01-24,12017,10802,1215,11.25,1190
2022-01-25,12088,11024,1064,9.65,1190
2022-01-26,12088,11050,1038,9.39,1190
2022-01-27,12088,11075,1013,9.15,1190
2022-01-28,12914,11785,1129,9.58,1190
2022-01-29,11144,9252,1892,20.45,1190
2022-01-30,7073,5139,1934,37.63,1190
2020-02-01,9870,9562,308,3.22,1194
2020-02-02,4019,3177,842,26.5,1194
2020-02-03,9723,10060,-337,-3.35,1194
2020-02-04,9894,10021,-127,-1.27,1194
2020-02-05,9894,10012,-118,-1.18,1194
2020-02-06,9894,10006,-112,-1.12,1194
2020-02-07,11085,11215,-130,-1.16,1194
2020-02-08,9870,9508,362,3.81,1194
2020-02-09,4019,3113,906,29.1,1194
2020-02-10,9723,9990,-267,-2.67,1194
2020-02-11,9894,9951,-57,-0.57,1194
2020-02-12,9894,9947,-53,-0.53,1194
2020-02-13,9894,9952,-58,-0.58,1194
2020-02-14,11085,11176,-91,-0.81,1194
2020-02-15,9870,9489,381,4.02,1194
2020-02-16,4019,3118,901,28.9,1194
2020-02-17,9723,10024,-301,-3.0,1194
2020-02-18,9894,10016,-122,-1.22,1194
2020-02-19,9894,10045,-151,-1.5,1194
2020-02-20,9894,10084,-190,-1.88,1194
2020-02-21,11085,11343,-258,-2.27,1194
2020-02-22,9870,9691,179,1.85,1194
2020-02-23,4019,3353,666,19.86,1194
2020-02-24,9723,10289,-566,-5.5,1194
2020-02-25,9894,10310,-416,-4.03,1194
2020-02-26,9894,10363,-469,-4.53,1194
2020-02-27,9894,10422,-528,-5.07,1194
2020-02-28,11085,11697,-612,-5.23,1194
2020-02-29,9870,10055,-185,-1.84,1194
2020-03-01,3031,3723,-692,-18.59,1194
2020-03-02,8172,10660,-2488,-23.34,1194
2020-03-03,8288,10675,-2387,-22.36,1194
2020-03-04,8288,10719,-2431,-22.68,1194
2020-03-05,8288,10763,-2475,-23.0,1194
2020-03-06,10856,12019,-1163,-9.68,1194
2020-03-07,8216,10356,-2140,-20.66,1194
2020-03-08,3031,3999,-968,-24.21,1194
2020-03-09,8172,10909,-2737,-25.09,1194
2020-03-10,8288,10896,-2608,-23.94,1194
2020-03-11,8288,10910,-2622,-24.03,1194
2020-03-12,8288,10926,-2638,-24.14,1194
2020-03-13,10856,12155,-1299,-10.69,1194
2020-03-14,8216,10465,-2249,-21.49,1194
2020-03-15,3031,4084,-1053,-25.78,1194
2020-03-16,8172,10973,-2801,-25.53,1194
2020-03-17,8288,10942,-2654,-24.26,1194
2020-03-18,8288,10942,-2654,-24.26,1194
2020-03-19,8288,10947,-2659,-24.29,1194
2020-03-20,10856,12170,-1314,-10.8,1194
2020-03-21,8216,10477,-2261,-21.58,1194
2020-03-22,3031,4098,-1067,-26.04,1194
2020-03-23,8172,10991,-2819,-25.65,1194
2020-03-24,8288,10968,-2680,-24.43,1194
2020-03-25,8288,10979,-2691,-24.51,1194
2020-03-26,8288,10997,-2709,-24.63,1194
2020-03-27,10856,12234,-1378,-11.26,1194
2020-03-28,8216,10557,-2341,-22.17,1194
2020-03-29,3031,4194,-1163,-27.73,1194
2020-03-30,8172,11103,-2931,-26.4,1194
2020-03-31,8288,11095,-2807,-25.3,1194
2020-04-01,8370,11119,-2749,-24.72,1194
2020-04-02,8370,11149,-2779,-24.93,1194
2020-04-03,9013,12395,-3382,-27.29,1194
2020-04-04,8263,10725,-2462,-22.96,1194
2020-04-05,2476,4365,-1889,-43.28,1194
2020-04-06,8315,11275,-2960,-26.25,1194
2020-04-07,8370,11264,-2894,-25.69,1194
2020-04-08,8370,11283,-2913,-25.82,1194
2020-04-09,8370,11305,-2935,-25.96,1194
2020-04-10,9013,12540,-3527,-28.13,1194
2020-04-11,8263,10857,-2594,-23.89,1194
2020-04-12,2476,4483,-2007,-44.77,1194
2020-04-13,8315,11377,-3062,-26.91,1194
2020-04-14,8370,11350,-2980,-26.26,1194
2020-04-15,8370,11353,-2983,-26.27,1194
2020-04-16,8370,11359,-2989,-26.31,1194
2020-04-17,9013,12579,-3566,-28.35,1194
2020-04-18,8263,10882,-2619,-24.07,1194
2020-04-19,2476,4496,-2020,-44.93,1194
2020-04-20,8315,11381,-3066,-26.94,1194
2020-04-21,8370,11348,-2978,-26.24,1194
2020-04-22,8370,11347,-2977,-26.24,1194
2020-04-23,8370,11352,-2982,-26.27,1194
2020-04-24,9013,12575,-3562,-28.33,1194
2020-04-25,8263,10884,-2621,-24.08,1194
2020-04-26,2476,4507,-2031,-45.06,1194
2020-04-27,8315,11402,-3087,-27.07,1194
2020-04-28,8370,11382,-3012,-26.46,1194
2020-04-29,8370,11396,-3026,-26.55,1194
2020-04-30,8370,11417,-3047,-26.69,1194
2020-05-01,11375,12656,-1281,-10.12,1194
2020-05-02,10629,10981,-352,-3.21,1194
2020-05-03,3772,4619,-847,-18.34,1194
2020-05-04,9900,11529,-1629,-14.13,1194
2020-05-05,10160,11521,-1361,-11.81,1194
2020-05-06,10160,11545,-1385,-12.0,1194
2020-05-07,10160,11574,-1414,-12.22,1194
2020-05-08,11375,12817,-1442,-11.25,1194
2020-05-09,10629,11143,-514,-4.61,1194
2020-05-10,3772,4778,-1006,-21.05,1194
2020-05-11,9900,11682,-1782,-15.25,1194
2020-05-12,10160,11665,-1505,-12.9,1194
2020-05-13,10160,11676,-1516,-12.98,1194
2020-05-14,10160,11688,-1528,-13.07,1194
2020-05-15,11375,12912,-1537,-11.9,1194
2020-05-16,10629,11217,-588,-5.24,1194
2020-05-17,3772,4829,-1057,-21.89,1194
2020-05-18,9900,11709,-1809,-15.45,1194
2020-05-19,10160,11666,-1506,-12.91,1194
2020-05-20,10160,11653,-1493,-12.81,1194
2020-05-21,10160,11641,-1481,-12.72,1194
2020-05-22,11375,12843,-1468,-11.43,1194
2020-05-23,10629,11128,-499,-4.48,1194
2020-05-24,3772,4722,-950,-20.12,1194
2020-05-25,9900,11588,-1688,-14.57,1194
2020-05-26,10160,11535,-1375,-11.92,1194
2020-05-27,10160,11515,-1355,-11.77,1194
2020-05-28,10160,11501,-1341,-11.66,1194
2020-05-29,11375,12705,-1330,-10.47,1194
2020-05-30,10629,10996,-367,-3.34,1194
2020-05-31,3772,4601,-829,-18.02,1194
2020-06-01,10406,11480,-1074,-9.36,1194
2020-06-02,10497,11443,-946,-8.27,1194
2020-06-03,10497,11442,-945,-8.26,1194
2020-06-04,10497,11448,-951,-8.31,1194
2020-06-05,11424,12673,-1249,-9.86,1194
2020-06-06,9990,10986,-996,-9.07,1194
2020-06-07,4300,4612,-312,-6.76,1194
2020-06-08,10406,11510,-1104,-9.59,1194
2020-06-09,10497,11491,-994,-8.65,1194
2020-06-10,10497,11504,-1007,-8.75,1194
2020-06-11,10497,11521,-1024,-8.89,1194
2020-06-12,11424,12753,-1329,-10.42,1194
2020-06-13,9990,11067,-1077,-9.73,1194
2020-06-14,4300,4689,-389,-8.3,1194
2020-06-15,10406,11578,-1172,-10.12,1194
2020-06-16,10497,11544,-1047,-9.07,1194
2020-06-17,10497,11537,-1040,-9.01,1194
2020-06-18,10497,11528,-1031,-8.94,1194
2020-06-19,11424,12729,-1305,-10.25,1194
2020-06-20,9990,11008,-1018,-9.25,1194
2020-06-21,4300,4591,-291,-6.34,1194
2020-06-22,10406,11438,-1032,-9.02,1194
2020-06-23,10497,11360,-863,-7.6,1194
2020-06-24,10497,11307,-810,-7.16,1194
2020-06-25,10497,11253,-756,-6.72,1194
2020-06-26,11424,12409,-985,-7.94,1194
2020-06-27,9990,10645,-655,-6.15,1194
2020-06-28,4300,4188,112,2.67,1194
2020-06-29,10406,10999,-593,-5.39,1194
2020-06-30,10497,10890,-393,-3.61,1194
2020-07-01,10050,10811,-761,-7.04,1194
2020-07-02,10050,10737,-687,-6.4,1194
2020-07-03,11229,11880,-651,-5.48,1194
2020-07-04,9469,10110,-641,-6.34,1194
2020-07-05,4419,3654,765,20.94,1194
2020-07-06,10073,10474,-401,-3.83,1194
2020-07-07,10050,10380,-330,-3.18,1194
2020-07-08,10050,10323,-273,-2.64,1194
2020-07-09,10050,10278,-228,-2.22,1194
2020-07-10,11229,11455,-226,-1.97,1194
2020-07-11,9469,9724,-255,-2.62,1194
2020-07-12,4419,3311,1108,33.46,1194
2020-07-13,10073,10176,-103,-1.01,1194
2020-07-14,10050,10130,-80,-0.79,1194
2020-07-15,10050,10122,-72,-0.71,1194
2020-07-16,10050,10125,-75,-0.74,1194
2020-07-17,11229,11349,-120,-1.06,1194
2020-07-18,9469,9663,-194,-2.01,1194
2020-07-19,4419,3291,1128,34.28,1194
2020-07-20,10073,10194,-121,-1.19,1194
2020-07-21,10050,10180,-130,-1.28,1194
2020-07-22,10050,10199,-149,-1.46,1194
2020-07-23,10050,10223,-173,-1.69,1194
2020-07-24,11229,11462,-233,-2.03,1194
2020-07-25,9469,9784,-315,-3.22,1194
2020-07-26,4419,3415,1004,29.4,1194
2020-07-27,10073,10314,-241,-2.34,1194
2020-07-28,10050,10291,-241,-2.34,1194
2020-07-29,10050,10296,-246,-2.39,1194
2020-07-30,10050,10301,-251,-2.44,1194
2020-07-31,11229,11518,-289,-2.51,1194
2020-08-01,9210,9815,-605,-6.16,1194
2020-08-02,4314,3419,895,26.18,1194
2020-08-03,10119,10291,-172,-1.67,1194
2020-08-04,9893,10240,-347,-3.39,1194
2020-08-05,9893,10219,-326,-3.19,1194
2020-08-06,9893,10199,-306,-3.0,1194
2020-08-07,11121,11395,-274,-2.4,1194
2020-08-08,9210,9674,-464,-4.8,1194
2020-08-09,4314,3265,1049,32.13,1194
2020-08-10,10119,10128,-9,-0.09,1194
2020-08-11,9893,10074,-181,-1.8,1194
2020-08-12,9893,10055,-162,-1.61,1194
2020-08-13,9893,10043,-150,-1.49,1194
2020-08-14,11121,11252,-131,-1.16,1194
2020-08-15,9210,9550,-340,-3.56,1194
2020-08-16,4314,3163,1151,36.39,1194
2020-08-17,10119,10054,65,0.65,1194
2020-08-18,9893,10031,-138,-1.38,1194
2020-08-19,9893,10046,-153,-1.52,1194
2020-08-20,9893,10070,-177,-1.76,1194
2020-08-21,11121,11316,-195,-1.72,1194
2020-08-22,9210,9651,-441,-4.57,1194
2020-08-23,4314,3302,1012,30.65,1194
2020-08-24,10119,10228,-109,-1.07,1194
2020-08-25,9893,10239,-346,-3.38,1194
2020-08-26,9893,10283,-390,-3.79,1194
2020-08-27,9893,10334,-441,-4.27,1194
2020-08-28,11121,11603,-482,-4.15,1194
2020-08-29,9210,9955,-745,-7.48,1194
2020-08-30,4314,3618,696,19.24,1194
2020-08-31,10119,10551,-432,-4.09,1194
2020-09-01,10557,10563,-6,-0.06,1194
2020-09-02,10557,10604,-47,-0.44,1194
2020-09-03,10557,10647,-90,-0.85,1194
2020-09-04,11741,11902,-161,-1.35,1194
2020-09-05,10660,10237,423,4.13,1194
2020-09-06,4691,3880,811,20.9,1194
2020-09-07,10842,10789,53,0.49,1194
2020-09-08,10557,10775,-218,-2.02,1194
2020-09-09,10557,10790,-233,-2.16,1194
2020-09-10,10557,10804,-247,-2.29,1194
2020-09-11,11741,12032,-291,-2.42,1194
2020-09-12,10660,10341,319,3.08,1194
2020-09-13,4691,3958,733,18.52,1194
2020-09-14,10842,10845,-3,-0.03,1194
2020-09-15,10557,10811,-254,-2.35,1194
2020-09-16,10557,10809,-252,-2.33,1194
2020-09-17,10557,10811,-254,-2.35,1194
2020-09-18,11741,12029,-288,-2.39,1194
2020-09-19,10660,10332,328,3.17,1194
2020-09-20,4691,3948,743,18.82,1194
2020-09-21,10842,10837,5,0.05,1194
2020-09-22,10557,10809,-252,-2.33,1194
2020-09-23,10557,10815,-258,-2.39,1194
2020-09-24,10557,10828,-271,-2.5,1194
2020-09-25,11741,12060,-319,-2.65,1194
2020-09-26,10660,10379,281,2.71,1194
2020-09-27,4691,4011,680,16.95,1194
2020-09-28,10842,10916,-74,-0.68,1194
2020-09-29,10557,10905,-348,-3.19,1194
2020-09-30,10557,10927,-370,-3.39,1194
2020-10-01,10509,10954,-445,-4.06,1194
2020-10-02,11740,12198,-458,-3.75,1194
2020-10-03,10656,10527,129,1.23,1194
2020-10-04,4145,4166,-21,-0.5,1194
2020-10-05,10555,11075,-520,-4.7,1194
2020-10-06,10509,11065,-556,-5.02,1194
2020-10-07,10509,11085,-576,-5.2,1194
2020-10-08,10509,11107,-598,-5.38,1194
2020-10-09,11740,12344,-604,-4.89,1194
2020-10-10,10656,10662,-6,-0.06,1194
2020-10-11,4145,4288,-143,-3.33,1194
2020-10-12,10555,11183,-628,-5.62,1194
2020-10-13,10509,11156,-647,-5.8,1194
2020-10-14,10509,11159,-650,-5.82,1194
2020-10-15,10509,11163,-654,-5.86,1194
2020-10-16,11740,12382,-642,-5.18,1194
2020-10-17,10656,10683,-27,-0.25,1194
2020-10-18,4145,4293,-148,-3.45,1194
2020-10-19,10555,11174,-619,-5.54,1194
2020-10-20,10509,11134,-625,-5.61,1194
2020-10-21,10509,11127,-618,-5.55,1194
2020-10-22,10509,11123,-614,-5.52,1194
2020-10-23,11740,12337,-597,-4.84,1194
2020-10-24,10656,10635,21,0.2,1194
2020-10-25,4145,4245,-100,-2.36,1194
2020-10-26,10555,11128,-573,-5.15,1194
2020-10-27,10509,11094,-585,-5.27,1194
2020-10-28,10509,11093,-584,-5.26,1194
2020-10-29,10509,11098,-589,-5.31,1194
2020-10-30,11740,12321,-581,-4.72,1194
2020-10-31,10656,10630,26,0.24,1194
2020-11-01,3269,4252,-983,-23.12,1194
2020-11-02,9911,11145,-1234,-11.07,1194
2020-11-03,8677,11122,-2445,-21.98,1194
2020-11-04,8677,11130,-2453,-22.04,1194
2020-11-05,8677,11144,-2467,-22.14,1194
2020-11-06,10627,12373,-1746,-14.11,1194
2020-11-07,9640,10687,-1047,-9.8,1194
2020-11-08,3269,4311,-1042,-24.17,1194
2020-11-09,9911,11205,-1294,-11.55,1194
2020-11-10,8677,11179,-2502,-22.38,1194
2020-11-11,8677,11184,-2507,-22.42,1194
2020-11-12,8677,11191,-2514,-22.46,1194
2020-11-13,10627,12413,-1786,-14.39,1194
2020-11-14,9640,10718,-1078,-10.06,1194
2020-11-15,3269,4332,-1063,-24.54,1194
2020-11-16,9911,11216,-1305,-11.64,1194
2020-11-17,8677,11180,-2503,-22.39,1194
2020-11-18,8677,11175,-2498,-22.35,1194
2020-11-19,8677,11173,-2496,-22.34,1194
2020-11-20,10627,12388,-1761,-14.22,1194
2020-11-21,9640,10687,-1047,-9.8,1194
2020-11-22,3269,4298,-1029,-23.94,1194
2020-11-23,9911,11182,-1271,-11.37,1194
2020-11-24,8677,11149,-2472,-22.17,1194
2020-11-25,8677,11149,-2472,-22.17,1194
2020-11-26,8677,11157,-2480,-22.23,1194
2020-11-27,10627,12384,-1757,-14.19,1194
2020-11-28,9640,10698,-1058,-9.89,1194
2020-11-29,3269,4327,-1058,-24.45,1194
2020-11-30,9911,11230,-1319,-11.75,1194
2020-12-01,10256,11218,-962,-8.58,1194
2020-12-02,10256,11241,-985,-8.76,1194
2020-12-03,10256,11272,-1016,-9.01,1194
2020-12-04,11732,12521,-789,-6.3,1194
2020-12-05,10637,10856,-219,-2.02,1194
2020-12-06,3427,4504,-1077,-23.91,1194
2020-12-07,11250,11424,-174,-1.52,1194
2020-12-08,10256,11424,-1168,-10.22,1194
2020-12-09,10256,11456,-1200,-10.47,1194
2020-12-10,10256,11490,-1234,-10.74,1194
2020-12-11,11732,12737,-1005,-7.89,1194
2020-12-12,10637,11064,-427,-3.86,1194
2020-12-13,3427,4698,-1271,-27.05,1194
2020-12-14,11250,11597,-347,-2.99,1194
2020-12-15,10256,11571,-1315,-11.36,1194
2020-12-16,10256,11570,-1314,-11.36,1194
2020-12-17,10256,11565,-1309,-11.32,1194
2020-12-18,11732,12768,-1036,-8.11,1194
2020-12-19,10637,11046,-409,-3.7,1194
2020-12-20,3427,4627,-1200,-25.93,1194
2020-12-21,11250,11470,-220,-1.92,1194
2020-12-22,10256,11386,-1130,-9.92,1194
2020-12-23,10256,11325,-1069,-9.44,1194
2020-12-24,10256,11261,-1005,-8.92,1194
2020-12-25,11732,12406,-674,-5.43,1194
2020-12-26,10637,10630,7,0.07,1194
2020-12-27,3427,4158,-731,-17.58,1194
2020-12-28,11250,10955,295,2.69,1194
2020-12-29,10256,10829,-573,-5.29,1194
2020-12-30,10256,10733,-477,-4.44,1194
2020-12-31,10256,10642,-386,-3.63,1194
2021-01-01,9411,11767,-2356,-20.02,1194
2021-01-02,8186,9979,-1793,-17.97,1194
2021-01-03,2673,3505,-832,-23.74,1194
2021-01-04,8160,10307,-2147,-20.83,1194
2021-01-05,8298,10196,-1898,-18.62,1194
2021-01-06,8298,10123,-1825,-18.03,1194
2021-01-07,8298,10061,-1763,-17.52,1194
2021-01-08,9411,11224,-1813,-16.15,1194
2021-01-09,8186,9479,-1293,-13.64,1194
2021-01-10,2673,3053,-380,-12.45,1194
2021-01-11,8160,9908,-1748,-17.64,1194
2021-01-12,8298,9852,-1554,-15.77,1194
2021-01-13,8298,9837,-1539,-15.65,1194
2021-01-14,8298,9834,-1536,-15.62,1194
2021-01-15,9411,11055,-1644,-14.87,1194
2021-01-16,8186,9366,-1180,-12.6,1194
2021-01-17,2673,2994,-321,-10.72,1194
2021-01-18,8160,9898,-1738,-17.56,1194
2021-01-19,8298,9888,-1590,-16.08,1194
2021-01-20,8298,9912,-1614,-16.28,1194
2021-01-21,8298,9942,-1644,-16.54,1194
2021-01-22,9411,11190,-1779,-15.9,1194
2021-01-23,8186,9521,-1335,-14.02,1194
2021-01-24,2673,3163,-490,-15.49,1194
2021-01-25,8160,10074,-1914,-19.0,1194
2021-01-26,8298,10064,-1766,-17.55,1194
2021-01-27,8298,10083,-1785,-17.7,1194
2021-01-28,8298,10102,-1804,-17.86,1194
2021-01-29,9411,11334,-1923,-16.97,1194
2021-01-30,8186,9646,-1460,-15.14,1194
2021-01-31,2673,3266,-593,-18.16,1194
2021-02-01,9340,10153,-813,-8.01,1194
2021-02-02,9125,10118,-993,-9.81,1194
2021-02-03,9125,10111,-986,-9.75,1194
2021-02-04,9125,10107,-982,-9.72,1194
2021-02-05,10309,11317,-1008,-8.91,1194
2021-02-06,9330,9611,-281,-2.92,1194
2021-02-07,3200,3215,-15,-0.47,1194
2021-02-08,9340,10091,-751,-7.44,1194
2021-02-09,9125,10049,-924,-9.19,1194
2021-02-10,9125,10041,-916,-9.12,1194
2021-02-11,9125,10041,-916,-9.12,1194
2021-02-12,10309,11260,-951,-8.45,1194
2021-02-13,9330,9568,-238,-2.49,1194
2021-02-14,3200,3191,9,0.28,1194
2021-02-15,9340,10090,-750,-7.43,1194
2021-02-16,9125,10075,-950,-9.43,1194
2021-02-17,9125,10098,-973,-9.64,1194
2021-02-18,9125,10130,-1005,-9.92,1194
2021-02-19,10309,11383,-1074,-9.44,1194
2021-02-20,9330,9726,-396,-4.07,1194
2021-02-21,3200,3383,-183,-5.41,1194
2021-02-22,9340,10316,-976,-9.46,1194
2021-02-23,9125,10333,-1208,-11.69,1194
2021-02-24,9125,10385,-1260,-12.13,1194
2021-02-25,9125,10442,-1317,-12.61,1194
2021-02-26,10309,11717,-1408,-12.02,1194
2021-02-27,9330,10076,-746,-7.4,1194
2021-02-28,3200,3746,-546,-14.58,1194
2021-03-01,10324,10685,-361,-3.38,1194
2021-03-02,10447,10704,-257,-2.4,1194
2021-03-03,10447,10752,-305,-2.84,1194
2021-03-04,10447,10801,-354,-3.28,1194
2021-03-05,11500,12062,-562,-4.66,1194
2021-03-06,10621,10404,217,2.09,1194
2021-03-07,3436,4052,-616,-15.2,1194
2021-03-08,10324,10968,-644,-5.87,1194
2021-03-09,10447,10960,-513,-4.68,1194
2021-03-10,10447,10980,-533,-4.85,1194
2021-03-11,10447,11000,-553,-5.03,1194
2021-03-12,11500,12232,-732,-5.98,1194
2021-03-13,10621,10546,75,0.71,1194
2021-03-14,3436,4168,-732,-17.56,1194
2021-03-15,10324,11058,-734,-6.64,1194
2021-03-16,10447,11029,-582,-5.28,1194
2021-03-17,10447,11030,-583,-5.29,1194
2021-03-18,10447,11035,-588,-5.33,1194
2021-03-19,11500,12256,-756,-6.17,1194
2021-03-20,10621,10562,59,0.56,1194
2021-03-21,3436,4180,-744,-17.8,1194
2021-03-22,10324,11071,-747,-6.75,1194
2021-03-23,10447,11046,-599,-5.42,1194
2021-03-24,10447,11054,-607,-5.49,1194
2021-03-25,10447,11069,-622,-5.62,1194
2021-03-26,11500,12303,-803,-6.53,1194
2021-03-27,10621,10623,-2,-0.02,1194
2021-03-28,3436,4257,-821,-19.29,1194
2021-03-29,10324,11163,-839,-7.52,1194
2021-03-30,10447,11154,-707,-6.34,1194
2021-03-31,10447,11177,-730,-6.53,1194
2021-04-01,9003,11206,-2203,-19.66,1194
2021-04-02,10677,12452,-1775,-14.25,1194
2021-04-03,9228,10782,-1554,-14.41,1194
2021-04-04,3425,4423,-998,-22.56,1194
2021-04-05,9282,11334,-2052,-18.1,1194
2021-04-06,9003,11325,-2322,-20.5,1194
2021-04-07,9003,11347,-2344,-20.66,1194
2021-04-08,9003,11371,-2368,-20.82,1194
2021-04-09,10677,12610,-1933,-15.33,1194
2021-04-10,9228,10930,-1702,-15.57,1194
2021-04-11,3425,4558,-1133,-24.86,1194
2021-04-12,9282,11456,-2174,-18.98,1194
2021-04-13,9003,11432,-2429,-21.25,1194
2021-04-14,9003,11437,-2434,-21.28,1194
2021-04-15,9003,11445,-2442,-21.34,1194
2021-04-16,10677,12667,-1990,-15.71,1194
2021-04-17,9228,10972,-1744,-15.9,1194
2021-04-18,3425,4587,-1162,-25.33,1194
2021-04-19,9282,11472,-2190,-19.09,1194
2021-04-20,9003,11438,-2435,-21.29,1194
2021-04-21,9003,11437,-2434,-21.28,1194
2021-04-22,9003,11440,-2437,-21.3,1194
2021-04-23,10677,12661,-1984,-15.67,1194
2021-04-24,9228,10968,-1740,-15.86,1194
2021-04-25,3425,4587,-1162,-25.33,1194
2021-04-26,9282,11480,-2198,-19.15,1194
2021-04-27,9003,11456,-2453,-21.41,1194
2021-04-28,9003,11467,-2464,-21.49,1194
2021-04-29,9003,11485,-2482,-21.61,1194
2021-04-30,10677,12721,-2044,-16.07,1194
2021-05-01,10947,11044,-97,-0.88,1194
2021-05-02,3756,4680,-924,-19.74,1194
2021-05-03,11189,11588,-399,-3.44,1194
2021-05-04,11130,11580,-450,-3.89,1194
2021-05-05,11130,11603,-473,-4.08,1194
2021-05-06,11130,11632,-502,-4.32,1194
2021-05-07,12272,12876,-604,-4.69,1194
2021-05-08,10947,11205,-258,-2.3,1194
2021-05-09,3756,4842,-1086,-22.43,1194
2021-05-10,11189,11749,-560,-4.77,1194
2021-05-11,11130,11735,-605,-5.16,1194
2021-05-12,11130,11750,-620,-5.28,1194
2021-05-13,11130,11766,-636,-5.41,1194
2021-05-14,12272,12995,-723,-5.56,1194
2021-05-15,10947,11305,-358,-3.17,1194
2021-05-16,3756,4921,-1165,-23.67,1194
2021-05-17,11189,11805,-616,-5.22,1194
2021-05-18,11130,11767,-637,-5.41,1194
2021-05-19,11130,11757,-627,-5.33,1194
2021-05-20,11130,11749,-619,-5.27,1194
2021-05-21,12272,12954,-682,-5.26,1194
2021-05-22,10947,11241,-294,-2.62,1194
2021-05-23,3756,4837,-1081,-22.35,1194
2021-05-24,11189,11703,-514,-4.39,1194
2021-05-25,11130,11650,-520,-4.46,1194
2021-05-26,11130,11629,-499,-4.29,1194
2021-05-27,11130,11613,-483,-4.16,1194
2021-05-28,12272,12815,-543,-4.24,1194
2021-05-29,10947,11102,-155,-1.4,1194
2021-05-30,3756,4703,-947,-20.14,1194
2021-05-31,11189,11578,-389,-3.36,1194
2021-06-01,11089,11538,-449,-3.89,1194
2021-06-02,11089,11532,-443,-3.84,1194
2021-06-03,11089,11534,-445,-3.86,1194
2021-06-04,12230,12756,-526,-4.12,1194
2021-06-05,10247,11065,-818,-7.39,1194
2021-06-06,4439,4688,-249,-5.31,1194
2021-06-07,11098,11584,-486,-4.2,1194
2021-06-08,11089,11564,-475,-4.11,1194
2021-06-09,11089,11576,-487,-4.21,1194
2021-06-10,11089,11594,-505,-4.36,1194
2021-06-11,12230,12827,-597,-4.65,1194
2021-06-12,10247,11143,-896,-8.04,1194
2021-06-13,4439,4769,-330,-6.92,1194
2021-06-14,11098,11663,-565,-4.84,1194
2021-06-15,11089,11634,-545,-4.68,1194
2021-06-16,11089,11633,-544,-4.68,1194
2021-06-17,11089,11632,-543,-4.67,1194
2021-06-18,12230,12840,-610,-4.75,1194
2021-06-19,10247,11127,-880,-7.91,1194
2021-06-20,4439,4719,-280,-5.93,1194
2021-06-21,11098,11575,-477,-4.12,1194
2021-06-22,11089,11505,-416,-3.62,1194
2021-06-23,11089,11460,-371,-3.24,1194
2021-06-24,11089,11414,-325,-2.85,1194
2021-06-25,12230,12577,-347,-2.76,1194
2021-06-26,10247,10819,-572,-5.29,1194
2021-06-27,4439,4367,72,1.65,1194
2021-06-28,11098,11182,-84,-0.75,1194
2021-06-29,11089,11075,14,0.13,1194
2021-06-30,11089,10998,91,0.83,1194
2021-07-01,10119,10924,-805,-7.37,1194
2021-07-02,11021,12066,-1045,-8.66,1194
2021-07-03,9466,10293,-827,-8.03,1194
2021-07-04,3974,3833,141,3.68,1194
2021-07-05,10201,10647,-446,-4.19,1194
2021-07-06,10119,10547,-428,-4.06,1194
2021-07-07,10119,10483,-364,-3.47,1194
2021-07-08,10119,10430,-311,-2.98,1194
2021-07-09,11021,11598,-577,-4.97,1194
2021-07-10,9466,9858,-392,-3.98,1194
2021-07-11,3974,3436,538,15.66,1194
2021-07-12,10201,10292,-91,-0.88,1194
2021-07-13,10119,10237,-118,-1.15,1194
2021-07-14,10119,10221,-102,-1.0,1194
2021-07-15,10119,10216,-97,-0.95,1194
2021-07-16,11021,11433,-412,-3.6,1194
2021-07-17,9466,9741,-275,-2.82,1194
2021-07-18,3974,3364,610,18.13,1194
2021-07-19,10201,10263,-62,-0.6,1194
2021-07-20,10119,10246,-127,-1.24,1194
2021-07-21,10119,10263,-144,-1.4,1194
2021-07-22,10119,10287,-168,-1.63,1194
2021-07-23,11021,11527,-506,-4.39,1194
2021-07-24,9466,9851,-385,-3.91,1194
2021-07-25,3974,3484,490,14.06,1194
2021-07-26,10201,10387,-186,-1.79,1194
2021-07-27,10119,10368,-249,-2.4,1194
2021-07-28,10119,10378,-259,-2.5,1194
2021-07-29,10119,10388,-269,-2.59,1194
2021-07-30,11021,11610,-589,-5.07,1194
2021-07-31,9466,9913,-447,-4.51,1194
2021-08-01,3990,3522,468,13.29,1194
2021-08-02,9934,10398,-464,-4.46,1194
2021-08-03,9858,10351,-493,-4.76,1194
2021-08-04,9858,10333,-475,-4.6,1194
2021-08-05,9858,10317,-459,-4.45,1194
2021-08-06,10673,11514,-841,-7.3,1194
2021-08-07,9020,9795,-775,-7.91,1194
2021-08-08,3990,3385,605,17.87,1194
2021-08-09,9934,10246,-312,-3.05,1194
2021-08-10,9858,10190,-332,-3.26,1194
2021-08-11,9858,10168,-310,-3.05,1194
2021-08-12,9858,10152,-294,-2.9,1194
2021-08-13,10673,11356,-683,-6.01,1194
2021-08-14,9020,9648,-628,-6.51,1194
2021-08-15,3990,3255,735,22.58,1194
2021-08-16,9934,10139,-205,-2.02,1194
2021-08-17,9858,10109,-251,-2.48,1194
2021-08-18,9858,10116,-258,-2.55,1194
2021-08-19,9858,10134,-276,-2.72,1194
2021-08-20,10673,11373,-700,-6.15,1194
2021-08-21,9020,9702,-682,-7.03,1194
2021-08-22,3990,3347,643,19.21,1194
2021-08-23,9934,10268,-334,-3.25,1194
2021-08-24,9858,10275,-417,-4.06,1194
2021-08-25,9858,10316,-458,-4.44,1194
2021-08-26,9858,10365,-507,-4.89,1194
2021-08-27,10673,11631,-958,-8.24,1194
2021-08-28,9020,9984,-964,-9.66,1194
2021-08-29,3990,3647,343,9.4,1194
2021-08-30,9934,10582,-648,-6.12,1194
2021-08-31,9858,10596,-738,-6.96,1194
2021-09-01,10924,10641,283,2.66,1194
2021-09-02,10924,10687,237,2.22,1194
2021-09-03,11888,11947,-59,-0.49,1194
2021-09-04,10712,10287,425,4.13,1194
2021-09-05,4930,3934,996,25.32,1194
2021-09-06,10893,10849,44,0.41,1194
2021-09-07,10924,10840,84,0.77,1194
2021-09-08,10924,10860,64,0.59,1194
2021-09-09,10924,10879,45,0.41,1194
2021-09-10,11888,12111,-223,-1.84,1194
2021-09-11,10712,10424,288,2.76,1194
2021-09-12,4930,4044,886,21.91,1194
2021-09-13,10893,10933,-40,-0.37,1194
2021-09-14,10924,10902,22,0.2,1194
2021-09-15,10924,10900,24,0.22,1194
2021-09-16,10924,10902,22,0.2,1194
2021-09-17,11888,12120,-232,-1.91,1194
2021-09-18,10712,10422,290,2.78,1194
2021-09-19,4930,4036,894,22.15,1194
2021-09-20,10893,10923,-30,-0.27,1194
2021-09-21,10924,10893,31,0.28,1194
2021-09-22,10924,10896,28,0.26,1194
2021-09-23,10924,10906,18,0.17,1194
2021-09-24,11888,12135,-247,-2.04,1194
2021-09-25,10712,10450,262,2.51,1194
2021-09-26,4930,4079,851,20.86,1194
2021-09-27,10893,10982,-89,-0.81,1194
2021-09-28,10924,10968,-44,-0.4,1194
2021-09-29,10924,10988,-64,-0.58,1194
2021-09-30,10924,11014,-90,-0.82,1194
2021-10-01,12152,12257,-105,-0.86,1194
2021-10-02,11006,10585,421,3.98,1194
2021-10-03,4394,4225,169,4.0,1194
2021-10-04,11146,11135,11,0.1,1194
2021-10-05,10739,11126,-387,-3.48,1194
2021-10-06,10739,11148,-409,-3.67,1194
2021-10-07,10739,11173,-434,-3.88,1194
2021-10-08,12152,12412,-260,-2.09,1194
2021-10-09,11006,10733,273,2.54,1194
2021-10-10,4394,4363,31,0.71,1194
2021-10-11,11146,11261,-115,-1.02,1194
2021-10-12,10739,11238,-499,-4.44,1194
2021-10-13,10739,11243,-504,-4.48,1194
2021-10-14,10739,11251,-512,-4.55,1194
2021-10-15,12152,12472,-320,-2.57,1194
2021-10-16,11006,10776,230,2.13,1194
2021-10-17,4394,4388,6,0.14,1194
2021-10-18,11146,11270,-124,-1.1,1194
2021-10-19,10739,11232,-493,-4.39,1194
2021-10-20,10739,11225,-486,-4.33,1194
2021-10-21,10739,11221,-482,-4.3,1194
2021-10-22,12152,12434,-282,-2.27,1194
2021-10-23,11006,10732,274,2.55,1194
2021-10-24,4394,4341,53,1.22,1194
2021-10-25,11146,11222,-76,-0.68,1194
2021-10-26,10739,11186,-447,-4.0,1194
2021-10-27,10739,11183,-444,-3.97,1194
2021-10-28,10739,11186,-447,-4.0,1194
2021-10-29,12152,12407,-255,-2.06,1194
2021-10-30,11006,10714,292,2.73,1194
2021-10-31,4394,4333,61,1.41,1194
2021-11-01,9995,11225,-1230,-10.96,1194
2021-11-02,10305,11200,-895,-7.99,1194
2021-11-03,10305,11208,-903,-8.06,1194
2021-11-04,10305,11221,-916,-8.16,1194
2021-11-05,11883,12450,-567,-4.55,1194
2021-11-06,10670,10764,-94,-0.87,1194
2021-11-07,3912,4389,-477,-10.87,1194
2021-11-08,9995,11284,-1289,-11.42,1194
2021-11-09,10305,11260,-955,-8.48,1194
2021-11-10,10305,11266,-961,-8.53,1194
2021-11-11,10305,11276,-971,-8.61,1194
2021-11-12,11883,12500,-617,-4.94,1194
2021-11-13,10670,10806,-136,-1.26,1194
2021-11-14,3912,4422,-510,-11.53,1194
2021-11-15,9995,11308,-1313,-11.61,1194
2021-11-16,10305,11273,-968,-8.59,1194
2021-11-17,10305,11269,-964,-8.55,1194
2021-11-18,10305,11269,-964,-8.55,1194
2021-11-19,11883,12484,-601,-4.81,1194
2021-11-20,10670,10783,-113,-1.05,1194
2021-11-21,3912,4393,-481,-10.95,1194
2021-11-22,9995,11275,-1280,-11.35,1194
2021-11-23,10305,11239,-934,-8.31,1194
2021-11-24,10305,11237,-932,-8.29,1194
2021-11-25,10305,11242,-937,-8.33,1194
2021-11-26,11883,12465,-582,-4.67,1194
2021-11-27,10670,10775,-105,-0.97,1194
2021-11-28,3912,4400,-488,-11.09,1194
2021-11-29,9995,11299,-1304,-11.54,1194
2021-11-30,10305,11282,-977,-8.66,1194
2021-12-01,10871,11301,-430,-3.8,1194
2021-12-02,10871,11328,-457,-4.03,1194
2021-12-03,10696,12574,-1878,-14.94,1194
2021-12-04,10672,10907,-235,-2.15,1194
2021-12-05,3755,4552,-797,-17.51,1194
2021-12-06,10962,11471,-509,-4.44,1194
2021-12-07,10871,11472,-601,-5.24,1194
2021-12-08,10871,11505,-634,-5.51,1194
2021-12-09,10871,11541,-670,-5.81,1194
2021-12-10,10696,12791,-2095,-16.38,1194
2021-12-11,10672,11124,-452,-4.06,1194
2021-12-12,3755,4763,-1008,-21.16,1194
2021-12-13,10962,11669,-707,-6.06,1194
2021-12-14,10871,11651,-780,-6.69,1194
2021-12-15,10871,11659,-788,-6.76,1194
2021-12-16,10871,11663,-792,-6.79,1194
2021-12-17,10696,12877,-2181,-16.94,1194
2021-12-18,10672,11166,-494,-4.42,1194
2021-12-19,3755,4757,-1002,-21.06,1194
2021-12-20,10962,11612,-650,-5.6,1194
2021-12-21,10871,11538,-667,-5.78,1194
2021-12-22,10871,11488,-617,-5.37,1194
2021-12-23,10871,11434,-563,-4.92,1194
2021-12-24,10696,12588,-1892,-15.03,1194
2021-12-25,10672,10819,-147,-1.36,1194
2021-12-26,3755,4354,-599,-13.76,1194
2021-12-27,10962,11156,-194,-1.74,1194
2021-12-28,10871,11034,-163,-1.48,1194
2021-12-29,10871,10941,-70,-0.64,1194
2021-12-30,10871,10850,21,0.19,1194
2021-12-31,10696,11975,-1279,-10.68,1194
2022-01-01,9172,10184,-1012,-9.94,1194
2022-01-02,3417,3706,-289,-7.8,1194
2022-01-03,9553,10503,-950,-9.05,1194
2022-01-04,9544,10384,-840,-8.09,1194
2022-01-05,9544,10303,-759,-7.37,1194
2022-01-06,9544,10233,-689,-6.73,1194
2022-01-07,10512,11386,-874,-7.68,1194
2022-01-08,9172,9630,-458,-4.76,1194
2022-01-09,3417,3194,223,6.98,1194
2022-01-10,9553,10038,-485,-4.83,1194
2022-01-11,9544,9972,-428,-4.29,1194
2022-01-12,9544,9946,-402,-4.04,1194
2022-01-13,9544,9933,-389,-3.92,1194
2022-01-14,10512,11144,-632,-5.67,1194
2022-01-15,9172,9447,-275,-2.91,1194
2022-01-16,3417,3068,349,11.38,1194
2022-01-17,9553,9966,-413,-4.14,1194
2022-01-18,9544,9950,-406,-4.08,1194
2022-01-19,9544,9970,-426,-4.27,1194
2022-01-20,9544,9998,-454,-4.54,1194
2022-01-21,10512,11244,-732,-6.51,1194
2022-01-22,9172,9576,-404,-4.22,1194
2022-01-23,3417,3219,198,6.15,1194
2022-01-24,9553,10132,-579,-5.71,1194
2022-01-25,9544,10125,-581,-5.74,1194
2022-01-26,9544,10147,-603,-5.94,1194
2022-01-27,9544,10171,-627,-6.16,1194
2022-01-28,10512,11407,-895,-7.85,1194
2022-01-29,9172,9725,-553,-5.69,1194
2022-01-30,3417,3349,68,2.03,1194
2020-02-01,16167,15791,376,2.38,1198
2020-02-02,9259,8776,483,5.5,1198
2020-02-03,17719,17740,-21,-0.12,1198
2020-02-04,18159,17886,273,1.53,1198
2020-02-05,18159,17893,266,1.49,1198
2020-02-06,18159,17897,262,1.46,1198
2020-02-07,19267,19065,202,1.06,1198
2020-02-08,16167,15854,313,1.97,1198
2020-02-09,9259,8820,439,4.98,1198
2020-02-10,17719,17772,-53,-0.3,1198
2020-02-11,18159,17910,249,1.39,1198
2020-02-12,18159,17914,245,1.37,1198
2020-02-13,18159,17922,237,1.32,1198
2020-02-14,19267,19098,169,0.88,1198
2020-02-15,16167,15901,266,1.67,1198
2020-02-16,9259,8887,372,4.19,1198
2020-02-17,17719,17861,-142,-0.8,1198
2020-02-18,18159,18026,133,0.74,1198
2020-02-19,18159,18061,98,0.54,1198
2020-02-20,18159,18100,59,0.33,1198
2020-02-21,19267,19310,-43,-0.22,1198
2020-02-22,16167,16146,21,0.13,1198
2020-02-23,9259,9164,95,1.04,1198
2020-02-24,17719,18169,-450,-2.48,1198
2020-02-25,18159,18362,-203,-1.11,1198
2020-02-26,18159,18421,-262,-1.42,1198
2020-02-27,18159,18481,-322,-1.74,1198
2020-02-28,19267,19706,-439,-2.23,1198
2020-02-29,16167,16553,-386,-2.33,1198
2020-03-01,6598,9576,-2978,-31.1,1198
2020-03-02,14219,18581,-4362,-23.48,1198
2020-03-03,14580,18769,-4189,-22.32,1198
2020-03-04,14580,18817,-4237,-22.52,1198
2020-03-05,14580,18861,-4281,-22.7,1198
2020-03-06,15746,20066,-4320,-21.53,1198
2020-03-07,11495,16889,-5394,-31.94,1198
2020-03-08,6598,9886,-3288,-33.26,1198
2020-03-09,14219,18862,-4643,-24.62,1198
2020-03-10,14580,19020,-4440,-23.34,1198
2020-03-11,14580,19038,-4458,-23.42,1198
2020-03-12,14580,19052,-4472,-23.47,1198
2020-03-13,15746,20230,-4484,-22.17,1198
2020-03-14,11495,17027,-5532,-32.49,1198
2020-03-15,6598,10001,-3403,-34.03,1198
2020-03-16,14219,18959,-4740,-25.0,1198
2020-03-17,14580,19102,-4522,-23.67,1198
2020-03-18,14580,19110,-4530,-23.7,1198
2020-03-19,14580,19120,-4540,-23.74,1198
2020-03-20,15746,20297,-4551,-22.42,1198
2020-03-21,11495,17100,-5605,-32.78,1198
2020-03-22,6598,10084,-3486,-34.57,1198
2020-03-23,14219,19055,-4836,-25.38,1198
2020-03-24,14580,19217,-4637,-24.13,1198
2020-03-25,14580,19246,-4666,-24.24,1198
2020-03-26,14580,19280,-4700,-24.38,1198
2020-03-27,15746,20483,-4737,-23.13,1198
2020-03-28,11495,17312,-5817,-33.6,1198
2020-03-29,6598,10322,-3724,-36.08,1198
2020-03-30,14219,19320,-5101,-26.4,1198
2020-03-31,14580,19506,-4926,-25.25,1198
2020-04-01,14327,19557,-5230,-26.74,1198
2020-04-02,14327,19609,-5282,-26.94,1198
2020-04-03,13966,20828,-6862,-32.95,1198
2020-04-04,10614,17667,-7053,-39.92,1198
2020-04-05,5325,10685,-5360,-50.16,1198
2020-04-06,14163,19684,-5521,-28.05,1198
2020-04-07,14327,19866,-5539,-27.88,1198
2020-04-08,14327,19909,-5582,-28.04,1198
2020-04-09,14327,19948,-5621,-28.18,1198
2020-04-10,13966,21149,-7183,-33.96,1198
2020-04-11,10614,17967,-7353,-40.93,1198
2020-04-12,5325,10960,-5635,-51.41,1198
2020-04-13,14163,19932,-5769,-28.94,1198
2020-04-14,14327,20085,-5758,-28.67,1198
2020-04-15,14327,20097,-5770,-28.71,1198
2020-04-16,14327,20105,-5778,-28.74,1198
2020-04-17,13966,21276,-7310,-34.36,1198
2020-04-18,10614,18065,-7451,-41.25,1198
2020-04-19,5325,11030,-5705,-51.72,1198
2020-04-20,14163,19977,-5814,-29.1,1198
2020-04-21,14327,20108,-5781,-28.75,1198
2020-04-22,14327,20102,-5775,-28.73,1198
2020-04-23,14327,20097,-5770,-28.71,1198
2020-04-24,13966,21257,-7291,-34.3,1198
2020-04-25,10614,18041,-7427,-41.17,1198
2020-04-26,5325,11004,-5679,-51.61,1198
2020-04-27,14163,19954,-5791,-29.02,1198
2020-04-28,14327,20091,-5764,-28.69,1198
2020-04-29,14327,20096,-5769,-28.71,1198
2020-04-30,14327,20102,-5775,-28.73,1198
2020-05-01,20064,21278,-1214,-5.71,1198
2020-05-02,16980,18078,-1098,-6.07,1198
2020-05-03,8431,11059,-2628,-23.76,1198
2020-05-04,19050,20026,-976,-4.87,1198
2020-05-05,19222,20180,-958,-4.75,1198
2020-05-06,19222,20200,-978,-4.84,1198
2020-05-07,19222,20221,-999,-4.94,1198
2020-05-08,20064,21407,-1343,-6.27,1198
2020-05-09,16980,18216,-1236,-6.79,1198
2020-05-10,8431,11202,-2771,-24.74,1198
2020-05-11,19050,20171,-1121,-5.56,1198
2020-05-12,19222,20324,-1102,-5.42,1198
2020-05-13,19222,20338,-1116,-5.49,1198
2020-05-14,19222,20350,-1128,-5.54,1198
2020-05-15,20064,21525,-1461,-6.79,1198
2020-05-16,16980,18319,-1339,-7.31,1198
2020-05-17,8431,11288,-2857,-25.31,1198
2020-05-18,19050,20238,-1188,-5.87,1198
2020-05-19,19222,20370,-1148,-5.64,1198
2020-05-20,19222,20364,-1142,-5.61,1198
2020-05-21,19222,20355,-1133,-5.57,1198
2020-05-22,20064,21510,-1446,-6.72,1198
2020-05-23,16980,18285,-1305,-7.14,1198
2020-05-24,8431,11238,-2807,-24.98,1198
2020-05-25,19050,20174,-1124,-5.57,1198
2020-05-26,19222,20295,-1073,-5.29,1198
2020-05-27,19222,20282,-1060,-5.23,1198
2020-05-28,19222,20269,-1047,-5.17,1198
2020-05-29,20064,21425,-1361,-6.35,1198
2020-05-30,16980,18204,-1224,-6.72,1198
2020-05-31,8431,11164,-2733,-24.48,1198
2020-06-01,19734,20111,-377,-1.87,1198
2020-06-02,20286,20247,39,0.19,1198
2020-06-03,20286,20250,36,0.18,1198
2020-06-04,20286,20255,31,0.15,1198
2020-06-05,20533,21429,-896,-4.18,1198
2020-06-06,16914,18228,-1314,-7.21,1198
2020-06-07,9589,11207,-1618,-14.44,1198
2020-06-08,19734,20172,-438,-2.17,1198
2020-06-09,20286,20323,-37,-0.18,1198
2020-06-10,20286,20339,-53,-0.26,1198
2020-06-11,20286,20353,-67,-0.33,1198
2020-06-12,20533,21533,-1000,-4.64,1198
2020-06-13,16914,18332,-1418,-7.74,1198
2020-06-14,9589,11307,-1718,-15.19,1198
2020-06-15,19734,20262,-528,-2.61,1198
2020-06-16,20286,20398,-112,-0.55,1198
2020-06-17,20286,20393,-107,-0.52,1198
2020-06-18,20286,20383,-97,-0.48,1198
2020-06-19,20533,21533,-1000,-4.64,1198
2020-06-20,16914,18298,-1384,-7.56,1198
2020-06-21,9589,11236,-1647,-14.66,1198
2020-06-22,19734,20152,-418,-2.07,1198
2020-06-23,20286,20247,39,0.19,1198
2020-06-24,20286,20201,85,0.42,1198
2020-06-25,20286,20150,136,0.67,1198
2020-06-26,20533,21259,-726,-3.42,1198
2020-06-27,16914,17988,-1074,-5.97,1198
2020-06-28,9589,10891,-1302,-11.95,1198
2020-06-29,19734,19777,-43,-0.22,1198
2020-06-30,20286,19847,439,2.21,1198
2020-07-01,19449,19782,-333,-1.68,1198
2020-07-02,19449,19717,-268,-1.36,1198
2020-07-03,20057,20820,-763,-3.66,1198
2020-07-04,16364,17548,-1184,-6.75,1198
2020-07-05,9915,10458,-543,-5.19,1198
2020-07-06,19306,19357,-51,-0.26,1198
2020-07-07,19449,19446,3,0.02,1198
2020-07-08,19449,19405,44,0.23,1198
2020-07-09,19449,19370,79,0.41,1198
2020-07-10,20057,20507,-450,-2.19,1198
2020-07-11,16364,17271,-907,-5.25,1198
2020-07-12,9915,10221,-306,-2.99,1198
2020-07-13,19306,19159,147,0.77,1198
2020-07-14,19449,19288,161,0.83,1198
2020-07-15,19449,19285,164,0.85,1198
2020-07-16,19449,19286,163,0.85,1198
2020-07-17,20057,20455,-398,-1.95,1198
2020-07-18,16364,17247,-883,-5.12,1198
2020-07-19,9915,10219,-304,-2.97,1198
2020-07-20,19306,19174,132,0.69,1198
2020-07-21,19449,19313,136,0.7,1198
2020-07-22,19449,19314,135,0.7,1198
2020-07-23,19449,19311,138,0.71,1198
2020-07-24,20057,20470,-413,-2.02,1198
2020-07-25,16364,17245,-881,-5.11,1198
2020-07-26,9915,10194,-279,-2.74,1198
2020-07-27,19306,19121,185,0.97,1198
2020-07-28,19449,19227,222,1.15,1198
2020-07-29,19449,19191,258,1.34,1198
2020-07-30,19449,19150,299,1.56,1198
2020-07-31,20057,20268,-211,-1.04,1198
2020-08-01,15016,17004,-1988,-11.69,1198
2020-08-02,9638,9914,-276,-2.78,1198
2020-08-03,18417,18804,-387,-2.06,1198
2020-08-04,18229,18878,-649,-3.44,1198
2020-08-05,18229,18815,-586,-3.11,1198
2020-08-06,18229,18751,-522,-2.78,1198
2020-08-07,18900,19855,-955,-4.81,1198
2020-08-08,15016,16583,-1567,-9.45,1198
2020-08-09,9638,9494,144,1.52,1198
2020-08-10,18417,18394,23,0.13,1198
2020-08-11,18229,18486,-257,-1.39,1198
2020-08-12,18229,18448,-219,-1.19,1198
2020-08-13,18229,18419,-190,-1.03,1198
2020-08-14,18900,19565,-665,-3.4,1198
2020-08-15,15016,16341,-1325,-8.11,1198
2020-08-16,9638,9307,331,3.56,1198
2020-08-17,18417,18265,152,0.83,1198
2020-08-18,18229,18419,-190,-1.03,1198
2020-08-19,18229,18447,-218,-1.18,1198
2020-08-20,18229,18484,-255,-1.38,1198
2020-08-21,18900,19694,-794,-4.03,1198
2020-08-22,15016,16535,-1519,-9.19,1198
2020-08-23,9638,9560,78,0.82,1198
2020-08-24,18417,18574,-157,-0.85,1198
2020-08-25,18229,18779,-550,-2.93,1198
2020-08-26,18229,18850,-621,-3.29,1198
2020-08-27,18229,18922,-693,-3.66,1198
2020-08-28,18900,20161,-1261,-6.25,1198
2020-08-29,15016,17021,-2005,-11.78,1198
2020-08-30,9638,10057,-419,-4.17,1198
2020-08-31,18417,19074,-657,-3.44,1198
2020-09-01,18948,19272,-324,-1.68,1198
2020-09-02,18948,19329,-381,-1.97,1198
2020-09-03,18948,19380,-432,-2.23,1198
2020-09-04,19419,20591,-1172,-5.69,1198
2020-09-05,16198,17417,-1219,-7.0,1198
2020-09-06,9924,10416,-492,-4.72,1198
2020-09-07,18741,19391,-650,-3.35,1198
2020-09-08,18948,19547,-599,-3.06,1198
2020-09-09,18948,19560,-612,-3.13,1198
2020-09-10,18948,19569,-621,-3.17,1198
2020-09-11,19419,20738,-1319,-6.36,1198
2020-09-12,16198,17526,-1328,-7.58,1198
2020-09-13,9924,10491,-567,-5.4,1198
2020-09-14,18741,19437,-696,-3.58,1198
2020-09-15,18948,19569,-621,-3.17,1198
2020-09-16,18948,19565,-617,-3.15,1198
2020-09-17,18948,19562,-614,-3.14,1198
2020-09-18,19419,20728,-1309,-6.32,1198
2020-09-19,16198,17518,-1320,-7.54,1198
2020-09-20,9924,10491,-567,-5.4,1198
2020-09-21,18741,19452,-711,-3.66,1198
2020-09-22,18948,19604,-656,-3.35,1198
2020-09-23,18948,19625,-677,-3.45,1198
2020-09-24,18948,19650,-702,-3.57,1198
2020-09-25,19419,20847,-1428,-6.85,1198
2020-09-26,16198,17670,-1472,-8.33,1198
2020-09-27,9924,10676,-752,-7.04,1198
2020-09-28,18741,19669,-928,-4.72,1198
2020-09-29,18948,19852,-904,-4.55,1198
2020-09-30,18948,19900,-952,-4.78,1198
2020-10-01,19029,19950,-921,-4.62,1198
2020-10-02,20109,21166,-1057,-4.99,1198
2020-10-03,16694,18004,-1310,-7.28,1198
2020-10-04,9482,11019,-1537,-13.95,1198
2020-10-05,18665,20015,-1350,-6.74,1198
2020-10-06,19029,20194,-1165,-5.77,1198
2020-10-07,19029,20233,-1204,-5.95,1198
2020-10-08,19029,20267,-1238,-6.11,1198
2020-10-09,20109,21462,-1353,-6.3,1198
2020-10-10,16694,18273,-1579,-8.64,1198
2020-10-11,9482,11257,-1775,-15.77,1198
2020-10-12,18665,20218,-1553,-7.68,1198
2020-10-13,19029,20360,-1331,-6.54,1198
2020-10-14,19029,20360,-1331,-6.54,1198
2020-10-15,19029,20354,-1325,-6.51,1198
2020-10-16,20109,21510,-1401,-6.51,1198
2020-10-17,16694,18283,-1589,-8.69,1198
2020-10-18,9482,11231,-1749,-15.57,1198
2020-10-19,18665,20160,-1495,-7.42,1198
2020-10-20,19029,20274,-1245,-6.14,1198
2020-10-21,19029,20250,-1221,-6.03,1198
2020-10-22,19029,20226,-1197,-5.92,1198
2020-10-23,20109,21368,-1259,-5.89,1198
2020-10-24,16694,18134,-1440,-7.94,1198
2020-10-25,9482,11080,-1598,-14.42,1198
2020-10-26,18665,20013,-1348,-6.74,1198
2020-10-27,19029,20135,-1106,-5.49,1198
2020-10-28,19029,20125,-1096,-5.45,1198
2020-10-29,19029,20118,-1089,-5.41,1198
2020-10-30,20109,21281,-1172,-5.51,1198
2020-10-31,16694,18069,-1375,-7.61,1198
2020-11-01,7499,11040,-3541,-32.07,1198
2020-11-02,16937,19997,-3060,-15.3,1198
2020-11-03,15494,20143,-4649,-23.08,1198
2020-11-04,15494,20155,-4661,-23.13,1198
2020-11-05,15494,20168,-4674,-23.18,1198
2020-11-06,16773,21348,-4575,-21.43,1198
2020-11-07,13214,18150,-4936,-27.2,1198
2020-11-08,7499,11129,-3630,-32.62,1198
2020-11-09,16937,20090,-3153,-15.69,1198
2020-11-10,15494,20235,-4741,-23.43,1198
2020-11-11,15494,20240,-4746,-23.45,1198
2020-11-12,15494,20242,-4748,-23.46,1198
2020-11-13,16773,21405,-4632,-21.64,1198
2020-11-14,13214,18186,-4972,-27.34,1198
2020-11-15,7499,11140,-3641,-32.68,1198
2020-11-16,16937,20073,-3136,-15.62,1198
2020-11-17,15494,20187,-4693,-23.25,1198
2020-11-18,15494,20160,-4666,-23.14,1198
2020-11-19,15494,20129,-4635,-23.03,1198
2020-11-20,16773,21259,-4486,-21.1,1198
2020-11-21,13214,18009,-4795,-26.63,1198
2020-11-22,7499,10934,-3435,-31.42,1198
2020-11-23,16937,19841,-2904,-14.64,1198
2020-11-24,15494,19934,-4440,-22.27,1198
2020-11-25,15494,19890,-4396,-22.1,1198
2020-11-26,15494,19847,-4353,-21.93,1198
2020-11-27,16773,20971,-4198,-20.02,1198
2020-11-28,13214,17720,-4506,-25.43,1198
2020-11-29,7499,10650,-3151,-29.59,1198
2020-11-30,16937,19568,-2631,-13.45,1198
2020-12-01,16086,19676,-3590,-18.25,1198
2020-12-02,16086,19653,-3567,-18.15,1198
2020-12-03,16086,19635,-3549,-18.07,1198
2020-12-04,18133,20787,-2654,-12.77,1198
2020-12-05,14588,17566,-2978,-16.95,1198
2020-12-06,7548,10528,-2980,-28.31,1198
2020-12-07,17226,19477,-2251,-11.56,1198
2020-12-08,16086,19616,-3530,-18.0,1198
2020-12-09,16086,19621,-3535,-18.02,1198
2020-12-10,16086,19628,-3542,-18.05,1198
2020-12-11,18133,20800,-2667,-12.82,1198
2020-12-12,14588,17595,-3007,-17.09,1198
2020-12-13,7548,10566,-3018,-28.56,1198
2020-12-14,17226,19518,-2292,-11.74,1198
2020-12-15,16086,19652,-3566,-18.15,1198
2020-12-16,16086,19645,-3559,-18.12,1198
2020-12-17,16086,19631,-3545,-18.06,1198
2020-12-18,18133,20777,-2644,-12.73,1198
2020-12-19,14588,17537,-2949,-16.82,1198
2020-12-20,7548,10467,-2919,-27.89,1198
2020-12-21,17226,19373,-2147,-11.08,1198
2020-12-22,16086,19455,-3369,-17.32,1198
2020-12-23,16086,19393,-3307,-17.05,1198
2020-12-24,16086,19322,-3236,-16.75,1198
2020-12-25,18133,20409,-2276,-11.15,1198
2020-12-26,14588,17110,-2522,-14.74,1198
2020-12-27,7548,9984,-2436,-24.4,1198
2020-12-28,17226,18835,-1609,-8.54,1198
2020-12-29,16086,18868,-2782,-14.74,1198
2020-12-30,16086,18761,-2675,-14.26,1198
2020-12-31,16086,18652,-2566,-13.76,1198
2021-01-01,14896,19709,-4813,-24.42,1198
2021-01-02,10336,16389,-6053,-36.93,1198
2021-01-03,5996,9250,-3254,-35.18,1198
2021-01-04,13999,18099,-4100,-22.65,1198
2021-01-05,14378,18139,-3761,-20.73,1198
2021-01-06,14378,18050,-3672,-20.34,1198
2021-01-07,14378,17968,-3590,-19.98,1198
2021-01-08,14896,19061,-4165,-21.85,1198
2021-01-09,10336,15785,-5449,-34.52,1198
2021-01-10,5996,8698,-2702,-31.06,1198
2021-01-11,13999,17605,-3606,-20.48,1198
2021-01-12,14378,17708,-3330,-18.81,1198
2021-01-13,14378,17686,-3308,-18.7,1198
2021-01-14,14378,17674,-3296,-18.65,1198
2021-01-15,14896,18838,-3942,-20.93,1198
2021-01-16,10336,15632,-5296,-33.88,1198
2021-01-17,5996,8614,-2618,-30.39,1198
2021-01-18,13999,17587,-3588,-20.4,1198
2021-01-19,14378,17753,-3375,-19.01,1198
2021-01-20,14378,17787,-3409,-19.17,1198
2021-01-21,14378,17825,-3447,-19.34,1198
2021-01-22,14896,19032,-4136,-21.73,1198
2021-01-23,10336,15863,-5527,-34.84,1198
2021-01-24,5996,8872,-2876,-32.42,1198
2021-01-25,13999,17865,-3866,-21.64,1198
2021-01-26,14378,18042,-3664,-20.31,1198
2021-01-27,14378,18081,-3703,-20.48,1198
2021-01-28,14378,18116,-3738,-20.63,1198
2021-01-29,14896,19314,-4418,-22.87,1198
2021-01-30,10336,16129,-5793,-35.92,1198
2021-01-31,5996,9119,-3123,-34.25,1198
2021-02-01,17103,18088,-985,-5.45,1198
2021-02-02,16957,18239,-1282,-7.03,1198
2021-02-03,16957,18250,-1293,-7.08,1198
2021-02-04,16957,18258,-1301,-7.13,1198
2021-02-05,17682,19428,-1746,-8.99,1198
2021-02-06,14363,16218,-1855,-11.44,1198
2021-02-07,7410,9186,-1776,-19.33,1198
2021-02-08,17103,18137,-1034,-5.7,1198
2021-02-09,16957,18274,-1317,-7.21,1198
2021-02-10,16957,18276,-1319,-7.22,1198
2021-02-11,16957,18279,-1322,-7.23,1198
2021-02-12,17682,19451,-1769,-9.09,1198
2021-02-13,14363,16249,-1886,-11.61,1198
2021-02-14,7410,9229,-1819,-19.71,1198
2021-02-15,17103,18198,-1095,-6.02,1198
2021-02-16,16957,18357,-1400,-7.63,1198
2021-02-17,16957,18385,-1428,-7.77,1198
2021-02-18,16957,18418,-1461,-7.93,1198
2021-02-19,17682,19622,-1940,-9.89,1198
2021-02-20,14363,16452,-2089,-12.7,1198
2021-02-21,7410,9466,-2056,-21.72,1198
2021-02-22,17103,18467,-1364,-7.39,1198
2021-02-23,16957,18657,-1700,-9.11,1198
2021-02-24,16957,18714,-1757,-9.39,1198
2021-02-25,16957,18773,-1816,-9.67,1198
2021-02-26,17682,19998,-2316,-11.58,1198
2021-02-27,14363,16845,-2482,-14.73,1198
2021-02-28,7410,9871,-2461,-24.93,1198
2021-03-01,18009,18878,-869,-4.6,1198
2021-03-02,18076,19070,-994,-5.21,1198
2021-03-03,18076,19122,-1046,-5.47,1198
2021-03-04,18076,19171,-1095,-5.71,1198
2021-03-05,18582,20382,-1800,-8.83,1198
2021-03-06,15503,17210,-1707,-9.92,1198
2021-03-07,7727,10213,-2486,-24.34,1198
2021-03-08,18009,19195,-1186,-6.18,1198
2021-03-09,18076,19358,-1282,-6.62,1198
2021-03-10,18076,19381,-1305,-6.73,1198
2021-03-11,18076,19400,-1324,-6.82,1198
2021-03-12,18582,20581,-1999,-9.71,1198
2021-03-13,15503,17381,-1878,-10.8,1198
2021-03-14,7727,10357,-2630,-25.39,1198
2021-03-15,18009,19316,-1307,-6.77,1198
2021-03-16,18076,19459,-1383,-7.11,1198
2021-03-17,18076,19467,-1391,-7.15,1198
2021-03-18,18076,19474,-1398,-7.18,1198
2021-03-19,18582,20649,-2067,-10.01,1198
2021-03-20,15503,17448,-1945,-11.15,1198
2021-03-21,7727,10428,-2701,-25.9,1198
2021-03-22,18009,19396,-1387,-7.15,1198
2021-03-23,18076,19552,-1476,-7.55,1198
2021-03-24,18076,19576,-1500,-7.66,1198
2021-03-25,18076,19605,-1529,-7.8,1198
2021-03-26,18582,20803,-2221,-10.68,1198
2021-03-27,15503,17627,-2124,-12.05,1198
2021-03-28,7727,10634,-2907,-27.34,1198
2021-03-29,18009,19628,-1619,-8.25,1198
2021-03-30,18076,19810,-1734,-8.75,1198
2021-03-31,18076,19859,-1783,-8.98,1198
2021-04-01,16020,19910,-3890,-19.54,1198
2021-04-02,16736,21128,-4392,-20.79,1198
2021-04-03,12387,17968,-5581,-31.06,1198
2021-04-04,7544,10987,-3443,-31.34,1198
2021-04-05,16350,19988,-3638,-18.2,1198
2021-04-06,16020,20174,-4154,-20.59,1198
2021-04-07,16020,20221,-4201,-20.78,1198
2021-04-08,16020,20265,-4245,-20.95,1198
2021-04-09,16736,21471,-4735,-22.05,1198
2021-04-10,12387,18295,-5908,-32.29,1198
2021-04-11,7544,11293,-3749,-33.2,1198
2021-04-12,16350,20270,-3920,-19.34,1198
2021-04-13,16020,20429,-4409,-21.58,1198
2021-04-14,16020,20447,-4427,-21.65,1198
2021-04-15,16020,20461,-4441,-21.7,1198
2021-04-16,16736,21636,-4900,-22.65,1198
2021-04-17,12387,18429,-6042,-32.79,1198
2021-04-18,7544,11397,-3853,-33.81,1198
2021-04-19,16350,20347,-3997,-19.64,1198
2021-04-20,16020,20480,-4460,-21.78,1198
2021-04-21,16020,20476,-4456,-21.76,1198
2021-04-22,16020,20470,-4450,-21.74,1198
2021-04-23,16736,21630,-4894,-22.63,1198
2021-04-24,12387,18412,-6025,-32.72,1198
2021-04-25,7544,11374,-3830,-33.67,1198
2021-04-26,16350,20321,-3971,-19.54,1198
2021-04-27,16020,20456,-4436,-21.69,1198
2021-04-28,16020,20457,-4437,-21.69,1198
2021-04-29,16020,20461,-4441,-21.7,1198
2021-04-30,16736,21632,-4896,-22.63,1198
2021-05-01,17140,18429,-1289,-6.99,1198
2021-05-02,8685,11407,-2722,-23.86,1198
2021-05-03,19797,20371,-574,-2.82,1198
2021-05-04,19762,20524,-762,-3.71,1198
2021-05-05,19762,20542,-780,-3.8,1198
2021-05-06,19762,20561,-799,-3.89,1198
2021-05-07,20192,21747,-1555,-7.15,1198
2021-05-08,17140,18556,-1416,-7.63,1198
2021-05-09,8685,11543,-2858,-24.76,1198
2021-05-10,19797,20514,-717,-3.5,1198
2021-05-11,19762,20669,-907,-4.39,1198
2021-05-12,19762,20686,-924,-4.47,1198
2021-05-13,19762,20701,-939,-4.54,1198
2021-05-14,20192,21880,-1688,-7.71,1198
2021-05-15,17140,18677,-1537,-8.23,1198
2021-05-16,8685,11650,-2965,-25.45,1198
2021-05-17,19797,20604,-807,-3.92,1198
2021-05-18,19762,20740,-978,-4.72,1198
2021-05-19,19762,20737,-975,-4.7,1198
2021-05-20,19762,20732,-970,-4.68,1198
2021-05-21,20192,21889,-1697,-7.75,1198
2021-05-22,17140,18667,-1527,-8.18,1198
2021-05-23,8685,11621,-2936,-25.26,1198
2021-05-24,19797,20558,-761,-3.7,1198
2021-05-25,19762,20679,-917,-4.43,1198
2021-05-26,19762,20665,-903,-4.37,1198
2021-05-27,19762,20651,-889,-4.3,1198
2021-05-28,20192,21804,-1612,-7.39,1198
2021-05-29,17140,18581,-1441,-7.76,1198
2021-05-30,8685,11538,-2853,-24.73,1198
2021-05-31,19797,20482,-685,-3.34,1198
2021-06-01,20050,20614,-564,-2.74,1198
2021-06-02,20050,20613,-563,-2.73,1198
2021-06-03,20050,20615,-565,-2.74,1198
2021-06-04,20568,21786,-1218,-5.59,1198
2021-06-05,16772,18581,-1809,-9.74,1198
2021-06-06,10208,11558,-1350,-11.68,1198
2021-06-07,19762,20520,-758,-3.69,1198
2021-06-08,20050,20671,-621,-3.0,1198
2021-06-09,20050,20686,-636,-3.07,1198
2021-06-10,20050,20701,-651,-3.14,1198
2021-06-11,20568,21882,-1314,-6.0,1198
2021-06-12,16772,18684,-1912,-10.23,1198
2021-06-13,10208,11662,-1454,-12.47,1198
2021-06-14,19762,20621,-859,-4.17,1198
2021-06-15,20050,20763,-713,-3.43,1198
2021-06-16,20050,20764,-714,-3.44,1198
2021-06-17,20050,20761,-711,-3.42,1198
2021-06-18,20568,21918,-1350,-6.16,1198
2021-06-19,16772,18691,-1919,-10.27,1198
2021-06-20,10208,11637,-1429,-12.28,1198
2021-06-21,19762,20560,-798,-3.88,1198
2021-06-22,20050,20663,-613,-2.97,1198
2021-06-23,20050,20624,-574,-2.78,1198
2021-06-24,20050,20579,-529,-2.57,1198
2021-06-25,20568,21695,-1127,-5.19,1198
2021-06-26,16772,18428,-1656,-8.99,1198
2021-06-27,10208,11335,-1127,-9.94,1198
2021-06-28,19762,20224,-462,-2.28,1198
2021-06-29,20050,20295,-245,-1.21,1198
2021-06-30,20050,20230,-180,-0.89,1198
2021-07-01,18348,20164,-1816,-9.01,1198
2021-07-02,19203,21265,-2062,-9.7,1198
2021-07-03,15292,17989,-2697,-14.99,1198
2021-07-04,9150,10895,-1745,-16.02,1198
2021-07-05,18413,19788,-1375,-6.95,1198
2021-07-06,18348,19871,-1523,-7.66,1198
2021-07-07,18348,19824,-1476,-7.45,1198
2021-07-08,18348,19781,-1433,-7.24,1198
2021-07-09,19203,20910,-1707,-8.16,1198
2021-07-10,15292,17668,-2376,-13.45,1198
2021-07-11,9150,10609,-1459,-13.75,1198
2021-07-12,18413,19541,-1128,-5.77,1198
2021-07-13,18348,19664,-1316,-6.69,1198
2021-07-14,18348,19656,-1308,-6.65,1198
2021-07-15,18348,19652,-1304,-6.64,1198
2021-07-16,19203,20817,-1614,-7.75,1198
2021-07-17,15292,17608,-2316,-13.15,1198
2021-07-18,9150,10579,-1429,-13.51,1198
2021-07-19,18413,19534,-1121,-5.74,1198
2021-07-20,18348,19675,-1327,-6.74,1198
2021-07-21,18348,19679,-1331,-6.76,1198
2021-07-22,18348,19680,-1332,-6.77,1198
2021-07-23,19203,20844,-1641,-7.87,1198
2021-07-24,15292,17626,-2334,-13.24,1198
2021-07-25,9150,10581,-1431,-13.52,1198
2021-07-26,18413,19515,-1102,-5.65,1198
2021-07-27,18348,19629,-1281,-6.53,1198
2021-07-28,18348,19601,-1253,-6.39,1198
2021-07-29,18348,19567,-1219,-6.23,1198
2021-07-30,19203,20693,-1490,-7.2,1198
2021-07-31,15292,17434,-2142,-12.29,1198
2021-08-01,8845,10350,-1505,-14.54,1198
2021-08-02,17471,19245,-1774,-9.22,1198
2021-08-03,17471,19322,-1851,-9.58,1198
2021-08-04,17471,19260,-1789,-9.29,1198
2021-08-05,17471,19197,-1726,-8.99,1198
2021-08-06,17995,20299,-2304,-11.35,1198
2021-08-07,14391,17024,-2633,-15.47,1198
2021-08-08,8845,9931,-1086,-10.94,1198
2021-08-09,17471,18824,-1353,-7.19,1198
2021-08-10,17471,18908,-1437,-7.6,1198
2021-08-11,17471,18862,-1391,-7.37,1198
2021-08-12,17471,18823,-1352,-7.18,1198
2021-08-13,17995,19958,-1963,-9.84,1198
2021-08-14,14391,16723,-2332,-13.94,1198
2021-08-15,8845,9676,-831,-8.59,1198
2021-08-16,17471,18622,-1151,-6.18,1198
2021-08-17,17471,18764,-1293,-6.89,1198
2021-08-18,17471,18780,-1309,-6.97,1198
2021-08-19,17471,18806,-1335,-7.1,1198
2021-08-20,17995,20006,-2011,-10.05,1198
2021-08-21,14391,16836,-2445,-14.52,1198
2021-08-22,8845,9854,-1009,-10.24,1198
2021-08-23,17471,18861,-1390,-7.37,1198
2021-08-24,17471,19060,-1589,-8.34,1198
2021-08-25,17471,19127,-1656,-8.66,1198
2021-08-26,17471,19198,-1727,-9.0,1198
2021-08-27,17995,20436,-2441,-11.94,1198
2021-08-28,14391,17297,-2906,-16.8,1198
2021-08-29,8845,10336,-1491,-14.43,1198
2021-08-30,17471,19356,-1885,-9.74,1198
2021-08-31,17471,19560,-2089,-10.68,1198
2021-09-01,18953,19623,-670,-3.41,1198
2021-09-02,18953,19681,-728,-3.7,1198
2021-09-03,19899,20900,-1001,-4.79,1198
2021-09-04,16311,17734,-1423,-8.02,1198
2021-09-05,10256,10741,-485,-4.52,1198
2021-09-06,18961,19725,-764,-3.87,1198
2021-09-07,18953,19888,-935,-4.7,1198
2021-09-08,18953,19909,-956,-4.8,1198
2021-09-09,18953,19924,-971,-4.87,1198
2021-09-10,19899,21099,-1200,-5.69,1198
2021-09-11,16311,17892,-1581,-8.84,1198
2021-09-12,10256,10859,-603,-5.55,1198
2021-09-13,18961,19808,-847,-4.28,1198
2021-09-14,18953,19940,-987,-4.95,1198
2021-09-15,18953,19936,-983,-4.93,1198
2021-09-16,18953,19932,-979,-4.91,1198
2021-09-17,19899,21095,-1196,-5.67,1198
2021-09-18,16311,17881,-1570,-8.78,1198
2021-09-19,10256,10850,-594,-5.47,1198
2021-09-20,18961,19806,-845,-4.27,1198
2021-09-21,18953,19951,-998,-5.0,1198
2021-09-22,18953,19966,-1013,-5.07,1198
2021-09-23,18953,19985,-1032,-5.16,1198
2021-09-24,19899,21175,-1276,-6.03,1198
2021-09-25,16311,17993,-1682,-9.35,1198
2021-09-26,10256,10993,-737,-6.7,1198
2021-09-27,18961,19982,-1021,-5.11,1198
2021-09-28,18953,20161,-1208,-5.99,1198
2021-09-29,18953,20206,-1253,-6.2,1198
2021-09-30,18953,20254,-1301,-6.42,1198
2021-10-01,20010,21470,-1460,-6.8,1198
2021-10-02,16390,18308,-1918,-10.48,1198
2021-10-03,9537,11324,-1787,-15.78,1198
2021-10-04,18828,20323,-1495,-7.36,1198
2021-10-05,18952,20506,-1554,-7.58,1198
2021-10-06,18952,20550,-1598,-7.78,1198
2021-10-07,18952,20590,-1638,-7.96,1198
2021-10-08,20010,21791,-1781,-8.17,1198
2021-10-09,16390,18609,-2219,-11.92,1198
2021-10-10,9537,11600,-2063,-17.78,1198
2021-10-11,18828,20569,-1741,-8.46,1198
2021-10-12,18952,20718,-1766,-8.52,1198
2021-10-13,18952,20725,-1773,-8.55,1198
2021-10-14,18952,20726,-1774,-8.56,1198
2021-10-15,20010,21888,-1878,-8.58,1198
2021-10-16,16390,18667,-2277,-12.2,1198
2021-10-17,9537,11619,-2082,-17.92,1198
2021-10-18,18828,20552,-1724,-8.39,1198
2021-10-19,18952,20668,-1716,-8.3,1198
2021-10-20,18952,20646,-1694,-8.2,1198
2021-10-21,18952,20622,-1670,-8.1,1198
2021-10-22,20010,21764,-1754,-8.06,1198
2021-10-23,16390,18528,-2138,-11.54,1198
2021-10-24,9537,11472,-1935,-16.87,1198
2021-10-25,18828,20402,-1574,-7.71,1198
2021-10-26,18952,20520,-1568,-7.64,1198
2021-10-27,18952,20505,-1553,-7.57,1198
2021-10-28,18952,20493,-1541,-7.52,1198
2021-10-29,20010,21651,-1641,-7.58,1198
2021-10-30,16390,18435,-2045,-11.09,1198
2021-10-31,9537,11401,-1864,-16.35,1198
2021-11-01,17770,20355,-2585,-12.7,1198
2021-11-02,18226,20497,-2271,-11.08,1198
2021-11-03,18226,20507,-2281,-11.12,1198
2021-11-04,18226,20518,-2292,-11.17,1198
2021-11-05,19754,21697,-1943,-8.96,1198
2021-11-06,15531,18499,-2968,-16.04,1198
2021-11-07,9041,11479,-2438,-21.24,1198
2021-11-08,17770,20442,-2672,-13.07,1198
2021-11-09,18226,20590,-2364,-11.48,1198
2021-11-10,18226,20599,-2373,-11.52,1198
2021-11-11,18226,20605,-2379,-11.55,1198
2021-11-12,19754,21774,-2020,-9.28,1198
2021-11-13,15531,18560,-3029,-16.32,1198
2021-11-14,9041,11520,-2479,-21.52,1198
2021-11-15,17770,20460,-2690,-13.15,1198
2021-11-16,18226,20580,-2354,-11.44,1198
2021-11-17,18226,20559,-2333,-11.35,1198
2021-11-18,18226,20533,-2307,-11.24,1198
2021-11-19,19754,21669,-1915,-8.84,1198
2021-11-20,15531,18422,-2891,-15.69,1198
2021-11-21,9041,11351,-2310,-20.35,1198
2021-11-22,17770,20261,-2491,-12.29,1198
2021-11-23,18226,20355,-2129,-10.46,1198
2021-11-24,18226,20311,-2085,-10.27,1198
2021-11-25,18226,20267,-2041,-10.07,1198
2021-11-26,19754,21389,-1635,-7.64,1198
2021-11-27,15531,18135,-2604,-14.36,1198
2021-11-28,9041,11062,-2021,-18.27,1198
2021-11-29,17770,19975,-2205,-11.04,1198
2021-11-30,18226,20078,-1852,-9.22,1198
2021-12-01,18512,20049,-1537,-7.67,1198
2021-12-02,18512,20025,-1513,-7.56,1198
2021-12-03,17841,21171,-3330,-15.73,1198
2021-12-04,15010,17944,-2934,-16.35,1198
2021-12-05,8560,10900,-2340,-21.47,1198
2021-12-06,18772,19845,-1073,-5.41,1198
2021-12-07,18512,19980,-1468,-7.35,1198
2021-12-08,18512,19981,-1469,-7.35,1198
2021-12-09,18512,19986,-1474,-7.38,1198
2021-12-10,17841,21158,-3317,-15.68,1198
2021-12-11,15010,17953,-2943,-16.39,1198
2021-12-12,8560,10926,-2366,-21.65,1198
2021-12-13,18772,19881,-1109,-5.58,1198
2021-12-14,18512,20020,-1508,-7.53,1198
2021-12-15,18512,20019,-1507,-7.53,1198
2021-12-16,18512,20013,-1501,-7.5,1198
2021-12-17,17841,21167,-3326,-15.71,1198
2021-12-18,15010,17937,-2927,-16.32,1198
2021-12-19,8560,10877,-2317,-21.3,1198
2021-12-20,18772,19794,-1022,-5.16,1198
2021-12-21,18512,19887,-1375,-6.91,1198
2021-12-22,18512,19836,-1324,-6.67,1198
2021-12-23,18512,19776,-1264,-6.39,1198
2021-12-24,17841,20873,-3032,-14.53,1198
2021-12-25,15010,17583,-2573,-14.63,1198
2021-12-26,8560,10465,-1905,-18.2,1198
2021-12-27,18772,19324,-552,-2.86,1198
2021-12-28,18512,19362,-850,-4.39,1198
2021-12-29,18512,19260,-748,-3.88,1198
2021-12-30,18512,19154,-642,-3.35,1198
2021-12-31,17841,20212,-2371,-11.73,1198
2022-01-01,13901,16891,-2990,-17.7,1198
2022-01-02,8016,9749,-1733,-17.78,1198
2022-01-03,17059,18593,-1534,-8.25,1198
2022-01-04,17205,18627,-1422,-7.63,1198
2022-01-05,17205,18529,-1324,-7.15,1198
2022-01-06,17205,18438,-1233,-6.69,1198
2022-01-07,18062,19520,-1458,-7.47,1198
2022-01-08,13901,16232,-2331,-14.36,1198
2022-01-09,8016,9133,-1117,-12.23,1198
2022-01-10,17059,18027,-968,-5.37,1198
2022-01-11,17205,18117,-912,-5.03,1198
2022-01-12,17205,18082,-877,-4.85,1198
2022-01-13,17205,18057,-852,-4.72,1198
2022-01-14,18062,19208,-1146,-5.97,1198
2022-01-15,13901,15991,-2090,-13.07,1198
2022-01-16,8016,8963,-947,-10.57,1198
2022-01-17,17059,17926,-867,-4.84,1198
2022-01-18,17205,18083,-878,-4.86,1198
2022-01-19,17205,18111,-906,-5.0,1198
2022-01-20,17205,18144,-939,-5.18,1198
2022-01-21,18062,19347,-1285,-6.64,1198
2022-01-22,13901,16176,-2275,-14.06,1198
2022-01-23,8016,9185,-1169,-12.73,1198
2022-01-24,17059,18178,-1119,-6.16,1198
2022-01-25,17205,18357,-1152,-6.28,1198
2022-01-26,17205,18399,-1194,-6.49,1198
2022-01-27,17205,18438,-1233,-6.69,1198
2022-01-28,18062,19640,-1578,-8.03,1198
2022-01-29,13901,16460,-2559,-15.55,1198
2022-01-30,8016,9455,-1439,-15.22,1198
2020-02-01,12529,11318,1211,10.7,1617
2020-02-02,10036,8849,1187,13.41,1617
2020-02-03,13586,14299,-713,-4.99,1617
2020-02-04,14379,14450,-71,-0.49,1617
2020-02-05,14379,14470,-91,-0.63,1617
2020-02-06,14379,14500,-121,-0.83,1617
2020-02-07,15393,15221,172,1.13,1617
2020-02-08,12529,11443,1086,9.49,1617
2020-02-09,10036,8950,1086,12.13,1617
2020-02-10,13586,14378,-792,-5.51,1617
2020-02-11,14379,14511,-132,-0.91,1617
2020-02-12,14379,14516,-137,-0.94,1617
2020-02-13,14379,14536,-157,-1.08,1617
2020-02-14,15393,15251,142,0.93,1617
2020-02-15,12529,11472,1057,9.21,1617
2020-02-16,10036,8983,1053,11.72,1617
2020-02-17,13586,14419,-833,-5.78,1617
2020-02-18,14379,14565,-186,-1.28,1617
2020-02-19,14379,14587,-208,-1.43,1617
2020-02-20,14379,14627,-248,-1.7,1617
2020-02-21,15393,15366,27,0.18,1617
2020-02-22,12529,11613,916,7.89,1617
2020-02-23,10036,9151,885,9.67,1617
2020-02-24,13586,14615,-1029,-7.04,1617
2020-02-25,14379,14789,-410,-2.77,1617
2020-02-26,14379,14838,-459,-3.09,1617
2020-02-27,14379,14903,-524,-3.52,1617
2020-02-28,15393,15664,-271,-1.73,1617
2020-02-29,12529,11929,600,5.03,1617
2020-03-01,7618,9483,-1865,-19.67,1617
2020-03-02,11005,14958,-3953,-26.43,1617
2020-03-03,11120,15137,-4017,-26.54,1617
2020-03-04,11120,15187,-4067,-26.78,1617
2020-03-05,11120,15248,-4128,-27.07,1617
2020-03-06,12024,16000,-3976,-24.85,1617
2020-03-07,9030,12251,-3221,-26.29,1617
2020-03-08,7618,9786,-2168,-22.15,1617
2020-03-09,11005,15238,-4233,-27.78,1617
2020-03-10,11120,15392,-4272,-27.75,1617
2020-03-11,11120,15412,-4292,-27.85,1617
2020-03-12,11120,15442,-4322,-27.99,1617
2020-03-13,12024,16161,-4137,-25.6,1617
2020-03-14,9030,12378,-3348,-27.05,1617
2020-03-15,7618,9880,-2262,-22.89,1617
2020-03-16,11005,15299,-4294,-28.07,1617
2020-03-17,11120,15422,-4302,-27.9,1617
2020-03-18,11120,15413,-4293,-27.85,1617
2020-03-19,11120,15416,-4296,-27.87,1617
2020-03-20,12024,16112,-4088,-25.37,1617
2020-03-21,9030,12310,-3280,-26.65,1617
2020-03-22,7618,9797,-2179,-22.24,1617
2020-03-23,11005,15205,-4200,-27.62,1617
2020-03-24,11120,15320,-4200,-27.42,1617
2020-03-25,11120,15308,-4188,-27.36,1617
2020-03-26,11120,15312,-4192,-27.38,1617
2020-03-27,12024,16013,-3989,-24.91,1617
2020-03-28,9030,12218,-3188,-26.09,1617
2020-03-29,7618,9714,-2096,-21.58,1617
2020-03-30,11005,15135,-4130,-27.29,1617
2020-03-31,11120,15264,-4144,-27.15,1617
2020-04-01,10516,15268,-4752,-31.12,1617
2020-04-02,10516,15287,-4771,-31.21,1617
2020-04-03,10424,16003,-5579,-34.86,1617
2020-04-04,8513,12224,-3711,-30.36,1617
2020-04-05,5919,9734,-3815,-39.19,1617
2020-04-06,10542,15166,-4624,-30.49,1617
2020-04-07,10516,15305,-4789,-31.29,1617
2020-04-08,10516,15316,-4800,-31.34,1617
2020-04-09,10516,15340,-4824,-31.45,1617
2020-04-10,10424,16059,-5635,-35.09,1617
2020-04-11,8513,12278,-3765,-30.66,1617
2020-04-12,5919,9785,-3866,-39.51,1617
2020-04-13,10542,15212,-4670,-30.7,1617
2020-04-14,10516,15343,-4827,-31.46,1617
2020-04-15,10516,15345,-4829,-31.47,1617
2020-04-16,10516,15358,-4842,-31.53,1617
2020-04-17,10424,16064,-5640,-35.11,1617
2020-04-18,8513,12272,-3759,-30.63,1617
2020-04-19,5919,9766,-3847,-39.39,1617
2020-04-20,10542,15180,-4638,-30.55,1617
2020-04-21,10516,15300,-4784,-31.27,1617
2020-04-22,10516,15291,-4775,-31.23,1617
2020-04-23,10516,15295,-4779,-31.25,1617
2020-04-24,10424,15995,-5571,-34.83,1617
2020-04-25,8513,12197,-3684,-30.2,1617
2020-04-26,5919,9688,-3769,-38.9,1617
2020-04-27,10542,15102,-4560,-30.19,1617
2020-04-28,10516,15223,-4707,-30.92,1617
2020-04-29,10516,15218,-4702,-30.9,1617
2020-04-30,10516,15228,-4712,-30.94,1617
2020-05-01,14220,15934,-1714,-10.76,1617
2020-05-02,11949,12145,-196,-1.61,1617
2020-05-03,9203,9645,-442,-4.58,1617
2020-05-04,13653,15069,-1416,-9.4,1617
2020-05-05,13982,15200,-1218,-8.01,1617
2020-05-06,13982,15205,-1223,-8.04,1617
2020-05-07,13982,15224,-1242,-8.16,1617
2020-05-08,14220,15938,-1718,-10.78,1617
2020-05-09,11949,12156,-207,-1.7,1617
2020-05-10,9203,9661,-458,-4.74,1617
2020-05-11,13653,15088,-1435,-9.51,1617
2020-05-12,13982,15221,-1239,-8.14,1617
2020-05-13,13982,15224,-1242,-8.16,1617
2020-05-14,13982,15241,-1259,-8.26,1617
2020-05-15,14220,15950,-1730,-10.85,1617
2020-05-16,11949,12162,-213,-1.75,1617
2020-05-17,9203,9660,-457,-4.73,1617
2020-05-18,13653,15079,-1426,-9.46,1617
2020-05-19,13982,15202,-1220,-8.03,1617
2020-05-20,13982,15197,-1215,-7.99,1617
2020-05-21,13982,15204,-1222,-8.04,1617
2020-05-22,14220,15906,-1686,-10.6,1617
2020-05-23,11949,12111,-162,-1.34,1617
2020-05-24,9203,9604,-401,-4.18,1617
2020-05-25,13653,15020,-1367,-9.1,1617
2020-05-26,13982,15143,-1161,-7.67,1617
2020-05-27,13982,15140,-1158,-7.65,1617
2020-05-28,13982,15153,-1171,-7.73,1617
2020-05-29,14220,15863,-1643,-10.36,1617
2020-05-30,11949,12078,-129,-1.07,1617
2020-05-31,9203,9585,-382,-3.99,1617
2020-06-01,14683,15016,-333,-2.22,1617
2020-06-02,15418,15156,262,1.73,1617
2020-06-03,15418,15171,247,1.63,1617
2020-06-04,15418,15203,215,1.41,1617
2020-06-05,14983,15932,-949,-5.96,1617
2020-06-06,11962,12166,-204,-1.68,1617
2020-06-07,9729,9689,40,0.41,1617
2020-06-08,14683,15135,-452,-2.99,1617
2020-06-09,15418,15287,131,0.86,1617
2020-06-10,15418,15309,109,0.71,1617
2020-06-11,15418,15344,74,0.48,1617
2020-06-12,14983,16071,-1088,-6.77,1617
2020-06-13,11962,12296,-334,-2.72,1617
2020-06-14,9729,9805,-76,-0.78,1617
2020-06-15,14683,15230,-547,-3.59,1617
2020-06-16,15418,15355,63,0.41,1617
2020-06-17,15418,15344,74,0.48,1617
2020-06-18,15418,15339,79,0.52,1617
2020-06-19,14983,16021,-1038,-6.48,1617
2020-06-20,11962,12196,-234,-1.92,1617
2020-06-21,9729,9650,79,0.82,1617
2020-06-22,14683,15018,-335,-2.23,1617
2020-06-23,15418,15082,336,2.23,1617
2020-06-24,15418,15009,409,2.73,1617
2020-06-25,15418,14943,475,3.18,1617
2020-06-26,14983,15564,-581,-3.73,1617
2020-06-27,11962,11682,280,2.4,1617
2020-06-28,9729,9083,646,7.11,1617
2020-06-29,14683,14401,282,1.96,1617
2020-06-30,15418,14423,995,6.9,1617
2020-07-01,14574,14316,258,1.8,1617
2020-07-02,14574,14222,352,2.48,1617
2020-07-03,15029,14826,203,1.37,1617
2020-07-04,11979,10935,1044,9.55,1617
2020-07-05,10537,8337,2200,26.39,1617
2020-07-06,13977,13666,311,2.28,1617
2020-07-07,14574,13709,865,6.31,1617
2020-07-08,14574,13632,942,6.91,1617
2020-07-09,14574,13578,996,7.34,1617
2020-07-10,15029,14229,800,5.62,1617
2020-07-11,11979,10393,1586,15.26,1617
2020-07-12,10537,7856,2681,34.13,1617
2020-07-13,13977,13251,726,5.48,1617
2020-07-14,14574,13362,1212,9.07,1617
2020-07-15,14574,13356,1218,9.12,1617
2020-07-16,14574,13372,1202,8.99,1617
2020-07-17,15029,14092,937,6.65,1617
2020-07-18,11979,10323,1656,16.04,1617
2020-07-19,10537,7847,2690,34.28,1617
2020-07-20,13977,13299,678,5.1,1617
2020-07-21,14574,13460,1114,8.28,1617
2020-07-22,14574,13495,1079,8.0,1617
2020-07-23,14574,13545,1029,7.6,1617
2020-07-24,15029,14289,740,5.18,1617
2020-07-25,11979,10533,1446,13.73,1617
2020-07-26,10537,8062,2475,30.7,1617
2020-07-27,13977,13508,469,3.47,1617
2020-07-28,14574,13655,919,6.73,1617
2020-07-29,14574,13667,907,6.64,1617
2020-07-30,14574,13687,887,6.48,1617
2020-07-31,15029,14394,635,4.41,1617
2020-08-01,11787,10596,1191,11.24,1617
2020-08-02,10186,8079,2107,26.08,1617
2020-08-03,13743,13478,265,1.97,1617
2020-08-04,13960,13576,384,2.83,1617
2020-08-05,13960,13541,419,3.09,1617
2020-08-06,13960,13517,443,3.28,1617
2020-08-07,14628,14184,444,3.13,1617
2020-08-08,11787,10352,1435,13.86,1617
2020-08-09,10186,7809,2377,30.44,1617
2020-08-10,13743,13189,554,4.2,1617
2020-08-11,13960,13279,681,5.13,1617
2020-08-12,13960,13246,714,5.39,1617
2020-08-13,13960,13234,726,5.49,1617
2020-08-14,14628,13924,704,5.06,1617
2020-08-15,11787,10127,1660,16.39,1617
2020-08-16,10186,7629,2557,33.52,1617
2020-08-17,13743,13064,679,5.2,1617
2020-08-18,13960,13219,741,5.61,1617
2020-08-19,13960,13258,702,5.29,1617
2020-08-20,13960,13325,635,4.77,1617
2020-08-21,14628,14100,528,3.74,1617
2020-08-22,11787,10391,1396,13.43,1617
2020-08-23,10186,7983,2203,27.6,1617
2020-08-24,13743,13510,233,1.72,1617
2020-08-25,13960,13753,207,1.51,1617
2020-08-26,13960,13878,82,0.59,1617
2020-08-27,13960,14025,-65,-0.46,1617
2020-08-28,14628,14874,-246,-1.65,1617
2020-08-29,11787,11230,557,4.96,1617
2020-08-30,10186,8878,1308,14.73,1617
2020-08-31,13743,14449,-706,-4.89,1617
2020-09-01,15183,14726,457,3.1,1617
2020-09-02,15183,14872,311,2.09,1617
2020-09-03,15183,15029,154,1.02,1617
2020-09-04,15558,15874,-316,-1.99,1617
2020-09-05,12706,12215,491,4.02,1617
2020-09-06,10370,9835,535,5.44,1617
2020-09-07,14699,15367,-668,-4.35,1617
2020-09-08,15183,15595,-412,-2.64,1617
2020-09-09,15183,15683,-500,-3.19,1617
2020-09-10,15183,15773,-590,-3.74,1617
2020-09-11,15558,16547,-989,-5.98,1617
2020-09-12,12706,12810,-104,-0.81,1617
2020-09-13,10370,10350,20,0.19,1617
2020-09-14,14699,15801,-1102,-6.97,1617
2020-09-15,15183,15947,-764,-4.79,1617
2020-09-16,15183,15955,-772,-4.84,1617
2020-09-17,15183,15968,-785,-4.92,1617
2020-09-18,15558,16668,-1110,-6.66,1617
2020-09-19,12706,12864,-158,-1.23,1617
2020-09-20,10370,10344,26,0.25,1617
2020-09-21,14699,15741,-1042,-6.62,1617
2020-09-22,15183,15841,-658,-4.15,1617
2020-09-23,15183,15812,-629,-3.98,1617
2020-09-24,15183,15796,-613,-3.88,1617
2020-09-25,15558,16476,-918,-5.57,1617
2020-09-26,12706,12660,46,0.36,1617
2020-09-27,10370,10135,235,2.32,1617
2020-09-28,14699,15535,-836,-5.38,1617
2020-09-29,15183,15644,-461,-2.95,1617
2020-09-30,15183,15629,-446,-2.85,1617
2020-10-01,14905,15632,-727,-4.65,1617
2020-10-02,15453,16335,-882,-5.4,1617
2020-10-03,12595,12544,51,0.41,1617
2020-10-04,9975,10045,-70,-0.7,1617
2020-10-05,14956,15471,-515,-3.33,1617
2020-10-06,14905,15607,-702,-4.5,1617
2020-10-07,14905,15616,-711,-4.55,1617
2020-10-08,14905,15642,-737,-4.71,1617
2020-10-09,15453,16364,-911,-5.57,1617
2020-10-10,12595,12590,5,0.04,1617
2020-10-11,9975,10103,-128,-1.27,1617
2020-10-12,14956,15539,-583,-3.75,1617
2020-10-13,14905,15679,-774,-4.94,1617
2020-10-14,14905,15690,-785,-5.0,1617
2020-10-15,14905,15714,-809,-5.15,1617
2020-10-16,15453,16430,-977,-5.95,1617
2020-10-17,12595,12647,-52,-0.41,1617
2020-10-18,9975,10150,-175,-1.72,1617
2020-10-19,14956,15573,-617,-3.96,1617
2020-10-20,14905,15701,-796,-5.07,1617
2020-10-21,14905,15698,-793,-5.05,1617
2020-10-22,14905,15708,-803,-5.11,1617
2020-10-23,15453,16412,-959,-5.84,1617
2020-10-24,12595,12617,-22,-0.17,1617
2020-10-25,9975,10111,-136,-1.35,1617
2020-10-26,14956,15527,-571,-3.68,1617
2020-10-27,14905,15650,-745,-4.76,1617
2020-10-28,14905,15645,-740,-4.73,1617
2020-10-29,14905,15656,-751,-4.8,1617
2020-10-30,15453,16363,-910,-5.56,1617
2020-10-31,12595,12575,20,0.16,1617
2020-11-01,8405,10077,-1672,-16.59,1617
2020-11-02,13717,15503,-1786,-11.52,1617
2020-11-03,12734,15638,-2904,-18.57,1617
2020-11-04,12734,15646,-2912,-18.61,1617
2020-11-05,12734,15670,-2936,-18.74,1617
2020-11-06,13852,16391,-2539,-15.49,1617
2020-11-07,10507,12615,-2108,-16.71,1617
2020-11-08,8405,10128,-1723,-17.01,1617
2020-11-09,13717,15564,-1847,-11.87,1617
2020-11-10,12734,15705,-2971,-18.92,1617
2020-11-11,12734,15718,-2984,-18.98,1617
2020-11-12,12734,15744,-3010,-19.12,1617
2020-11-13,13852,16463,-2611,-15.86,1617
2020-11-14,10507,12682,-2175,-17.15,1617
2020-11-15,8405,10188,-1783,-17.5,1617
2020-11-16,13717,15612,-1895,-12.14,1617
2020-11-17,12734,15739,-3005,-19.09,1617
2020-11-18,12734,15735,-3001,-19.07,1617
2020-11-19,12734,15742,-3008,-19.11,1617
2020-11-20,13852,16441,-2589,-15.75,1617
2020-11-21,10507,12639,-2132,-16.87,1617
2020-11-22,8405,10122,-1717,-16.96,1617
2020-11-23,13717,15525,-1808,-11.65,1617
2020-11-24,12734,15631,-2897,-18.53,1617
2020-11-25,12734,15608,-2874,-18.41,1617
2020-11-26,12734,15597,-2863,-18.36,1617
2020-11-27,13852,16281,-2429,-14.92,1617
2020-11-28,10507,12467,-1960,-15.72,1617
2020-11-29,8405,9942,-1537,-15.46,1617
2020-11-30,13717,15341,-1624,-10.59,1617
2020-12-01,13458,15446,-1988,-12.87,1617
2020-12-02,13458,15426,-1968,-12.76,1617
2020-12-03,13458,15423,-1965,-12.74,1617
2020-12-04,14783,16117,-1334,-8.28,1617
2020-12-05,11636,12317,-681,-5.53,1617
2020-12-06,8437,9808,-1371,-13.98,1617
2020-12-07,13667,15225,-1558,-10.23,1617
2020-12-08,13458,15350,-1892,-12.33,1617
2020-12-09,13458,15350,-1892,-12.33,1617
2020-12-10,13458,15367,-1909,-12.42,1617
2020-12-11,14783,16081,-1298,-8.07,1617
2020-12-12,11636,12298,-662,-5.38,1617
2020-12-13,8437,9805,-1368,-13.95,1617
2020-12-14,13667,15234,-1567,-10.29,1617
2020-12-15,13458,15367,-1909,-12.42,1617
2020-12-16,13458,15372,-1914,-12.45,1617
2020-12-17,13458,15388,-1930,-12.54,1617
2020-12-18,14783,16095,-1312,-8.15,1617
2020-12-19,11636,12302,-666,-5.41,1617
2020-12-20,8437,9792,-1355,-13.84,1617
2020-12-21,13667,15200,-1533,-10.09,1617
2020-12-22,13458,15307,-1849,-12.08,1617
2020-12-23,13458,15281,-1823,-11.93,1617
2020-12-24,13458,15263,-1805,-11.83,1617
2020-12-25,14783,15934,-1151,-7.22,1617
2020-12-26,11636,12102,-466,-3.85,1617
2020-12-27,8437,9552,-1115,-11.67,1617
2020-12-28,13667,14919,-1252,-8.39,1617
2020-12-29,13458,14987,-1529,-10.2,1617
2020-12-30,13458,14923,-1465,-9.82,1617
2020-12-31,13458,14870,-1412,-9.5,1617
2021-01-01,12840,15509,-2669,-17.21,1617
2021-01-02,9919,11650,-1731,-14.86,1617
2021-01-03,7664,9079,-1415,-15.59,1617
2021-01-04,11948,14430,-2482,-17.2,1617
2021-01-05,12321,14490,-2169,-14.97,1617
2021-01-06,12321,14424,-2103,-14.58,1617
2021-01-07,12321,14377,-2056,-14.3,1617
2021-01-08,12840,15029,-2189,-14.57,1617
2021-01-09,9919,11190,-1271,-11.36,1617
2021-01-10,7664,8646,-982,-11.36,1617
2021-01-11,11948,14032,-2084,-14.85,1617
2021-01-12,12321,14131,-1810,-12.81,1617
2021-01-13,12321,14110,-1789,-12.68,1617
2021-01-14,12321,14111,-1790,-12.69,1617
2021-01-15,12840,14815,-1975,-13.33,1617
2021-01-16,9919,11031,-1112,-10.08,1617
2021-01-17,7664,8542,-878,-10.28,1617
2021-01-18,11948,13982,-2034,-14.55,1617
2021-01-19,12321,14135,-1814,-12.83,1617
2021-01-20,12321,14166,-1845,-13.02,1617
2021-01-21,12321,14216,-1895,-13.33,1617
2021-01-22,12840,14965,-2125,-14.2,1617
2021-01-23,9919,11220,-1301,-11.6,1617
2021-01-24,7664,8765,-1101,-12.56,1617
2021-01-25,11948,14234,-2286,-16.06,1617
2021-01-26,12321,14408,-2087,-14.49,1617
2021-01-27,12321,14454,-2133,-14.76,1617
2021-01-28,12321,14513,-2192,-15.1,1617
2021-01-29,12840,15264,-2424,-15.88,1617
2021-01-30,9919,11515,-1596,-13.86,1617
2021-01-31,7664,9052,-1388,-15.33,1617
2021-02-01,13621,14506,-885,-6.1,1617
2021-02-02,13786,14662,-876,-5.97,1617
2021-02-03,13786,14687,-901,-6.13,1617
2021-02-04,13786,14721,-935,-6.35,1617
2021-02-05,14588,15447,-859,-5.56,1617
2021-02-06,11599,11672,-73,-0.63,1617
2021-02-07,8982,9183,-201,-2.19,1617
2021-02-08,13621,14613,-992,-6.79,1617
2021-02-09,13786,14747,-961,-6.52,1617
2021-02-10,13786,14752,-966,-6.55,1617
2021-02-11,13786,14771,-985,-6.67,1617
2021-02-12,14588,15485,-897,-5.79,1617
2021-02-13,11599,11703,-104,-0.89,1617
2021-02-14,8982,9212,-230,-2.5,1617
2021-02-15,13621,14644,-1023,-6.99,1617
2021-02-16,13786,14786,-1000,-6.76,1617
2021-02-17,13786,14803,-1017,-6.87,1617
2021-02-18,13786,14838,-1052,-7.09,1617
2021-02-19,14588,15572,-984,-6.32,1617
2021-02-20,11599,11812,-213,-1.8,1617
2021-02-21,8982,9346,-364,-3.89,1617
2021-02-22,13621,14805,-1184,-8.0,1617
2021-02-23,13786,14975,-1189,-7.94,1617
2021-02-24,13786,15020,-1234,-8.22,1617
2021-02-25,13786,15082,-1296,-8.59,1617
2021-02-26,14588,15841,-1253,-7.91,1617
2021-02-27,11599,12105,-506,-4.18,1617
2021-02-28,8982,9658,-676,-7.0,1617
2021-03-01,14005,15134,-1129,-7.46,1617
2021-03-02,14324,15315,-991,-6.47,1617
2021-03-03,14324,15367,-1043,-6.79,1617
2021-03-04,14324,15431,-1107,-7.17,1617
2021-03-05,14780,16187,-1407,-8.69,1617
2021-03-06,12268,12443,-175,-1.41,1617
2021-03-07,9236,9984,-748,-7.49,1617
2021-03-08,14005,15442,-1437,-9.31,1617
2021-03-09,14324,15601,-1277,-8.19,1617
2021-03-10,14324,15628,-1304,-8.34,1617
2021-03-11,14324,15664,-1340,-8.55,1617
2021-03-12,14780,16389,-1609,-9.82,1617
2021-03-13,12268,12613,-345,-2.74,1617
2021-03-14,9236,10120,-884,-8.74,1617
2021-03-15,14005,15544,-1539,-9.9,1617
2021-03-16,14324,15671,-1347,-8.6,1617
2021-03-17,14324,15666,-1342,-8.57,1617
2021-03-18,14324,15672,-1348,-8.6,1617
2021-03-19,14780,16370,-1590,-9.71,1617
2021-03-20,12268,12570,-302,-2.4,1617
2021-03-21,9236,10056,-820,-8.15,1617
2021-03-22,14005,15464,-1459,-9.43,1617
2021-03-23,14324,15578,-1254,-8.05,1617
2021-03-24,14324,15565,-1241,-7.97,1617
2021-03-25,14324,15567,-1243,-7.98,1617
2021-03-26,14780,16265,-1485,-9.13,1617
2021-03-27,12268,12468,-200,-1.6,1617
2021-03-28,9236,9962,-726,-7.29,1617
2021-03-29,14005,15379,-1374,-8.93,1617
2021-03-30,14324,15506,-1182,-7.62,1617
2021-03-31,14324,15506,-1182,-7.62,1617
2021-04-01,13408,15523,-2115,-13.62,1617
2021-04-02,14265,16237,-1972,-12.15,1617
2021-04-03,11249,12455,-1206,-9.68,1617
2021-04-04,8908,9964,-1056,-10.6,1617
2021-04-05,13334,15395,-2061,-13.39,1617
2021-04-06,13408,15534,-2126,-13.69,1617
2021-04-07,13408,15545,-2137,-13.75,1617
2021-04-08,13408,15570,-2162,-13.89,1617
2021-04-09,14265,16289,-2024,-12.43,1617
2021-04-10,11249,12510,-1261,-10.08,1617
2021-04-11,8908,10019,-1111,-11.09,1617
2021-04-12,13334,15448,-2114,-13.68,1617
2021-04-13,13408,15581,-2173,-13.95,1617
2021-04-14,13408,15585,-2177,-13.97,1617
2021-04-15,13408,15601,-2193,-14.06,1617
2021-04-16,14265,16310,-2045,-12.54,1617
2021-04-17,11249,12519,-1270,-10.14,1617
2021-04-18,8908,10015,-1107,-11.05,1617
2021-04-19,13334,15432,-2098,-13.6,1617
2021-04-20,13408,15553,-2145,-13.79,1617
2021-04-21,13408,15544,-2136,-13.74,1617
2021-04-22,13408,15550,-2142,-13.77,1617
2021-04-23,14265,16249,-1984,-12.21,1617
2021-04-24,11249,12451,-1202,-9.65,1617
2021-04-25,8908,9942,-1034,-10.4,1617
2021-04-26,13334,15355,-2021,-13.16,1617
2021-04-27,13408,15474,-2066,-13.35,1617
2021-04-28,13408,15467,-2059,-13.31,1617
2021-04-29,13408,15475,-2067,-13.36,1617
2021-04-30,14265,16180,-1915,-11.84,1617
2021-05-01,12957,12389,568,4.58,1617
2021-05-02,9696,9887,-191,-1.93,1617
2021-05-03,15067,15309,-242,-1.58,1617
2021-05-04,15143,15439,-296,-1.92,1617
2021-05-05,15143,15442,-299,-1.94,1617
2021-05-06,15143,15460,-317,-2.05,1617
2021-05-07,15575,16174,-599,-3.7,1617
2021-05-08,12957,12391,566,4.57,1617
2021-05-09,9696,9896,-200,-2.02,1617
2021-05-10,15067,15324,-257,-1.68,1617
2021-05-11,15143,15457,-314,-2.03,1617
2021-05-12,15143,15462,-319,-2.06,1617
2021-05-13,15143,15480,-337,-2.18,1617
2021-05-14,15575,16191,-616,-3.8,1617
2021-05-15,12957,12404,553,4.46,1617
2021-05-16,9696,9904,-208,-2.1,1617
2021-05-17,15067,15325,-258,-1.68,1617
2021-05-18,15143,15450,-307,-1.99,1617
2021-05-19,15143,15446,-303,-1.96,1617
2021-05-20,15143,15454,-311,-2.01,1617
2021-05-21,15575,16157,-582,-3.6,1617
2021-05-22,12957,12362,595,4.81,1617
2021-05-23,9696,9855,-159,-1.61,1617
2021-05-24,15067,15270,-203,-1.33,1617
2021-05-25,15143,15392,-249,-1.62,1617
2021-05-26,15143,15387,-244,-1.59,1617
2021-05-27,15143,15397,-254,-1.65,1617
2021-05-28,15575,16104,-529,-3.28,1617
2021-05-29,12957,12316,641,5.2,1617
2021-05-30,9696,9819,-123,-1.25,1617
2021-05-31,15067,15247,-180,-1.18,1617
2021-06-01,15421,15384,37,0.24,1617
2021-06-02,15421,15395,26,0.17,1617
2021-06-03,15421,15424,-3,-0.02,1617
2021-06-04,15694,16150,-456,-2.82,1617
2021-06-05,12626,12381,245,1.98,1617
2021-06-06,10620,9903,717,7.24,1617
2021-06-07,15036,15348,-312,-2.03,1617
2021-06-08,15421,15499,-78,-0.5,1617
2021-06-09,15421,15523,-102,-0.66,1617
2021-06-10,15421,15560,-139,-0.89,1617
2021-06-11,15694,16290,-596,-3.66,1617
2021-06-12,12626,12521,105,0.84,1617
2021-06-13,10620,10035,585,5.83,1617
2021-06-14,15036,15468,-432,-2.79,1617
2021-06-15,15421,15600,-179,-1.15,1617
2021-06-16,15421,15599,-178,-1.14,1617
2021-06-17,15421,15604,-183,-1.17,1617
2021-06-18,15694,16296,-602,-3.69,1617
2021-06-19,12626,12482,144,1.15,1617
2021-06-20,10620,9948,672,6.76,1617
2021-06-21,15036,15327,-291,-1.9,1617
2021-06-22,15421,15402,19,0.12,1617
2021-06-23,15421,15341,80,0.52,1617
2021-06-24,15421,15285,136,0.89,1617
2021-06-25,15694,15915,-221,-1.39,1617
2021-06-26,12626,12041,585,4.86,1617
2021-06-27,10620,9448,1172,12.4,1617
2021-06-28,15036,14772,264,1.79,1617
2021-06-29,15421,14798,623,4.21,1617
2021-06-30,15421,14692,729,4.96,1617
2021-07-01,13874,14599,-725,-4.97,1617
2021-07-02,14730,15200,-470,-3.09,1617
2021-07-03,10920,11306,-386,-3.41,1617
2021-07-04,8873,8702,171,1.97,1617
2021-07-05,13045,14025,-980,-6.99,1617
2021-07-06,13874,14059,-185,-1.32,1617
2021-07-07,13874,13972,-98,-0.7,1617
2021-07-08,13874,13907,-33,-0.24,1617
2021-07-09,14730,14546,184,1.26,1617
2021-07-10,10920,10697,223,2.08,1617
2021-07-11,8873,8146,727,8.92,1617
2021-07-12,13045,13528,-483,-3.57,1617
2021-07-13,13874,13627,247,1.81,1617
2021-07-14,13874,13608,266,1.95,1617
2021-07-15,13874,13613,261,1.92,1617
2021-07-16,14730,14322,408,2.85,1617
2021-07-17,10920,10543,377,3.58,1617
2021-07-18,8873,8060,813,10.09,1617
2021-07-19,13045,13505,-460,-3.41,1617
2021-07-20,13874,13662,212,1.55,1617
2021-07-21,13874,13694,180,1.31,1617
2021-07-22,13874,13743,131,0.95,1617
2021-07-23,14730,14487,243,1.68,1617
2021-07-24,10920,10734,186,1.73,1617
2021-07-25,8873,8268,605,7.32,1617
2021-07-26,13045,13720,-675,-4.92,1617
2021-07-27,13874,13873,1,0.01,1617
2021-07-28,13874,13893,-19,-0.14,1617
2021-07-29,13874,13921,-47,-0.34,1617
2021-07-30,14730,14637,93,0.64,1617
2021-07-31,10920,10849,71,0.65,1617
2021-08-01,9852,8341,1511,18.12,1617
2021-08-02,13555,13749,-194,-1.41,1617
2021-08-03,13870,13855,15,0.11,1617
2021-08-04,13870,13827,43,0.31,1617
2021-08-05,13870,13807,63,0.46,1617
2021-08-06,14430,14478,-48,-0.33,1617
2021-08-07,11907,10648,1259,11.82,1617
2021-08-08,9852,8105,1747,21.55,1617
2021-08-09,13555,13484,71,0.53,1617
2021-08-10,13870,13570,300,2.21,1617
2021-08-11,13870,13531,339,2.51,1617
2021-08-12,13870,13510,360,2.66,1617
2021-08-13,14430,14191,239,1.68,1617
2021-08-14,11907,10382,1525,14.69,1617
2021-08-15,9852,7870,1982,25.18,1617
2021-08-16,13555,13292,263,1.98,1617
2021-08-17,13870,13430,440,3.28,1617
2021-08-18,13870,13453,417,3.1,1617
2021-08-19,13870,13503,367,2.72,1617
2021-08-20,14430,14262,168,1.18,1617
2021-08-21,11907,10536,1371,13.01,1617
2021-08-22,9852,8112,1740,21.45,1617
2021-08-23,13555,13623,-68,-0.5,1617
2021-08-24,13870,13853,17,0.12,1617
2021-08-25,13870,13965,-95,-0.68,1617
2021-08-26,13870,14102,-232,-1.65,1617
2021-08-27,14430,14942,-512,-3.43,1617
2021-08-28,11907,11292,615,5.45,1617
2021-08-29,9852,8936,916,10.25,1617
2021-08-30,13555,14505,-950,-6.55,1617
2021-08-31,13870,14782,-912,-6.17,1617
2021-09-01,15902,14931,971,6.5,1617
2021-09-02,15902,15092,810,5.37,1617
2021-09-03,15809,15945,-136,-0.85,1617
2021-09-04,13466,12294,1172,9.53,1617
2021-09-05,11550,9925,1625,16.37,1617
2021-09-06,15470,15470,0,0.0,1617
2021-09-07,15902,15711,191,1.22,1617
2021-09-08,15902,15813,89,0.56,1617
2021-09-09,15902,15919,-17,-0.11,1617
2021-09-10,15809,16707,-898,-5.37,1617
2021-09-11,13466,12986,480,3.7,1617
2021-09-12,11550,10541,1009,9.57,1617
2021-09-13,15470,16006,-536,-3.35,1617
2021-09-14,15902,16165,-263,-1.63,1617
2021-09-15,15902,16186,-284,-1.75,1617
2021-09-16,15902,16210,-308,-1.9,1617
2021-09-17,15809,16920,-1111,-6.57,1617
2021-09-18,13466,13125,341,2.6,1617
2021-09-19,11550,10611,939,8.85,1617
2021-09-20,15470,16014,-544,-3.4,1617
2021-09-21,15902,16118,-216,-1.34,1617
2021-09-22,15902,16091,-189,-1.17,1617
2021-09-23,15902,16076,-174,-1.08,1617
2021-09-24,15809,16755,-946,-5.65,1617
2021-09-25,13466,12937,529,4.09,1617
2021-09-26,11550,10409,1141,10.96,1617
2021-09-27,15470,15805,-335,-2.12,1617
2021-09-28,15902,15910,-8,-0.05,1617
2021-09-29,15902,15891,11,0.07,1617
2021-09-30,15902,15889,13,0.08,1617
2021-10-01,16730,16586,144,0.87,1617
2021-10-02,14296,12790,1506,11.77,1617
2021-10-03,11219,10286,933,9.07,1617
2021-10-04,15354,15708,-354,-2.25,1617
2021-10-05,15697,15840,-143,-0.9,1617
2021-10-06,15697,15847,-150,-0.95,1617
2021-10-07,15697,15870,-173,-1.09,1617
2021-10-08,16730,16590,140,0.84,1617
2021-10-09,14296,12815,1481,11.56,1617
2021-10-10,11219,10328,891,8.63,1617
2021-10-11,15354,15764,-410,-2.6,1617
2021-10-12,15697,15906,-209,-1.31,1617
2021-10-13,15697,15918,-221,-1.39,1617
2021-10-14,15697,15944,-247,-1.55,1617
2021-10-15,16730,16663,67,0.4,1617
2021-10-16,14296,12882,1414,10.98,1617
2021-10-17,11219,10388,831,8.0,1617
2021-10-18,15354,15814,-460,-2.91,1617
2021-10-19,15697,15944,-247,-1.55,1617
2021-10-20,15697,15943,-246,-1.54,1617
2021-10-21,15697,15955,-258,-1.62,1617
2021-10-22,16730,16660,70,0.42,1617
2021-10-23,14296,12867,1429,11.11,1617
2021-10-24,11219,10361,858,8.28,1617
2021-10-25,15354,15777,-423,-2.68,1617
2021-10-26,15697,15899,-202,-1.27,1617
2021-10-27,15697,15893,-196,-1.23,1617
2021-10-28,15697,15902,-205,-1.29,1617
2021-10-29,16730,16608,122,0.73,1617
2021-10-30,14296,12817,1479,11.54,1617
2021-10-31,11219,10317,902,8.74,1617
2021-11-01,14420,15741,-1321,-8.39,1617
2021-11-02,15148,15872,-724,-4.56,1617
2021-11-03,15148,15878,-730,-4.6,1617
2021-11-04,15148,15900,-752,-4.73,1617
2021-11-05,15738,16619,-881,-5.3,1617
2021-11-06,13081,12841,240,1.87,1617
2021-11-07,10509,10354,155,1.5,1617
2021-11-08,14420,15789,-1369,-8.67,1617
2021-11-09,15148,15931,-783,-4.91,1617
2021-11-10,15148,15944,-796,-4.99,1617
2021-11-11,15148,15971,-823,-5.15,1617
2021-11-12,15738,16692,-954,-5.72,1617
2021-11-13,13081,12914,167,1.29,1617
2021-11-14,10509,10423,86,0.83,1617
2021-11-15,14420,15851,-1431,-9.03,1617
2021-11-16,15148,15982,-834,-5.22,1617
2021-11-17,15148,15982,-834,-5.22,1617
2021-11-18,15148,15993,-845,-5.28,1617
2021-11-19,15738,16696,-958,-5.74,1617
2021-11-20,13081,12898,183,1.42,1617
2021-11-21,10509,10385,124,1.19,1617
2021-11-22,14420,15791,-1371,-8.68,1617
2021-11-23,15148,15900,-752,-4.73,1617
2021-11-24,15148,15879,-731,-4.6,1617
2021-11-25,15148,15870,-722,-4.55,1617
2021-11-26,15738,16555,-817,-4.94,1617
2021-11-27,13081,12741,340,2.67,1617
2021-11-28,10509,10216,293,2.87,1617
2021-11-29,14420,15613,-1193,-7.64,1617
2021-11-30,15148,15717,-569,-3.62,1617
2021-12-01,14550,15694,-1144,-7.29,1617
2021-12-02,14550,15687,-1137,-7.25,1617
2021-12-03,14541,16378,-1837,-11.22,1617
2021-12-04,12451,12574,-123,-0.98,1617
2021-12-05,9538,10062,-524,-5.21,1617
2021-12-06,14652,15474,-822,-5.31,1617
2021-12-07,14550,15596,-1046,-6.71,1617
2021-12-08,14550,15593,-1043,-6.69,1617
2021-12-09,14550,15606,-1056,-6.77,1617
2021-12-10,14541,16318,-1777,-10.89,1617
2021-12-11,12451,12533,-82,-0.65,1617
2021-12-12,9538,10039,-501,-4.99,1617
2021-12-13,14652,15468,-816,-5.28,1617
2021-12-14,14550,15602,-1052,-6.74,1617
2021-12-15,14550,15608,-1058,-6.78,1617
2021-12-16,14550,15627,-1077,-6.89,1617
2021-12-17,14541,16339,-1798,-11.0,1617
2021-12-18,12451,12550,-99,-0.79,1617
2021-12-19,9538,10046,-508,-5.06,1617
2021-12-20,14652,15459,-807,-5.22,1617
2021-12-21,14550,15574,-1024,-6.58,1617
2021-12-22,14550,15555,-1005,-6.46,1617
2021-12-23,14550,15545,-995,-6.4,1617
2021-12-24,14541,16223,-1682,-10.37,1617
2021-12-25,12451,12398,53,0.43,1617
2021-12-26,9538,9856,-318,-3.23,1617
2021-12-27,14652,15229,-577,-3.79,1617
2021-12-28,14550,15303,-753,-4.92,1617
2021-12-29,14550,15245,-695,-4.56,1617
2021-12-30,14550,15196,-646,-4.25,1617
2021-12-31,14541,15838,-1297,-8.19,1617
2022-01-01,12040,11981,59,0.49,1617
2022-01-02,9238,9410,-172,-1.83,1617
2022-01-03,13869,14761,-892,-6.04,1617
2022-01-04,14010,14818,-808,-5.45,1617
2022-01-05,14010,14749,-739,-5.01,1617
2022-01-06,14010,14697,-687,-4.67,1617
2022-01-07,14796,15343,-547,-3.57,1617
2022-01-08,12040,11497,543,4.72,1617
2022-01-09,9238,8945,293,3.28,1617
2022-01-10,13869,14321,-452,-3.16,1617
2022-01-11,14010,14410,-400,-2.78,1617
2022-01-12,14010,14379,-369,-2.57,1617
2022-01-13,14010,14371,-361,-2.51,1617
2022-01-14,14796,15065,-269,-1.79,1617
2022-01-15,12040,11270,770,6.83,1617
2022-01-16,9238,8771,467,5.32,1617
2022-01-17,13869,14203,-334,-2.35,1617
2022-01-18,14010,14347,-337,-2.35,1617
2022-01-19,14010,14371,-361,-2.51,1617
2022-01-20,14010,14414,-404,-2.8,1617
2022-01-21,14796,15158,-362,-2.39,1617
2022-01-22,12040,11409,631,5.53,1617
2022-01-23,9238,8951,287,3.21,1617
2022-01-24,13869,14418,-549,-3.81,1617
2022-01-25,14010,14592,-582,-3.99,1617
2022-01-26,14010,14639,-629,-4.3,1617
2022-01-27,14010,14699,-689,-4.69,1617
2022-01-28,14796,15453,-657,-4.25,1617
2022-01-29,12040,11708,332,2.84,1617
2022-01-30,9238,9248,-10,-0.11,1617
2020-02-01,13348,14534,-1186,-8.16,1618
2020-02-02,9451,10885,-1434,-13.17,1618
2020-02-03,16254,18292,-2038,-11.14,1618
2020-02-04,16793,18403,-1610,-8.75,1618
2020-02-05,16793,18457,-1664,-9.02,1618
2020-02-06,16793,18515,-1722,-9.3,1618
2020-02-07,17197,18911,-1714,-9.06,1618
2020-02-08,13348,14932,-1584,-10.61,1618
2020-02-09,9451,11281,-1830,-16.22,1618
2020-02-10,16254,18683,-2429,-13.0,1618
2020-02-11,16793,18788,-1995,-10.62,1618
2020-02-12,16793,18834,-2041,-10.84,1618
2020-02-13,16793,18882,-2089,-11.06,1618
2020-02-14,17197,19268,-2071,-10.75,1618
2020-02-15,13348,15278,-1930,-12.63,1618
2020-02-16,9451,11615,-2164,-18.63,1618
2020-02-17,16254,19006,-2752,-14.48,1618
2020-02-18,16793,19099,-2306,-12.07,1618
2020-02-19,16793,19135,-2342,-12.24,1618
2020-02-20,16793,19173,-2380,-12.41,1618
2020-02-21,17197,19550,-2353,-12.04,1618
2020-02-22,13348,15553,-2205,-14.18,1618
2020-02-23,9451,11884,-2433,-20.47,1618
2020-02-24,16254,19269,-3015,-15.65,1618
2020-02-25,16793,19359,-2566,-13.25,1618
2020-02-26,16793,19392,-2599,-13.4,1618
2020-02-27,16793,19429,-2636,-13.57,1618
2020-02-28,17197,19805,-2608,-13.17,1618
2020-02-29,13348,15808,-2460,-15.56,1618
2020-03-01,6914,12140,-5226,-43.05,1618
2020-03-02,12745,19528,-6783,-34.73,1618
2020-03-03,12858,19619,-6761,-34.46,1618
2020-03-04,12858,19654,-6796,-34.58,1618
2020-03-05,12858,19692,-6834,-34.7,1618
2020-03-06,13578,20069,-6491,-32.34,1618
2020-03-07,9452,16072,-6620,-41.19,1618
2020-03-08,6914,12404,-5490,-44.26,1618
2020-03-09,12745,19789,-7044,-35.6,1618
2020-03-10,12858,19878,-7020,-35.32,1618
2020-03-11,12858,19909,-7051,-35.42,1618
2020-03-12,12858,19943,-7085,-35.53,1618
2020-03-13,13578,20315,-6737,-33.16,1618
2020-03-14,9452,16312,-6860,-42.05,1618
2020-03-15,6914,12637,-5723,-45.29,1618
2020-03-16,12745,20015,-7270,-36.32,1618
2020-03-17,12858,20097,-7239,-36.02,1618
2020-03-18,12858,20120,-7262,-36.09,1618
2020-03-19,12858,20147,-7289,-36.18,1618
2020-03-20,13578,20512,-6934,-33.8,1618
2020-03-21,9452,16502,-7050,-42.72,1618
2020-03-22,6914,12821,-5907,-46.07,1618
2020-03-23,12745,20195,-7450,-36.89,1618
2020-03-24,12858,20273,-7415,-36.58,1618
2020-03-25,12858,20295,-7437,-36.64,1618
2020-03-26,12858,20320,-7462,-36.72,1618
2020-03-27,13578,20686,-7108,-34.36,1618
2020-03-28,9452,16678,-7226,-43.33,1618
2020-03-29,6914,13000,-6086,-46.82,1618
2020-03-30,12745,20379,-7634,-37.46,1618
2020-03-31,12858,20462,-7604,-37.16,1618
2020-04-01,12276,20489,-8213,-40.08,1618
2020-04-02,12276,20521,-8245,-40.18,1618
2020-04-03,11697,20893,-9196,-44.01,1618
2020-04-04,8562,16892,-8330,-49.31,1618
2020-04-05,5626,13221,-7595,-57.45,1618
2020-04-06,12417,20604,-8187,-39.74,1618
2020-04-07,12276,20691,-8415,-40.67,1618
2020-04-08,12276,20722,-8446,-40.76,1618
2020-04-09,12276,20755,-8479,-40.85,1618
2020-04-10,11697,21127,-9430,-44.63,1618
2020-04-11,8562,17123,-8561,-50.0,1618
2020-04-12,5626,13447,-7821,-58.16,1618
2020-04-13,12417,20823,-8406,-40.37,1618
2020-04-14,12276,20901,-8625,-41.27,1618
2020-04-15,12276,20920,-8644,-41.32,1618
2020-04-16,12276,20940,-8664,-41.38,1618
2020-04-17,11697,21295,-9598,-45.07,1618
2020-04-18,8562,17274,-8712,-50.43,1618
2020-04-19,5626,13578,-7952,-58.57,1618
2020-04-20,12417,20934,-8517,-40.69,1618
2020-04-21,12276,20991,-8715,-41.52,1618
2020-04-22,12276,20988,-8712,-41.51,1618
2020-04-23,12276,20985,-8709,-41.5,1618
2020-04-24,11697,21318,-9621,-45.13,1618
2020-04-25,8562,17276,-8714,-50.44,1618
2020-04-26,5626,13560,-7934,-58.51,1618
2020-04-27,12417,20897,-8480,-40.58,1618
2020-04-28,12276,20936,-8660,-41.36,1618
2020-04-29,12276,20918,-8642,-41.31,1618
2020-04-30,12276,20902,-8626,-41.27,1618
2020-05-01,16936,21226,-4290,-20.21,1618
2020-05-02,13434,17176,-3742,-21.79,1618
2020-05-03,8836,13455,-4619,-34.33,1618
2020-05-04,16884,20790,-3906,-18.79,1618
2020-05-05,16996,20830,-3834,-18.41,1618
2020-05-06,16996,20815,-3819,-18.35,1618
2020-05-07,16996,20806,-3810,-18.31,1618
2020-05-08,16936,21137,-4201,-19.88,1618
2020-05-09,13434,17098,-3664,-21.43,1618
2020-05-10,8836,13388,-4552,-34.0,1618
2020-05-11,16884,20737,-3853,-18.58,1618
2020-05-12,16996,20791,-3795,-18.25,1618
2020-05-13,16996,20791,-3795,-18.25,1618
2020-05-14,16996,20796,-3800,-18.27,1618
2020-05-15,16936,21143,-4207,-19.9,1618
2020-05-16,13434,17118,-3684,-21.52,1618
2020-05-17,8836,13422,-4586,-34.17,1618
2020-05-18,16884,20783,-3899,-18.76,1618
2020-05-19,16996,20849,-3853,-18.48,1618
2020-05-20,16996,20859,-3863,-18.52,1618
2020-05-21,16996,20873,-3877,-18.57,1618
2020-05-22,16936,21226,-4290,-20.21,1618
2020-05-23,13434,17206,-3772,-21.92,1618
2020-05-24,8836,13514,-4678,-34.62,1618
2020-05-25,16884,20877,-3993,-19.13,1618
2020-05-26,16996,20944,-3948,-18.85,1618
2020-05-27,16996,20953,-3957,-18.89,1618
2020-05-28,16996,20965,-3969,-18.93,1618
2020-05-29,16936,21315,-4379,-20.54,1618
2020-05-30,13434,17291,-3857,-22.31,1618
2020-05-31,8836,13595,-4759,-35.01,1618
2020-06-01,17796,20953,-3157,-15.07,1618
2020-06-02,18252,21014,-2762,-13.14,1618
2020-06-03,18252,21018,-2766,-13.16,1618
2020-06-04,18252,21024,-2772,-13.18,1618
2020-06-05,17604,21369,-3765,-17.62,1618
2020-06-06,13434,17341,-3907,-22.53,1618
2020-06-07,9425,13639,-4214,-30.9,1618
2020-06-08,17796,20993,-3197,-15.23,1618
2020-06-09,18252,21050,-2798,-13.29,1618
2020-06-10,18252,21049,-2797,-13.29,1618
2020-06-11,18252,21051,-2799,-13.3,1618
2020-06-12,17604,21392,-3788,-17.71,1618
2020-06-13,13434,17358,-3924,-22.61,1618
2020-06-14,9425,13651,-4226,-30.96,1618
2020-06-15,17796,20999,-3203,-15.25,1618
2020-06-16,18252,21048,-2796,-13.28,1618
2020-06-17,18252,21040,-2788,-13.25,1618
2020-06-18,18252,21032,-2780,-13.22,1618
2020-06-19,17604,21362,-3758,-17.59,1618
2020-06-20,13434,17317,-3883,-22.42,1618
2020-06-21,9425,13597,-4172,-30.68,1618
2020-06-22,17796,20929,-3133,-14.97,1618
2020-06-23,18252,20963,-2711,-12.93,1618
2020-06-24,18252,20938,-2686,-12.83,1618
2020-06-25,18252,20913,-2661,-12.72,1618
2020-06-26,17604,21224,-3620,-17.06,1618
2020-06-27,13434,17160,-3726,-21.71,1618
2020-06-28,9425,13421,-3996,-29.77,1618
2020-06-29,17796,20736,-2940,-14.18,1618
2020-06-30,18252,20752,-2500,-12.05,1618
2020-07-01,16858,20710,-3852,-18.6,1618
2020-07-02,16858,20671,-3813,-18.45,1618
2020-07-03,17267,20970,-3703,-17.66,1618
2020-07-04,13034,16895,-3861,-22.85,1618
2020-07-05,10103,13149,-3046,-23.17,1618
2020-07-06,17340,20459,-3119,-15.25,1618
2020-07-07,16858,20474,-3616,-17.66,1618
2020-07-08,16858,20435,-3577,-17.5,1618
2020-07-09,16858,20401,-3543,-17.37,1618
2020-07-10,17267,20710,-3443,-16.62,1618
2020-07-11,13034,16648,-3614,-21.71,1618
2020-07-12,10103,12918,-2815,-21.79,1618
2020-07-13,17340,20248,-2908,-14.36,1618
2020-07-14,16858,20285,-3427,-16.89,1618
2020-07-15,16858,20270,-3412,-16.83,1618
2020-07-16,16858,20263,-3405,-16.8,1618
2020-07-17,17267,20599,-3332,-16.18,1618
2020-07-18,13034,16566,-3532,-21.32,1618
2020-07-19,10103,12865,-2762,-21.47,1618
2020-07-20,17340,20222,-2882,-14.25,1618
2020-07-21,16858,20286,-3428,-16.9,1618
2020-07-22,16858,20296,-3438,-16.94,1618
2020-07-23,16858,20310,-3452,-17.0,1618
2020-07-24,17267,20666,-3399,-16.45,1618
2020-07-25,13034,16648,-3614,-21.71,1618
2020-07-26,10103,12959,-2856,-22.04,1618
2020-07-27,17340,20324,-2984,-14.68,1618
2020-07-28,16858,20391,-3533,-17.33,1618
2020-07-29,16858,20401,-3543,-17.37,1618
2020-07-30,16858,20410,-3552,-17.4,1618
2020-07-31,17267,20757,-3490,-16.81,1618
2020-08-01,13178,16726,-3548,-21.21,1618
2020-08-02,9662,13021,-3359,-25.8,1618
2020-08-03,17184,20367,-3183,-15.63,1618
2020-08-04,17303,20414,-3111,-15.24,1618
2020-08-05,17303,20401,-3098,-15.19,1618
2020-08-06,17303,20388,-3085,-15.13,1618
2020-08-07,16748,20712,-3964,-19.14,1618
2020-08-08,13178,16660,-3482,-20.9,1618
2020-08-09,9662,12936,-3274,-25.31,1618
2020-08-10,17184,20266,-3082,-15.21,1618
2020-08-11,17303,20300,-2997,-14.76,1618
2020-08-12,17303,20278,-2975,-14.67,1618
2020-08-13,17303,20262,-2959,-14.6,1618
2020-08-14,16748,20589,-3841,-18.66,1618
2020-08-15,13178,16546,-3368,-20.36,1618
2020-08-16,9662,12837,-3175,-24.73,1618
2020-08-17,17184,20188,-3004,-14.88,1618
2020-08-18,17303,20250,-2947,-14.55,1618
2020-08-19,17303,20263,-2960,-14.61,1618
2020-08-20,17303,20287,-2984,-14.71,1618
2020-08-21,16748,20659,-3911,-18.93,1618
2020-08-22,13178,16666,-3488,-20.93,1618
2020-08-23,9662,13010,-3348,-25.73,1618
2020-08-24,17184,20419,-3235,-15.84,1618
2020-08-25,17303,20539,-3236,-15.76,1618
2020-08-26,17303,20611,-3308,-16.05,1618
2020-08-27,17303,20694,-3391,-16.39,1618
2020-08-28,16748,21122,-4374,-20.71,1618
2020-08-29,13178,17183,-4005,-23.31,1618
2020-08-30,9662,13577,-3915,-28.84,1618
2020-08-31,17184,21029,-3845,-18.28,1618
2020-09-01,17800,21187,-3387,-15.99,1618
2020-09-02,17800,21289,-3489,-16.39,1618
2020-09-03,17800,21394,-3594,-16.8,1618
2020-09-04,17816,21836,-4020,-18.41,1618
2020-09-05,13928,17900,-3972,-22.19,1618
2020-09-06,10018,14288,-4270,-29.89,1618
2020-09-07,17574,21724,-4150,-19.1,1618
2020-09-08,17800,21857,-4057,-18.56,1618
2020-09-09,17800,21924,-4124,-18.81,1618
2020-09-10,17800,21984,-4184,-19.03,1618
2020-09-11,17816,22373,-4557,-20.37,1618
2020-09-12,13928,18377,-4449,-24.21,1618
2020-09-13,10018,14698,-4680,-31.84,1618
2020-09-14,17574,22062,-4488,-20.34,1618
2020-09-15,17800,22117,-4317,-19.52,1618
2020-09-16,17800,22105,-4305,-19.48,1618
2020-09-17,17800,22084,-4284,-19.4,1618
2020-09-18,17816,22391,-4575,-20.43,1618
2020-09-19,13928,18314,-4386,-23.95,1618
2020-09-20,10018,14557,-4539,-31.18,1618
2020-09-21,17574,21846,-4272,-19.56,1618
2020-09-22,17800,21832,-4032,-18.47,1618
2020-09-23,17800,21756,-3956,-18.18,1618
2020-09-24,17800,21678,-3878,-17.89,1618
2020-09-25,17816,21936,-4120,-18.78,1618
2020-09-26,13928,17819,-3891,-21.84,1618
2020-09-27,10018,14030,-4012,-28.6,1618
2020-09-28,17574,21296,-3722,-17.48,1618
2020-09-29,17800,21268,-3468,-16.31,1618
2020-09-30,17800,21186,-3386,-15.98,1618
2020-10-01,17418,21112,-3694,-17.5,1618
2020-10-02,17731,21382,-3651,-17.08,1618
2020-10-03,13621,17283,-3662,-21.19,1618
2020-10-04,9577,13520,-3943,-29.16,1618
2020-10-05,17822,20818,-2996,-14.39,1618
2020-10-06,17418,20827,-3409,-16.37,1618
2020-10-07,17418,20786,-3368,-16.2,1618
2020-10-08,17418,20755,-3337,-16.08,1618
2020-10-09,17731,21071,-3340,-15.85,1618
2020-10-10,13621,17019,-3398,-19.97,1618
2020-10-11,9577,13302,-3725,-28.0,1618
2020-10-12,17822,20646,-2824,-13.68,1618
2020-10-13,17418,20698,-3280,-15.85,1618
2020-10-14,17418,20699,-3281,-15.85,1618
2020-10-15,17418,20706,-3288,-15.88,1618
2020-10-16,17731,21055,-3324,-15.79,1618
2020-10-17,13621,17034,-3413,-20.04,1618
2020-10-18,9577,13342,-3765,-28.22,1618
2020-10-19,17822,20707,-2885,-13.93,1618
2020-10-20,17418,20776,-3358,-16.16,1618
2020-10-21,17418,20789,-3371,-16.22,1618
2020-10-22,17418,20804,-3386,-16.28,1618
2020-10-23,17731,21158,-3427,-16.2,1618
2020-10-24,13621,17138,-3517,-20.52,1618
2020-10-25,9577,13444,-3867,-28.76,1618
2020-10-26,17822,20805,-2983,-14.34,1618
2020-10-27,17418,20868,-3450,-16.53,1618
2020-10-28,17418,20874,-3456,-16.56,1618
2020-10-29,17418,20882,-3464,-16.59,1618
2020-10-30,17731,21228,-3497,-16.47,1618
2020-10-31,13621,17200,-3579,-20.81,1618
2020-11-01,7696,13500,-5804,-42.99,1618
2020-11-02,15900,20856,-4956,-23.76,1618
2020-11-03,14614,20915,-6301,-30.13,1618
2020-11-04,14614,20918,-6304,-30.14,1618
2020-11-05,14614,20925,-6311,-30.16,1618
2020-11-06,15332,21273,-5941,-27.93,1618
2020-11-07,11162,17247,-6085,-35.28,1618
2020-11-08,7696,13552,-5856,-43.21,1618
2020-11-09,15900,20912,-5012,-23.97,1618
2020-11-10,14614,20977,-6363,-30.33,1618
2020-11-11,14614,20987,-6373,-30.37,1618
2020-11-12,14614,21001,-6387,-30.41,1618
2020-11-13,15332,21354,-6022,-28.2,1618
2020-11-14,11162,17335,-6173,-35.61,1618
2020-11-15,7696,13643,-5947,-43.59,1618
2020-11-16,15900,21006,-5106,-24.31,1618
2020-11-17,14614,21073,-6459,-30.65,1618
2020-11-18,14614,21081,-6467,-30.68,1618
2020-11-19,14614,21092,-6478,-30.71,1618
2020-11-20,15332,21440,-6108,-28.49,1618
2020-11-21,11162,17412,-6250,-35.89,1618
2020-11-22,7696,13710,-6014,-43.87,1618
2020-11-23,15900,21060,-5160,-24.5,1618
2020-11-24,14614,21111,-6497,-30.78,1618
2020-11-25,14614,21103,-6489,-30.75,1618
2020-11-26,14614,21095,-6481,-30.72,1618
2020-11-27,15332,21424,-6092,-28.44,1618
2020-11-28,11162,17377,-6215,-35.77,1618
2020-11-29,7696,13655,-5959,-43.64,1618
2020-11-30,15900,20987,-5087,-24.24,1618
2020-12-01,14837,21021,-6184,-29.42,1618
2020-12-02,14837,20997,-6160,-29.34,1618
2020-12-03,14837,20977,-6140,-29.27,1618
2020-12-04,16337,21296,-4959,-23.29,1618
2020-12-05,12295,17241,-4946,-28.69,1618
2020-12-06,8027,13517,-5490,-40.62,1618
2020-12-07,15032,20850,-5818,-27.9,1618
2020-12-08,14837,20890,-6053,-28.98,1618
2020-12-09,14837,20876,-6039,-28.93,1618
2020-12-10,14837,20870,-6033,-28.91,1618
2020-12-11,16337,21208,-4871,-22.97,1618
2020-12-12,12295,17176,-4881,-28.42,1618
2020-12-13,8027,13479,-5452,-40.45,1618
2020-12-14,15032,20842,-5810,-27.88,1618
2020-12-15,14837,20914,-6077,-29.06,1618
2020-12-16,14837,20936,-6099,-29.13,1618
2020-12-17,14837,20967,-6130,-29.24,1618
2020-12-18,16337,21342,-5005,-23.45,1618
2020-12-19,12295,17349,-5054,-29.13,1618
2020-12-20,8027,13689,-5662,-41.36,1618
2020-12-21,15032,21089,-6057,-28.72,1618
2020-12-22,14837,21197,-6360,-30.0,1618
2020-12-23,14837,21251,-6414,-30.18,1618
2020-12-24,14837,21311,-6474,-30.38,1618
2020-12-25,16337,21712,-5375,-24.76,1618
2020-12-26,12295,17741,-5446,-30.7,1618
2020-12-27,8027,14100,-6073,-43.07,1618
2020-12-28,15032,21513,-6481,-30.13,1618
2020-12-29,14837,21629,-6792,-31.4,1618
2020-12-30,14837,21687,-6850,-31.59,1618
2020-12-31,14837,21747,-6910,-31.77,1618
2021-01-01,14202,22144,-7942,-35.87,1618
2021-01-02,9741,18165,-8424,-46.37,1618
2021-01-03,6910,14510,-7600,-52.38,1618
2021-01-04,13402,21908,-8506,-38.83,1618
2021-01-05,14001,22007,-8006,-36.38,1618
2021-01-06,14001,22045,-8044,-36.49,1618
2021-01-07,14001,22084,-8083,-36.6,1618
2021-01-08,14202,22458,-8256,-36.76,1618
2021-01-09,9741,18457,-8716,-47.22,1618
2021-01-10,6910,14781,-7871,-53.25,1618
2021-01-11,13402,22158,-8756,-39.52,1618
2021-01-12,14001,22238,-8237,-37.04,1618
2021-01-13,14001,22259,-8258,-37.1,1618
2021-01-14,14001,22284,-8283,-37.17,1618
2021-01-15,14202,22647,-8445,-37.29,1618
2021-01-16,9741,18637,-8896,-47.73,1618
2021-01-17,6910,14956,-8046,-53.8,1618
2021-01-18,13402,22332,-8930,-39.99,1618
2021-01-19,14001,22413,-8412,-37.53,1618
2021-01-20,14001,22439,-8438,-37.6,1618
2021-01-21,14001,22471,-8470,-37.69,1618
2021-01-22,14202,22845,-8643,-37.83,1618
2021-01-23,9741,18848,-9107,-48.32,1618
2021-01-24,6910,15182,-8272,-54.49,1618
2021-01-25,13402,22574,-9172,-40.63,1618
2021-01-26,14001,22673,-8672,-38.25,1618
2021-01-27,14001,22718,-8717,-38.37,1618
2021-01-28,14001,22768,-8767,-38.51,1618
2021-01-29,14202,23159,-8957,-38.68,1618
2021-01-30,9741,19179,-9438,-49.21,1618
2021-01-31,6910,15529,-8619,-55.5,1618
2021-02-01,15827,22935,-7108,-30.99,1618
2021-02-02,15899,23046,-7147,-31.01,1618
2021-02-03,15899,23101,-7202,-31.18,1618
2021-02-04,15899,23158,-7259,-31.35,1618
2021-02-05,16290,23555,-7265,-30.84,1618
2021-02-06,12327,19578,-7251,-37.04,1618
2021-02-07,8310,15928,-7618,-47.83,1618
2021-02-08,15827,23332,-7505,-32.17,1618
2021-02-09,15899,23439,-7540,-32.17,1618
2021-02-10,15899,23487,-7588,-32.31,1618
2021-02-11,15899,23537,-7638,-32.45,1618
2021-02-12,16290,23925,-7635,-31.91,1618
2021-02-13,12327,19937,-7610,-38.17,1618
2021-02-14,8310,16277,-7967,-48.95,1618
2021-02-15,15827,23669,-7842,-33.13,1618
2021-02-16,15899,23764,-7865,-33.1,1618
2021-02-17,15899,23802,-7903,-33.2,1618
2021-02-18,15899,23841,-7942,-33.31,1618
2021-02-19,16290,24219,-7929,-32.74,1618
2021-02-20,12327,20222,-7895,-39.04,1618
2021-02-21,8310,16553,-8243,-49.8,1618
2021-02-22,15827,23939,-8112,-33.89,1618
2021-02-23,15899,24029,-8130,-33.83,1618
2021-02-24,15899,24062,-8163,-33.92,1618
2021-02-25,15899,24099,-8200,-34.03,1618
2021-02-26,16290,24475,-8185,-33.44,1618
2021-02-27,12327,20477,-8150,-39.8,1618
2021-02-28,8310,16809,-8499,-50.56,1618
2021-03-01,16876,24196,-7320,-30.25,1618
2021-03-02,16878,24287,-7409,-30.51,1618
2021-03-03,16878,24322,-7444,-30.61,1618
2021-03-04,16878,24360,-7482,-30.71,1618
2021-03-05,17096,24737,-7641,-30.89,1618
2021-03-06,13664,20741,-7077,-34.12,1618
2021-03-07,8728,17073,-8345,-48.88,1618
2021-03-08,16876,24459,-7583,-31.0,1618
2021-03-09,16878,24549,-7671,-31.25,1618
2021-03-10,16878,24581,-7703,-31.34,1618
2021-03-11,16878,24616,-7738,-31.43,1618
2021-03-12,17096,24990,-7894,-31.59,1618
2021-03-13,13664,20988,-7324,-34.9,1618
2021-03-14,8728,17314,-8586,-49.59,1618
2021-03-15,16876,24694,-7818,-31.66,1618
2021-03-16,16878,24777,-7899,-31.88,1618
2021-03-17,16878,24802,-7924,-31.95,1618
2021-03-18,16878,24829,-7951,-32.02,1618
2021-03-19,17096,25195,-8099,-32.15,1618
2021-03-20,13664,21186,-7522,-35.5,1618
2021-03-21,8728,17506,-8778,-50.14,1618
2021-03-22,16876,24880,-8004,-32.17,1618
2021-03-23,16878,24958,-8080,-32.37,1618
2021-03-24,16878,24979,-8101,-32.43,1618
2021-03-25,16878,25004,-8126,-32.5,1618
2021-03-26,17096,25369,-8273,-32.61,1618
2021-03-27,13664,21360,-7696,-36.03,1618
2021-03-28,8728,17681,-8953,-50.64,1618
2021-03-29,16876,25058,-8182,-32.65,1618
2021-03-30,16878,25140,-8262,-32.86,1618
2021-03-31,16878,25166,-8288,-32.93,1618
2021-04-01,15613,25197,-9584,-38.04,1618
2021-04-02,16195,25568,-9373,-36.66,1618
2021-04-03,11876,21566,-9690,-44.93,1618
2021-04-04,8565,17894,-9329,-52.13,1618
2021-04-05,15812,25277,-9465,-37.45,1618
2021-04-06,15613,25364,-9751,-38.44,1618
2021-04-07,15613,25395,-9782,-38.52,1618
2021-04-08,15613,25429,-9816,-38.6,1618
2021-04-09,16195,25802,-9607,-37.23,1618
2021-04-10,11876,21800,-9924,-45.52,1618
2021-04-11,8565,18126,-9561,-52.75,1618
2021-04-12,15812,25505,-9693,-38.0,1618
2021-04-13,15613,25585,-9972,-38.98,1618
2021-04-14,15613,25608,-9995,-39.03,1618
2021-04-15,15613,25631,-10018,-39.09,1618
2021-04-16,16195,25990,-9795,-37.69,1618
2021-04-17,11876,21973,-10097,-45.95,1618
2021-04-18,8565,18281,-9716,-53.15,1618
2021-04-19,15812,25641,-9829,-38.33,1618
2021-04-20,15613,25702,-10089,-39.25,1618
2021-04-21,15613,25702,-10089,-39.25,1618
2021-04-22,15613,25703,-10090,-39.26,1618
2021-04-23,16195,26040,-9845,-37.81,1618
2021-04-24,11876,22001,-10125,-46.02,1618
2021-04-25,8565,18288,-9723,-53.17,1618
2021-04-26,15812,25627,-9815,-38.3,1618
2021-04-27,15613,25668,-10055,-39.17,1618
2021-04-28,15613,25652,-10039,-39.14,1618
2021-04-29,15613,25637,-10024,-39.1,1618
2021-04-30,16195,25961,-9766,-37.62,1618
2021-05-01,14580,21911,-7331,-33.46,1618
2021-05-02,9331,18189,-8858,-48.7,1618
2021-05-03,18162,25523,-7361,-28.84,1618
2021-05-04,18020,25562,-7542,-29.5,1618
2021-05-05,18020,25545,-7525,-29.46,1618
2021-05-06,18020,25534,-7514,-29.43,1618
2021-05-07,18158,25863,-7705,-29.79,1618
2021-05-08,14580,21820,-7240,-33.18,1618
2021-05-09,9331,18109,-8778,-48.47,1618
2021-05-10,18162,25454,-7292,-28.65,1618
2021-05-11,18020,25505,-7485,-29.35,1618
2021-05-12,18020,25503,-7483,-29.34,1618
2021-05-13,18020,25506,-7486,-29.35,1618
2021-05-14,18158,25850,-7692,-29.76,1618
2021-05-15,14580,21822,-7242,-33.19,1618
2021-05-16,9331,18125,-8794,-48.52,1618
2021-05-17,18162,25484,-7322,-28.73,1618
2021-05-18,18020,25549,-7529,-29.47,1618
2021-05-19,18020,25558,-7538,-29.49,1618
2021-05-20,18020,25571,-7551,-29.53,1618
2021-05-21,18158,25924,-7766,-29.96,1618
2021-05-22,14580,21904,-7324,-33.44,1618
2021-05-23,9331,18212,-8881,-48.76,1618
2021-05-24,18162,25576,-7414,-28.99,1618
2021-05-25,18020,25643,-7623,-29.73,1618
2021-05-26,18020,25653,-7633,-29.75,1618
2021-05-27,18020,25665,-7645,-29.79,1618
2021-05-28,18158,26017,-7859,-30.21,1618
2021-05-29,14580,21994,-7414,-33.71,1618
2021-05-30,9331,18298,-8967,-49.01,1618
2021-05-31,18162,25657,-7495,-29.21,1618
2021-06-01,18006,25719,-7713,-29.99,1618
2021-06-02,18006,25724,-7718,-30.0,1618
2021-06-03,18006,25732,-7726,-30.02,1618
2021-06-04,17931,26078,-8147,-31.24,1618
2021-06-05,13620,22049,-8429,-38.23,1618
2021-06-06,10433,18349,-7916,-43.14,1618
2021-06-07,17676,25703,-8027,-31.23,1618
2021-06-08,18006,25761,-7755,-30.1,1618
2021-06-09,18006,25761,-7755,-30.1,1618
2021-06-10,18006,25764,-7758,-30.11,1618
2021-06-11,17931,26106,-8175,-31.31,1618
2021-06-12,13620,22073,-8453,-38.3,1618
2021-06-13,10433,18368,-7935,-43.2,1618
2021-06-14,17676,25717,-8041,-31.27,1618
2021-06-15,18006,25768,-7762,-30.12,1618
2021-06-16,18006,25761,-7755,-30.1,1618
2021-06-17,18006,25757,-7751,-30.09,1618
2021-06-18,17931,26089,-8158,-31.27,1618
2021-06-19,13620,22046,-8426,-38.22,1618
2021-06-20,10433,18329,-7896,-43.08,1618
2021-06-21,17676,25665,-7989,-31.13,1618
2021-06-22,18006,25702,-7696,-29.94,1618
2021-06-23,18006,25680,-7674,-29.88,1618
2021-06-24,18006,25659,-7653,-29.83,1618
2021-06-25,17931,25974,-8043,-30.97,1618
2021-06-26,13620,21913,-8293,-37.85,1618
2021-06-27,10433,18177,-7744,-42.6,1618
2021-06-28,17676,25495,-7819,-30.67,1618
2021-06-29,18006,25513,-7507,-29.42,1618
2021-06-30,18006,25473,-7467,-29.31,1618
2021-07-01,16465,25435,-8970,-35.27,1618
2021-07-02,16728,25735,-9007,-35.0,1618
2021-07-03,12180,21661,-9481,-43.77,1618
2021-07-04,9234,17915,-8681,-48.46,1618
2021-07-05,16490,25224,-8734,-34.63,1618
2021-07-06,16465,25237,-8772,-34.76,1618
2021-07-07,16465,25196,-8731,-34.65,1618
2021-07-08,16465,25159,-8694,-34.56,1618
2021-07-09,16728,25464,-8736,-34.31,1618
2021-07-10,12180,21398,-9218,-43.08,1618
2021-07-11,9234,17664,-8430,-47.72,1618
2021-07-12,16490,24989,-8499,-34.01,1618
2021-07-13,16465,25021,-8556,-34.2,1618
2021-07-14,16465,25001,-8536,-34.14,1618
2021-07-15,16465,24988,-8523,-34.11,1618
2021-07-16,16728,25319,-8591,-33.93,1618
2021-07-17,12180,21281,-9101,-42.77,1618
2021-07-18,9234,17575,-8341,-47.46,1618
2021-07-19,16490,24928,-8438,-33.85,1618
2021-07-20,16465,24988,-8523,-34.11,1618
2021-07-21,16465,24995,-8530,-34.13,1618
2021-07-22,16465,25008,-8543,-34.16,1618
2021-07-23,16728,25361,-8633,-34.04,1618
2021-07-24,12180,21343,-9163,-42.93,1618
2021-07-25,9234,17654,-8420,-47.69,1618
2021-07-26,16490,25020,-8530,-34.09,1618
2021-07-27,16465,25089,-8624,-34.37,1618
2021-07-28,16465,25100,-8635,-34.4,1618
2021-07-29,16465,25113,-8648,-34.44,1618
2021-07-30,16728,25463,-8735,-34.3,1618
2021-07-31,12180,21437,-9257,-43.18,1618
2021-08-01,8918,17735,-8817,-49.72,1618
2021-08-02,15411,25086,-9675,-38.57,1618
2021-08-03,15689,25137,-9448,-37.59,1618
2021-08-04,15689,25128,-9439,-37.56,1618
2021-08-05,15689,25119,-9430,-37.54,1618
2021-08-06,15424,25446,-10022,-39.39,1618
2021-08-07,12103,21397,-9294,-43.44,1618
2021-08-08,8918,17674,-8756,-49.54,1618
2021-08-09,15411,25005,-9594,-38.37,1618
2021-08-10,15689,25039,-9350,-37.34,1618
2021-08-11,15689,25017,-9328,-37.29,1618
2021-08-12,15689,24998,-9309,-37.24,1618
2021-08-13,15424,25321,-9897,-39.09,1618
2021-08-14,12103,21273,-9170,-43.11,1618
2021-08-15,8918,17558,-8640,-49.21,1618
2021-08-16,15411,24902,-9491,-38.11,1618
2021-08-17,15689,24956,-9267,-37.13,1618
2021-08-18,15689,24959,-9270,-37.14,1618
2021-08-19,15689,24974,-9285,-37.18,1618
2021-08-20,15424,25335,-9911,-39.12,1618
2021-08-21,12103,21331,-9228,-43.26,1618
2021-08-22,8918,17665,-8747,-49.52,1618
2021-08-23,15411,25062,-9651,-38.51,1618
2021-08-24,15689,25172,-9483,-37.67,1618
2021-08-25,15689,25234,-9545,-37.83,1618
2021-08-26,15689,25307,-9618,-38.01,1618
2021-08-27,15424,25727,-10303,-40.05,1618
2021-08-28,12103,21781,-9678,-44.43,1618
2021-08-29,8918,18168,-9250,-50.91,1618
2021-08-30,15411,25616,-10205,-39.84,1618
2021-08-31,15689,25772,-10083,-39.12,1618
2021-09-01,17127,25873,-8746,-33.8,1618
2021-09-02,17127,25978,-8851,-34.07,1618
2021-09-03,17433,26423,-8990,-34.02,1618
2021-09-04,13362,22492,-9130,-40.59,1618
2021-09-05,10084,18886,-8802,-46.61,1618
2021-09-06,17329,26330,-9001,-34.19,1618
2021-09-07,17127,26472,-9345,-35.3,1618
2021-09-08,17127,26550,-9423,-35.49,1618
2021-09-09,17127,26622,-9495,-35.67,1618
2021-09-10,17433,27025,-9592,-35.49,1618
2021-09-11,13362,23043,-9681,-42.01,1618
2021-09-12,10084,19378,-9294,-47.96,1618
2021-09-13,17329,26757,-9428,-35.24,1618
2021-09-14,17127,26828,-9701,-36.16,1618
2021-09-15,17127,26830,-9703,-36.16,1618
2021-09-16,17127,26824,-9697,-36.15,1618
2021-09-17,17433,27145,-9712,-35.78,1618
2021-09-18,13362,23081,-9719,-42.11,1618
2021-09-19,10084,19336,-9252,-47.85,1618
2021-09-20,17329,26636,-9307,-34.94,1618
2021-09-21,17127,26631,-9504,-35.69,1618
2021-09-22,17127,26562,-9435,-35.52,1618
2021-09-23,17127,26490,-9363,-35.35,1618
2021-09-24,17433,26753,-9320,-34.84,1618
2021-09-25,13362,22638,-9276,-40.98,1618
2021-09-26,10084,18850,-8766,-46.5,1618
2021-09-27,17329,26115,-8786,-33.64,1618
2021-09-28,17127,26085,-8958,-34.34,1618
2021-09-29,17127,26000,-8873,-34.13,1618
2021-09-30,17127,25921,-8794,-33.93,1618
2021-10-01,17935,26185,-8250,-31.51,1618
2021-10-02,14056,22080,-8024,-36.34,1618
2021-10-03,9944,18309,-8365,-45.69,1618
2021-10-04,17229,25598,-8369,-32.69,1618
2021-10-05,17368,25599,-8231,-32.15,1618
2021-10-06,17368,25549,-8181,-32.02,1618
2021-10-07,17368,25510,-8142,-31.92,1618
2021-10-08,17935,25817,-7882,-30.53,1618
2021-10-09,14056,21757,-7701,-35.4,1618
2021-10-10,9944,18033,-8089,-44.86,1618
2021-10-11,17229,25369,-8140,-32.09,1618
2021-10-12,17368,25415,-8047,-31.66,1618
2021-10-13,17368,25410,-8042,-31.65,1618
2021-10-14,17368,25413,-8045,-31.66,1618
2021-10-15,17935,25759,-7824,-30.37,1618
2021-10-16,14056,21734,-7678,-35.33,1618
2021-10-17,9944,18040,-8096,-44.88,1618
2021-10-18,17229,25404,-8175,-32.18,1618
2021-10-19,17368,25472,-8104,-31.82,1618
2021-10-20,17368,25484,-8116,-31.85,1618
2021-10-21,17368,25500,-8132,-31.89,1618
2021-10-22,17935,25855,-7920,-30.63,1618
2021-10-23,14056,21836,-7780,-35.63,1618
2021-10-24,9944,18144,-8200,-45.19,1618
2021-10-25,17229,25506,-8277,-32.45,1618
2021-10-26,17368,25571,-8203,-32.08,1618
2021-10-27,17368,25578,-8210,-32.1,1618
2021-10-28,17368,25587,-8219,-32.12,1618
2021-10-29,17935,25935,-8000,-30.85,1618
2021-10-30,14056,21908,-7852,-35.84,1618
2021-10-31,9944,18208,-8264,-45.39,1618
2021-11-01,15700,25564,-9864,-38.59,1618
2021-11-02,16305,25623,-9318,-36.37,1618
2021-11-03,16305,25626,-9321,-36.37,1618
2021-11-04,16305,25632,-9327,-36.39,1618
2021-11-05,16750,25978,-9228,-35.52,1618
2021-11-06,13193,21952,-8759,-39.9,1618
2021-11-07,9344,18255,-8911,-48.81,1618
2021-11-08,15700,25614,-9914,-38.71,1618
2021-11-09,16305,25678,-9373,-36.5,1618
2021-11-10,16305,25686,-9381,-36.52,1618
2021-11-11,16305,25699,-9394,-36.55,1618
2021-11-12,16750,26052,-9302,-35.71,1618
2021-11-13,13193,22032,-8839,-40.12,1618
2021-11-14,9344,18341,-8997,-49.05,1618
2021-11-15,15700,25704,-10004,-38.92,1618
2021-11-16,16305,25772,-9467,-36.73,1618
2021-11-17,16305,25782,-9477,-36.76,1618
2021-11-18,16305,25794,-9489,-36.79,1618
2021-11-19,16750,26144,-9394,-35.93,1618
2021-11-20,13193,22119,-8926,-40.35,1618
2021-11-21,9344,18420,-9076,-49.27,1618
2021-11-22,15700,25774,-10074,-39.09,1618
2021-11-23,16305,25829,-9524,-36.87,1618
2021-11-24,16305,25824,-9519,-36.86,1618
2021-11-25,16305,25820,-9515,-36.85,1618
2021-11-26,16750,26152,-9402,-35.95,1618
2021-11-27,13193,22108,-8915,-40.32,1618
2021-11-28,9344,18390,-9046,-49.19,1618
2021-11-29,15700,25724,-10024,-38.97,1618
2021-11-30,16305,25760,-9455,-36.7,1618
2021-12-01,15190,25738,-10548,-40.98,1618
2021-12-02,15190,25718,-10528,-40.94,1618
2021-12-03,14736,26037,-11301,-43.4,1618
2021-12-04,11816,21982,-10166,-46.25,1618
2021-12-05,8705,18256,-9551,-52.32,1618
2021-12-06,15858,25587,-9729,-38.02,1618
2021-12-07,15190,25623,-10433,-40.72,1618
2021-12-08,15190,25605,-10415,-40.68,1618
2021-12-09,15190,25594,-10404,-40.65,1618
2021-12-10,14736,25926,-11190,-43.16,1618
2021-12-11,11816,21889,-10073,-46.02,1618
2021-12-12,8705,18185,-9480,-52.13,1618
2021-12-13,15858,25541,-9683,-37.91,1618
2021-12-14,15190,25607,-10417,-40.68,1618
2021-12-15,15190,25621,-10431,-40.71,1618
2021-12-16,15190,25645,-10455,-40.77,1618
2021-12-17,14736,26013,-11277,-43.35,1618
2021-12-18,11816,22014,-10198,-46.33,1618
2021-12-19,8705,18348,-9643,-52.56,1618
2021-12-20,15858,25742,-9884,-38.4,1618
2021-12-21,15190,25845,-10655,-41.23,1618
2021-12-22,15190,25895,-10705,-41.34,1618
2021-12-23,15190,25952,-10762,-41.47,1618
2021-12-24,14736,26350,-11614,-44.08,1618
2021-12-25,11816,22378,-10562,-47.2,1618
2021-12-26,8705,18735,-10030,-53.54,1618
2021-12-27,15858,26148,-10290,-39.35,1618
2021-12-28,15190,26265,-11075,-42.17,1618
2021-12-29,15190,26325,-11135,-42.3,1618
2021-12-30,15190,26388,-11198,-42.44,1618
2021-12-31,14736,26787,-12051,-44.99,1618
2022-01-01,12047,22811,-10764,-47.19,1618
2022-01-02,8130,19161,-11031,-57.57,1618
2022-01-03,15040,26563,-11523,-43.38,1618
2022-01-04,14975,26665,-11690,-43.84,1618
2022-01-05,14975,26708,-11733,-43.93,1618
2022-01-06,14975,26751,-11776,-44.02,1618
2022-01-07,15518,27129,-11611,-42.8,1618
2022-01-08,12047,23131,-11084,-47.92,1618
2022-01-09,8130,19459,-11329,-58.22,1618
2022-01-10,15040,26839,-11799,-43.96,1618
2022-01-11,14975,26920,-11945,-44.37,1618
2022-01-12,14975,26943,-11968,-44.42,1618
2022-01-13,14975,26969,-11994,-44.47,1618
2022-01-14,15518,27332,-11814,-43.22,1618
2022-01-15,12047,23322,-11275,-48.34,1618
2022-01-16,8130,19641,-11511,-58.61,1618
2022-01-17,15040,27015,-11975,-44.33,1618
2022-01-18,14975,27094,-12119,-44.73,1618
2022-01-19,14975,27118,-12143,-44.78,1618
2022-01-20,14975,27147,-12172,-44.84,1618
2022-01-21,15518,27518,-12000,-43.61,1618
2022-01-22,12047,23518,-11471,-48.78,1618
2022-01-23,8130,19849,-11719,-59.04,1618
2022-01-24,15040,27237,-12197,-44.78,1618
2022-01-25,14975,27332,-12357,-45.21,1618
2022-01-26,14975,27374,-12399,-45.29,1618
2022-01-27,14975,27421,-12446,-45.39,1618
2022-01-28,15518,27810,-12292,-44.2,1618
2022-01-29,12047,23827,-11780,-49.44,1618
2022-01-30,8130,20175,-12045,-59.7,1618
2020-02-01,13484,10593,2891,27.29,1624
2020-02-02,8664,5923,2741,46.28,1624
2020-02-03,15118,12222,2896,23.69,1624
2020-02-04,15680,12321,3359,27.26,1624
2020-02-05,15680,12287,3393,27.61,1624
2020-02-06,15680,12271,3409,27.78,1624
2020-02-07,16796,13091,3705,28.3,1624
2020-02-08,13484,10443,3041,29.12,1624
2020-02-09,8664,5765,2899,50.29,1624
2020-02-10,15118,12061,3057,25.35,1624
2020-02-11,15680,12163,3517,28.92,1624
2020-02-12,15680,12138,3542,29.18,1624
2020-02-13,15680,12138,3542,29.18,1624
2020-02-14,16796,12979,3817,29.41,1624
2020-02-15,13484,10358,3126,30.18,1624
2020-02-16,8664,5712,2952,51.68,1624
2020-02-17,15118,12043,3075,25.53,1624
2020-02-18,15680,12185,3495,28.68,1624
2020-02-19,15680,12202,3478,28.5,1624
2020-02-20,15680,12245,3435,28.05,1624
2020-02-21,16796,13130,3666,27.92,1624
2020-02-22,13484,10551,2933,27.8,1624
2020-02-23,8664,5946,2718,45.71,1624
2020-02-24,15118,12317,2801,22.74,1624
2020-02-25,15680,12494,3186,25.5,1624
2020-02-26,15680,12541,3139,25.03,1624
2020-02-27,15680,12609,3071,24.36,1624
2020-02-28,16796,13514,3282,24.29,1624
2020-02-29,13484,10949,2535,23.15,1624
2020-03-01,6242,6351,-109,-1.72,1624
2020-03-02,11346,12722,-1376,-10.82,1624
2020-03-03,11503,12894,-1391,-10.79,1624
2020-03-04,11503,12929,-1426,-11.03,1624
2020-03-05,11503,12980,-1477,-11.38,1624
2020-03-06,12558,13863,-1305,-9.41,1624
2020-03-07,9344,11271,-1927,-17.1,1624
2020-03-08,6242,6644,-402,-6.05,1624
2020-03-09,11346,12982,-1636,-12.6,1624
2020-03-10,11503,13120,-1617,-12.32,1624
2020-03-11,11503,13121,-1618,-12.33,1624
2020-03-12,11503,13137,-1634,-12.44,1624
2020-03-13,12558,13987,-1429,-10.22,1624
2020-03-14,9344,11365,-2021,-17.78,1624
2020-03-15,6242,6710,-468,-6.97,1624
2020-03-16,11346,13025,-1679,-12.89,1624
2020-03-17,11503,13143,-1640,-12.48,1624
2020-03-18,11503,13130,-1627,-12.39,1624
2020-03-19,11503,13138,-1635,-12.44,1624
2020-03-20,12558,13984,-1426,-10.2,1624
2020-03-21,9344,11364,-2020,-17.78,1624
2020-03-22,6242,6715,-473,-7.04,1624
2020-03-23,11346,13042,-1696,-13.0,1624
2020-03-24,11503,13177,-1674,-12.7,1624
2020-03-25,11503,13184,-1681,-12.75,1624
2020-03-26,11503,13214,-1711,-12.95,1624
2020-03-27,12558,14086,-1528,-10.85,1624
2020-03-28,9344,11493,-2149,-18.7,1624
2020-03-29,6242,6872,-630,-9.17,1624
2020-03-30,11346,13226,-1880,-14.21,1624
2020-03-31,11503,13386,-1883,-14.07,1624
2020-04-01,11623,13417,-1794,-13.37,1624
2020-04-02,11623,13469,-1846,-13.71,1624
2020-04-03,11424,14359,-2935,-20.44,1624
2020-04-04,8892,11779,-2887,-24.51,1624
2020-04-05,5294,7167,-1873,-26.13,1624
2020-04-06,11708,13525,-1817,-13.43,1624
2020-04-07,11623,13685,-2062,-15.07,1624
2020-04-08,11623,13710,-2087,-15.22,1624
2020-04-09,11623,13752,-2129,-15.48,1624
2020-04-10,11424,14626,-3202,-21.89,1624
2020-04-11,8892,12027,-3135,-26.07,1624
2020-04-12,5294,7393,-2099,-28.39,1624
2020-04-13,11708,13726,-2018,-14.7,1624
2020-04-14,11623,13858,-2235,-16.13,1624
2020-04-15,11623,13854,-2231,-16.1,1624
2020-04-16,11623,13866,-2243,-16.18,1624
2020-04-17,11424,14710,-3286,-22.34,1624
2020-04-18,8892,12083,-3191,-26.41,1624
2020-04-19,5294,7422,-2128,-28.67,1624
2020-04-20,11708,13730,-2022,-14.73,1624
2020-04-21,11623,13840,-2217,-16.02,1624
2020-04-22,11623,13818,-2195,-15.89,1624
2020-04-23,11623,13816,-2193,-15.87,1624
2020-04-24,11424,14651,-3227,-22.03,1624
2020-04-25,8892,12018,-3126,-26.01,1624
2020-04-26,5294,7355,-2061,-28.02,1624
2020-04-27,11708,13666,-1958,-14.33,1624
2020-04-28,11623,13784,-2161,-15.68,1624
2020-04-29,11623,13772,-2149,-15.6,1624
2020-04-30,11623,13783,-2160,-15.67,1624
2020-05-01,16075,14634,1441,9.85,1624
2020-05-02,13593,12018,1575,13.11,1624
2020-05-03,8451,7374,1077,14.61,1624
2020-05-04,15538,13704,1834,13.38,1624
2020-05-05,15711,13839,1872,13.53,1624
2020-05-06,15711,13845,1866,13.48,1624
2020-05-07,15711,13871,1840,13.27,1624
2020-05-08,16075,14735,1340,9.09,1624
2020-05-09,13593,12129,1464,12.07,1624
2020-05-10,8451,7491,960,12.82,1624
2020-05-11,15538,13824,1714,12.4,1624
2020-05-12,15711,13958,1753,12.56,1624
2020-05-13,15711,13959,1752,12.55,1624
2020-05-14,15711,13976,1735,12.41,1624
2020-05-15,16075,14827,1248,8.42,1624
2020-05-16,13593,12205,1388,11.37,1624
2020-05-17,8451,7549,902,11.95,1624
2020-05-18,15538,13861,1677,12.1,1624
2020-05-19,15711,13973,1738,12.44,1624
2020-05-20,15711,13950,1761,12.62,1624
2020-05-21,15711,13944,1767,12.67,1624
2020-05-22,16075,14772,1303,8.82,1624
2020-05-23,13593,12129,1464,12.07,1624
2020-05-24,8451,7453,998,13.39,1624
2020-05-25,15538,13748,1790,13.02,1624
2020-05-26,15711,13846,1865,13.47,1624
2020-05-27,15711,13813,1898,13.74,1624
2020-05-28,15711,13801,1910,13.84,1624
2020-05-29,16075,14627,1448,9.9,1624
2020-05-30,13593,11986,1607,13.41,1624
2020-05-31,8451,7317,1134,15.5,1624
2020-06-01,16096,13622,2474,18.16,1624
2020-06-02,16329,13733,2596,18.9,1624
2020-06-03,16329,13717,2612,19.04,1624
2020-06-04,16329,13724,2605,18.98,1624
2020-06-05,16474,14571,1903,13.06,1624
2020-06-06,14004,11952,2052,17.17,1624
2020-06-07,9178,7305,1873,25.64,1624
2020-06-08,16096,13631,2465,18.08,1624
2020-06-09,16329,13763,2566,18.64,1624
2020-06-10,16329,13764,2565,18.64,1624
2020-06-11,16329,13785,2544,18.45,1624
2020-06-12,16474,14643,1831,12.5,1624
2020-06-13,14004,12029,1975,16.42,1624
2020-06-14,9178,7383,1795,24.31,1624
2020-06-15,16096,13704,2392,17.45,1624
2020-06-16,16329,13825,2504,18.11,1624
2020-06-17,16329,13810,2519,18.24,1624
2020-06-18,16329,13809,2520,18.25,1624
2020-06-19,16474,14639,1835,12.54,1624
2020-06-20,14004,11994,2010,16.76,1624
2020-06-21,9178,7311,1867,25.54,1624
2020-06-22,16096,13592,2504,18.42,1624
2020-06-23,16329,13671,2658,19.44,1624
2020-06-24,16329,13611,2718,19.97,1624
2020-06-25,16329,13565,2764,20.38,1624
2020-06-26,16474,14350,2124,14.8,1624
2020-06-27,14004,11661,2343,20.09,1624
2020-06-28,9178,6938,2240,32.29,1624
2020-06-29,16096,13182,2914,22.11,1624
2020-06-30,16329,13227,3102,23.45,1624
2020-07-01,16120,13141,2979,22.67,1624
2020-07-02,16120,13073,3047,23.31,1624
2020-07-03,16202,13844,2358,17.03,1624
2020-07-04,13916,11147,2769,24.84,1624
2020-07-05,9950,6423,3527,54.91,1624
2020-07-06,15473,12675,2798,22.07,1624
2020-07-07,16120,12735,3385,26.58,1624
2020-07-08,16120,12670,3450,27.23,1624
2020-07-09,16120,12630,3490,27.63,1624
2020-07-10,16202,13435,2767,20.6,1624
2020-07-11,13916,10777,3139,29.13,1624
2020-07-12,9950,6096,3854,63.22,1624
2020-07-13,15473,12393,3080,24.85,1624
2020-07-14,16120,12501,3619,28.95,1624
2020-07-15,16120,12484,3636,29.13,1624
2020-07-16,16120,12492,3628,29.04,1624
2020-07-17,16202,13342,2860,21.44,1624
2020-07-18,13916,10728,3188,29.72,1624
2020-07-19,9950,6086,3864,63.49,1624
2020-07-20,15473,12417,3056,24.61,1624
2020-07-21,16120,12554,3566,28.41,1624
2020-07-22,16120,12559,3561,28.35,1624
2020-07-23,16120,12583,3537,28.11,1624
2020-07-24,16202,13443,2759,20.52,1624
2020-07-25,13916,10830,3086,28.49,1624
2020-07-26,9950,6183,3767,60.93,1624
2020-07-27,15473,12504,2969,23.74,1624
2020-07-28,16120,12623,3497,27.7,1624
2020-07-29,16120,12606,3514,27.88,1624
2020-07-30,16120,12603,3517,27.91,1624
2020-07-31,16202,13432,2770,20.62,1624
2020-08-01,11827,10786,1041,9.65,1624
2020-08-02,8125,6106,2019,33.07,1624
2020-08-03,13387,12392,995,8.03,1624
2020-08-04,13431,12478,953,7.64,1624
2020-08-05,13431,12430,1001,8.05,1624
2020-08-06,13431,12400,1031,8.31,1624
2020-08-07,13989,13205,784,5.94,1624
2020-08-08,11827,10542,1285,12.19,1624
2020-08-09,8125,5849,2276,38.91,1624
2020-08-10,13387,12130,1257,10.36,1624
2020-08-11,13431,12218,1213,9.93,1624
2020-08-12,13431,12178,1253,10.29,1624
2020-08-13,13431,12164,1267,10.42,1624
2020-08-14,13989,12992,997,7.67,1624
2020-08-15,11827,10358,1469,14.18,1624
2020-08-16,8125,5700,2425,42.54,1624
2020-08-17,13387,12022,1365,11.35,1624
2020-08-18,13431,12154,1277,10.51,1624
2020-08-19,13431,12163,1268,10.43,1624
2020-08-20,13431,12198,1233,10.11,1624
2020-08-21,13989,13078,911,6.97,1624
2020-08-22,11827,10495,1332,12.69,1624
2020-08-23,8125,5887,2238,38.02,1624
2020-08-24,13387,12256,1131,9.23,1624
2020-08-25,13431,12432,999,8.04,1624
2020-08-26,13431,12480,951,7.62,1624
2020-08-27,13431,12549,882,7.03,1624
2020-08-28,13989,13457,532,3.95,1624
2020-08-29,11827,10894,933,8.56,1624
2020-08-30,8125,6300,1825,28.97,1624
2020-08-31,13387,12675,712,5.62,1624
2020-09-01,13907,12851,1056,8.22,1624
2020-09-02,13907,12891,1016,7.88,1624
2020-09-03,13907,12946,961,7.42,1624
2020-09-04,14727,13833,894,6.46,1624
2020-09-05,12003,11245,758,6.74,1624
2020-09-06,7778,6621,1157,17.47,1624
2020-09-07,13850,12963,887,6.84,1624
2020-09-08,13907,13102,805,6.14,1624
2020-09-09,13907,13105,802,6.12,1624
2020-09-10,13907,13122,785,5.98,1624
2020-09-11,14727,13972,755,5.4,1624
2020-09-12,12003,11350,653,5.75,1624
2020-09-13,7778,6694,1084,16.19,1624
2020-09-14,13850,13007,843,6.48,1624
2020-09-15,13907,13123,784,5.97,1624
2020-09-16,13907,13108,799,6.1,1624
2020-09-17,13907,13113,794,6.06,1624
2020-09-18,14727,13956,771,5.52,1624
2020-09-19,12003,11333,670,5.91,1624
2020-09-20,7778,6683,1095,16.38,1624
2020-09-21,13850,13008,842,6.47,1624
2020-09-22,13907,13140,767,5.84,1624
2020-09-23,13907,13146,761,5.79,1624
2020-09-24,13907,13176,731,5.55,1624
2020-09-25,14727,14049,678,4.83,1624
2020-09-26,12003,11456,547,4.77,1624
2020-09-27,7778,6838,940,13.75,1624
2020-09-28,13850,13194,656,4.97,1624
2020-09-29,13907,13358,549,4.11,1624
2020-09-30,13907,13393,514,3.84,1624
2020-10-01,13674,13450,224,1.67,1624
2020-10-02,14613,14345,268,1.87,1624
2020-10-03,11976,11772,204,1.73,1624
2020-10-04,7410,7166,244,3.4,1624
2020-10-05,13943,13531,412,3.04,1624
2020-10-06,13674,13697,-23,-0.17,1624
2020-10-07,13674,13728,-54,-0.39,1624
2020-10-08,13674,13775,-101,-0.73,1624
2020-10-09,14613,14654,-41,-0.28,1624
2020-10-10,11976,12059,-83,-0.69,1624
2020-10-11,7410,7428,-18,-0.24,1624
2020-10-12,13943,13761,182,1.32,1624
2020-10-13,13674,13893,-219,-1.58,1624
2020-10-14,13674,13887,-213,-1.53,1624
2020-10-15,13674,13894,-220,-1.58,1624
2020-10-16,14613,14733,-120,-0.81,1624
2020-10-17,11976,12097,-121,-1.0,1624
2020-10-18,7410,7426,-16,-0.22,1624
2020-10-19,13943,13722,221,1.61,1624
2020-10-20,13674,13819,-145,-1.05,1624
2020-10-21,13674,13780,-106,-0.77,1624
2020-10-22,13674,13760,-86,-0.62,1624
2020-10-23,14613,14576,37,0.25,1624
2020-10-24,11976,11921,55,0.46,1624
2020-10-25,7410,7237,173,2.39,1624
2020-10-26,13943,13524,419,3.1,1624
2020-10-27,13674,13617,57,0.42,1624
2020-10-28,13674,13580,94,0.69,1624
2020-10-29,13674,13566,108,0.8,1624
2020-10-30,14613,14391,222,1.54,1624
2020-10-31,11976,11750,226,1.92,1624
2020-11-01,6100,7082,-982,-13.87,1624
2020-11-02,12658,13387,-729,-5.45,1624
2020-11-03,11823,13499,-1676,-12.42,1624
2020-11-04,11823,13482,-1659,-12.31,1624
2020-11-05,11823,13487,-1664,-12.34,1624
2020-11-06,12809,14331,-1522,-10.62,1624
2020-11-07,9884,11706,-1822,-15.56,1624
2020-11-08,6100,7051,-951,-13.49,1624
2020-11-09,12658,13368,-710,-5.31,1624
2020-11-10,11823,13488,-1665,-12.34,1624
2020-11-11,11823,13475,-1652,-12.26,1624
2020-11-12,11823,13481,-1658,-12.3,1624
2020-11-13,12809,14322,-1513,-10.56,1624
2020-11-14,9884,11691,-1807,-15.46,1624
2020-11-15,6100,7027,-927,-13.19,1624
2020-11-16,12658,13331,-673,-5.05,1624
2020-11-17,11823,13436,-1613,-12.01,1624
2020-11-18,11823,13407,-1584,-11.81,1624
2020-11-19,11823,13395,-1572,-11.74,1624
2020-11-20,12809,14218,-1409,-9.91,1624
2020-11-21,9884,11569,-1685,-14.56,1624
2020-11-22,6100,6888,-788,-11.44,1624
2020-11-23,12658,13178,-520,-3.95,1624
2020-11-24,11823,13270,-1447,-10.9,1624
2020-11-25,11823,13231,-1408,-10.64,1624
2020-11-26,11823,13212,-1389,-10.51,1624
2020-11-27,12809,14031,-1222,-8.71,1624
2020-11-28,9884,11383,-1499,-13.17,1624
2020-11-29,6100,6707,-607,-9.05,1624
2020-11-30,12658,13004,-346,-2.66,1624
2020-12-01,11787,13108,-1321,-10.08,1624
2020-12-02,11787,13084,-1297,-9.91,1624
2020-12-03,11787,13083,-1296,-9.91,1624
2020-12-04,13275,13923,-648,-4.65,1624
2020-12-05,10739,11297,-558,-4.94,1624
2020-12-06,6183,6643,-460,-6.92,1624
2020-12-07,12424,12963,-539,-4.16,1624
2020-12-08,11787,13089,-1302,-9.95,1624
2020-12-09,11787,13085,-1298,-9.92,1624
2020-12-10,11787,13102,-1315,-10.04,1624
2020-12-11,13275,13957,-682,-4.89,1624
2020-12-12,10739,11341,-602,-5.31,1624
2020-12-13,6183,6693,-510,-7.62,1624
2020-12-14,12424,13015,-591,-4.54,1624
2020-12-15,11787,13137,-1350,-10.28,1624
2020-12-16,11787,13124,-1337,-10.19,1624
2020-12-17,11787,13125,-1338,-10.19,1624
2020-12-18,13275,13959,-684,-4.9,1624
2020-12-19,10739,11317,-578,-5.11,1624
2020-12-20,6183,6638,-455,-6.85,1624
2020-12-21,12424,12924,-500,-3.87,1624
2020-12-22,11787,13007,-1220,-9.38,1624
2020-12-23,11787,12952,-1165,-8.99,1624
2020-12-24,11787,12910,-1123,-8.7,1624
2020-12-25,13275,13700,-425,-3.1,1624
2020-12-26,10739,11014,-275,-2.5,1624
2020-12-27,6183,6293,-110,-1.75,1624
2020-12-28,12424,12539,-115,-0.92,1624
2020-12-29,11787,12585,-798,-6.34,1624
2020-12-30,11787,12498,-711,-5.69,1624
2020-12-31,11787,12429,-642,-5.17,1624
2021-01-01,11045,13197,-2152,-16.31,1624
2021-01-02,8254,10496,-2242,-21.36,1624
2021-01-03,5003,5768,-765,-13.26,1624
2021-01-04,10264,12013,-1749,-14.56,1624
2021-01-05,10501,12066,-1565,-12.97,1624
2021-01-06,10501,11993,-1492,-12.44,1624
2021-01-07,10501,11945,-1444,-12.09,1624
2021-01-08,11045,12741,-1696,-13.31,1624
2021-01-09,8254,10074,-1820,-18.07,1624
2021-01-10,5003,5383,-380,-7.06,1624
2021-01-11,10264,11671,-1407,-12.06,1624
2021-01-12,10501,11770,-1269,-10.78,1624
2021-01-13,10501,11745,-1244,-10.59,1624
2021-01-14,10501,11746,-1245,-10.6,1624
2021-01-15,11045,12590,-1545,-12.27,1624
2021-01-16,8254,9970,-1716,-17.21,1624
2021-01-17,5003,5324,-321,-6.03,1624
2021-01-18,10264,11654,-1390,-11.93,1624
2021-01-19,10501,11790,-1289,-10.93,1624
2021-01-20,10501,11797,-1296,-10.99,1624
2021-01-21,10501,11824,-1323,-11.19,1624
2021-01-22,11045,12688,-1643,-12.95,1624
2021-01-23,8254,10083,-1829,-18.14,1624
2021-01-24,5003,5444,-441,-8.1,1624
2021-01-25,10264,11775,-1511,-12.83,1624
2021-01-26,10501,11906,-1405,-11.8,1624
2021-01-27,10501,11902,-1401,-11.77,1624
2021-01-28,10501,11914,-1413,-11.86,1624
2021-01-29,11045,12758,-1713,-13.43,1624
2021-01-30,8254,10128,-1874,-18.5,1624
2021-01-31,5003,5464,-461,-8.44,1624
2021-02-01,12220,11767,453,3.85,1624
2021-02-02,12090,11870,220,1.85,1624
2021-02-03,12090,11838,252,2.13,1624
2021-02-04,12090,11824,266,2.25,1624
2021-02-05,13048,12645,403,3.19,1624
2021-02-06,10511,9996,515,5.15,1624
2021-02-07,6129,5317,812,15.27,1624
2021-02-08,12220,11610,610,5.25,1624
2021-02-09,12090,11709,381,3.25,1624
2021-02-10,12090,11679,411,3.52,1624
2021-02-11,12090,11673,417,3.57,1624
2021-02-12,13048,12508,540,4.32,1624
2021-02-13,10511,9879,632,6.4,1624
2021-02-14,6129,5225,904,17.3,1624
2021-02-15,12220,11548,672,5.82,1624
2021-02-16,12090,11682,408,3.49,1624
2021-02-17,12090,11691,399,3.41,1624
2021-02-18,12090,11726,364,3.1,1624
2021-02-19,13048,12604,444,3.52,1624
2021-02-20,10511,10018,493,4.92,1624
2021-02-21,6129,5408,721,13.33,1624
2021-02-22,12220,11773,447,3.8,1624
2021-02-23,12090,11946,144,1.21,1624
2021-02-24,12090,11991,99,0.83,1624
2021-02-25,12090,12057,33,0.27,1624
2021-02-26,13048,12962,86,0.66,1624
2021-02-27,10511,10398,113,1.09,1624
2021-02-28,6129,5802,327,5.64,1624
2021-03-01,13026,12177,849,6.97,1624
2021-03-02,13035,12352,683,5.53,1624
2021-03-03,13035,12393,642,5.18,1624
2021-03-04,13035,12449,586,4.71,1624
2021-03-05,13510,13338,172,1.29,1624
2021-03-06,11284,10753,531,4.94,1624
2021-03-07,6474,6132,342,5.58,1624
2021-03-08,13026,12477,549,4.4,1624
2021-03-09,13035,12620,415,3.29,1624
2021-03-10,13035,12627,408,3.23,1624
2021-03-11,13035,12649,386,3.05,1624
2021-03-12,13510,13504,6,0.04,1624
2021-03-13,11284,10885,399,3.67,1624
2021-03-14,6474,6233,241,3.87,1624
2021-03-15,13026,12550,476,3.79,1624
2021-03-16,13035,12669,366,2.89,1624
2021-03-17,13035,12655,380,3.0,1624
2021-03-18,13035,12662,373,2.95,1624
2021-03-19,13510,13506,4,0.03,1624
2021-03-20,11284,10882,402,3.69,1624
2021-03-21,6474,6231,243,3.9,1624
2021-03-22,13026,12553,473,3.77,1624
2021-03-23,13035,12683,352,2.78,1624
2021-03-24,13035,12684,351,2.77,1624
2021-03-25,13035,12710,325,2.56,1624
2021-03-26,13510,13577,-67,-0.49,1624
2021-03-27,11284,10978,306,2.79,1624
2021-03-28,6474,6353,121,1.9,1624
2021-03-29,13026,12703,323,2.54,1624
2021-03-30,13035,12860,175,1.36,1624
2021-03-31,13035,12888,147,1.14,1624
2021-04-01,11897,12938,-1041,-8.05,1624
2021-04-02,12555,13826,-1271,-9.19,1624
2021-04-03,9751,11246,-1495,-13.29,1624
2021-04-04,6286,6636,-350,-5.27,1624
2021-04-05,11976,12996,-1020,-7.85,1624
2021-04-06,11897,13158,-1261,-9.58,1624
2021-04-07,11897,13187,-1290,-9.78,1624
2021-04-08,11897,13233,-1336,-10.1,1624
2021-04-09,12555,14112,-1557,-11.03,1624
2021-04-10,9751,11518,-1767,-15.34,1624
2021-04-11,6286,6890,-604,-8.77,1624
2021-04-12,11976,13228,-1252,-9.46,1624
2021-04-13,11897,13366,-1469,-10.99,1624
2021-04-14,11897,13367,-1470,-11.0,1624
2021-04-15,11897,13384,-1487,-11.11,1624
2021-04-16,12555,14233,-1678,-11.79,1624
2021-04-17,9751,11610,-1859,-16.01,1624
2021-04-18,6286,6952,-666,-9.58,1624
2021-04-19,11976,13263,-1287,-9.7,1624
2021-04-20,11897,13375,-1478,-11.05,1624
2021-04-21,11897,13354,-1457,-10.91,1624
2021-04-22,11897,13352,-1455,-10.9,1624
2021-04-23,12555,14187,-1632,-11.5,1624
2021-04-24,9751,11552,-1801,-15.59,1624
2021-04-25,6286,6888,-602,-8.74,1624
2021-04-26,11976,13197,-1221,-9.25,1624
2021-04-27,11897,13311,-1414,-10.62,1624
2021-04-28,11897,13296,-1399,-10.52,1624
2021-04-29,11897,13303,-1406,-10.57,1624
2021-04-30,12555,14150,-1595,-11.27,1624
2021-05-01,12292,11531,761,6.6,1624
2021-05-02,7362,6884,478,6.94,1624
2021-05-03,14184,13211,973,7.37,1624
2021-05-04,14229,13344,885,6.63,1624
2021-05-05,14229,13347,882,6.61,1624
2021-05-06,14229,13372,857,6.41,1624
2021-05-07,14772,14235,537,3.77,1624
2021-05-08,12292,11629,663,5.7,1624
2021-05-09,7362,6992,370,5.29,1624
2021-05-10,14184,13327,857,6.43,1624
2021-05-11,14229,13463,766,5.69,1624
2021-05-12,14229,13466,763,5.67,1624
2021-05-13,14229,13487,742,5.5,1624
2021-05-14,14772,14342,430,3.0,1624
2021-05-15,12292,11725,567,4.84,1624
2021-05-16,7362,7073,289,4.09,1624
2021-05-17,14184,13390,794,5.93,1624
2021-05-18,14229,13506,723,5.35,1624
2021-05-19,14229,13487,742,5.5,1624
2021-05-20,14229,13485,744,5.52,1624
2021-05-21,14772,14316,456,3.19,1624
2021-05-22,12292,11676,616,5.28,1624
2021-05-23,7362,7002,360,5.14,1624
2021-05-24,14184,13298,886,6.66,1624
2021-05-25,14229,13397,832,6.21,1624
2021-05-26,14229,13364,865,6.47,1624
2021-05-27,14229,13350,879,6.58,1624
2021-05-28,14772,14174,598,4.22,1624
2021-05-29,12292,11531,761,6.6,1624
2021-05-30,7362,6858,504,7.35,1624
2021-05-31,14184,13160,1024,7.78,1624
2021-06-01,14487,13267,1220,9.2,1624
2021-06-02,14487,13247,1240,9.36,1624
2021-06-03,14487,13249,1238,9.34,1624
2021-06-04,14762,14092,670,4.75,1624
2021-06-05,12458,11469,989,8.62,1624
2021-06-06,8711,6819,1892,27.75,1624
2021-06-07,14055,13142,913,6.95,1624
2021-06-08,14487,13272,1215,9.15,1624
2021-06-09,14487,13272,1215,9.15,1624
2021-06-10,14487,13292,1195,8.99,1624
2021-06-11,14762,14150,612,4.33,1624
2021-06-12,12458,11539,919,7.96,1624
2021-06-13,8711,6895,1816,26.34,1624
2021-06-14,14055,13220,835,6.32,1624
2021-06-15,14487,13347,1140,8.54,1624
2021-06-16,14487,13337,1150,8.62,1624
2021-06-17,14487,13343,1144,8.57,1624
2021-06-18,14762,14181,581,4.1,1624
2021-06-19,12458,11543,915,7.93,1624
2021-06-20,8711,6868,1843,26.83,1624
2021-06-21,14055,13158,897,6.82,1624
2021-06-22,14487,13245,1242,9.38,1624
2021-06-23,14487,13194,1293,9.8,1624
2021-06-24,14487,13155,1332,10.13,1624
2021-06-25,14762,13948,814,5.84,1624
2021-06-26,12458,11265,1193,10.59,1624
2021-06-27,8711,6546,2165,33.07,1624
2021-06-28,14055,12795,1260,9.85,1624
2021-06-29,14487,12843,1644,12.8,1624
2021-06-30,14487,12758,1729,13.55,1624
2021-07-01,13601,12691,910,7.17,1624
2021-07-02,14023,13460,563,4.18,1624
2021-07-03,11523,10761,762,7.08,1624
2021-07-04,7747,6033,1714,28.41,1624
2021-07-05,13360,12280,1080,8.79,1624
2021-07-06,13601,12334,1267,10.27,1624
2021-07-07,13601,12261,1340,10.93,1624
2021-07-08,13601,12214,1387,11.36,1624
2021-07-09,14023,13010,1013,7.79,1624
2021-07-10,11523,10343,1180,11.41,1624
2021-07-11,7747,5653,2094,37.04,1624
2021-07-12,13360,11942,1418,11.87,1624
2021-07-13,13601,12041,1560,12.96,1624
2021-07-14,13601,12015,1586,13.2,1624
2021-07-15,13601,12016,1585,13.19,1624
2021-07-16,14023,12860,1163,9.04,1624
2021-07-17,11523,10240,1283,12.53,1624
2021-07-18,7747,5593,2154,38.51,1624
2021-07-19,13360,11922,1438,12.06,1624
2021-07-20,13601,12057,1544,12.81,1624
2021-07-21,13601,12061,1540,12.77,1624
2021-07-22,13601,12086,1515,12.54,1624
2021-07-23,14023,12948,1075,8.3,1624
2021-07-24,11523,10338,1185,11.46,1624
2021-07-25,7747,5696,2051,36.01,1624
2021-07-26,13360,12021,1339,11.14,1624
2021-07-27,13601,12146,1455,11.98,1624
2021-07-28,13601,12135,1466,12.08,1624
2021-07-29,13601,12139,1462,12.04,1624
2021-07-30,14023,12975,1048,8.08,1624
2021-07-31,11523,10335,1188,11.49,1624
2021-08-01,7531,5661,1870,33.03,1624
2021-08-02,13008,11952,1056,8.84,1624
2021-08-03,13110,12043,1067,8.86,1624
2021-08-04,13110,11998,1112,9.27,1624
2021-08-05,13110,11971,1139,9.51,1624
2021-08-06,13545,12778,767,6.0,1624
2021-08-07,11107,10114,993,9.82,1624
2021-08-08,7531,5420,2111,38.95,1624
2021-08-09,13008,11698,1310,11.2,1624
2021-08-10,13110,11782,1328,11.27,1624
2021-08-11,13110,11737,1373,11.7,1624
2021-08-12,13110,11716,1394,11.9,1624
2021-08-13,13545,12537,1008,8.04,1624
2021-08-14,11107,9895,1212,12.25,1624
2021-08-15,7531,5228,2303,44.05,1624
2021-08-16,13008,11540,1468,12.72,1624
2021-08-17,13110,11663,1447,12.41,1624
2021-08-18,13110,11662,1448,12.42,1624
2021-08-19,13110,11688,1422,12.17,1624
2021-08-20,13545,12559,986,7.85,1624
2021-08-21,11107,9968,1139,11.43,1624
2021-08-22,7531,5353,2178,40.69,1624
2021-08-23,13008,11715,1293,11.04,1624
2021-08-24,13110,11886,1224,10.3,1624
2021-08-25,13110,11929,1181,9.9,1624
2021-08-26,13110,11996,1114,9.29,1624
2021-08-27,13545,12902,643,4.98,1624
2021-08-28,11107,10340,767,7.42,1624
2021-08-29,7531,5747,1784,31.04,1624
2021-08-30,13008,12125,883,7.28,1624
2021-08-31,13110,12304,806,6.55,1624
2021-09-01,13813,12349,1464,11.86,1624
2021-09-02,13813,12410,1403,11.31,1624
2021-09-03,14606,13303,1303,9.79,1624
2021-09-04,11995,10722,1273,11.87,1624
2021-09-05,8065,6105,1960,32.1,1624
2021-09-06,13552,12454,1098,8.82,1624
2021-09-07,13813,12600,1213,9.63,1624
2021-09-08,13813,12609,1204,9.55,1624
2021-09-09,13813,12633,1180,9.34,1624
2021-09-10,14606,13489,1117,8.28,1624
2021-09-11,11995,10870,1125,10.35,1624
2021-09-12,8065,6218,1847,29.7,1624
2021-09-13,13552,12534,1018,8.12,1624
2021-09-14,13813,12651,1162,9.19,1624
2021-09-15,13813,12636,1177,9.31,1624
2021-09-16,13813,12640,1173,9.28,1624
2021-09-17,14606,13482,1124,8.34,1624
2021-09-18,11995,10856,1139,10.49,1624
2021-09-19,8065,6201,1864,30.06,1624
2021-09-20,13552,12521,1031,8.23,1624
2021-09-21,13813,12648,1165,9.21,1624
2021-09-22,13813,12648,1165,9.21,1624
2021-09-23,13813,12673,1140,9.0,1624
2021-09-24,14606,13539,1067,7.88,1624
2021-09-25,11995,10940,1055,9.64,1624
2021-09-26,8065,6316,1749,27.69,1624
2021-09-27,13552,12668,884,6.98,1624
2021-09-28,13813,12827,986,7.69,1624
2021-09-29,13813,12859,954,7.42,1624
2021-09-30,13813,12913,900,6.97,1624
2021-10-01,14912,13806,1106,8.01,1624
2021-10-02,12657,11232,1425,12.69,1624
2021-10-03,8151,6627,1524,23.0,1624
2021-10-04,13818,12994,824,6.34,1624
2021-10-05,13881,13162,719,5.46,1624
2021-10-06,13881,13198,683,5.18,1624
2021-10-07,13881,13249,632,4.77,1624
2021-10-08,14912,14134,778,5.5,1624
2021-10-09,12657,11545,1112,9.63,1624
2021-10-10,8151,6921,1230,17.77,1624
2021-10-11,13818,13262,556,4.19,1624
2021-10-12,13881,13401,480,3.58,1624
2021-10-13,13881,13402,479,3.57,1624
2021-10-14,13881,13417,464,3.46,1624
2021-10-15,14912,14263,649,4.55,1624
2021-10-16,12657,11634,1023,8.79,1624
2021-10-17,8151,6969,1182,16.96,1624
2021-10-18,13818,13270,548,4.13,1624
2021-10-19,13881,13371,510,3.81,1624
2021-10-20,13881,13336,545,4.09,1624
2021-10-21,13881,13319,562,4.22,1624
2021-10-22,14912,14136,776,5.49,1624
2021-10-23,12657,11482,1175,10.23,1624
2021-10-24,8151,6797,1354,19.92,1624
2021-10-25,13818,13084,734,5.61,1624
2021-10-26,13881,13175,706,5.36,1624
2021-10-27,13881,13135,746,5.68,1624
2021-10-28,13881,13118,763,5.82,1624
2021-10-29,14912,13940,972,6.97,1624
2021-10-30,12657,11295,1362,12.06,1624
2021-10-31,8151,6622,1529,23.09,1624
2021-11-01,12528,12924,-396,-3.06,1624
2021-11-02,13119,13033,86,0.66,1624
2021-11-03,13119,13013,106,0.81,1624
2021-11-04,13119,13015,104,0.8,1624
2021-11-05,14088,13856,232,1.67,1624
2021-11-06,11683,11230,453,4.03,1624
2021-11-07,7405,6574,831,12.64,1624
2021-11-08,12528,12891,-363,-2.82,1624
2021-11-09,13119,13011,108,0.83,1624
2021-11-10,13119,13000,119,0.92,1624
2021-11-11,13119,13007,112,0.86,1624
2021-11-12,14088,13850,238,1.72,1624
2021-11-13,11683,11222,461,4.11,1624
2021-11-14,7405,6561,844,12.86,1624
2021-11-15,12528,12869,-341,-2.65,1624
2021-11-16,13119,12978,141,1.09,1624
2021-11-17,13119,12952,167,1.29,1624
2021-11-18,13119,12943,176,1.36,1624
2021-11-19,14088,13769,319,2.32,1624
2021-11-20,11683,11123,560,5.03,1624
2021-11-21,7405,6444,961,14.91,1624
2021-11-22,12528,12735,-207,-1.63,1624
2021-11-23,13119,12828,291,2.27,1624
2021-11-24,13119,12789,330,2.58,1624
2021-11-25,13119,12769,350,2.74,1624
2021-11-26,14088,13587,501,3.69,1624
2021-11-27,11683,10937,746,6.82,1624
2021-11-28,7405,6257,1148,18.35,1624
2021-11-29,12528,12551,-23,-0.18,1624
2021-11-30,13119,12652,467,3.69,1624
2021-12-01,12497,12624,-127,-1.01,1624
2021-12-02,12497,12618,-121,-0.96,1624
2021-12-03,12235,13454,-1219,-9.06,1624
2021-12-04,10703,10823,-120,-1.11,1624
2021-12-05,6934,6165,769,12.47,1624
2021-12-06,13005,12482,523,4.19,1624
2021-12-07,12497,12605,-108,-0.86,1624
2021-12-08,12497,12599,-102,-0.81,1624
2021-12-09,12497,12615,-118,-0.94,1624
2021-12-10,12235,13468,-1233,-9.16,1624
2021-12-11,10703,10853,-150,-1.38,1624
2021-12-12,6934,6207,727,11.71,1624
2021-12-13,13005,12531,474,3.78,1624
2021-12-14,12497,12657,-160,-1.26,1624
2021-12-15,12497,12648,-151,-1.19,1624
2021-12-16,12497,12656,-159,-1.26,1624
2021-12-17,12235,13496,-1261,-9.34,1624
2021-12-18,10703,10861,-158,-1.45,1624
2021-12-19,6934,6190,744,12.02,1624
2021-12-20,13005,12484,521,4.17,1624
2021-12-21,12497,12576,-79,-0.63,1624
2021-12-22,12497,12529,-32,-0.26,1624
2021-12-23,12497,12495,2,0.02,1624
2021-12-24,12235,13292,-1057,-7.95,1624
2021-12-25,10703,10613,90,0.85,1624
2021-12-26,6934,5898,1036,17.57,1624
2021-12-27,13005,12149,856,7.05,1624
2021-12-28,12497,12200,297,2.43,1624
2021-12-29,12497,12115,382,3.15,1624
2021-12-30,12497,12048,449,3.73,1624
2021-12-31,12235,12816,-581,-4.53,1624
2022-01-01,10577,10115,462,4.57,1624
2022-01-02,6238,5384,854,15.86,1624
2022-01-03,11881,11625,256,2.2,1624
2022-01-04,11939,11674,265,2.27,1624
2022-01-05,11939,11594,345,2.98,1624
2022-01-06,11939,11539,400,3.47,1624
2022-01-07,12746,12327,419,3.4,1624
2022-01-08,10577,9651,926,9.59,1624
2022-01-09,6238,4952,1286,25.97,1624
2022-01-10,11881,11231,650,5.79,1624
2022-01-11,11939,11321,618,5.46,1624
2022-01-12,11939,11287,652,5.78,1624
2022-01-13,11939,11279,660,5.85,1624
2022-01-14,12746,12115,631,5.21,1624
2022-01-15,10577,9488,1089,11.48,1624
2022-01-16,6238,4837,1401,28.96,1624
2022-01-17,11881,11161,720,6.45,1624
2022-01-18,11939,11293,646,5.72,1624
2022-01-19,11939,11297,642,5.68,1624
2022-01-20,11939,11323,616,5.44,1624
2022-01-21,12746,12188,558,4.58,1624
2022-01-22,10577,9583,994,10.37,1624
2022-01-23,6238,4946,1292,26.12,1624
2022-01-24,11881,11280,601,5.33,1624
2022-01-25,11939,11415,524,4.59,1624
2022-01-26,11939,11415,524,4.59,1624
2022-01-27,11939,11432,507,4.43,1624
2022-01-28,12746,12281,465,3.79,1624
2022-01-29,10577,9657,920,9.53,1624
2022-01-30,6238,4998,1240,24.81,1624
2020-02-01,29036,26578,2458,9.25,1075
2020-02-02,23763,21599,2164,10.02,1075
2020-02-03,37609,36708,901,2.45,1075
2020-02-04,39679,38827,852,2.19,1075
2020-02-05,39679,38878,801,2.06,1075
2020-02-06,39679,38887,792,2.04,1075
2020-02-07,39747,38424,1323,3.44,1075
2020-02-08,29036,26711,2325,8.7,1075
2020-02-09,23763,21698,2065,9.52,1075
2020-02-10,37609,36784,825,2.24,1075
2020-02-11,39679,38890,789,2.03,1075
2020-02-12,39679,38942,737,1.89,1075
2020-02-13,39679,38962,717,1.84,1075
2020-02-14,39747,38525,1222,3.17,1075
2020-02-15,29036,26850,2186,8.14,1075
2020-02-16,23763,21887,1876,8.57,1075
2020-02-17,37609,37034,575,1.55,1075
2020-02-18,39679,39210,469,1.2,1075
2020-02-19,39679,39340,339,0.86,1075
2020-02-20,39679,39445,234,0.59,1075
2020-02-21,39747,39096,651,1.67,1075
2020-02-22,29036,27512,1524,5.54,1075
2020-02-23,23763,22639,1124,4.96,1075
2020-02-24,37609,37872,-263,-0.69,1075
2020-02-25,39679,40131,-452,-1.13,1075
2020-02-26,39679,40336,-657,-1.63,1075
2020-02-27,39679,40508,-829,-2.05,1075
2020-02-28,39747,40215,-468,-1.16,1075
2020-02-29,29036,28675,361,1.26,1075
2020-03-01,16491,23833,-7342,-30.81,1075
2020-03-02,28064,39084,-11020,-28.2,1075
2020-03-03,29342,41346,-12004,-29.03,1075
2020-03-04,29342,41541,-12199,-29.37,1075
2020-03-05,29342,41688,-12346,-29.62,1075
2020-03-06,29092,41358,-12266,-29.66,1075
2020-03-07,18227,29769,-11542,-38.77,1075
2020-03-08,16491,24866,-8375,-33.68,1075
2020-03-09,28064,40049,-11985,-29.93,1075
2020-03-10,29342,42235,-12893,-30.53,1075
2020-03-11,29342,42348,-13006,-30.71,1075
2020-03-12,29342,42410,-13068,-30.81,1075
2020-03-13,29092,41994,-12902,-30.72,1075
2020-03-14,18227,30319,-12092,-39.88,1075
2020-03-15,16491,25334,-8843,-34.91,1075
2020-03-16,28064,40439,-12375,-30.6,1075
2020-03-17,29342,42554,-13212,-31.05,1075
2020-03-18,29342,42603,-13261,-31.13,1075
2020-03-19,29342,42611,-13269,-31.14,1075
2020-03-20,29092,42151,-13059,-30.98,1075
2020-03-21,18227,30442,-12215,-40.13,1075
2020-03-22,16491,25435,-8944,-35.16,1075
2020-03-23,28064,40528,-12464,-30.75,1075
2020-03-24,29342,42642,-13300,-31.19,1075
2020-03-25,29342,42700,-13358,-31.28,1075
2020-03-26,29342,42727,-13385,-31.33,1075
2020-03-27,29092,42293,-13201,-31.21,1075
2020-03-28,18227,30617,-12390,-40.47,1075
2020-03-29,16491,25648,-9157,-35.7,1075
2020-03-30,28064,40783,-12719,-31.19,1075
2020-03-31,29342,42940,-13598,-31.67,1075
2020-04-01,22874,43043,-20169,-46.86,1075
2020-04-02,22874,43112,-20238,-46.94,1075
2020-04-03,21512,42719,-21207,-49.64,1075
2020-04-04,15467,31079,-15612,-50.23,1075
2020-04-05,12266,26141,-13875,-53.08,1075
2020-04-06,22392,41299,-18907,-45.78,1075
2020-04-07,22874,43474,-20600,-47.38,1075
2020-04-08,22874,43586,-20712,-47.52,1075
2020-04-09,22874,43657,-20783,-47.61,1075
2020-04-10,21512,43256,-21744,-50.27,1075
2020-04-11,15467,31602,-16135,-51.06,1075
2020-04-12,12266,26641,-14375,-53.96,1075
2020-04-13,22392,41772,-19380,-46.39,1075
2020-04-14,22874,43912,-21038,-47.91,1075
2020-04-15,22874,43985,-21111,-48.0,1075
2020-04-16,22874,44013,-21139,-48.03,1075
2020-04-17,21512,43568,-22056,-50.62,1075
2020-04-18,15467,31868,-16401,-51.47,1075
2020-04-19,12266,26863,-14597,-54.34,1075
2020-04-20,22392,41949,-19557,-46.62,1075
2020-04-21,22874,44049,-21175,-48.07,1075
2020-04-22,22874,44085,-21211,-48.11,1075
2020-04-23,22874,44080,-21206,-48.11,1075
2020-04-24,21512,43608,-22096,-50.67,1075
2020-04-25,15467,31887,-16420,-51.49,1075
2020-04-26,12266,26867,-14601,-54.35,1075
2020-04-27,22392,41945,-19553,-46.62,1075
2020-04-28,22874,44042,-21168,-48.06,1075
2020-04-29,22874,44082,-21208,-48.11,1075
2020-04-30,22874,44086,-21212,-48.12,1075
2020-05-01,34006,43628,-9622,-22.05,1075
2020-05-02,24883,31925,-7042,-22.06,1075
2020-05-03,19691,26925,-7234,-26.87,1075
2020-05-04,33670,42026,-8356,-19.88,1075
2020-05-05,35466,44147,-8681,-19.66,1075
2020-05-06,35466,44210,-8744,-19.78,1075
2020-05-07,35466,44238,-8772,-19.83,1075
2020-05-08,34006,43800,-9794,-22.36,1075
2020-05-09,24883,32115,-7232,-22.52,1075
2020-05-10,19691,27129,-7438,-27.42,1075
2020-05-11,33670,42241,-8571,-20.29,1075
2020-05-12,35466,44368,-8902,-20.06,1075
2020-05-13,35466,44433,-8967,-20.18,1075
2020-05-14,35466,44457,-8991,-20.22,1075
2020-05-15,34006,44012,-10006,-22.73,1075
2020-05-16,24883,32316,-7433,-23.0,1075
2020-05-17,19691,27317,-7626,-27.92,1075
2020-05-18,33670,42411,-8741,-20.61,1075
2020-05-19,35466,44520,-9054,-20.34,1075
2020-05-20,35466,44565,-9099,-20.42,1075
2020-05-21,35466,44571,-9105,-20.43,1075
2020-05-22,34006,44108,-10102,-22.9,1075
2020-05-23,24883,32396,-7513,-23.19,1075
2020-05-24,19691,27383,-7692,-28.09,1075
2020-05-25,33670,42469,-8799,-20.72,1075
2020-05-26,35466,44572,-9106,-20.43,1075
2020-05-27,35466,44618,-9152,-20.51,1075
2020-05-28,35466,44628,-9162,-20.53,1075
2020-05-29,34006,44175,-10169,-23.02,1075
2020-05-30,24883,32479,-7596,-23.39,1075
2020-05-31,19691,27486,-7795,-28.36,1075
2020-06-01,39894,42596,-2702,-6.34,1075
2020-06-02,43067,44727,-1660,-3.71,1075
2020-06-03,43067,44802,-1735,-3.87,1075
2020-06-04,43067,44843,-1776,-3.96,1075
2020-06-05,38586,44420,-5834,-13.13,1075
2020-06-06,32011,32752,-741,-2.26,1075
2020-06-07,25179,27785,-2606,-9.38,1075
2020-06-08,39894,42915,-3021,-7.04,1075
2020-06-09,43067,45060,-1993,-4.42,1075
2020-06-10,43067,45142,-2075,-4.6,1075
2020-06-11,43067,45181,-2114,-4.68,1075
2020-06-12,38586,44747,-6161,-13.77,1075
2020-06-13,32011,33057,-1046,-3.16,1075
2020-06-14,25179,28057,-2878,-10.26,1075
2020-06-15,39894,43142,-3248,-7.53,1075
2020-06-16,43067,45232,-2165,-4.79,1075
2020-06-17,43067,45247,-2180,-4.82,1075
2020-06-18,43067,45209,-2142,-4.74,1075
2020-06-19,38586,44689,-6103,-13.66,1075
2020-06-20,32011,32904,-893,-2.71,1075
2020-06-21,25179,27802,-2623,-9.43,1075
2020-06-22,39894,42782,-2888,-6.75,1075
2020-06-23,43067,44762,-1695,-3.79,1075
2020-06-24,43067,44668,-1601,-3.58,1075
2020-06-25,43067,44522,-1455,-3.27,1075
2020-06-26,38586,43897,-5311,-12.1,1075
2020-06-27,32011,32014,-3,-0.01,1075
2020-06-28,25179,26822,-1643,-6.13,1075
2020-06-29,39894,41721,-1827,-4.38,1075
2020-06-30,43067,43634,-567,-1.3,1075
2020-07-01,45347,43486,1861,4.28,1075
2020-07-02,45347,43300,2047,4.73,1075
2020-07-03,43497,42652,845,1.98,1075
2020-07-04,30897,30762,135,0.44,1075
2020-07-05,28570,25580,2990,11.69,1075
2020-07-06,42142,40506,1636,4.04,1075
2020-07-07,45347,42462,2885,6.79,1075
2020-07-08,45347,42370,2977,7.03,1075
2020-07-09,45347,42256,3091,7.31,1075
2020-07-10,43497,41691,1806,4.33,1075
2020-07-11,30897,29893,1004,3.36,1075
2020-07-12,28570,24812,3758,15.15,1075
2020-07-13,42142,39843,2299,5.77,1075
2020-07-14,45347,41906,3441,8.21,1075
2020-07-15,45347,41923,3424,8.17,1075
2020-07-16,45347,41914,3433,8.19,1075
2020-07-17,43497,41448,2049,4.94,1075
2020-07-18,30897,29743,1154,3.88,1075
2020-07-19,28570,24744,3826,15.46,1075
2020-07-20,42142,39846,2296,5.76,1075
2020-07-21,45347,41966,3381,8.06,1075
2020-07-22,45347,42025,3322,7.9,1075
2020-07-23,45347,42043,3304,7.86,1075
2020-07-24,43497,41588,1909,4.59,1075
2020-07-25,30897,29879,1018,3.41,1075
2020-07-26,28570,24859,3711,14.93,1075
2020-07-27,42142,39927,2215,5.55,1075
2020-07-28,45347,42000,3347,7.97,1075
2020-07-29,45347,42000,3347,7.97,1075
2020-07-30,45347,41950,3397,8.1,1075
2020-07-31,43497,41420,2077,5.01,1075
2020-08-01,32666,29630,3036,10.25,1075
2020-08-02,28126,24529,3597,14.66,1075
2020-08-03,39265,39516,-251,-0.64,1075
2020-08-04,41414,41511,-97,-0.23,1075
2020-08-05,41414,41440,-26,-0.06,1075
2020-08-06,41414,41327,87,0.21,1075
2020-08-07,41124,40746,378,0.93,1075
2020-08-08,32666,28918,3748,12.96,1075
2020-08-09,28126,23793,4333,18.21,1075
2020-08-10,39265,38772,493,1.27,1075
2020-08-11,41414,40776,638,1.56,1075
2020-08-12,41414,40731,683,1.68,1075
2020-08-13,41414,40661,753,1.85,1075
2020-08-14,41124,40140,984,2.45,1075
2020-08-15,32666,28388,4278,15.07,1075
2020-08-16,28126,23353,4773,20.44,1075
2020-08-17,39265,38435,830,2.16,1075
2020-08-18,41414,40553,861,2.12,1075
2020-08-19,41414,40630,784,1.93,1075
2020-08-20,41414,40687,727,1.79,1075
2020-08-21,41124,40296,828,2.05,1075
2020-08-22,32666,28674,3992,13.92,1075
2020-08-23,28126,23767,4359,18.34,1075
2020-08-24,39265,38970,295,0.76,1075
2020-08-25,41414,41202,212,0.51,1075
2020-08-26,41414,41381,33,0.08,1075
2020-08-27,41414,41529,-115,-0.28,1075
2020-08-28,41124,41213,-89,-0.22,1075
2020-08-29,32666,29650,3016,10.17,1075
2020-08-30,28126,24784,3342,13.48,1075
2020-08-31,39265,40011,-746,-1.86,1075
2020-09-01,44550,42248,2302,5.45,1075
2020-09-02,44550,42416,2134,5.03,1075
2020-09-03,44550,42534,2016,4.74,1075
2020-09-04,41665,42173,-508,-1.2,1075
2020-09-05,34311,30550,3761,12.31,1075
2020-09-06,27396,25612,1784,6.97,1075
2020-09-07,41630,40756,874,2.14,1075
2020-09-08,44550,42902,1648,3.84,1075
2020-09-09,44550,42972,1578,3.67,1075
2020-09-10,44550,42990,1560,3.63,1075
2020-09-11,41665,42527,-862,-2.03,1075
2020-09-12,34311,30805,3506,11.38,1075
2020-09-13,27396,25771,1625,6.31,1075
2020-09-14,41630,40827,803,1.97,1075
2020-09-15,44550,42891,1659,3.87,1075
2020-09-16,44550,42891,1659,3.87,1075
2020-09-17,44550,42850,1700,3.97,1075
2020-09-18,41665,42341,-676,-1.6,1075
2020-09-19,34311,30585,3726,12.18,1075
2020-09-20,27396,25531,1865,7.3,1075
2020-09-21,41630,40579,1051,2.59,1075
2020-09-22,44550,42649,1901,4.46,1075
2020-09-23,44550,42666,1884,4.42,1075
2020-09-24,44550,42652,1898,4.45,1075
2020-09-25,41665,42179,-514,-1.22,1075
2020-09-26,34311,30465,3846,12.62,1075
2020-09-27,27396,25460,1936,7.6,1075
2020-09-28,41630,40559,1071,2.64,1075
2020-09-29,44550,42682,1868,4.38,1075
2020-09-30,44550,42750,1800,4.21,1075
2020-10-01,42455,42785,-330,-0.77,1075
2020-10-02,40198,42356,-2158,-5.09,1075
2020-10-03,29682,30681,-999,-3.26,1075
2020-10-04,22984,25705,-2721,-10.59,1075
2020-10-05,41247,40826,421,1.03,1075
2020-10-06,42455,42960,-505,-1.18,1075
2020-10-07,42455,43029,-574,-1.33,1075
2020-10-08,42455,43054,-599,-1.39,1075
2020-10-09,40198,42606,-2408,-5.65,1075
2020-10-10,29682,30901,-1219,-3.94,1075
2020-10-11,22984,25888,-2904,-11.22,1075
2020-10-12,41247,40962,285,0.7,1075
2020-10-13,42455,43043,-588,-1.37,1075
2020-10-14,42455,43055,-600,-1.39,1075
2020-10-15,42455,43019,-564,-1.31,1075
2020-10-16,40198,42507,-2309,-5.43,1075
2020-10-17,29682,30740,-1058,-3.44,1075
2020-10-18,22984,25666,-2682,-10.45,1075
2020-10-19,41247,40683,564,1.39,1075
2020-10-20,42455,42713,-258,-0.6,1075
2020-10-21,42455,42679,-224,-0.52,1075
2020-10-22,42455,42606,-151,-0.35,1075
2020-10-23,40198,42066,-1868,-4.44,1075
2020-10-24,29682,30280,-598,-1.97,1075
2020-10-25,22984,25196,-2212,-8.78,1075
2020-10-26,41247,40213,1034,2.57,1075
2020-10-27,42455,42252,203,0.48,1075
2020-10-28,42455,42237,218,0.52,1075
2020-10-29,42455,42189,266,0.63,1075
2020-10-30,40198,41682,-1484,-3.56,1075
2020-10-31,29682,29934,-252,-0.84,1075
2020-11-01,17420,24892,-7472,-30.02,1075
2020-11-02,34227,39953,-5726,-14.33,1075
2020-11-03,30480,42037,-11557,-27.49,1075
2020-11-04,30480,42065,-11585,-27.54,1075
2020-11-05,30480,42058,-11578,-27.53,1075
2020-11-06,30062,41587,-11525,-27.71,1075
2020-11-07,20114,29869,-9755,-32.66,1075
2020-11-08,17420,24850,-7430,-29.9,1075
2020-11-09,34227,39926,-5699,-14.27,1075
2020-11-10,30480,42015,-11535,-27.45,1075
2020-11-11,30480,42040,-11560,-27.5,1075
2020-11-12,30480,42020,-11540,-27.46,1075
2020-11-13,30062,41526,-11464,-27.61,1075
2020-11-14,20114,29776,-9662,-32.45,1075
2020-11-15,17420,24717,-7297,-29.52,1075
2020-11-16,34227,39747,-5520,-13.89,1075
2020-11-17,30480,41784,-11304,-27.05,1075
2020-11-18,30480,41751,-11271,-27.0,1075
2020-11-19,30480,41671,-11191,-26.86,1075
2020-11-20,30062,41117,-11055,-26.89,1075
2020-11-21,20114,29307,-9193,-31.37,1075
2020-11-22,17420,24192,-6772,-27.99,1075
2020-11-23,34227,39168,-4941,-12.61,1075
2020-11-24,30480,41158,-10678,-25.94,1075
2020-11-25,30480,41086,-10606,-25.81,1075
2020-11-26,30480,40975,-10495,-25.61,1075
2020-11-27,30062,40400,-10338,-25.59,1075
2020-11-28,20114,28579,-8465,-29.62,1075
2020-11-29,17420,23462,-6042,-25.75,1075
2020-11-30,34227,38449,-4222,-10.98,1075
2020-12-01,32649,40459,-7810,-19.3,1075
2020-12-02,32649,40417,-7768,-19.22,1075
2020-12-03,32649,40345,-7696,-19.08,1075
2020-12-04,34390,39815,-5425,-13.63,1075
2020-12-05,23118,28046,-4928,-17.57,1075
2020-12-06,17345,22985,-5640,-24.54,1075
2020-12-07,31416,38029,-6613,-17.39,1075
2020-12-08,32649,40096,-7447,-18.57,1075
2020-12-09,32649,40110,-7461,-18.6,1075
2020-12-10,32649,40089,-7440,-18.56,1075
2020-12-11,34390,39604,-5214,-13.17,1075
2020-12-12,23118,27872,-4754,-17.06,1075
2020-12-13,17345,22838,-5493,-24.05,1075
2020-12-14,31416,37899,-6483,-17.11,1075
2020-12-15,32649,39970,-7321,-18.32,1075
2020-12-16,32649,39975,-7326,-18.33,1075
2020-12-17,32649,39932,-7283,-18.24,1075
2020-12-18,34390,39411,-5021,-12.74,1075
2020-12-19,23118,27629,-4511,-16.33,1075
2020-12-20,17345,22534,-5189,-23.03,1075
2020-12-21,31416,37522,-6106,-16.27,1075
2020-12-22,32649,39511,-6862,-17.37,1075
2020-12-23,32649,39425,-6776,-17.19,1075
2020-12-24,32649,39285,-6636,-16.89,1075
2020-12-25,34390,38664,-4274,-11.05,1075
2020-12-26,23118,26781,-3663,-13.68,1075
2020-12-27,17345,21585,-4240,-19.64,1075
2020-12-28,31416,36477,-5061,-13.87,1075
2020-12-29,32649,38376,-5727,-14.92,1075
2020-12-30,32649,38209,-5560,-14.55,1075
2020-12-31,32649,38000,-5351,-14.08,1075
2021-01-01,28343,37322,-8979,-24.06,1075
2021-01-02,18006,25399,-7393,-29.11,1075
2021-01-03,14988,20179,-5191,-25.72,1075
2021-01-04,26636,35063,-8427,-24.03,1075
2021-01-05,28319,36974,-8655,-23.41,1075
2021-01-06,28319,36836,-8517,-23.12,1075
2021-01-07,28319,36674,-8355,-22.78,1075
2021-01-08,28343,36062,-7719,-21.4,1075
2021-01-09,18006,24219,-6213,-25.65,1075
2021-01-10,14988,19096,-4108,-21.51,1075
2021-01-11,26636,34089,-7453,-21.86,1075
2021-01-12,28319,36119,-7800,-21.6,1075
2021-01-13,28319,36110,-7791,-21.58,1075
2021-01-14,28319,36082,-7763,-21.51,1075
2021-01-15,28343,35607,-7264,-20.4,1075
2021-01-16,18006,23902,-5896,-24.67,1075
2021-01-17,14988,18914,-3926,-20.76,1075
2021-01-18,26636,34038,-7402,-21.75,1075
2021-01-19,28319,36191,-7872,-21.75,1075
2021-01-20,28319,36295,-7976,-21.98,1075
2021-01-21,28319,36369,-8050,-22.13,1075
2021-01-22,28343,35982,-7639,-21.23,1075
2021-01-23,18006,24351,-6345,-26.06,1075
2021-01-24,14988,19420,-4432,-22.82,1075
2021-01-25,26636,34586,-7950,-22.99,1075
2021-01-26,28319,36766,-8447,-22.98,1075
2021-01-27,28319,36882,-8563,-23.22,1075
2021-01-28,28319,36952,-8633,-23.36,1075
2021-01-29,28343,36549,-8206,-22.45,1075
2021-01-30,18006,24889,-6883,-27.65,1075
2021-01-31,14988,19921,-4933,-24.76,1075
2021-02-01,33709,35041,-1332,-3.8,1075
2021-02-02,34830,37169,-2339,-6.29,1075
2021-02-03,34830,37229,-2399,-6.44,1075
2021-02-04,34830,37244,-2414,-6.48,1075
2021-02-05,33294,36787,-3493,-9.5,1075
2021-02-06,22952,25077,-2125,-8.47,1075
2021-02-07,18879,20064,-1185,-5.91,1075
2021-02-08,33709,35148,-1439,-4.09,1075
2021-02-09,34830,37250,-2420,-6.5,1075
2021-02-10,34830,37295,-2465,-6.61,1075
2021-02-11,34830,37306,-2476,-6.64,1075
2021-02-12,33294,36858,-3564,-9.67,1075
2021-02-13,22952,25170,-2218,-8.81,1075
2021-02-14,18879,20193,-1314,-6.51,1075
2021-02-15,33709,35323,-1614,-4.57,1075
2021-02-16,34830,37483,-2653,-7.08,1075
2021-02-17,34830,37596,-2766,-7.36,1075
2021-02-18,34830,37684,-2854,-7.57,1075
2021-02-19,33294,37319,-4025,-10.79,1075
2021-02-20,22952,25719,-2767,-10.76,1075
2021-02-21,18879,20831,-1952,-9.37,1075
2021-02-22,33709,36052,-2343,-6.5,1075
2021-02-23,34830,38300,-3470,-9.06,1075
2021-02-24,34830,38497,-3667,-9.53,1075
2021-02-25,34830,38663,-3833,-9.91,1075
2021-02-26,33294,38366,-5072,-13.22,1075
2021-02-27,22952,26825,-3873,-14.44,1075
2021-02-28,18879,21985,-3106,-14.13,1075
2021-03-01,36242,37240,-998,-2.68,1075
2021-03-02,37893,39509,-1616,-4.09,1075
2021-03-03,37893,39713,-1820,-4.58,1075
2021-03-04,37893,39871,-1978,-4.96,1075
2021-03-05,35930,39554,-3624,-9.16,1075
2021-03-06,25674,27979,-2305,-8.24,1075
2021-03-07,19854,23092,-3238,-14.02,1075
2021-03-08,36242,38290,-2048,-5.35,1075
2021-03-09,37893,40492,-2599,-6.42,1075
2021-03-10,37893,40621,-2728,-6.72,1075
2021-03-11,37893,40699,-2806,-6.89,1075
2021-03-12,35930,40297,-4367,-10.84,1075
2021-03-13,25674,28636,-2962,-10.34,1075
2021-03-14,19854,23663,-3809,-16.1,1075
2021-03-15,36242,38778,-2536,-6.54,1075
2021-03-16,37893,40901,-3008,-7.35,1075
2021-03-17,37893,40957,-3064,-7.48,1075
2021-03-18,37893,40969,-3076,-7.51,1075
2021-03-19,35930,40511,-4581,-11.31,1075
2021-03-20,25674,28803,-3129,-10.86,1075
2021-03-21,19854,23794,-3940,-16.56,1075
2021-03-22,36242,38883,-2641,-6.79,1075
2021-03-23,37893,40992,-3099,-7.56,1075
2021-03-24,37893,41044,-3151,-7.68,1075
2021-03-25,37893,41063,-3170,-7.72,1075
2021-03-26,35930,40621,-4691,-11.55,1075
2021-03-27,25674,28937,-3263,-11.28,1075
2021-03-28,19854,23960,-4106,-17.14,1075
2021-03-29,36242,39086,-2844,-7.28,1075
2021-03-30,37893,41236,-3343,-8.11,1075
2021-03-31,37893,41332,-3439,-8.32,1075
2021-04-01,34702,41395,-6693,-16.17,1075
2021-04-02,32650,40996,-8346,-20.36,1075
2021-04-03,22904,29354,-6450,-21.97,1075
2021-04-04,19793,24413,-4620,-18.92,1075
2021-04-05,35471,39572,-4101,-10.36,1075
2021-04-06,34702,41747,-7045,-16.88,1075
2021-04-07,34702,41862,-7160,-17.1,1075
2021-04-08,34702,41937,-7235,-17.25,1075
2021-04-09,32650,41541,-8891,-21.4,1075
2021-04-10,22904,29893,-6989,-23.38,1075
2021-04-11,19793,24940,-5147,-20.64,1075
2021-04-12,35471,40079,-4608,-11.5,1075
2021-04-13,34702,42227,-7525,-17.82,1075
2021-04-14,34702,42309,-7607,-17.98,1075
2021-04-15,34702,42346,-7644,-18.05,1075
2021-04-16,32650,41909,-9259,-22.09,1075
2021-04-17,22904,30217,-7313,-24.2,1075
2021-04-18,19793,25218,-5425,-21.51,1075
2021-04-19,35471,40311,-4840,-12.01,1075
2021-04-20,34702,42416,-7714,-18.19,1075
2021-04-21,34702,42456,-7754,-18.26,1075
2021-04-22,34702,42454,-7752,-18.26,1075
2021-04-23,32650,41983,-9333,-22.23,1075
2021-04-24,22904,30263,-7359,-24.32,1075
2021-04-25,19793,25242,-5449,-21.59,1075
2021-04-26,35471,40318,-4847,-12.02,1075
2021-04-27,34702,42412,-7710,-18.18,1075
2021-04-28,34702,42449,-7747,-18.25,1075
2021-04-29,34702,42449,-7747,-18.25,1075
2021-04-30,32650,41986,-9336,-22.24,1075
2021-05-01,30340,30279,61,0.2,1075
2021-05-02,23795,25275,-1480,-5.86,1075
2021-05-03,43604,40371,3233,8.01,1075
2021-05-04,45875,42488,3387,7.97,1075
2021-05-05,45875,42548,3327,7.82,1075
2021-05-06,45875,42572,3303,7.76,1075
2021-05-07,40894,42132,-1238,-2.94,1075
2021-05-08,30340,30446,-106,-0.35,1075
2021-05-09,23795,25460,-1665,-6.54,1075
2021-05-10,43604,40572,3032,7.47,1075
2021-05-11,45875,42701,3174,7.43,1075
2021-05-12,45875,42768,3107,7.26,1075
2021-05-13,45875,42795,3080,7.2,1075
2021-05-14,40894,42353,-1459,-3.44,1075
2021-05-15,30340,30661,-321,-1.05,1075
2021-05-16,23795,25665,-1870,-7.29,1075
2021-05-17,43604,40763,2841,6.97,1075
2021-05-18,45875,42875,3000,7.0,1075
2021-05-19,45875,42924,2951,6.87,1075
2021-05-20,45875,42932,2943,6.86,1075
2021-05-21,40894,42471,-1577,-3.71,1075
2021-05-22,30340,30760,-420,-1.37,1075
2021-05-23,23795,25748,-1953,-7.59,1075
2021-05-24,43604,40833,2771,6.79,1075
2021-05-25,45875,42935,2940,6.85,1075
2021-05-26,45875,42978,2897,6.74,1075
2021-05-27,45875,42984,2891,6.73,1075
2021-05-28,40894,42527,-1633,-3.84,1075
2021-05-29,30340,30825,-485,-1.57,1075
2021-05-30,23795,25827,-2032,-7.87,1075
2021-05-31,43604,40931,2673,6.53,1075
2021-06-01,48176,43056,5120,11.89,1075
2021-06-02,48176,43125,5051,11.71,1075
2021-06-03,48176,43161,5015,11.62,1075
2021-06-04,45606,42734,2872,6.72,1075
2021-06-05,37872,31062,6810,21.92,1075
2021-06-06,32856,26093,6763,25.92,1075
2021-06-07,47083,41223,5860,14.22,1075
2021-06-08,48176,43370,4806,11.08,1075
2021-06-09,48176,43455,4721,10.86,1075
2021-06-10,48176,43500,4676,10.75,1075
2021-06-11,45606,43074,2532,5.88,1075
2021-06-12,37872,31393,6479,20.64,1075
2021-06-13,32856,26405,6451,24.43,1075
2021-06-14,47083,41504,5579,13.44,1075
2021-06-15,48176,43610,4566,10.47,1075
2021-06-16,48176,43642,4534,10.39,1075
2021-06-17,48176,43623,4553,10.44,1075
2021-06-18,45606,43122,2484,5.76,1075
2021-06-19,37872,31357,6515,20.78,1075
2021-06-20,32856,26276,6580,25.04,1075
2021-06-21,47083,41276,5807,14.07,1075
2021-06-22,48176,43276,4900,11.32,1075
2021-06-23,48176,43200,4976,11.52,1075
2021-06-24,48176,43071,5105,11.85,1075
2021-06-25,45606,42461,3145,7.41,1075
2021-06-26,37872,30591,7281,23.8,1075
2021-06-27,32856,25410,7446,29.3,1075
2021-06-28,47083,40317,6766,16.78,1075
2021-06-29,48176,42234,5942,14.07,1075
2021-06-30,48176,42088,6088,14.46,1075
2021-07-01,44743,41901,2842,6.78,1075
2021-07-02,42651,41248,1403,3.4,1075
2021-07-03,33307,29350,3957,13.48,1075
2021-07-04,28288,24158,4130,17.1,1075
2021-07-05,42083,39071,3012,7.71,1075
2021-07-06,44743,41011,3732,9.1,1075
2021-07-07,44743,40903,3840,9.39,1075
2021-07-08,44743,40770,3973,9.74,1075
2021-07-09,42651,40185,2466,6.14,1075
2021-07-10,33307,28367,4940,17.41,1075
2021-07-11,28288,23266,5022,21.59,1075
2021-07-12,42083,38277,3806,9.94,1075
2021-07-13,44743,40321,4422,10.97,1075
2021-07-14,44743,40321,4422,10.97,1075
2021-07-15,44743,40296,4447,11.04,1075
2021-07-16,42651,39817,2834,7.12,1075
2021-07-17,33307,28100,5207,18.53,1075
2021-07-18,28288,23093,5195,22.5,1075
2021-07-19,42083,38190,3893,10.19,1075
2021-07-20,44743,40307,4436,11.01,1075
2021-07-21,44743,40367,4376,10.84,1075
2021-07-22,44743,40389,4354,10.78,1075
2021-07-23,42651,39940,2711,6.79,1075
2021-07-24,33307,28239,5068,17.95,1075
2021-07-25,28288,23231,5057,21.77,1075
2021-07-26,42083,38312,3771,9.84,1075
2021-07-27,44743,40399,4344,10.75,1075
2021-07-28,44743,40414,4329,10.71,1075
2021-07-29,44743,40379,4364,10.81,1075
2021-07-30,42651,39865,2786,6.99,1075
2021-07-31,33307,28090,5217,18.57,1075
2021-08-01,26624,23003,3621,15.74,1075
2021-08-02,38127,38002,125,0.33,1075
2021-08-03,39962,40008,-46,-0.11,1075
2021-08-04,39962,39945,17,0.04,1075
2021-08-05,39962,39837,125,0.31,1075
2021-08-06,38605,39257,-652,-1.66,1075
2021-08-07,32282,27428,4854,17.7,1075
2021-08-08,26624,22299,4325,19.4,1075
2021-08-09,38127,37270,857,2.3,1075
2021-08-10,39962,39264,698,1.78,1075
2021-08-11,39962,39205,757,1.93,1075
2021-08-12,39962,39119,843,2.15,1075
2021-08-13,38605,38579,26,0.07,1075
2021-08-14,32282,26806,5476,20.43,1075
2021-08-15,26624,21749,4875,22.41,1075
2021-08-16,38127,36807,1320,3.59,1075
2021-08-17,39962,38900,1062,2.73,1075
2021-08-18,39962,38953,1009,2.59,1075
2021-08-19,39962,38987,975,2.5,1075
2021-08-20,38605,38573,32,0.08,1075
2021-08-21,32282,26929,5353,19.88,1075
2021-08-22,26624,22003,4621,21.0,1075
2021-08-23,38127,37189,938,2.52,1075
2021-08-24,39962,39406,556,1.41,1075
2021-08-25,39962,39574,388,0.98,1075
2021-08-26,39962,39714,248,0.62,1075
2021-08-27,38605,39393,-788,-2.0,1075
2021-08-28,32282,27829,4453,16.0,1075
2021-08-29,26624,22965,3659,15.93,1075
2021-08-30,38127,38198,-71,-0.19,1075
2021-08-31,39962,40443,-481,-1.19,1075
2021-09-01,44027,40621,3406,8.38,1075
2021-09-02,44027,40753,3274,8.03,1075
2021-09-03,42206,40408,1798,4.45,1075
2021-09-04,32152,28802,3350,11.63,1075
2021-09-05,26914,23882,3032,12.7,1075
2021-09-06,43306,39045,4261,10.91,1075
2021-09-07,44027,41209,2818,6.84,1075
2021-09-08,44027,41298,2729,6.61,1075
2021-09-09,44027,41334,2693,6.52,1075
2021-09-10,42206,40888,1318,3.22,1075
2021-09-11,32152,29181,2971,10.18,1075
2021-09-12,26914,24161,2753,11.39,1075
2021-09-13,43306,39227,4079,10.4,1075
2021-09-14,44027,41301,2726,6.6,1075
2021-09-15,44027,41307,2720,6.58,1075
2021-09-16,44027,41270,2757,6.68,1075
2021-09-17,42206,40762,1444,3.54,1075
2021-09-18,32152,29005,3147,10.85,1075
2021-09-19,26914,23948,2966,12.39,1075
2021-09-20,43306,38991,4315,11.07,1075
2021-09-21,44027,41054,2973,7.24,1075
2021-09-22,44027,41063,2964,7.22,1075
2021-09-23,44027,41039,2988,7.28,1075
2021-09-24,42206,40556,1650,4.07,1075
2021-09-25,32152,28833,3319,11.51,1075
2021-09-26,26914,23818,3096,13.0,1075
2021-09-27,43306,38907,4399,11.31,1075
2021-09-28,44027,41021,3006,7.33,1075
2021-09-29,44027,41082,2945,7.17,1075
2021-09-30,44027,41111,2916,7.09,1075
2021-10-01,41900,40678,1222,3.0,1075
2021-10-02,33249,29000,4249,14.65,1075
2021-10-03,25833,24024,1809,7.53,1075
2021-10-04,39214,39146,68,0.17,1075
2021-10-05,43776,41283,2493,6.04,1075
2021-10-06,43776,41358,2418,5.85,1075
2021-10-07,43776,41390,2386,5.76,1075
2021-10-08,41900,40950,950,2.32,1075
2021-10-09,33249,29256,3993,13.65,1075
2021-10-10,25833,24253,1580,6.51,1075
2021-10-11,39214,39338,-124,-0.32,1075
2021-10-12,43776,41431,2345,5.66,1075
2021-10-13,43776,41455,2321,5.6,1075
2021-10-14,43776,41431,2345,5.66,1075
2021-10-15,41900,40930,970,2.37,1075
2021-10-16,33249,29173,4076,13.97,1075
2021-10-17,25833,24107,1726,7.16,1075
2021-10-18,39214,39132,82,0.21,1075
2021-10-19,43776,41167,2609,6.34,1075
2021-10-20,43776,41137,2639,6.42,1075
2021-10-21,43776,41066,2710,6.6,1075
2021-10-22,41900,40526,1374,3.39,1075
2021-10-23,33249,28738,4511,15.7,1075
2021-10-24,25833,23651,2182,9.23,1075
2021-10-25,39214,38663,551,1.43,1075
2021-10-26,43776,40696,3080,7.57,1075
2021-10-27,43776,40673,3103,7.63,1075
2021-10-28,43776,40618,3158,7.77,1075
2021-10-29,41900,40102,1798,4.48,1075
2021-10-30,33249,28345,4904,17.3,1075
2021-10-31,25833,23295,2538,10.9,1075
2021-11-01,35030,38348,-3318,-8.65,1075
2021-11-02,38975,40425,-1450,-3.59,1075
2021-11-03,38975,40447,-1472,-3.64,1075
2021-11-04,38975,40436,-1461,-3.61,1075
2021-11-05,37885,39961,-2076,-5.2,1075
2021-11-06,26758,28241,-1483,-5.25,1075
2021-11-07,23431,23223,208,0.9,1075
2021-11-08,35030,38301,-3271,-8.54,1075
2021-11-09,38975,40394,-1419,-3.51,1075
2021-11-10,38975,40425,-1450,-3.59,1075
2021-11-11,38975,40412,-1437,-3.56,1075
2021-11-12,37885,39927,-2042,-5.11,1075
2021-11-13,26758,28187,-1429,-5.07,1075
2021-11-14,23431,23139,292,1.26,1075
2021-11-15,35030,38179,-3149,-8.25,1075
2021-11-16,38975,40228,-1253,-3.11,1075
2021-11-17,38975,40207,-1232,-3.06,1075
2021-11-18,38975,40138,-1163,-2.9,1075
2021-11-19,37885,39594,-1709,-4.32,1075
2021-11-20,26758,27793,-1035,-3.72,1075
2021-11-21,23431,22685,746,3.29,1075
2021-11-22,35030,37668,-2638,-7.0,1075
2021-11-23,38975,39662,-687,-1.73,1075
2021-11-24,38975,39592,-617,-1.56,1075
2021-11-25,38975,39482,-507,-1.28,1075
2021-11-26,37885,38905,-1020,-2.62,1075
2021-11-27,26758,27080,-322,-1.19,1075
2021-11-28,23431,21958,1473,6.71,1075
2021-11-29,35030,36938,-1908,-5.17,1075
2021-11-30,38975,38939,36,0.09,1075
2021-12-01,32923,38887,-5964,-15.34,1075
2021-12-02,32923,38805,-5882,-15.16,1075
2021-12-03,29805,38264,-8459,-22.11,1075
2021-12-04,21899,26483,-4584,-17.31,1075
2021-12-05,18964,21412,-2448,-11.43,1075
2021-12-06,33645,36446,-2801,-7.69,1075
2021-12-07,32923,38504,-5581,-14.49,1075
2021-12-08,32923,38510,-5587,-14.51,1075
2021-12-09,32923,38484,-5561,-14.45,1075
2021-12-10,29805,37995,-8190,-21.56,1075
2021-12-11,21899,26262,-4363,-16.61,1075
2021-12-12,18964,21229,-2265,-10.67,1075
2021-12-13,33645,36293,-2648,-7.3,1075
2021-12-14,32923,38371,-5448,-14.2,1075
2021-12-15,32923,38385,-5462,-14.23,1075
2021-12-16,32923,38353,-5430,-14.16,1075
2021-12-17,29805,37845,-8040,-21.24,1075
2021-12-18,21899,26079,-4180,-16.03,1075
2021-12-19,18964,21001,-2037,-9.7,1075
2021-12-20,33645,36006,-2361,-6.56,1075
2021-12-21,32923,38014,-5091,-13.39,1075
2021-12-22,32923,37947,-5024,-13.24,1075
2021-12-23,32923,37826,-4903,-12.96,1075
2021-12-24,29805,37223,-7418,-19.93,1075
2021-12-25,21899,25357,-3458,-13.64,1075
2021-12-26,18964,20177,-1213,-6.01,1075
2021-12-27,33645,35082,-1437,-4.1,1075
2021-12-28,32923,36992,-4069,-11.0,1075
2021-12-29,32923,36833,-3910,-10.62,1075
2021-12-30,32923,36629,-3706,-10.12,1075
2021-12-31,29805,35954,-6149,-17.1,1075
2022-01-01,23013,24029,-1016,-4.23,1075
2022-01-02,18403,18804,-401,-2.13,1075
2022-01-03,30434,33680,-3246,-9.64,1075
2022-01-04,30951,35579,-4628,-13.01,1075
2022-01-05,30951,35426,-4475,-12.63,1075
2022-01-06,30951,35247,-4296,-12.19,1075
2022-01-07,30706,34615,-3909,-11.29,1075
2022-01-08,23013,22750,263,1.16,1075
2022-01-09,18403,17603,800,4.54,1075
2022-01-10,30434,32571,-2137,-6.56,1075
2022-01-11,30951,34576,-3625,-10.48,1075
2022-01-12,30951,34541,-3590,-10.39,1075
2022-01-13,30951,34489,-3538,-10.26,1075
2022-01-14,30706,33989,-3283,-9.66,1075
2022-01-15,23013,22261,752,3.38,1075
2022-01-16,18403,17252,1151,6.67,1075
2022-01-17,30434,32356,-1922,-5.94,1075
2022-01-18,30951,34493,-3542,-10.27,1075
2022-01-19,30951,34583,-3632,-10.5,1075
2022-01-20,30951,34646,-3695,-10.67,1075
2022-01-21,30706,34251,-3545,-10.35,1075
2022-01-22,23013,22615,398,1.76,1075
2022-01-23,18403,17683,720,4.07,1075
2022-01-24,30434,32849,-2415,-7.35,1075
2022-01-25,30951,35033,-4082,-11.65,1075
2022-01-26,30951,35153,-4202,-11.95,1075
2022-01-27,30951,35231,-4280,-12.15,1075
2022-01-28,30706,34837,-4131,-11.86,1075
2022-01-29,23013,23187,-174,-0.75,1075
2022-01-30,18403,18230,173,0.95,1075
2020-02-01,6468,5476,992,18.12,1195
2020-02-02,4429,3581,848,23.68,1195
2020-02-03,7721,6907,814,11.79,1195
2020-02-04,7908,7090,818,11.54,1195
2020-02-05,7908,7102,806,11.35,1195
2020-02-06,7908,7107,801,11.27,1195
2020-02-07,8133,7286,847,11.63,1195
2020-02-08,6468,5556,912,16.41,1195
2020-02-09,4429,3653,776,21.24,1195
2020-02-10,7721,6973,748,10.73,1195
2020-02-11,7908,7151,757,10.59,1195
2020-02-12,7908,7161,747,10.43,1195
2020-02-13,7908,7165,743,10.37,1195
2020-02-14,8133,7344,789,10.74,1195
2020-02-15,6468,5616,852,15.17,1195
2020-02-16,4429,3717,712,19.16,1195
2020-02-17,7721,7043,678,9.63,1195
2020-02-18,7908,7227,681,9.42,1195
2020-02-19,7908,7244,664,9.17,1195
2020-02-20,7908,7257,651,8.97,1195
2020-02-21,8133,7444,689,9.26,1195
2020-02-22,6468,5725,743,12.98,1195
2020-02-23,4429,3835,594,15.49,1195
2020-02-24,7721,7169,552,7.7,1195
2020-02-25,7908,7360,548,7.45,1195
2020-02-26,7908,7384,524,7.1,1195
2020-02-27,7908,7401,507,6.85,1195
2020-02-28,8133,7592,541,7.13,1195
2020-02-29,6468,5874,594,10.11,1195
2020-03-01,3139,3984,-845,-21.21,1195
2020-03-02,5607,7316,-1709,-23.36,1195
2020-03-03,5732,7504,-1772,-23.61,1195
2020-03-04,5732,7522,-1790,-23.8,1195
2020-03-05,5732,7532,-1800,-23.9,1195
2020-03-06,5993,7715,-1722,-22.32,1195
2020-03-07,4237,5988,-1751,-29.24,1195
2020-03-08,3139,4089,-950,-23.23,1195
2020-03-09,5607,7410,-1803,-24.33,1195
2020-03-10,5732,7588,-1856,-24.46,1195
2020-03-11,5732,7596,-1864,-24.54,1195
2020-03-12,5732,7598,-1866,-24.56,1195
2020-03-13,5993,7772,-1779,-22.89,1195
2020-03-14,4237,6039,-1802,-29.84,1195
2020-03-15,3139,4134,-995,-24.07,1195
2020-03-16,5607,7453,-1846,-24.77,1195
2020-03-17,5732,7629,-1897,-24.87,1195
2020-03-18,5732,7638,-1906,-24.95,1195
2020-03-19,5732,7643,-1911,-25.0,1195
2020-03-20,5993,7823,-1830,-23.39,1195
2020-03-21,4237,6097,-1860,-30.51,1195
2020-03-22,3139,4202,-1063,-25.3,1195
2020-03-23,5607,7531,-1924,-25.55,1195
2020-03-24,5732,7721,-1989,-25.76,1195
2020-03-25,5732,7744,-2012,-25.98,1195
2020-03-26,5732,7763,-2031,-26.16,1195
2020-03-27,5993,7959,-1966,-24.7,1195
2020-03-28,4237,6249,-2012,-32.2,1195
2020-03-29,3139,4369,-1230,-28.15,1195
2020-03-30,5607,7713,-2106,-27.3,1195
2020-03-31,5732,7917,-2185,-27.6,1195
2020-04-01,5380,7952,-2572,-32.34,1195
2020-04-02,5380,7982,-2602,-32.6,1195
2020-04-03,5242,8187,-2945,-35.97,1195
2020-04-04,4002,6483,-2481,-38.27,1195
2020-04-05,2571,4606,-2035,-44.18,1195
2020-04-06,5427,7951,-2524,-31.74,1195
2020-04-07,5380,8153,-2773,-34.01,1195
2020-04-08,5380,8183,-2803,-34.25,1195
2020-04-09,5380,8205,-2825,-34.43,1195
2020-04-10,5242,8399,-3157,-37.59,1195
2020-04-11,4002,6683,-2681,-40.12,1195
2020-04-12,2571,4791,-2220,-46.34,1195
2020-04-13,5427,8120,-2693,-33.17,1195
2020-04-14,5380,8303,-2923,-35.2,1195
2020-04-15,5380,8314,-2934,-35.29,1195
2020-04-16,5380,8316,-2936,-35.31,1195
2020-04-17,5242,8489,-3247,-38.25,1195
2020-04-18,4002,6752,-2750,-40.73,1195
2020-04-19,2571,4841,-2270,-46.89,1195
2020-04-20,5427,8150,-2723,-33.41,1195
2020-04-21,5380,8315,-2935,-35.3,1195
2020-04-22,5380,8310,-2930,-35.26,1195
2020-04-23,5380,8297,-2917,-35.16,1195
2020-04-24,5242,8458,-3216,-38.02,1195
2020-04-25,4002,6711,-2709,-40.37,1195
2020-04-26,2571,4792,-2221,-46.35,1195
2020-04-27,5427,8096,-2669,-32.97,1195
2020-04-28,5380,8258,-2878,-34.85,1195
2020-04-29,5380,8252,-2872,-34.8,1195
2020-04-30,5380,8241,-2861,-34.72,1195
2020-05-01,8200,8405,-205,-2.44,1195
2020-05-02,6678,6663,15,0.23,1195
2020-05-03,4376,4750,-374,-7.87,1195
2020-05-04,7899,8061,-162,-2.01,1195
2020-05-05,8087,8232,-145,-1.76,1195
2020-05-06,8087,8234,-147,-1.79,1195
2020-05-07,8087,8232,-145,-1.76,1195
2020-05-08,8200,8405,-205,-2.44,1195
2020-05-09,6678,6671,7,0.1,1195
2020-05-10,4376,4766,-390,-8.18,1195
2020-05-11,7899,8084,-185,-2.29,1195
2020-05-12,8087,8259,-172,-2.08,1195
2020-05-13,8087,8266,-179,-2.17,1195
2020-05-14,8087,8267,-180,-2.18,1195
2020-05-15,8200,8441,-241,-2.86,1195
2020-05-16,6678,6707,-29,-0.43,1195
2020-05-17,4376,4800,-424,-8.83,1195
2020-05-18,7899,8115,-216,-2.66,1195
2020-05-19,8087,8286,-199,-2.4,1195
2020-05-20,8087,8288,-201,-2.43,1195
2020-05-21,8087,8283,-196,-2.37,1195
2020-05-22,8200,8451,-251,-2.97,1195
2020-05-23,6678,6710,-32,-0.48,1195
2020-05-24,4376,4797,-421,-8.78,1195
2020-05-25,7899,8105,-206,-2.54,1195
2020-05-26,8087,8271,-184,-2.22,1195
2020-05-27,8087,8268,-181,-2.19,1195
2020-05-28,8087,8258,-171,-2.07,1195
2020-05-29,8200,8423,-223,-2.65,1195
2020-05-30,6678,6679,-1,-0.01,1195
2020-05-31,4376,4764,-388,-8.14,1195
2020-06-01,8441,8073,368,4.56,1195
2020-06-02,9020,8239,781,9.48,1195
2020-06-03,9020,8238,782,9.49,1195
2020-06-04,9020,8231,789,9.59,1195
2020-06-05,8802,8399,403,4.8,1195
2020-06-06,7264,6660,604,9.07,1195
2020-06-07,5000,4750,250,5.26,1195
2020-06-08,8441,8064,377,4.68,1195
2020-06-09,9020,8235,785,9.53,1195
2020-06-10,9020,8238,782,9.49,1195
2020-06-11,9020,8235,785,9.53,1195
2020-06-12,8802,8407,395,4.7,1195
2020-06-13,7264,6670,594,8.91,1195
2020-06-14,5000,4761,239,5.02,1195
2020-06-15,8441,8074,367,4.55,1195
2020-06-16,9020,8244,776,9.41,1195
2020-06-17,9020,8244,776,9.41,1195
2020-06-18,9020,8237,783,9.51,1195
2020-06-19,8802,8402,400,4.76,1195
2020-06-20,7264,6658,606,9.1,1195
2020-06-21,5000,4741,259,5.46,1195
2020-06-22,8441,8045,396,4.92,1195
2020-06-23,9020,8205,815,9.93,1195
2020-06-24,9020,8194,826,10.08,1195
2020-06-25,9020,8176,844,10.32,1195
2020-06-26,8802,8330,472,5.67,1195
2020-06-27,7264,6576,688,10.46,1195
2020-06-28,5000,4648,352,7.57,1195
2020-06-29,8441,7943,498,6.27,1195
2020-06-30,9020,8095,925,11.43,1195
2020-07-01,8882,8077,805,9.97,1195
2020-07-02,8882,8054,828,10.28,1195
2020-07-03,8740,8205,535,6.52,1195
2020-07-04,6628,6449,179,2.78,1195
2020-07-05,5216,4522,694,15.35,1195
2020-07-06,8599,7819,780,9.98,1195
2020-07-07,8882,7974,908,11.39,1195
2020-07-08,8882,7963,919,11.54,1195
2020-07-09,8882,7947,935,11.77,1195
2020-07-10,8740,8107,633,7.81,1195
2020-07-11,6628,6360,268,4.21,1195
2020-07-12,5216,4444,772,17.37,1195
2020-07-13,8599,7751,848,10.94,1195
2020-07-14,8882,7918,964,12.17,1195
2020-07-15,8882,7918,964,12.17,1195
2020-07-16,8882,7913,969,12.25,1195
2020-07-17,8740,8082,658,8.14,1195
2020-07-18,6628,6344,284,4.48,1195
2020-07-19,5216,4435,781,17.61,1195
2020-07-20,8599,7749,850,10.97,1195
2020-07-21,8882,7920,962,12.15,1195
2020-07-22,8882,7922,960,12.12,1195
2020-07-23,8882,7916,966,12.2,1195
2020-07-24,8740,8084,656,8.11,1195
2020-07-25,6628,6343,285,4.49,1195
2020-07-26,5216,4428,788,17.8,1195
2020-07-27,8599,7734,865,11.18,1195
2020-07-28,8882,7896,986,12.49,1195
2020-07-29,8882,7888,994,12.6,1195
2020-07-30,8882,7872,1010,12.83,1195
2020-07-31,8740,8028,712,8.87,1195
2020-08-01,6508,6275,233,3.71,1195
2020-08-02,4904,4349,555,12.76,1195
2020-08-03,7803,7644,159,2.08,1195
2020-08-04,7903,7797,106,1.36,1195
2020-08-05,7903,7780,123,1.58,1195
2020-08-06,7903,7757,146,1.88,1195
2020-08-07,7914,7908,6,0.08,1195
2020-08-08,6508,6152,356,5.79,1195
2020-08-09,4904,4226,678,16.04,1195
2020-08-10,7803,7523,280,3.72,1195
2020-08-11,7903,7680,223,2.9,1195
2020-08-12,7903,7670,233,3.04,1195
2020-08-13,7903,7656,247,3.23,1195
2020-08-14,7914,7818,96,1.23,1195
2020-08-15,6508,6075,433,7.13,1195
2020-08-16,4904,4163,741,17.8,1195
2020-08-17,7803,7477,326,4.36,1195
2020-08-18,7903,7651,252,3.29,1195
2020-08-19,7903,7658,245,3.2,1195
2020-08-20,7903,7662,241,3.15,1195
2020-08-21,7914,7842,72,0.92,1195
2020-08-22,6508,6117,391,6.39,1195
2020-08-23,4904,4221,683,16.18,1195
2020-08-24,7803,7549,254,3.36,1195
2020-08-25,7903,7735,168,2.17,1195
2020-08-26,7903,7753,150,1.93,1195
2020-08-27,7903,7765,138,1.78,1195
2020-08-28,7914,7951,-37,-0.47,1195
2020-08-29,6508,6229,279,4.48,1195
2020-08-30,4904,4333,571,13.18,1195
2020-08-31,7803,7659,144,1.88,1195
2020-09-01,8330,7841,489,6.24,1195
2020-09-02,8330,7852,478,6.09,1195
2020-09-03,8330,7855,475,6.05,1195
2020-09-04,8148,8031,117,1.46,1195
2020-09-05,6469,6296,173,2.75,1195
2020-09-06,4526,4388,138,3.14,1195
2020-09-07,7792,7700,92,1.19,1195
2020-09-08,8330,7868,462,5.87,1195
2020-09-09,8330,7866,464,5.9,1195
2020-09-10,8330,7856,474,6.03,1195
2020-09-11,8148,8019,129,1.61,1195
2020-09-12,6469,6274,195,3.11,1195
2020-09-13,4526,4357,169,3.88,1195
2020-09-14,7792,7663,129,1.68,1195
2020-09-15,8330,7827,503,6.43,1195
2020-09-16,8330,7823,507,6.48,1195
2020-09-17,8330,7814,516,6.6,1195
2020-09-18,8148,7981,167,2.09,1195
2020-09-19,6469,6242,227,3.64,1195
2020-09-20,4526,4333,193,4.45,1195
2020-09-21,7792,7649,143,1.87,1195
2020-09-22,8330,7825,505,6.45,1195
2020-09-23,8330,7835,495,6.32,1195
2020-09-24,8330,7841,489,6.24,1195
2020-09-25,8148,8023,125,1.56,1195
2020-09-26,6469,6300,169,2.68,1195
2020-09-27,4526,4407,119,2.7,1195
2020-09-28,7792,7738,54,0.7,1195
2020-09-29,8330,7928,402,5.07,1195
2020-09-30,8330,7951,379,4.77,1195
2020-10-01,8104,7968,136,1.71,1195
2020-10-02,7957,8159,-202,-2.48,1195
2020-10-03,6215,6442,-227,-3.52,1195
2020-10-04,4236,4553,-317,-6.96,1195
2020-10-05,7802,7885,-83,-1.05,1195
2020-10-06,8104,8074,30,0.37,1195
2020-10-07,8104,8092,12,0.15,1195
2020-10-08,8104,8102,2,0.02,1195
2020-10-09,7957,8284,-327,-3.95,1195
2020-10-10,6215,6555,-340,-5.19,1195
2020-10-11,4236,4652,-416,-8.94,1195
2020-10-12,7802,7969,-167,-2.1,1195
2020-10-13,8104,8140,-36,-0.44,1195
2020-10-14,8104,8141,-37,-0.45,1195
2020-10-15,8104,8132,-28,-0.34,1195
2020-10-16,7957,8296,-339,-4.09,1195
2020-10-17,6215,6549,-334,-5.1,1195
2020-10-18,4236,4629,-393,-8.49,1195
2020-10-19,7802,7930,-128,-1.61,1195
2020-10-20,8104,8087,17,0.21,1195
2020-10-21,8104,8075,29,0.36,1195
2020-10-22,8104,8056,48,0.6,1195
2020-10-23,7957,8211,-254,-3.09,1195
2020-10-24,6215,6458,-243,-3.76,1195
2020-10-25,4236,4534,-298,-6.57,1195
2020-10-26,7802,7834,-32,-0.41,1195
2020-10-27,8104,7992,112,1.4,1195
2020-10-28,8104,7983,121,1.52,1195
2020-10-29,8104,7968,136,1.71,1195
2020-10-30,7957,8130,-173,-2.13,1195
2020-10-31,6215,6385,-170,-2.66,1195
2020-11-01,3180,4470,-1290,-28.86,1195
2020-11-02,6929,7778,-849,-10.92,1195
2020-11-03,6228,7946,-1718,-21.62,1195
2020-11-04,6228,7946,-1718,-21.62,1195
2020-11-05,6228,7941,-1713,-21.57,1195
2020-11-06,6522,8110,-1588,-19.58,1195
2020-11-07,4586,6372,-1786,-28.03,1195
2020-11-08,3180,4461,-1281,-28.72,1195
2020-11-09,6929,7774,-845,-10.87,1195
2020-11-10,6228,7943,-1715,-21.59,1195
2020-11-11,6228,7943,-1715,-21.59,1195
2020-11-12,6228,7935,-1707,-21.51,1195
2020-11-13,6522,8100,-1578,-19.48,1195
2020-11-14,4586,6356,-1770,-27.85,1195
2020-11-15,3180,4439,-1259,-28.36,1195
2020-11-16,6929,7742,-813,-10.5,1195
2020-11-17,6228,7902,-1674,-21.18,1195
2020-11-18,6228,7891,-1663,-21.07,1195
2020-11-19,6228,7872,-1644,-20.88,1195
2020-11-20,6522,8027,-1505,-18.75,1195
2020-11-21,4586,6272,-1686,-26.88,1195
2020-11-22,3180,4344,-1164,-26.8,1195
2020-11-23,6929,7638,-709,-9.28,1195
2020-11-24,6228,7789,-1561,-20.04,1195
2020-11-25,6228,7772,-1544,-19.87,1195
2020-11-26,6228,7749,-1521,-19.63,1195
2020-11-27,6522,7900,-1378,-17.44,1195
2020-11-28,4586,6144,-1558,-25.36,1195
2020-11-29,3180,4218,-1038,-24.61,1195
2020-11-30,6929,7515,-586,-7.8,1195
2020-12-01,6258,7672,-1414,-18.43,1195
2020-12-02,6258,7662,-1404,-18.32,1195
2020-12-03,6258,7647,-1389,-18.16,1195
2020-12-04,6930,7809,-879,-11.26,1195
2020-12-05,5025,6064,-1039,-17.13,1195
2020-12-06,3071,4150,-1079,-26.0,1195
2020-12-07,6536,7459,-923,-12.37,1195
2020-12-08,6258,7628,-1370,-17.96,1195
2020-12-09,6258,7629,-1371,-17.97,1195
2020-12-10,6258,7624,-1366,-17.92,1195
2020-12-11,6930,7795,-865,-11.1,1195
2020-12-12,5025,6057,-1032,-17.04,1195
2020-12-13,3071,4147,-1076,-25.95,1195
2020-12-14,6536,7459,-923,-12.37,1195
2020-12-15,6258,7627,-1369,-17.95,1195
2020-12-16,6258,7625,-1367,-17.93,1195
2020-12-17,6258,7615,-1357,-17.82,1195
2020-12-18,6930,7776,-846,-10.88,1195
2020-12-19,5025,6027,-1002,-16.63,1195
2020-12-20,3071,4103,-1032,-25.15,1195
2020-12-21,6536,7398,-862,-11.65,1195
2020-12-22,6258,7548,-1290,-17.09,1195
2020-12-23,6258,7526,-1268,-16.85,1195
2020-12-24,6258,7495,-1237,-16.5,1195
2020-12-25,6930,7634,-704,-9.22,1195
2020-12-26,5025,5863,-838,-14.29,1195
2020-12-27,3071,3917,-846,-21.6,1195
2020-12-28,6536,7192,-656,-9.12,1195
2020-12-29,6258,7322,-1064,-14.53,1195
2020-12-30,6258,7283,-1025,-14.07,1195
2020-12-31,6258,7236,-978,-13.52,1195
2021-01-01,5657,7363,-1706,-23.17,1195
2021-01-02,3671,5582,-1911,-34.24,1195
2021-01-03,2550,3631,-1081,-29.77,1195
2021-01-04,5407,6903,-1496,-21.67,1195
2021-01-05,5602,7035,-1433,-20.37,1195
2021-01-06,5602,7001,-1399,-19.98,1195
2021-01-07,5602,6963,-1361,-19.55,1195
2021-01-08,5657,7103,-1446,-20.36,1195
2021-01-09,3671,5339,-1668,-31.24,1195
2021-01-10,2550,3406,-856,-25.13,1195
2021-01-11,5407,6701,-1294,-19.31,1195
2021-01-12,5602,6857,-1255,-18.3,1195
2021-01-13,5602,6849,-1247,-18.21,1195
2021-01-14,5602,6839,-1237,-18.09,1195
2021-01-15,5657,7008,-1351,-19.28,1195
2021-01-16,3671,5272,-1601,-30.37,1195
2021-01-17,2550,3368,-818,-24.29,1195
2021-01-18,5407,6691,-1284,-19.19,1195
2021-01-19,5602,6874,-1272,-18.5,1195
2021-01-20,5602,6891,-1289,-18.71,1195
2021-01-21,5602,6903,-1301,-18.85,1195
2021-01-22,5657,7092,-1435,-20.23,1195
2021-01-23,3671,5374,-1703,-31.69,1195
2021-01-24,2550,3485,-935,-26.83,1195
2021-01-25,5407,6819,-1412,-20.71,1195
2021-01-26,5602,7011,-1409,-20.1,1195
2021-01-27,5602,7034,-1432,-20.36,1195
2021-01-28,5602,7050,-1448,-20.54,1195
2021-01-29,5657,7239,-1582,-21.85,1195
2021-01-30,3671,5518,-1847,-33.47,1195
2021-01-31,2550,3625,-1075,-29.66,1195
2021-02-01,6615,6953,-338,-4.86,1195
2021-02-02,6675,7137,-462,-6.47,1195
2021-02-03,6675,7151,-476,-6.66,1195
2021-02-04,6675,7158,-483,-6.75,1195
2021-02-05,6834,7338,-504,-6.87,1195
2021-02-06,5077,5608,-531,-9.47,1195
2021-02-07,3166,3707,-541,-14.59,1195
2021-02-08,6615,7027,-412,-5.86,1195
2021-02-09,6675,7205,-530,-7.36,1195
2021-02-10,6675,7214,-539,-7.47,1195
2021-02-11,6675,7217,-542,-7.51,1195
2021-02-12,6834,7395,-561,-7.59,1195
2021-02-13,5077,5666,-589,-10.4,1195
2021-02-14,3166,3766,-600,-15.93,1195
2021-02-15,6615,7090,-475,-6.7,1195
2021-02-16,6675,7273,-598,-8.22,1195
2021-02-17,6675,7288,-613,-8.41,1195
2021-02-18,6675,7299,-624,-8.55,1195
2021-02-19,6834,7485,-651,-8.7,1195
2021-02-20,5077,5764,-687,-11.92,1195
2021-02-21,3166,3873,-707,-18.25,1195
2021-02-22,6615,7206,-591,-8.2,1195
2021-02-23,6675,7397,-722,-9.76,1195
2021-02-24,6675,7420,-745,-10.04,1195
2021-02-25,6675,7437,-762,-10.25,1195
2021-02-26,6834,7628,-794,-10.41,1195
2021-02-27,5077,5911,-834,-14.11,1195
2021-02-28,3166,4022,-856,-21.28,1195
2021-03-01,7079,7355,-276,-3.75,1195
2021-03-02,7292,7544,-252,-3.34,1195
2021-03-03,7292,7564,-272,-3.6,1195
2021-03-04,7292,7576,-284,-3.75,1195
2021-03-05,7116,7761,-645,-8.31,1195
2021-03-06,5678,6036,-358,-5.93,1195
2021-03-07,3432,4138,-706,-17.06,1195
2021-03-08,7079,7462,-383,-5.13,1195
2021-03-09,7292,7641,-349,-4.57,1195
2021-03-10,7292,7651,-359,-4.69,1195
2021-03-11,7292,7653,-361,-4.72,1195
2021-03-12,7116,7829,-713,-9.11,1195
2021-03-13,5678,6096,-418,-6.86,1195
2021-03-14,3432,4191,-759,-18.11,1195
2021-03-15,7079,7509,-430,-5.73,1195
2021-03-16,7292,7684,-392,-5.1,1195
2021-03-17,7292,7692,-400,-5.2,1195
2021-03-18,7292,7695,-403,-5.24,1195
2021-03-19,7116,7873,-757,-9.62,1195
2021-03-20,5678,6145,-467,-7.6,1195
2021-03-21,3432,4246,-814,-19.17,1195
2021-03-22,7079,7573,-494,-6.52,1195
2021-03-23,7292,7760,-468,-6.03,1195
2021-03-24,7292,7780,-488,-6.27,1195
2021-03-25,7292,7796,-504,-6.46,1195
2021-03-26,7116,7989,-873,-10.93,1195
2021-03-27,5678,6277,-599,-9.54,1195
2021-03-28,3432,4395,-963,-21.91,1195
2021-03-29,7079,7737,-658,-8.5,1195
2021-03-30,7292,7939,-647,-8.15,1195
2021-03-31,7292,7973,-681,-8.54,1195
2021-04-01,6477,8002,-1525,-19.06,1195
2021-04-02,6544,8206,-1662,-20.25,1195
2021-04-03,5010,6503,-1493,-22.96,1195
2021-04-04,3549,4627,-1078,-23.3,1195
2021-04-05,6483,7973,-1490,-18.69,1195
2021-04-06,6477,8176,-1699,-20.78,1195
2021-04-07,6477,8209,-1732,-21.1,1195
2021-04-08,6477,8234,-1757,-21.34,1195
2021-04-09,6544,8432,-1888,-22.39,1195
2021-04-10,5010,6718,-1708,-25.42,1195
2021-04-11,3549,4830,-1281,-26.52,1195
2021-04-12,6483,8162,-1679,-20.57,1195
2021-04-13,6477,8349,-1872,-22.42,1195
2021-04-14,6477,8364,-1887,-22.56,1195
2021-04-15,6477,8370,-1893,-22.62,1195
2021-04-16,6544,8547,-2003,-23.44,1195
2021-04-17,5010,6813,-1803,-26.46,1195
2021-04-18,3549,4905,-1356,-27.65,1195
2021-04-19,6483,8217,-1734,-21.1,1195
2021-04-20,6477,8384,-1907,-22.75,1195
2021-04-21,6477,8381,-1904,-22.72,1195
2021-04-22,6477,8370,-1893,-22.62,1195
2021-04-23,6544,8532,-1988,-23.3,1195
2021-04-24,5010,6785,-1775,-26.16,1195
2021-04-25,3549,4866,-1317,-27.07,1195
2021-04-26,6483,8170,-1687,-20.65,1195
2021-04-27,6477,8331,-1854,-22.25,1195
2021-04-28,6477,8324,-1847,-22.19,1195
2021-04-29,6477,8312,-1835,-22.08,1195
2021-04-30,6544,8475,-1931,-22.78,1195
2021-05-01,6428,6731,-303,-4.5,1195
2021-05-02,4011,4816,-805,-16.72,1195
2021-05-03,8074,8126,-52,-0.64,1195
2021-05-04,8100,8295,-195,-2.35,1195
2021-05-05,8100,8296,-196,-2.36,1195
2021-05-06,8100,8292,-192,-2.32,1195
2021-05-07,8052,8464,-412,-4.87,1195
2021-05-08,6428,6729,-301,-4.47,1195
2021-05-09,4011,4823,-812,-16.84,1195
2021-05-10,8074,8140,-66,-0.81,1195
2021-05-11,8100,8316,-216,-2.6,1195
2021-05-12,8100,8323,-223,-2.68,1195
2021-05-13,8100,8323,-223,-2.68,1195
2021-05-14,8052,8498,-446,-5.25,1195
2021-05-15,6428,6765,-337,-4.98,1195
2021-05-16,4011,4859,-848,-17.45,1195
2021-05-17,8074,8175,-101,-1.24,1195
2021-05-18,8100,8347,-247,-2.96,1195
2021-05-19,8100,8351,-251,-3.01,1195
2021-05-20,8100,8347,-247,-2.96,1195
2021-05-21,8052,8516,-464,-5.45,1195
2021-05-22,6428,6776,-348,-5.14,1195
2021-05-23,4011,4864,-853,-17.54,1195
2021-05-24,8074,8173,-99,-1.21,1195
2021-05-25,8100,8340,-240,-2.88,1195
2021-05-26,8100,8337,-237,-2.84,1195
2021-05-27,8100,8327,-227,-2.73,1195
2021-05-28,8052,8492,-440,-5.18,1195
2021-05-29,6428,6748,-320,-4.74,1195
2021-05-30,4011,4833,-822,-17.01,1195
2021-05-31,8074,8141,-67,-0.82,1195
2021-06-01,8427,8307,120,1.44,1195
2021-06-02,8427,8305,122,1.47,1195
2021-06-03,8427,8297,130,1.57,1195
2021-06-04,8337,8464,-127,-1.5,1195
2021-06-05,6556,6724,-168,-2.5,1195
2021-06-06,5124,4813,311,6.46,1195
2021-06-07,8144,8126,18,0.22,1195
2021-06-08,8427,8297,130,1.57,1195
2021-06-09,8427,8299,128,1.54,1195
2021-06-10,8427,8296,131,1.58,1195
2021-06-11,8337,8467,-130,-1.54,1195
2021-06-12,6556,6731,-175,-2.6,1195
2021-06-13,5124,4822,302,6.26,1195
2021-06-14,8144,8136,8,0.1,1195
2021-06-15,8427,8307,120,1.44,1195
2021-06-16,8427,8309,118,1.42,1195
2021-06-17,8427,8303,124,1.49,1195
2021-06-18,8337,8470,-133,-1.57,1195
2021-06-19,6556,6728,-172,-2.56,1195
2021-06-20,5124,4813,311,6.46,1195
2021-06-21,8144,8119,25,0.31,1195
2021-06-22,8427,8280,147,1.78,1195
2021-06-23,8427,8272,155,1.87,1195
2021-06-24,8427,8256,171,2.07,1195
2021-06-25,8337,8412,-75,-0.89,1195
2021-06-26,6556,6659,-103,-1.55,1195
2021-06-27,5124,4733,391,8.26,1195
2021-06-28,8144,8028,116,1.44,1195
2021-06-29,8427,8181,246,3.01,1195
2021-06-30,8427,8164,263,3.22,1195
2021-07-01,7822,8140,-318,-3.91,1195
2021-07-02,7664,8291,-627,-7.56,1195
2021-07-03,5827,6534,-707,-10.82,1195
2021-07-04,4321,4606,-285,-6.19,1195
2021-07-05,7625,7902,-277,-3.51,1195
2021-07-06,7822,8056,-234,-2.9,1195
2021-07-07,7822,8042,-220,-2.74,1195
2021-07-08,7822,8024,-202,-2.52,1195
2021-07-09,7664,8182,-518,-6.33,1195
2021-07-10,5827,6433,-606,-9.42,1195
2021-07-11,4321,4515,-194,-4.3,1195
2021-07-12,7625,7821,-196,-2.51,1195
2021-07-13,7822,7986,-164,-2.05,1195
2021-07-14,7822,7984,-162,-2.03,1195
2021-07-15,7822,7977,-155,-1.94,1195
2021-07-16,7664,8145,-481,-5.91,1195
2021-07-17,5827,6407,-580,-9.05,1195
2021-07-18,4321,4497,-176,-3.91,1195
2021-07-19,7625,7811,-186,-2.38,1195
2021-07-20,7822,7982,-160,-2.0,1195
2021-07-21,7822,7984,-162,-2.03,1195
2021-07-22,7822,7980,-158,-1.98,1195
2021-07-23,7664,8149,-485,-5.95,1195
2021-07-24,5827,6409,-582,-9.08,1195
2021-07-25,4321,4496,-175,-3.89,1195
2021-07-26,7625,7805,-180,-2.31,1195
2021-07-27,7822,7969,-147,-1.84,1195
2021-07-28,7822,7963,-141,-1.77,1195
2021-07-29,7822,7949,-127,-1.6,1195
2021-07-30,7664,8107,-443,-5.46,1195
2021-07-31,5827,6356,-529,-8.32,1195
2021-08-01,4052,4432,-380,-8.57,1195
2021-08-02,7010,7729,-719,-9.3,1195
2021-08-03,7264,7882,-618,-7.84,1195
2021-08-04,7264,7866,-602,-7.65,1195
2021-08-05,7264,7843,-579,-7.38,1195
2021-08-06,7095,7994,-899,-11.25,1195
2021-08-07,5656,6238,-582,-9.33,1195
2021-08-08,4052,4310,-258,-5.99,1195
2021-08-09,7010,7605,-595,-7.82,1195
2021-08-10,7264,7760,-496,-6.39,1195
2021-08-11,7264,7747,-483,-6.23,1195
2021-08-12,7264,7731,-467,-6.04,1195
2021-08-13,7095,7890,-795,-10.08,1195
2021-08-14,5656,6144,-488,-7.94,1195
2021-08-15,4052,4229,-177,-4.19,1195
2021-08-16,7010,7539,-529,-7.02,1195
2021-08-17,7264,7710,-446,-5.78,1195
2021-08-18,7264,7714,-450,-5.83,1195
2021-08-19,7264,7715,-451,-5.85,1195
2021-08-20,7095,7892,-797,-10.1,1195
2021-08-21,5656,6164,-508,-8.24,1195
2021-08-22,4052,4266,-214,-5.02,1195
2021-08-23,7010,7593,-583,-7.68,1195
2021-08-24,7264,7778,-514,-6.61,1195
2021-08-25,7264,7795,-531,-6.81,1195
2021-08-26,7264,7807,-543,-6.96,1195
2021-08-27,7095,7994,-899,-11.25,1195
2021-08-28,5656,6272,-616,-9.82,1195
2021-08-29,4052,4378,-326,-7.45,1195
2021-08-30,7010,7705,-695,-9.02,1195
2021-08-31,7264,7889,-625,-7.92,1195
2021-09-01,7964,7903,61,0.77,1195
2021-09-02,7964,7908,56,0.71,1195
2021-09-03,7887,8086,-199,-2.46,1195
2021-09-04,6178,6354,-176,-2.77,1195
2021-09-05,4664,4448,216,4.86,1195
2021-09-06,7802,7763,39,0.5,1195
2021-09-07,7964,7933,31,0.39,1195
2021-09-08,7964,7933,31,0.39,1195
2021-09-09,7964,7925,39,0.49,1195
2021-09-10,7887,8090,-203,-2.51,1195
2021-09-11,6178,6346,-168,-2.65,1195
2021-09-12,4664,4429,235,5.31,1195
2021-09-13,7802,7735,67,0.87,1195
2021-09-14,7964,7898,66,0.84,1195
2021-09-15,7964,7893,71,0.9,1195
2021-09-16,7964,7883,81,1.03,1195
2021-09-17,7887,8048,-161,-2.0,1195
2021-09-18,6178,6306,-128,-2.03,1195
2021-09-19,4664,4395,269,6.12,1195
2021-09-20,7802,7708,94,1.22,1195
2021-09-21,7964,7881,83,1.05,1195
2021-09-22,7964,7888,76,0.96,1195
2021-09-23,7964,7891,73,0.93,1195
2021-09-24,7887,8071,-184,-2.28,1195
2021-09-25,6178,6345,-167,-2.63,1195
2021-09-26,4664,4449,215,4.83,1195
2021-09-27,7802,7778,24,0.31,1195
2021-09-28,7964,7967,-3,-0.04,1195
2021-09-29,7964,7988,-24,-0.3,1195
2021-09-30,7964,8004,-40,-0.5,1195
2021-10-01,7991,8195,-204,-2.49,1195
2021-10-02,6522,6478,44,0.68,1195
2021-10-03,4642,4590,52,1.13,1195
2021-10-04,7524,7923,-399,-5.04,1195
2021-10-05,7866,8114,-248,-3.06,1195
2021-10-06,7866,8134,-268,-3.29,1195
2021-10-07,7866,8146,-280,-3.44,1195
2021-10-08,7991,8331,-340,-4.08,1195
2021-10-09,6522,6605,-83,-1.26,1195
2021-10-10,4642,4706,-64,-1.36,1195
2021-10-11,7524,8026,-502,-6.25,1195
2021-10-12,7866,8201,-335,-4.08,1195
2021-10-13,7866,8205,-339,-4.13,1195
2021-10-14,7866,8200,-334,-4.07,1195
2021-10-15,7991,8366,-375,-4.48,1195
2021-10-16,6522,6622,-100,-1.51,1195
2021-10-17,4642,4704,-62,-1.32,1195
2021-10-18,7524,8007,-483,-6.03,1195
2021-10-19,7866,8166,-300,-3.67,1195
2021-10-20,7866,8155,-289,-3.54,1195
2021-10-21,7866,8136,-270,-3.32,1195
2021-10-22,7991,8292,-301,-3.63,1195
2021-10-23,6522,6539,-17,-0.26,1195
2021-10-24,4642,4614,28,0.61,1195
2021-10-25,7524,7913,-389,-4.92,1195
2021-10-26,7866,8070,-204,-2.53,1195
2021-10-27,7866,8059,-193,-2.39,1195
2021-10-28,7866,8043,-177,-2.2,1195
2021-10-29,7991,8203,-212,-2.58,1195
2021-10-30,6522,6456,66,1.02,1195
2021-10-31,4642,4539,103,2.27,1195
2021-11-01,6823,7846,-1023,-13.04,1195
2021-11-02,7338,8012,-674,-8.41,1195
2021-11-03,7338,8011,-673,-8.4,1195
2021-11-04,7338,8005,-667,-8.33,1195
2021-11-05,7532,8173,-641,-7.84,1195
2021-11-06,5780,6435,-655,-10.18,1195
2021-11-07,4180,4524,-344,-7.6,1195
2021-11-08,6823,7837,-1014,-12.94,1195
2021-11-09,7338,8007,-669,-8.36,1195
2021-11-10,7338,8008,-670,-8.37,1195
2021-11-11,7338,8002,-664,-8.3,1195
2021-11-12,7532,8169,-637,-7.8,1195
2021-11-13,5780,6426,-646,-10.05,1195
2021-11-14,4180,4511,-331,-7.34,1195
2021-11-15,6823,7816,-993,-12.7,1195
2021-11-16,7338,7978,-640,-8.02,1195
2021-11-17,7338,7969,-631,-7.92,1195
2021-11-18,7338,7953,-615,-7.73,1195
2021-11-19,7532,8109,-577,-7.12,1195
2021-11-20,5780,6355,-575,-9.05,1195
2021-11-21,4180,4429,-249,-5.62,1195
2021-11-22,6823,7724,-901,-11.66,1195
2021-11-23,7338,7876,-538,-6.83,1195
2021-11-24,7338,7859,-521,-6.63,1195
2021-11-25,7338,7835,-497,-6.34,1195
2021-11-26,7532,7986,-454,-5.68,1195
2021-11-27,5780,6229,-449,-7.21,1195
2021-11-28,4180,4301,-121,-2.81,1195
2021-11-29,6823,7597,-774,-10.19,1195
2021-11-30,7338,7752,-414,-5.34,1195
2021-12-01,7013,7740,-727,-9.39,1195
2021-12-02,7013,7723,-710,-9.19,1195
2021-12-03,6509,7882,-1373,-17.42,1195
2021-12-04,5247,6135,-888,-14.47,1195
2021-12-05,3827,4219,-392,-9.29,1195
2021-12-06,7050,7526,-476,-6.32,1195
2021-12-07,7013,7693,-680,-8.84,1195
2021-12-08,7013,7693,-680,-8.84,1195
2021-12-09,7013,7687,-674,-8.77,1195
2021-12-10,6509,7857,-1348,-17.16,1195
2021-12-11,5247,6119,-872,-14.25,1195
2021-12-12,3827,4210,-383,-9.1,1195
2021-12-13,7050,7522,-472,-6.27,1195
2021-12-14,7013,7692,-679,-8.83,1195
2021-12-15,7013,7692,-679,-8.83,1195
2021-12-16,7013,7684,-671,-8.73,1195
2021-12-17,6509,7849,-1340,-17.07,1195
2021-12-18,5247,6103,-856,-14.03,1195
2021-12-19,3827,4183,-356,-8.51,1195
2021-12-20,7050,7482,-432,-5.77,1195
2021-12-21,7013,7636,-623,-8.16,1195
2021-12-22,7013,7618,-605,-7.94,1195
2021-12-23,7013,7591,-578,-7.61,1195
2021-12-24,6509,7734,-1225,-15.84,1195
2021-12-25,5247,5967,-720,-12.07,1195
2021-12-26,3827,4024,-197,-4.9,1195
2021-12-27,7050,7302,-252,-3.45,1195
2021-12-28,7013,7435,-422,-5.68,1195
2021-12-29,7013,7397,-384,-5.19,1195
2021-12-30,7013,7351,-338,-4.6,1195
2021-12-31,6509,7479,-970,-12.97,1195
2022-01-01,5415,5698,-283,-4.97,1195
2022-01-02,3610,3746,-136,-3.63,1195
2022-01-03,6168,7017,-849,-12.1,1195
2022-01-04,6645,7146,-501,-7.01,1195
2022-01-05,6645,7109,-464,-6.53,1195
2022-01-06,6645,7068,-423,-5.98,1195
2022-01-07,6754,7204,-450,-6.25,1195
2022-01-08,5415,5435,-20,-0.37,1195
2022-01-09,3610,3498,112,3.2,1195
2022-01-10,6168,6787,-619,-9.12,1195
2022-01-11,6645,6938,-293,-4.22,1195
2022-01-12,6645,6925,-280,-4.04,1195
2022-01-13,6645,6910,-265,-3.84,1195
2022-01-14,6754,7073,-319,-4.51,1195
2022-01-15,5415,5332,83,1.56,1195
2022-01-16,3610,3424,186,5.43,1195
2022-01-17,6168,6742,-574,-8.51,1195
2022-01-18,6645,6921,-276,-3.99,1195
2022-01-19,6645,6935,-290,-4.18,1195
2022-01-20,6645,6945,-300,-4.32,1195
2022-01-21,6754,7131,-377,-5.29,1195
2022-01-22,5415,5412,3,0.06,1195
2022-01-23,3610,3522,88,2.5,1195
2022-01-24,6168,6855,-687,-10.02,1195
2022-01-25,6645,7047,-402,-5.7,1195
2022-01-26,6645,7070,-425,-6.01,1195
2022-01-27,6645,7087,-442,-6.24,1195
2022-01-28,6754,7277,-523,-7.19,1195
2022-01-29,5415,5558,-143,-2.57,1195
2022-01-30,3610,3667,-57,-1.55,1195
2020-02-01,18955,17666,1289,7.3,1196
2020-02-02,13879,12550,1329,10.59,1196
2020-02-03,22683,22769,-86,-0.38,1196
2020-02-04,23250,23311,-61,-0.26,1196
2020-02-05,23250,23330,-80,-0.34,1196
2020-02-06,23250,23328,-78,-0.33,1196
2020-02-07,24526,24075,451,1.87,1196
2020-02-08,18955,17782,1173,6.6,1196
2020-02-09,13879,12645,1234,9.76,1196
2020-02-10,22683,22847,-164,-0.72,1196
2020-02-11,23250,23378,-128,-0.55,1196
2020-02-12,23250,23391,-141,-0.6,1196
2020-02-13,23250,23390,-140,-0.6,1196
2020-02-14,24526,24143,383,1.59,1196
2020-02-15,18955,17863,1092,6.11,1196
2020-02-16,13879,12743,1136,8.91,1196
2020-02-17,22683,22968,-285,-1.24,1196
2020-02-18,23250,23526,-276,-1.17,1196
2020-02-19,23250,23569,-319,-1.35,1196
2020-02-20,23250,23600,-350,-1.48,1196
2020-02-21,24526,24388,138,0.57,1196
2020-02-22,18955,18142,813,4.48,1196
2020-02-23,13879,13056,823,6.3,1196
2020-02-24,22683,23313,-630,-2.7,1196
2020-02-25,23250,23900,-650,-2.72,1196
2020-02-26,23250,23969,-719,-3.0,1196
2020-02-27,23250,24021,-771,-3.21,1196
2020-02-28,24526,24825,-299,-1.2,1196
2020-02-29,18955,18590,365,1.96,1196
2020-03-01,9630,13509,-3879,-28.71,1196
2020-03-02,16313,23764,-7451,-31.35,1196
2020-03-03,16879,24344,-7465,-30.66,1196
2020-03-04,16879,24400,-7521,-30.82,1196
2020-03-05,16879,24434,-7555,-30.92,1196
2020-03-06,17814,25215,-7401,-29.35,1196
2020-03-07,12435,18952,-6517,-34.39,1196
2020-03-08,9630,13841,-4211,-30.42,1196
2020-03-09,16313,24064,-7751,-32.21,1196
2020-03-10,16879,24609,-7730,-31.41,1196
2020-03-11,16879,24630,-7751,-31.47,1196
2020-03-12,16879,24631,-7752,-31.47,1196
2020-03-13,17814,25379,-7565,-29.81,1196
2020-03-14,12435,19086,-6651,-34.85,1196
2020-03-15,9630,13948,-4318,-30.96,1196
2020-03-16,16313,24148,-7835,-32.45,1196
2020-03-17,16879,24675,-7796,-31.59,1196
2020-03-18,16879,24684,-7805,-31.62,1196
2020-03-19,16879,24677,-7798,-31.6,1196
2020-03-20,17814,25423,-7609,-29.93,1196
2020-03-21,12435,19134,-6699,-35.01,1196
2020-03-22,9630,14005,-4375,-31.24,1196
2020-03-23,16313,24219,-7906,-32.64,1196
2020-03-24,16879,24765,-7886,-31.84,1196
2020-03-25,16879,24796,-7917,-31.93,1196
2020-03-26,16879,24813,-7934,-31.98,1196
2020-03-27,17814,25587,-7773,-30.38,1196
2020-03-28,12435,19326,-6891,-35.66,1196
2020-03-29,9630,14226,-4596,-32.31,1196
2020-03-30,16313,24468,-8155,-33.33,1196
2020-03-31,16879,25040,-8161,-32.59,1196
2020-04-01,14521,25094,-10573,-42.13,1196
2020-04-02,14521,25132,-10611,-42.22,1196
2020-04-03,14199,25922,-11723,-45.22,1196
2020-04-04,11016,19673,-8657,-44.0,1196
2020-04-05,7449,14579,-7130,-48.91,1196
2020-04-06,14881,24823,-9942,-40.05,1196
2020-04-07,14521,25391,-10870,-42.81,1196
2020-04-08,14521,25436,-10915,-42.91,1196
2020-04-09,14521,25461,-10940,-42.97,1196
2020-04-10,14199,26232,-12033,-45.87,1196
2020-04-11,11016,19960,-8944,-44.81,1196
2020-04-12,7449,14840,-7391,-49.8,1196
2020-04-13,14881,25055,-10174,-40.61,1196
2020-04-14,14521,25592,-11071,-43.26,1196
2020-04-15,14521,25605,-11084,-43.29,1196
2020-04-16,14521,25598,-11077,-43.27,1196
2020-04-17,14199,26338,-12139,-46.09,1196
2020-04-18,11016,20036,-9020,-45.02,1196
2020-04-19,7449,14889,-7440,-49.97,1196
2020-04-20,14881,25079,-10198,-40.66,1196
2020-04-21,14521,25597,-11076,-43.27,1196
2020-04-22,14521,25594,-11073,-43.26,1196
2020-04-23,14521,25575,-11054,-43.22,1196
2020-04-24,14199,26309,-12110,-46.03,1196
2020-04-25,11016,20006,-8990,-44.94,1196
2020-04-26,7449,14862,-7413,-49.88,1196
2020-04-27,14881,25060,-10179,-40.62,1196
2020-04-28,14521,25588,-11067,-43.25,1196
2020-04-29,14521,25601,-11080,-43.28,1196
2020-04-30,14521,25600,-11079,-43.28,1196
2020-05-01,22992,26353,-3361,-12.75,1196
2020-05-02,17297,20071,-2774,-13.82,1196
2020-05-03,11547,14948,-3401,-22.75,1196
2020-05-04,21911,25167,-3256,-12.94,1196
2020-05-05,22785,25714,-2929,-11.39,1196
2020-05-06,22785,25743,-2958,-11.49,1196
2020-05-07,22785,25755,-2970,-11.53,1196
2020-05-08,22992,26518,-3526,-13.3,1196
2020-05-09,17297,20241,-2944,-14.54,1196
2020-05-10,11547,15118,-3571,-23.62,1196
2020-05-11,21911,25332,-3421,-13.5,1196
2020-05-12,22785,25870,-3085,-11.93,1196
2020-05-13,22785,25883,-3098,-11.97,1196
2020-05-14,22785,25875,-3090,-11.94,1196
2020-05-15,22992,26613,-3621,-13.61,1196
2020-05-16,17297,20306,-3009,-14.82,1196
2020-05-17,11547,15151,-3604,-23.79,1196
2020-05-18,21911,25329,-3418,-13.49,1196
2020-05-19,22785,25830,-3045,-11.79,1196
2020-05-20,22785,25806,-3021,-11.71,1196
2020-05-21,22785,25760,-2975,-11.55,1196
2020-05-22,22992,26461,-3469,-13.11,1196
2020-05-23,17297,20120,-2823,-14.03,1196
2020-05-24,11547,14934,-3387,-22.68,1196
2020-05-25,21911,25085,-3174,-12.65,1196
2020-05-26,22785,25562,-2777,-10.86,1196
2020-05-27,22785,25520,-2735,-10.72,1196
2020-05-28,22785,25461,-2676,-10.51,1196
2020-05-29,22992,26156,-3164,-12.1,1196
2020-05-30,17297,19814,-2517,-12.7,1196
2020-05-31,11547,14633,-3086,-21.09,1196
2020-06-01,25039,24794,245,0.99,1196
2020-06-02,26102,25287,815,3.22,1196
2020-06-03,26102,25264,838,3.32,1196
2020-06-04,26102,25229,873,3.46,1196
2020-06-05,25092,25949,-857,-3.3,1196
2020-06-06,19221,19635,-414,-2.11,1196
2020-06-07,13435,14482,-1047,-7.23,1196
2020-06-08,25039,24670,369,1.5,1196
2020-06-09,26102,25189,913,3.62,1196
2020-06-10,26102,25190,912,3.62,1196
2020-06-11,26102,25174,928,3.69,1196
2020-06-12,25092,25909,-817,-3.15,1196
2020-06-13,19221,19604,-383,-1.95,1196
2020-06-14,13435,14453,-1018,-7.04,1196
2020-06-15,25039,24638,401,1.63,1196
2020-06-16,26102,25146,956,3.8,1196
2020-06-17,26102,25128,974,3.88,1196
2020-06-18,26102,25088,1014,4.04,1196
2020-06-19,25092,25791,-699,-2.71,1196
2020-06-20,19221,19449,-228,-1.17,1196
2020-06-21,13435,14255,-820,-5.75,1196
2020-06-22,25039,24392,647,2.65,1196
2020-06-23,26102,24849,1253,5.04,1196
2020-06-24,26102,24779,1323,5.34,1196
2020-06-25,26102,24684,1418,5.74,1196
2020-06-26,25092,25334,-242,-0.96,1196
2020-06-27,19221,18940,281,1.48,1196
2020-06-28,13435,13698,-263,-1.92,1196
2020-06-29,25039,23791,1248,5.25,1196
2020-06-30,26102,24210,1892,7.81,1196
2020-07-01,24607,24108,499,2.07,1196
2020-07-02,24607,23989,618,2.58,1196
2020-07-03,24767,24623,144,0.58,1196
2020-07-04,18637,18223,414,2.27,1196
2020-07-05,14288,12983,1305,10.05,1196
2020-07-06,23521,23089,432,1.87,1196
2020-07-07,24607,23529,1078,4.58,1196
2020-07-08,24607,23457,1150,4.9,1196
2020-07-09,24607,23377,1230,5.26,1196
2020-07-10,24767,24058,709,2.95,1196
2020-07-11,18637,17711,926,5.23,1196
2020-07-12,14288,12529,1759,14.04,1196
2020-07-13,23521,22697,824,3.63,1196
2020-07-14,24607,23202,1405,6.06,1196
2020-07-15,24607,23197,1410,6.08,1196
2020-07-16,24607,23183,1424,6.14,1196
2020-07-17,24767,23928,839,3.51,1196
2020-07-18,18637,17641,996,5.65,1196
2020-07-19,14288,12516,1772,14.16,1196
2020-07-20,23521,22735,786,3.46,1196
2020-07-21,24607,23284,1323,5.68,1196
2020-07-22,24607,23315,1292,5.54,1196
2020-07-23,24607,23328,1279,5.48,1196
2020-07-24,24767,24093,674,2.8,1196
2020-07-25,18637,17816,821,4.61,1196
2020-07-26,14288,12692,1596,12.57,1196
2020-07-27,23521,22904,617,2.69,1196
2020-07-28,24607,23438,1169,4.99,1196
2020-07-29,24607,23446,1161,4.95,1196
2020-07-30,24607,23432,1175,5.01,1196
2020-07-31,24767,24163,604,2.5,1196
2020-08-01,18514,17849,665,3.73,1196
2020-08-02,14286,12685,1601,12.62,1196
2020-08-03,22809,22856,-47,-0.21,1196
2020-08-04,23012,23350,-338,-1.45,1196
2020-08-05,23012,23320,-308,-1.32,1196
2020-08-06,23012,23271,-259,-1.11,1196
2020-08-07,23380,23971,-591,-2.47,1196
2020-08-08,18514,17632,882,5.0,1196
2020-08-09,14286,12450,1836,14.75,1196
2020-08-10,22809,22610,199,0.88,1196
2020-08-11,23012,23101,-89,-0.39,1196
2020-08-12,23012,23076,-64,-0.28,1196
2020-08-13,23012,23040,-28,-0.12,1196
2020-08-14,23380,23762,-382,-1.61,1196
2020-08-15,18514,17453,1061,6.08,1196
2020-08-16,14286,12309,1977,16.06,1196
2020-08-17,22809,22513,296,1.31,1196
2020-08-18,23012,23053,-41,-0.18,1196
2020-08-19,23012,23082,-70,-0.3,1196
2020-08-20,23012,23104,-92,-0.4,1196
2020-08-21,23380,23885,-505,-2.11,1196
2020-08-22,18514,17636,878,4.98,1196
2020-08-23,14286,12550,1736,13.83,1196
2020-08-24,22809,22810,-1,-0.0,1196
2020-08-25,23012,23403,-391,-1.67,1196
2020-08-26,23012,23481,-469,-2.0,1196
2020-08-27,23012,23544,-532,-2.26,1196
2020-08-28,23380,24361,-981,-4.03,1196
2020-08-29,18514,18139,375,2.07,1196
2020-08-30,14286,13073,1213,9.28,1196
2020-08-31,22809,23345,-536,-2.3,1196
2020-09-01,25688,23941,1747,7.3,1196
2020-09-02,25688,24013,1675,6.98,1196
2020-09-03,25688,24064,1624,6.75,1196
2020-09-04,25536,24860,676,2.72,1196
2020-09-05,19275,18611,664,3.57,1196
2020-09-06,14225,13512,713,5.28,1196
2020-09-07,24962,23745,1217,5.13,1196
2020-09-08,25688,24299,1389,5.72,1196
2020-09-09,25688,24328,1360,5.59,1196
2020-09-10,25688,24332,1356,5.57,1196
2020-09-11,25536,25083,453,1.81,1196
2020-09-12,19275,18790,485,2.58,1196
2020-09-13,14225,13649,576,4.22,1196
2020-09-14,24962,23845,1117,4.68,1196
2020-09-15,25688,24365,1323,5.43,1196
2020-09-16,25688,24364,1324,5.43,1196
2020-09-17,25688,24346,1342,5.51,1196
2020-09-18,25536,25079,457,1.82,1196
2020-09-19,19275,18775,500,2.66,1196
2020-09-20,14225,13629,596,4.37,1196
2020-09-21,24962,23826,1136,4.77,1196
2020-09-22,25688,24353,1335,5.48,1196
2020-09-23,25688,24364,1324,5.43,1196
2020-09-24,25688,24362,1326,5.44,1196
2020-09-25,25536,25116,420,1.67,1196
2020-09-26,19275,18835,440,2.34,1196
2020-09-27,14225,13714,511,3.73,1196
2020-09-28,24962,23937,1025,4.28,1196
2020-09-29,25688,24489,1199,4.9,1196
2020-09-30,25688,24525,1163,4.74,1196
2020-10-01,25340,24545,795,3.24,1196
2020-10-02,25485,25318,167,0.66,1196
2020-10-03,18914,19052,-138,-0.72,1196
2020-10-04,13252,13943,-691,-4.96,1196
2020-10-05,25070,24172,898,3.72,1196
2020-10-06,25340,24726,614,2.48,1196
2020-10-07,25340,24758,582,2.35,1196
2020-10-08,25340,24770,570,2.3,1196
2020-10-09,25485,25529,-44,-0.17,1196
2020-10-10,18914,19246,-332,-1.73,1196
2020-10-11,13252,14114,-862,-6.11,1196
2020-10-12,25070,24318,752,3.09,1196
2020-10-13,25340,24845,495,1.99,1196
2020-10-14,25340,24848,492,1.98,1196
2020-10-15,25340,24830,510,2.05,1196
2020-10-16,25485,25560,-75,-0.29,1196
2020-10-17,18914,19249,-335,-1.74,1196
2020-10-18,13252,14091,-839,-5.95,1196
2020-10-19,25070,24272,798,3.29,1196
2020-10-20,25340,24779,561,2.26,1196
2020-10-21,25340,24766,574,2.32,1196
2020-10-22,25340,24737,603,2.44,1196
2020-10-23,25485,25461,24,0.09,1196
2020-10-24,18914,19148,-234,-1.22,1196
2020-10-25,13252,13995,-743,-5.31,1196
2020-10-26,25070,24184,886,3.66,1196
2020-10-27,25340,24704,636,2.57,1196
2020-10-28,25340,24709,631,2.55,1196
2020-10-29,25340,24701,639,2.59,1196
2020-10-30,25485,25448,37,0.15,1196
2020-10-31,18914,19160,-246,-1.28,1196
2020-11-01,10591,14032,-3441,-24.52,1196
2020-11-02,20799,24247,-3448,-14.22,1196
2020-11-03,18912,24793,-5881,-23.72,1196
2020-11-04,18912,24820,-5908,-23.8,1196
2020-11-05,18912,24832,-5920,-23.84,1196
2020-11-06,20270,25595,-5325,-20.8,1196
2020-11-07,14441,19320,-4879,-25.25,1196
2020-11-08,10591,14199,-3608,-25.41,1196
2020-11-09,20799,24416,-3617,-14.81,1196
2020-11-10,18912,24958,-6046,-24.22,1196
2020-11-11,18912,24976,-6064,-24.28,1196
2020-11-12,18912,24973,-6061,-24.27,1196
2020-11-13,20270,25717,-5447,-21.18,1196
2020-11-14,14441,19417,-4976,-25.63,1196
2020-11-15,10591,14268,-3677,-25.77,1196
2020-11-16,20799,24453,-3654,-14.94,1196
2020-11-17,18912,24960,-6048,-24.23,1196
2020-11-18,18912,24942,-6030,-24.18,1196
2020-11-19,18912,24902,-5990,-24.05,1196
2020-11-20,20270,25610,-5340,-20.85,1196
2020-11-21,14441,19275,-4834,-25.08,1196
2020-11-22,10591,14094,-3503,-24.85,1196
2020-11-23,20799,24250,-3451,-14.23,1196
2020-11-24,18912,24733,-5821,-23.54,1196
2020-11-25,18912,24696,-5784,-23.42,1196
2020-11-26,18912,24643,-5731,-23.26,1196
2020-11-27,20270,25343,-5073,-20.02,1196
2020-11-28,14441,19007,-4566,-24.02,1196
2020-11-29,10591,13831,-3240,-23.43,1196
2020-11-30,20799,23999,-3200,-13.33,1196
2020-12-01,20641,24499,-3858,-15.75,1196
2020-12-02,20641,24484,-3843,-15.7,1196
2020-12-03,20641,24457,-3816,-15.6,1196
2020-12-04,22380,25187,-2807,-11.14,1196
2020-12-05,15937,18884,-2947,-15.61,1196
2020-12-06,10558,13742,-3184,-23.17,1196
2020-12-07,20866,23944,-3078,-12.85,1196
2020-12-08,20641,24477,-3836,-15.67,1196
2020-12-09,20641,24493,-3852,-15.73,1196
2020-12-10,20641,24493,-3852,-15.73,1196
2020-12-11,22380,25246,-2866,-11.35,1196
2020-12-12,15937,18959,-3022,-15.94,1196
2020-12-13,10558,13827,-3269,-23.64,1196
2020-12-14,20866,24031,-3165,-13.17,1196
2020-12-15,20641,24558,-3917,-15.95,1196
2020-12-16,20641,24560,-3919,-15.96,1196
2020-12-17,20641,24538,-3897,-15.88,1196
2020-12-18,22380,25260,-2880,-11.4,1196
2020-12-19,15937,18934,-2997,-15.83,1196
2020-12-20,10558,13756,-3198,-23.25,1196
2020-12-21,20866,23908,-3042,-12.72,1196
2020-12-22,20641,24377,-3736,-15.33,1196
2020-12-23,20641,24317,-3676,-15.12,1196
2020-12-24,20641,24229,-3588,-14.81,1196
2020-12-25,22380,24884,-2504,-10.06,1196
2020-12-26,15937,18492,-2555,-13.82,1196
2020-12-27,10558,13248,-2690,-20.3,1196
2020-12-28,20866,23337,-2471,-10.59,1196
2020-12-29,20641,23748,-3107,-13.08,1196
2020-12-30,20641,23636,-2995,-12.67,1196
2020-12-31,20641,23504,-2863,-12.18,1196
2021-01-01,18681,24123,-5442,-22.56,1196
2021-01-02,12468,17704,-5236,-29.58,1196
2021-01-03,9274,12444,-3170,-25.47,1196
2021-01-04,17092,22528,-5436,-24.13,1196
2021-01-05,17810,22945,-5135,-22.38,1196
2021-01-06,17810,22849,-5039,-22.05,1196
2021-01-07,17810,22745,-4935,-21.7,1196
2021-01-08,18681,23401,-4720,-20.17,1196
2021-01-09,12468,17030,-4562,-26.79,1196
2021-01-10,9274,11826,-2552,-21.58,1196
2021-01-11,17092,21974,-4882,-22.22,1196
2021-01-12,17810,22461,-4651,-20.71,1196
2021-01-13,17810,22440,-4630,-20.63,1196
2021-01-14,17810,22414,-4604,-20.54,1196
2021-01-15,18681,23151,-4470,-19.31,1196
2021-01-16,12468,16860,-4392,-26.05,1196
2021-01-17,9274,11735,-2461,-20.97,1196
2021-01-18,17092,21958,-4866,-22.16,1196
2021-01-19,17810,22517,-4707,-20.9,1196
2021-01-20,17810,22562,-4752,-21.06,1196
2021-01-21,17810,22596,-4786,-21.18,1196
2021-01-22,18681,23384,-4703,-20.11,1196
2021-01-23,12468,17137,-4669,-27.25,1196
2021-01-24,9274,12047,-2773,-23.02,1196
2021-01-25,17092,22296,-5204,-23.34,1196
2021-01-26,17810,22871,-5061,-22.13,1196
2021-01-27,17810,22925,-5115,-22.31,1196
2021-01-28,17810,22958,-5148,-22.42,1196
2021-01-29,18681,23739,-5058,-21.31,1196
2021-01-30,12468,17477,-5009,-28.66,1196
2021-01-31,9274,12367,-3093,-25.01,1196
2021-02-01,21034,22591,-1557,-6.89,1196
2021-02-02,21334,23139,-1805,-7.8,1196
2021-02-03,21334,23162,-1828,-7.89,1196
2021-02-04,21334,23165,-1831,-7.9,1196
2021-02-05,21554,23915,-2361,-9.87,1196
2021-02-06,15586,17625,-2039,-11.57,1196
2021-02-07,11060,12488,-1428,-11.43,1196
2021-02-08,21034,22691,-1657,-7.3,1196
2021-02-09,21334,23220,-1886,-8.12,1196
2021-02-10,21334,23231,-1897,-8.17,1196
2021-02-11,21334,23227,-1893,-8.15,1196
2021-02-12,21554,23976,-2422,-10.1,1196
2021-02-13,15586,17691,-2105,-11.9,1196
2021-02-14,11060,12565,-1505,-11.98,1196
2021-02-15,21034,22784,-1750,-7.68,1196
2021-02-16,21334,23335,-2001,-8.58,1196
2021-02-17,21334,23372,-2038,-8.72,1196
2021-02-18,21334,23397,-2063,-8.82,1196
2021-02-19,21554,24179,-2625,-10.86,1196
2021-02-20,15586,17927,-2341,-13.06,1196
2021-02-21,11060,12836,-1776,-13.84,1196
2021-02-22,21034,23089,-2055,-8.9,1196
2021-02-23,21334,23673,-2339,-9.88,1196
2021-02-24,21334,23739,-2405,-10.13,1196
2021-02-25,21334,23791,-2457,-10.33,1196
2021-02-26,21554,24595,-3041,-12.36,1196
2021-02-27,15586,18360,-2774,-15.11,1196
2021-02-28,11060,13282,-2222,-16.73,1196
2021-03-01,22333,23541,-1208,-5.13,1196
2021-03-02,22780,24125,-1345,-5.58,1196
2021-03-03,22780,24186,-1406,-5.81,1196
2021-03-04,22780,24226,-1446,-5.97,1196
2021-03-05,23086,25013,-1927,-7.7,1196
2021-03-06,17122,18757,-1635,-8.72,1196
2021-03-07,11396,13652,-2256,-16.53,1196
2021-03-08,22333,23881,-1548,-6.48,1196
2021-03-09,22780,24432,-1652,-6.76,1196
2021-03-10,22780,24460,-1680,-6.87,1196
2021-03-11,22780,24465,-1685,-6.89,1196
2021-03-12,23086,25218,-2132,-8.45,1196
2021-03-13,17122,18928,-1806,-9.54,1196
2021-03-14,11396,13793,-2397,-17.38,1196
2021-03-15,22333,23994,-1661,-6.92,1196
2021-03-16,22780,24522,-1742,-7.1,1196
2021-03-17,22780,24530,-1750,-7.13,1196
2021-03-18,22780,24521,-1741,-7.1,1196
2021-03-19,23086,25265,-2179,-8.62,1196
2021-03-20,17122,18973,-1851,-9.76,1196
2021-03-21,11396,13839,-2443,-17.65,1196
2021-03-22,22333,24049,-1716,-7.14,1196
2021-03-23,22780,24589,-1809,-7.36,1196
2021-03-24,22780,24615,-1835,-7.45,1196
2021-03-25,22780,24627,-1847,-7.5,1196
2021-03-26,23086,25395,-2309,-9.09,1196
2021-03-27,17122,19129,-2007,-10.49,1196
2021-03-28,11396,14024,-2628,-18.74,1196
2021-03-29,22333,24262,-1929,-7.95,1196
2021-03-30,22780,24831,-2051,-8.26,1196
2021-03-31,22780,24883,-2103,-8.45,1196
2021-04-01,20770,24920,-4150,-16.65,1196
2021-04-02,21024,25709,-4685,-18.22,1196
2021-04-03,15025,19461,-4436,-22.79,1196
2021-04-04,11318,14369,-3051,-21.23,1196
2021-04-05,21372,24615,-3243,-13.17,1196
2021-04-06,20770,25186,-4416,-17.53,1196
2021-04-07,20770,25236,-4466,-17.7,1196
2021-04-08,20770,25265,-4495,-17.79,1196
2021-04-09,21024,26042,-5018,-19.27,1196
2021-04-10,15025,19776,-4751,-24.02,1196
2021-04-11,11318,14662,-3344,-22.81,1196
2021-04-12,21372,24882,-3510,-14.11,1196
2021-04-13,20770,25426,-4656,-18.31,1196
2021-04-14,20770,25445,-4675,-18.37,1196
2021-04-15,20770,25442,-4672,-18.36,1196
2021-04-16,21024,26187,-5163,-19.72,1196
2021-04-17,15025,19889,-4864,-24.46,1196
2021-04-18,11318,14745,-3427,-23.24,1196
2021-04-19,21372,24938,-3566,-14.3,1196
2021-04-20,20770,25456,-4686,-18.41,1196
2021-04-21,20770,25454,-4684,-18.4,1196
2021-04-22,20770,25434,-4664,-18.34,1196
2021-04-23,21024,26167,-5143,-19.65,1196
2021-04-24,15025,19861,-4836,-24.35,1196
2021-04-25,11318,14714,-3396,-23.08,1196
2021-04-26,21372,24909,-3537,-14.2,1196
2021-04-27,20770,25434,-4664,-18.34,1196
2021-04-28,20770,25443,-4673,-18.37,1196
2021-04-29,20770,25437,-4667,-18.35,1196
2021-04-30,21024,26187,-5163,-19.72,1196
2021-05-01,19352,19901,-549,-2.76,1196
2021-05-02,13060,14774,-1714,-11.6,1196
2021-05-03,26184,24990,1194,4.78,1196
2021-05-04,26506,25536,970,3.8,1196
2021-05-05,26506,25564,942,3.68,1196
2021-05-06,26506,25576,930,3.64,1196
2021-05-07,26199,26339,-140,-0.53,1196
2021-05-08,19352,20064,-712,-3.55,1196
2021-05-09,13060,14944,-1884,-12.61,1196
2021-05-10,26184,25161,1023,4.07,1196
2021-05-11,26506,25703,803,3.12,1196
2021-05-12,26506,25722,784,3.05,1196
2021-05-13,26506,25720,786,3.06,1196
2021-05-14,26199,26464,-265,-1.0,1196
2021-05-15,19352,20165,-813,-4.03,1196
2021-05-16,13060,15017,-1957,-13.03,1196
2021-05-17,26184,25202,982,3.9,1196
2021-05-18,26506,25709,797,3.1,1196
2021-05-19,26506,25692,814,3.17,1196
2021-05-20,26506,25652,854,3.33,1196
2021-05-21,26199,26358,-159,-0.6,1196
2021-05-22,19352,20022,-670,-3.35,1196
2021-05-23,13060,14839,-1779,-11.99,1196
2021-05-24,26184,24992,1192,4.77,1196
2021-05-25,26506,25471,1035,4.06,1196
2021-05-26,26506,25429,1077,4.24,1196
2021-05-27,26506,25370,1136,4.48,1196
2021-05-28,26199,26063,136,0.52,1196
2021-05-29,19352,19718,-366,-1.86,1196
2021-05-30,13060,14533,-1473,-10.14,1196
2021-05-31,26184,24690,1494,6.05,1196
2021-06-01,26577,25177,1400,5.56,1196
2021-06-02,26577,25150,1427,5.67,1196
2021-06-03,26577,25109,1468,5.85,1196
2021-06-04,26313,25824,489,1.89,1196
2021-06-05,19863,19505,358,1.84,1196
2021-06-06,15088,14347,741,5.16,1196
2021-06-07,26005,24531,1474,6.01,1196
2021-06-08,26577,25047,1530,6.11,1196
2021-06-09,26577,25046,1531,6.11,1196
2021-06-10,26577,25029,1548,6.18,1196
2021-06-11,26313,25764,549,2.13,1196
2021-06-12,19863,19461,402,2.07,1196
2021-06-13,15088,14313,775,5.41,1196
2021-06-14,26005,24503,1502,6.13,1196
2021-06-15,26577,25016,1561,6.24,1196
2021-06-16,26577,25006,1571,6.28,1196
2021-06-17,26577,24973,1604,6.42,1196
2021-06-18,26313,25685,628,2.45,1196
2021-06-19,19863,19352,511,2.64,1196
2021-06-20,15088,14168,920,6.49,1196
2021-06-21,26005,24316,1689,6.95,1196
2021-06-22,26577,24783,1794,7.24,1196
2021-06-23,26577,24722,1855,7.5,1196
2021-06-24,26577,24637,1940,7.87,1196
2021-06-25,26313,25296,1017,4.02,1196
2021-06-26,19863,18909,954,5.05,1196
2021-06-27,15088,13672,1416,10.36,1196
2021-06-28,26005,23771,2234,9.4,1196
2021-06-29,26577,24192,2385,9.86,1196
2021-06-30,26577,24092,2485,10.31,1196
2021-07-01,24081,23973,108,0.45,1196
2021-07-02,24347,24605,-258,-1.05,1196
2021-07-03,18686,18201,485,2.66,1196
2021-07-04,14370,12956,1414,10.91,1196
2021-07-05,23228,23054,174,0.75,1196
2021-07-06,24081,23486,595,2.53,1196
2021-07-07,24081,23405,676,2.89,1196
2021-07-08,24081,23314,767,3.29,1196
2021-07-09,24347,23983,364,1.52,1196
2021-07-10,18686,17623,1063,6.03,1196
2021-07-11,14370,12430,1940,15.61,1196
2021-07-12,23228,22585,643,2.85,1196
2021-07-13,24081,23079,1002,4.34,1196
2021-07-14,24081,23062,1019,4.42,1196
2021-07-15,24081,23037,1044,4.53,1196
2021-07-16,24347,23773,574,2.41,1196
2021-07-17,18686,17478,1208,6.91,1196
2021-07-18,14370,12346,2024,16.39,1196
2021-07-19,23228,22559,669,2.97,1196
2021-07-20,24081,23104,977,4.23,1196
2021-07-21,24081,23133,948,4.1,1196
2021-07-22,24081,23146,935,4.04,1196
2021-07-23,24347,23912,435,1.82,1196
2021-07-24,18686,17638,1048,5.94,1196
2021-07-25,14370,12519,1851,14.79,1196
2021-07-26,23228,22735,493,2.17,1196
2021-07-27,24081,23276,805,3.46,1196
2021-07-28,24081,23291,790,3.39,1196
2021-07-29,24081,23284,797,3.42,1196
2021-07-30,24347,24023,324,1.35,1196
2021-07-31,18686,17717,969,5.47,1196
2021-08-01,13665,12561,1104,8.79,1196
2021-08-02,22214,22738,-524,-2.3,1196
2021-08-03,22738,23238,-500,-2.15,1196
2021-08-04,22738,23213,-475,-2.05,1196
2021-08-05,22738,23167,-429,-1.85,1196
2021-08-06,22771,23870,-1099,-4.6,1196
2021-08-07,17893,17532,361,2.06,1196
2021-08-08,13665,12350,1315,10.65,1196
2021-08-09,22214,22507,-293,-1.3,1196
2021-08-10,22738,22994,-256,-1.11,1196
2021-08-11,22738,22964,-226,-0.98,1196
2021-08-12,22738,22921,-183,-0.8,1196
2021-08-13,22771,23635,-864,-3.66,1196
2021-08-14,17893,17317,576,3.33,1196
2021-08-15,13665,12163,1502,12.35,1196
2021-08-16,22214,22356,-142,-0.64,1196
2021-08-17,22738,22885,-147,-0.64,1196
2021-08-18,22738,22904,-166,-0.72,1196
2021-08-19,22738,22914,-176,-0.77,1196
2021-08-20,22771,23684,-913,-3.85,1196
2021-08-21,17893,17425,468,2.69,1196
2021-08-22,13665,12330,1335,10.83,1196
2021-08-23,22214,22583,-369,-1.63,1196
2021-08-24,22738,23169,-431,-1.86,1196
2021-08-25,22738,23241,-503,-2.16,1196
2021-08-26,22738,23301,-563,-2.42,1196
2021-08-27,22771,24115,-1344,-5.57,1196
2021-08-28,17893,17893,0,0.0,1196
2021-08-29,13665,12828,837,6.52,1196
2021-08-30,22214,23102,-888,-3.84,1196
2021-08-31,22738,23702,-964,-4.07,1196
2021-09-01,25062,23779,1283,5.4,1196
2021-09-02,25062,23835,1227,5.15,1196
2021-09-03,25420,24638,782,3.17,1196
2021-09-04,18706,18397,309,1.68,1196
2021-09-05,14504,13307,1197,9.0,1196
2021-09-06,25146,23549,1597,6.78,1196
2021-09-07,25062,24112,950,3.94,1196
2021-09-08,25062,24148,914,3.78,1196
2021-09-09,25062,24161,901,3.73,1196
2021-09-10,25420,24919,501,2.01,1196
2021-09-11,18706,18632,74,0.4,1196
2021-09-12,14504,13497,1007,7.46,1196
2021-09-13,25146,23697,1449,6.11,1196
2021-09-14,25062,24220,842,3.48,1196
2021-09-15,25062,24222,840,3.47,1196
2021-09-16,25062,24204,858,3.54,1196
2021-09-17,25420,24937,483,1.94,1196
2021-09-18,18706,18632,74,0.4,1196
2021-09-19,14504,13484,1020,7.56,1196
2021-09-20,25146,23677,1469,6.2,1196
2021-09-21,25062,24201,861,3.56,1196
2021-09-22,25062,24208,854,3.53,1196
2021-09-23,25062,24201,861,3.56,1196
2021-09-24,25420,24949,471,1.89,1196
2021-09-25,18706,18663,43,0.23,1196
2021-09-26,14504,13538,966,7.14,1196
2021-09-27,25146,23756,1390,5.85,1196
2021-09-28,25062,24305,757,3.11,1196
2021-09-29,25062,24337,725,2.98,1196
2021-09-30,25062,24355,707,2.9,1196
2021-10-01,26039,25127,912,3.63,1196
2021-10-02,20228,18861,1367,7.25,1196
2021-10-03,14681,13752,929,6.76,1196
2021-10-04,24366,23982,384,1.6,1196
2021-10-05,25626,24539,1087,4.43,1196
2021-10-06,25626,24574,1052,4.28,1196
2021-10-07,25626,24590,1036,4.21,1196
2021-10-08,26039,25354,685,2.7,1196
2021-10-09,20228,19076,1152,6.04,1196
2021-10-10,14681,13950,731,5.24,1196
2021-10-11,24366,24159,207,0.86,1196
2021-10-12,25626,24692,934,3.78,1196
2021-10-13,25626,24700,926,3.75,1196
2021-10-14,25626,24687,939,3.8,1196
2021-10-15,26039,25422,617,2.43,1196
2021-10-16,20228,19114,1114,5.83,1196
2021-10-17,14681,13960,721,5.16,1196
2021-10-18,24366,24143,223,0.92,1196
2021-10-19,25626,24651,975,3.96,1196
2021-10-20,25626,24639,987,4.01,1196
2021-10-21,25626,24609,1017,4.13,1196
2021-10-22,26039,25331,708,2.79,1196
2021-10-23,20228,19016,1212,6.37,1196
2021-10-24,14681,13859,822,5.93,1196
2021-10-25,24366,24045,321,1.33,1196
2021-10-26,25626,24561,1065,4.34,1196
2021-10-27,25626,24560,1066,4.34,1196
2021-10-28,25626,24547,1079,4.4,1196
2021-10-29,26039,25289,750,2.97,1196
2021-10-30,20228,18997,1231,6.48,1196
2021-10-31,14681,13865,816,5.89,1196
2021-11-01,21953,24076,-2123,-8.82,1196
2021-11-02,23977,24618,-641,-2.6,1196
2021-11-03,23977,24643,-666,-2.7,1196
2021-11-04,23977,24653,-676,-2.74,1196
2021-11-05,25356,25416,-60,-0.24,1196
2021-11-06,18649,19140,-491,-2.57,1196
2021-11-07,13920,14022,-102,-0.73,1196
2021-11-08,21953,24241,-2288,-9.44,1196
2021-11-09,23977,24786,-809,-3.26,1196
2021-11-10,23977,24809,-832,-3.35,1196
2021-11-11,23977,24812,-835,-3.37,1196
2021-11-12,25356,25561,-205,-0.8,1196
2021-11-13,18649,19267,-618,-3.21,1196
2021-11-14,13920,14125,-205,-1.45,1196
2021-11-15,21953,24317,-2364,-9.72,1196
2021-11-16,23977,24831,-854,-3.44,1196
2021-11-17,23977,24820,-843,-3.4,1196
2021-11-18,23977,24786,-809,-3.26,1196
2021-11-19,25356,25499,-143,-0.56,1196
2021-11-20,18649,19169,-520,-2.71,1196
2021-11-21,13920,13992,-72,-0.51,1196
2021-11-22,21953,24151,-2198,-9.1,1196
2021-11-23,23977,24635,-658,-2.67,1196
2021-11-24,23977,24599,-622,-2.53,1196
2021-11-25,23977,24545,-568,-2.31,1196
2021-11-26,25356,25243,113,0.45,1196
2021-11-27,18649,18904,-255,-1.35,1196
2021-11-28,13920,13724,196,1.43,1196
2021-11-29,21953,23886,-1933,-8.09,1196
2021-11-30,23977,24381,-404,-1.66,1196
2021-12-01,22280,24360,-2080,-8.54,1196
2021-12-02,22280,24327,-2047,-8.41,1196
2021-12-03,21000,25050,-4050,-16.17,1196
2021-12-04,16595,18741,-2146,-11.45,1196
2021-12-05,12304,13593,-1289,-9.48,1196
2021-12-06,22790,23789,-999,-4.2,1196
2021-12-07,22280,24317,-2037,-8.38,1196
2021-12-08,22280,24330,-2050,-8.43,1196
2021-12-09,22280,24328,-2048,-8.42,1196
2021-12-10,21000,25080,-4080,-16.27,1196
2021-12-11,16595,18794,-2199,-11.7,1196
2021-12-12,12304,13664,-1360,-9.95,1196
2021-12-13,22790,23872,-1082,-4.53,1196
2021-12-14,22280,24404,-2124,-8.7,1196
2021-12-15,22280,24413,-2133,-8.74,1196
2021-12-16,22280,24400,-2120,-8.69,1196
2021-12-17,21000,25131,-4131,-16.44,1196
2021-12-18,16595,18816,-2221,-11.8,1196
2021-12-19,12304,13650,-1346,-9.86,1196
2021-12-20,22790,23813,-1023,-4.3,1196
2021-12-21,22280,24295,-2015,-8.29,1196
2021-12-22,22280,24247,-1967,-8.11,1196
2021-12-23,22280,24172,-1892,-7.83,1196
2021-12-24,21000,24839,-3839,-15.46,1196
2021-12-25,16595,18457,-1862,-10.09,1196
2021-12-26,12304,13224,-920,-6.96,1196
2021-12-27,22790,23321,-531,-2.28,1196
2021-12-28,22280,23740,-1460,-6.15,1196
2021-12-29,22280,23633,-1353,-5.73,1196
2021-12-30,22280,23504,-1224,-5.21,1196
2021-12-31,21000,24124,-3124,-12.95,1196
2022-01-01,17069,17705,-636,-3.59,1196
2022-01-02,11975,12442,-467,-3.75,1196
2022-01-03,21158,22521,-1363,-6.05,1196
2022-01-04,21503,22931,-1428,-6.23,1196
2022-01-05,21503,22826,-1323,-5.8,1196
2022-01-06,21503,22712,-1209,-5.32,1196
2022-01-07,22504,23357,-853,-3.65,1196
2022-01-08,17069,16972,97,0.57,1196
2022-01-09,11975,11755,220,1.87,1196
2022-01-10,21158,21888,-730,-3.34,1196
2022-01-11,21503,22360,-857,-3.83,1196
2022-01-12,21503,22325,-822,-3.68,1196
2022-01-13,21503,22284,-781,-3.5,1196
2022-01-14,22504,23006,-502,-2.18,1196
2022-01-15,17069,16702,367,2.2,1196
2022-01-16,11975,11565,410,3.55,1196
2022-01-17,21158,21777,-619,-2.84,1196
2022-01-18,21503,22326,-823,-3.69,1196
2022-01-19,21503,22363,-860,-3.85,1196
2022-01-20,21503,22390,-887,-3.96,1196
2022-01-21,22504,23174,-670,-2.89,1196
2022-01-22,17069,16923,146,0.86,1196
2022-01-23,11975,11832,143,1.21,1196
2022-01-24,21158,22081,-923,-4.18,1196
2022-01-25,21503,22658,-1155,-5.1,1196
2022-01-26,21503,22714,-1211,-5.33,1196
2022-01-27,21503,22751,-1248,-5.49,1196
2022-01-28,22504,23537,-1033,-4.39,1196
2022-01-29,17069,17280,-211,-1.22,1196
2022-01-30,11975,12176,-201,-1.65,1196
2020-02-01,17071,15885,1186,7.47,1197
2020-02-02,11356,9755,1601,16.41,1197
2020-02-03,17460,17407,53,0.3,1197
2020-02-04,17281,17229,52,0.3,1197
2020-02-05,17281,17242,39,0.23,1197
2020-02-06,17281,17252,29,0.17,1197
2020-02-07,18658,18482,176,0.95,1197
2020-02-08,17071,15965,1106,6.93,1197
2020-02-09,11356,9817,1539,15.68,1197
2020-02-10,17460,17456,4,0.02,1197
2020-02-11,17281,17268,13,0.08,1197
2020-02-12,17281,17277,4,0.02,1197
2020-02-13,17281,17288,-7,-0.04,1197
2020-02-14,18658,18522,136,0.73,1197
2020-02-15,17071,16015,1056,6.59,1197
2020-02-16,11356,9882,1474,14.92,1197
2020-02-17,17460,17539,-79,-0.45,1197
2020-02-18,17281,17373,-92,-0.53,1197
2020-02-19,17281,17407,-126,-0.72,1197
2020-02-20,17281,17444,-163,-0.93,1197
2020-02-21,18658,18707,-49,-0.26,1197
2020-02-22,17071,16228,843,5.19,1197
2020-02-23,11356,10123,1233,12.18,1197
2020-02-24,17460,17807,-347,-1.95,1197
2020-02-25,17281,17666,-385,-2.18,1197
2020-02-26,17281,17722,-441,-2.49,1197
2020-02-27,17281,17778,-497,-2.8,1197
2020-02-28,18658,19055,-397,-2.08,1197
2020-02-29,17071,16587,484,2.92,1197
2020-03-01,7360,10487,-3127,-29.82,1197
2020-03-02,12811,18171,-5360,-29.5,1197
2020-03-03,12564,18026,-5462,-30.3,1197
2020-03-04,12564,18073,-5509,-30.48,1197
2020-03-05,12564,18115,-5551,-30.64,1197
2020-03-06,13415,19375,-5960,-30.76,1197
2020-03-07,10911,16885,-5974,-35.38,1197
2020-03-08,7360,10762,-3402,-31.61,1197
2020-03-09,12811,18421,-5610,-30.45,1197
2020-03-10,12564,18248,-5684,-31.15,1197
2020-03-11,12564,18267,-5703,-31.22,1197
2020-03-12,12564,18282,-5718,-31.28,1197
2020-03-13,13415,19516,-6101,-31.26,1197
2020-03-14,10911,17002,-6091,-35.83,1197
2020-03-15,7360,10857,-3497,-32.21,1197
2020-03-16,12811,18497,-5686,-30.74,1197
2020-03-17,12564,18310,-5746,-31.38,1197
2020-03-18,12564,18318,-5754,-31.41,1197
2020-03-19,12564,18327,-5763,-31.45,1197
2020-03-20,13415,19559,-6144,-31.41,1197
2020-03-21,10911,17048,-6137,-36.0,1197
2020-03-22,7360,10911,-3551,-32.55,1197
2020-03-23,12811,18562,-5751,-30.98,1197
2020-03-24,12564,18390,-5826,-31.68,1197
2020-03-25,12564,18417,-5853,-31.78,1197
2020-03-26,12564,18447,-5883,-31.89,1197
2020-03-27,13415,19701,-6286,-31.91,1197
2020-03-28,10911,17214,-6303,-36.62,1197
2020-03-29,7360,11101,-3741,-33.7,1197
2020-03-30,12811,18776,-5965,-31.77,1197
2020-03-31,12564,18627,-6063,-32.55,1197
2020-04-01,11608,18674,-7066,-37.84,1197
2020-04-02,11608,18722,-7114,-38.0,1197
2020-04-03,11142,19991,-8849,-44.26,1197
2020-04-04,9484,17516,-8032,-45.86,1197
2020-04-05,4977,11409,-6432,-56.38,1197
2020-04-06,11286,19087,-7801,-40.87,1197
2020-04-07,11608,18935,-7327,-38.7,1197
2020-04-08,11608,18976,-7368,-38.83,1197
2020-04-09,11608,19012,-7404,-38.94,1197
2020-04-10,11142,20266,-9124,-45.02,1197
2020-04-11,9484,17771,-8287,-46.63,1197
2020-04-12,4977,11642,-6665,-57.25,1197
2020-04-13,11286,19294,-8008,-41.51,1197
2020-04-14,11608,19115,-7507,-39.27,1197
2020-04-15,11608,19126,-7518,-39.31,1197
2020-04-16,11608,19132,-7524,-39.33,1197
2020-04-17,11142,20356,-9214,-45.26,1197
2020-04-18,9484,17832,-8348,-46.81,1197
2020-04-19,4977,11674,-6697,-57.37,1197
2020-04-20,11286,19301,-8015,-41.53,1197
2020-04-21,11608,19098,-7490,-39.22,1197
2020-04-22,11608,19089,-7481,-39.19,1197
2020-04-23,11608,19080,-7472,-39.16,1197
2020-04-24,11142,20291,-9149,-45.09,1197
2020-04-25,9484,17758,-8274,-46.59,1197
2020-04-26,4977,11596,-6619,-57.08,1197
2020-04-27,11286,19222,-7936,-41.29,1197
2020-04-28,11608,19022,-7414,-38.98,1197
2020-04-29,11608,19020,-7412,-38.97,1197
2020-04-30,11608,19019,-7411,-38.97,1197
2020-05-01,18544,20243,-1699,-8.39,1197
2020-05-02,16797,17723,-926,-5.22,1197
2020-05-03,9691,11576,-1885,-16.28,1197
2020-05-04,16892,19218,-2326,-12.1,1197
2020-05-05,16894,19034,-2140,-11.24,1197
2020-05-06,16894,19047,-2153,-11.3,1197
2020-05-07,16894,19060,-2166,-11.36,1197
2020-05-08,18544,20295,-1751,-8.63,1197
2020-05-09,16797,17785,-988,-5.56,1197
2020-05-10,9691,11645,-1954,-16.78,1197
2020-05-11,16892,19291,-2399,-12.44,1197
2020-05-12,16894,19108,-2214,-11.59,1197
2020-05-13,16894,19118,-2224,-11.63,1197
2020-05-14,16894,19125,-2231,-11.67,1197
2020-05-15,18544,20351,-1807,-8.88,1197
2020-05-16,16797,17830,-1033,-5.79,1197
2020-05-17,9691,11676,-1985,-17.0,1197
2020-05-18,16892,19305,-2413,-12.5,1197
2020-05-19,16894,19104,-2210,-11.57,1197
2020-05-20,16894,19095,-2201,-11.53,1197
2020-05-21,16894,19083,-2189,-11.47,1197
2020-05-22,18544,20291,-1747,-8.61,1197
2020-05-23,16797,17751,-954,-5.37,1197
2020-05-24,9691,11580,-1889,-16.31,1197
2020-05-25,16892,19195,-2303,-12.0,1197
2020-05-26,16894,18982,-2088,-11.0,1197
2020-05-27,16894,18964,-2070,-10.92,1197
2020-05-28,16894,18946,-2052,-10.83,1197
2020-05-29,18544,20150,-1606,-7.97,1197
2020-05-30,16797,17611,-814,-4.62,1197
2020-05-31,9691,11445,-1754,-15.33,1197
2020-06-01,17488,19066,-1578,-8.28,1197
2020-06-02,19199,18863,336,1.78,1197
2020-06-03,19199,18857,342,1.81,1197
2020-06-04,19199,18854,345,1.83,1197
2020-06-05,18916,20074,-1158,-5.77,1197
2020-06-06,19522,17552,1970,11.22,1197
2020-06-07,10885,11401,-516,-4.53,1197
2020-06-08,17488,19039,-1551,-8.15,1197
2020-06-09,19199,18850,349,1.85,1197
2020-06-10,19199,18857,342,1.81,1197
2020-06-11,19199,18864,335,1.78,1197
2020-06-12,18916,20091,-1175,-5.85,1197
2020-06-13,19522,17572,1950,11.1,1197
2020-06-14,10885,11421,-536,-4.69,1197
2020-06-15,17488,19053,-1565,-8.21,1197
2020-06-16,19199,18855,344,1.82,1197
2020-06-17,19199,18848,351,1.86,1197
2020-06-18,19199,18837,362,1.92,1197
2020-06-19,18916,20042,-1126,-5.62,1197
2020-06-20,19522,17496,2026,11.58,1197
2020-06-21,10885,11316,-431,-3.81,1197
2020-06-22,17488,18917,-1429,-7.55,1197
2020-06-23,19199,18686,513,2.75,1197
2020-06-24,19199,18645,554,2.97,1197
2020-06-25,19199,18599,600,3.23,1197
2020-06-26,18916,19771,-855,-4.32,1197
2020-06-27,19522,17194,2328,13.54,1197
2020-06-28,10885,10985,-100,-0.91,1197
2020-06-29,17488,18560,-1072,-5.78,1197
2020-06-30,19199,18308,891,4.87,1197
2020-07-01,18584,18250,334,1.83,1197
2020-07-02,18584,18192,392,2.15,1197
2020-07-03,19159,19357,-198,-1.02,1197
2020-07-04,17378,16780,598,3.56,1197
2020-07-05,12237,10576,1661,15.71,1197
2020-07-06,17465,18162,-697,-3.84,1197
2020-07-07,18584,17926,658,3.67,1197
2020-07-08,18584,17889,695,3.89,1197
2020-07-09,18584,17857,727,4.07,1197
2020-07-10,19159,19052,107,0.56,1197
2020-07-11,17378,16507,871,5.28,1197
2020-07-12,12237,10338,1899,18.37,1197
2020-07-13,17465,17959,-494,-2.75,1197
2020-07-14,18584,17758,826,4.65,1197
2020-07-15,18584,17756,828,4.66,1197
2020-07-16,18584,17757,827,4.66,1197
2020-07-17,19159,18981,178,0.94,1197
2020-07-18,17378,16461,917,5.57,1197
2020-07-19,12237,10313,1924,18.66,1197
2020-07-20,17465,17950,-485,-2.7,1197
2020-07-21,18584,17759,825,4.65,1197
2020-07-22,18584,17760,824,4.64,1197
2020-07-23,18584,17758,826,4.65,1197
2020-07-24,19159,18973,186,0.98,1197
2020-07-25,17378,16438,940,5.72,1197
2020-07-26,12237,10269,1968,19.16,1197
2020-07-27,17465,17880,-415,-2.32,1197
2020-07-28,18584,17658,926,5.24,1197
2020-07-29,18584,17626,958,5.44,1197
2020-07-30,18584,17588,996,5.66,1197
2020-07-31,19159,18765,394,2.1,1197
2020-08-01,18806,16192,2614,16.14,1197
2020-08-02,12100,9986,2114,21.17,1197
2020-08-03,17118,17562,-444,-2.53,1197
2020-08-04,17592,17309,283,1.63,1197
2020-08-05,17592,17250,342,1.98,1197
2020-08-06,17592,17190,402,2.34,1197
2020-08-07,18595,18352,243,1.32,1197
2020-08-08,18806,15771,3035,19.24,1197
2020-08-09,12100,9564,2536,26.52,1197
2020-08-10,17118,17148,-30,-0.17,1197
2020-08-11,17592,16911,681,4.03,1197
2020-08-12,17592,16876,716,4.24,1197
2020-08-13,17592,16848,744,4.42,1197
2020-08-14,18595,18050,545,3.02,1197
2020-08-15,18806,15516,3290,21.2,1197
2020-08-16,12100,9362,2738,29.25,1197
2020-08-17,17118,17005,113,0.66,1197
2020-08-18,17592,16830,762,4.53,1197
2020-08-19,17592,16860,732,4.34,1197
2020-08-20,17592,16899,693,4.1,1197
2020-08-21,18595,18168,427,2.35,1197
2020-08-22,18806,15701,3105,19.78,1197
2020-08-23,12100,9611,2489,25.9,1197
2020-08-24,17118,17313,-195,-1.13,1197
2020-08-25,17592,17194,398,2.31,1197
2020-08-26,17592,17273,319,1.85,1197
2020-08-27,17592,17354,238,1.37,1197
2020-08-28,18595,18659,-64,-0.34,1197
2020-08-29,18806,16218,2588,15.96,1197
2020-08-30,12100,10146,1954,19.26,1197
2020-08-31,17118,17858,-740,-4.14,1197
2020-09-01,18405,17739,666,3.75,1197
2020-09-02,18405,17811,594,3.34,1197
2020-09-03,18405,17877,528,2.95,1197
2020-09-04,19242,19158,84,0.44,1197
2020-09-05,17650,16688,962,5.76,1197
2020-09-06,11802,10581,1221,11.54,1197
2020-09-07,18123,18253,-130,-0.71,1197
2020-09-08,18405,18092,313,1.73,1197
2020-09-09,18405,18118,287,1.58,1197
2020-09-10,18405,18138,267,1.47,1197
2020-09-11,19242,19373,-131,-0.68,1197
2020-09-12,17650,16858,792,4.7,1197
2020-09-13,11802,10709,1093,10.21,1197
2020-09-14,18123,18343,-220,-1.2,1197
2020-09-15,18405,18147,258,1.42,1197
2020-09-16,18405,18144,261,1.44,1197
2020-09-17,18405,18140,265,1.46,1197
2020-09-18,19242,19357,-115,-0.59,1197
2020-09-19,17650,16831,819,4.87,1197
2020-09-20,11802,10676,1126,10.55,1197
2020-09-21,18123,18309,-186,-1.02,1197
2020-09-22,18405,18119,286,1.58,1197
2020-09-23,18405,18127,278,1.53,1197
2020-09-24,18405,18138,267,1.47,1197
2020-09-25,19242,19374,-132,-0.68,1197
2020-09-26,17650,16869,781,4.63,1197
2020-09-27,11802,10738,1064,9.91,1197
2020-09-28,18123,18396,-273,-1.48,1197
2020-09-29,18405,18230,175,0.96,1197
2020-09-30,18405,18262,143,0.78,1197
2020-10-01,17963,18295,-332,-1.81,1197
2020-10-02,18833,19550,-717,-3.67,1197
2020-10-03,16370,17061,-691,-4.05,1197
2020-10-04,10644,10943,-299,-2.73,1197
2020-10-05,17832,18609,-777,-4.18,1197
2020-10-06,17963,18447,-484,-2.62,1197
2020-10-07,17963,18477,-514,-2.78,1197
2020-10-08,17963,18505,-542,-2.93,1197
2020-10-09,18833,19750,-917,-4.64,1197
2020-10-10,16370,17246,-876,-5.08,1197
2020-10-11,10644,11109,-465,-4.19,1197
2020-10-12,17832,18754,-922,-4.92,1197
2020-10-13,17963,18568,-605,-3.26,1197
2020-10-14,17963,18573,-610,-3.28,1197
2020-10-15,17963,18574,-611,-3.29,1197
2020-10-16,18833,19793,-960,-4.85,1197
2020-10-17,16370,17263,-893,-5.17,1197
2020-10-18,10644,11101,-457,-4.12,1197
2020-10-19,17832,18724,-892,-4.76,1197
2020-10-20,17963,18519,-556,-3.0,1197
2020-10-21,17963,18508,-545,-2.94,1197
2020-10-22,17963,18497,-534,-2.89,1197
2020-10-23,18833,19708,-875,-4.44,1197
2020-10-24,16370,17175,-805,-4.69,1197
2020-10-25,10644,11015,-371,-3.37,1197
2020-10-26,17832,18643,-811,-4.35,1197
2020-10-27,17963,18448,-485,-2.63,1197
2020-10-28,17963,18450,-487,-2.64,1197
2020-10-29,17963,18456,-493,-2.67,1197
2020-10-30,18833,19686,-853,-4.33,1197
2020-10-31,16370,17175,-805,-4.69,1197
2020-11-01,8316,11037,-2721,-24.65,1197
2020-11-02,16819,18688,-1869,-10.0,1197
2020-11-03,14176,18515,-4339,-23.44,1197
2020-11-04,14176,18538,-4362,-23.53,1197
2020-11-05,14176,18562,-4386,-23.63,1197
2020-11-06,15530,19809,-4279,-21.6,1197
2020-11-07,12878,17310,-4432,-25.6,1197
2020-11-08,8316,11180,-2864,-25.62,1197
2020-11-09,16819,18835,-2016,-10.7,1197
2020-11-10,14176,18661,-4485,-24.03,1197
2020-11-11,14176,18678,-4502,-24.1,1197
2020-11-12,14176,18692,-4516,-24.16,1197
2020-11-13,15530,19923,-4393,-22.05,1197
2020-11-14,12878,17404,-4526,-26.01,1197
2020-11-15,8316,11251,-2935,-26.09,1197
2020-11-16,16819,18880,-2061,-10.92,1197
2020-11-17,14176,18676,-4500,-24.1,1197
2020-11-18,14176,18662,-4486,-24.04,1197
2020-11-19,14176,18644,-4468,-23.96,1197
2020-11-20,15530,19842,-4312,-21.73,1197
2020-11-21,12878,17292,-4414,-25.53,1197
2020-11-22,8316,11109,-2793,-25.14,1197
2020-11-23,16819,18710,-1891,-10.11,1197
2020-11-24,14176,18482,-4306,-23.3,1197
2020-11-25,14176,18448,-4272,-23.16,1197
2020-11-26,14176,18414,-4238,-23.02,1197
2020-11-27,15530,19601,-4071,-20.77,1197
2020-11-28,12878,17046,-4168,-24.45,1197
2020-11-29,8316,10862,-2546,-23.44,1197
2020-11-30,16819,18468,-1649,-8.93,1197
2020-12-01,15854,18250,-2396,-13.13,1197
2020-12-02,15854,18231,-2377,-13.04,1197
2020-12-03,15854,18216,-2362,-12.97,1197
2020-12-04,17456,19426,-1970,-10.14,1197
2020-12-05,14510,16895,-2385,-14.12,1197
2020-12-06,8661,10739,-2078,-19.35,1197
2020-12-07,17037,18373,-1336,-7.27,1197
2020-12-08,15854,18183,-2329,-12.81,1197
2020-12-09,15854,18191,-2337,-12.85,1197
2020-12-10,15854,18200,-2346,-12.89,1197
2020-12-11,17456,19431,-1975,-10.16,1197
2020-12-12,14510,16918,-2408,-14.23,1197
2020-12-13,8661,10775,-2114,-19.62,1197
2020-12-14,17037,18415,-1378,-7.48,1197
2020-12-15,15854,18227,-2373,-13.02,1197
2020-12-16,15854,18229,-2375,-13.03,1197
2020-12-17,15854,18227,-2373,-13.02,1197
2020-12-18,17456,19440,-1984,-10.21,1197
2020-12-19,14510,16902,-2392,-14.15,1197
2020-12-20,8661,10728,-2067,-19.27,1197
2020-12-21,17037,18333,-1296,-7.07,1197
2020-12-22,15854,18104,-2250,-12.43,1197
2020-12-23,15854,18062,-2208,-12.22,1197
2020-12-24,15854,18012,-2158,-11.98,1197
2020-12-25,17456,19177,-1721,-8.97,1197
2020-12-26,14510,16589,-2079,-12.53,1197
2020-12-27,8661,10366,-1705,-16.45,1197
2020-12-28,17037,17924,-887,-4.95,1197
2020-12-29,15854,17650,-1796,-10.18,1197
2020-12-30,15854,17568,-1714,-9.76,1197
2020-12-31,15854,17484,-1630,-9.32,1197
2021-01-01,14417,18620,-4203,-22.57,1197
2021-01-02,10974,16011,-5037,-31.46,1197
2021-01-03,7095,9773,-2678,-27.4,1197
2021-01-04,13317,17325,-4008,-23.13,1197
2021-01-05,13609,17054,-3445,-20.2,1197
2021-01-06,13609,16983,-3374,-19.87,1197
2021-01-07,13609,16918,-3309,-19.56,1197
2021-01-08,14417,18081,-3664,-20.26,1197
2021-01-09,10974,15507,-4533,-29.23,1197
2021-01-10,7095,9312,-2217,-23.81,1197
2021-01-11,13317,16911,-3594,-21.25,1197
2021-01-12,13609,16693,-3084,-18.47,1197
2021-01-13,13609,16678,-3069,-18.4,1197
2021-01-14,13609,16673,-3064,-18.38,1197
2021-01-15,14417,17897,-3480,-19.44,1197
2021-01-16,10974,15384,-4410,-28.67,1197
2021-01-17,7095,9249,-2154,-23.29,1197
2021-01-18,13317,16906,-3589,-21.23,1197
2021-01-19,13609,16743,-3134,-18.72,1197
2021-01-20,13609,16779,-3170,-18.89,1197
2021-01-21,13609,16819,-3210,-19.09,1197
2021-01-22,14417,18083,-3666,-20.27,1197
2021-01-23,10974,15603,-4629,-29.67,1197
2021-01-24,7095,9494,-2399,-25.27,1197
2021-01-25,13317,17171,-3854,-22.44,1197
2021-01-26,13609,17020,-3411,-20.04,1197
2021-01-27,13609,17062,-3453,-20.24,1197
2021-01-28,13609,17101,-3492,-20.42,1197
2021-01-29,14417,18358,-3941,-21.47,1197
2021-01-30,10974,15867,-4893,-30.84,1197
2021-01-31,7095,9741,-2646,-27.16,1197
2021-02-01,16821,17399,-578,-3.32,1197
2021-02-02,16487,17225,-738,-4.28,1197
2021-02-03,16487,17242,-755,-4.38,1197
2021-02-04,16487,17256,-769,-4.46,1197
2021-02-05,17515,18488,-973,-5.26,1197
2021-02-06,14823,15973,-1150,-7.2,1197
2021-02-07,9189,9827,-638,-6.49,1197
2021-02-08,16821,17465,-644,-3.69,1197
2021-02-09,16487,17277,-790,-4.57,1197
2021-02-10,16487,17284,-797,-4.61,1197
2021-02-11,16487,17292,-805,-4.66,1197
2021-02-12,17515,18523,-1008,-5.44,1197
2021-02-13,14823,16012,-1189,-7.43,1197
2021-02-14,9189,9874,-685,-6.94,1197
2021-02-15,16821,17526,-705,-4.02,1197
2021-02-16,16487,17355,-868,-5.0,1197
2021-02-17,16487,17383,-896,-5.15,1197
2021-02-18,16487,17415,-928,-5.33,1197
2021-02-19,17515,18673,-1158,-6.2,1197
2021-02-20,14823,16189,-1366,-8.44,1197
2021-02-21,9189,10080,-891,-8.84,1197
2021-02-22,16821,17760,-939,-5.29,1197
2021-02-23,16487,17617,-1130,-6.41,1197
2021-02-24,16487,17670,-1183,-6.69,1197
2021-02-25,16487,17725,-1238,-6.98,1197
2021-02-26,17515,19002,-1487,-7.83,1197
2021-02-27,14823,16534,-1711,-10.35,1197
2021-02-28,9189,10436,-1247,-11.95,1197
2021-03-01,17876,18123,-247,-1.36,1197
2021-03-02,17667,17981,-314,-1.75,1197
2021-03-03,17667,18031,-364,-2.02,1197
2021-03-04,17667,18078,-411,-2.27,1197
2021-03-05,18298,19343,-1045,-5.4,1197
2021-03-06,16241,16859,-618,-3.67,1197
2021-03-07,9665,10740,-1075,-10.01,1197
2021-03-08,17876,18404,-528,-2.87,1197
2021-03-09,17667,18237,-570,-3.13,1197
2021-03-10,17667,18260,-593,-3.25,1197
2021-03-11,17667,18280,-613,-3.35,1197
2021-03-12,18298,19517,-1219,-6.25,1197
2021-03-13,16241,17006,-765,-4.5,1197
2021-03-14,9665,10863,-1198,-11.03,1197
2021-03-15,17876,18505,-629,-3.4,1197
2021-03-16,17667,18318,-651,-3.55,1197
2021-03-17,17667,18326,-659,-3.6,1197
2021-03-18,17667,18333,-666,-3.63,1197
2021-03-19,18298,19563,-1265,-6.47,1197
2021-03-20,16241,17049,-808,-4.74,1197
2021-03-21,9665,10908,-1243,-11.4,1197
2021-03-22,17876,18556,-680,-3.66,1197
2021-03-23,17667,18380,-713,-3.88,1197
2021-03-24,17667,18402,-735,-3.99,1197
2021-03-25,17667,18427,-760,-4.12,1197
2021-03-26,18298,19677,-1379,-7.01,1197
2021-03-27,16241,17186,-945,-5.5,1197
2021-03-28,9665,11068,-1403,-12.68,1197
2021-03-29,17876,18740,-864,-4.61,1197
2021-03-30,17667,18588,-921,-4.95,1197
2021-03-31,17667,18633,-966,-5.18,1197
2021-04-01,15197,18679,-3482,-18.64,1197
2021-04-02,16038,19948,-3910,-19.6,1197
2021-04-03,12698,17472,-4774,-27.32,1197
2021-04-04,8808,11367,-2559,-22.51,1197
2021-04-05,15422,19047,-3625,-19.03,1197
2021-04-06,15197,18898,-3701,-19.58,1197
2021-04-07,15197,18942,-3745,-19.77,1197
2021-04-08,15197,18983,-3786,-19.94,1197
2021-04-09,16038,20242,-4204,-20.77,1197
2021-04-10,12698,17752,-5054,-28.47,1197
2021-04-11,8808,11628,-2820,-24.25,1197
2021-04-12,15422,19286,-3864,-20.04,1197
2021-04-13,15197,19112,-3915,-20.48,1197
2021-04-14,15197,19129,-3932,-20.56,1197
2021-04-15,15197,19140,-3943,-20.6,1197
2021-04-16,16038,20369,-4331,-21.26,1197
2021-04-17,12698,17849,-5151,-28.86,1197
2021-04-18,8808,11695,-2887,-24.69,1197
2021-04-19,15422,19325,-3903,-20.2,1197
2021-04-20,15197,19125,-3928,-20.54,1197
2021-04-21,15197,19118,-3921,-20.51,1197
2021-04-22,15197,19109,-3912,-20.47,1197
2021-04-23,16038,20320,-4282,-21.07,1197
2021-04-24,12698,17786,-5088,-28.61,1197
2021-04-25,8808,11623,-2815,-24.22,1197
2021-04-26,15422,19247,-3825,-19.87,1197
2021-04-27,15197,19046,-3849,-20.21,1197
2021-04-28,15197,19041,-3844,-20.19,1197
2021-04-29,15197,19037,-3840,-20.17,1197
2021-04-30,16038,20257,-4219,-20.83,1197
2021-05-01,17273,17735,-462,-2.61,1197
2021-05-02,10333,11585,-1252,-10.81,1197
2021-05-03,19698,19224,474,2.47,1197
2021-05-04,19231,19038,193,1.01,1197
2021-05-05,19231,19049,182,0.96,1197
2021-05-06,19231,19061,170,0.89,1197
2021-05-07,19454,20295,-841,-4.14,1197
2021-05-08,17273,17785,-512,-2.88,1197
2021-05-09,10333,11645,-1312,-11.27,1197
2021-05-10,19698,19292,406,2.1,1197
2021-05-11,19231,19110,121,0.63,1197
2021-05-12,19231,19122,109,0.57,1197
2021-05-13,19231,19133,98,0.51,1197
2021-05-14,19454,20362,-908,-4.46,1197
2021-05-15,17273,17843,-570,-3.19,1197
2021-05-16,10333,11693,-1360,-11.63,1197
2021-05-17,19698,19326,372,1.92,1197
2021-05-18,19231,19128,103,0.54,1197
2021-05-19,19231,19123,108,0.56,1197
2021-05-20,19231,19114,117,0.61,1197
2021-05-21,19454,20325,-871,-4.29,1197
2021-05-22,17273,17787,-514,-2.89,1197
2021-05-23,10333,11618,-1285,-11.06,1197
2021-05-24,19698,19234,464,2.41,1197
2021-05-25,19231,19022,209,1.1,1197
2021-05-26,19231,19004,227,1.19,1197
2021-05-27,19231,18985,246,1.3,1197
2021-05-28,19454,20189,-735,-3.64,1197
2021-05-29,17273,17648,-375,-2.12,1197
2021-05-30,10333,11478,-1145,-9.98,1197
2021-05-31,19698,19097,601,3.15,1197
2021-06-01,19540,18891,649,3.44,1197
2021-06-02,19540,18882,658,3.48,1197
2021-06-03,19540,18876,664,3.52,1197
2021-06-04,20037,20093,-56,-0.28,1197
2021-06-05,16895,17567,-672,-3.83,1197
2021-06-06,12176,11414,762,6.68,1197
2021-06-07,18962,19050,-88,-0.46,1197
2021-06-08,19540,18860,680,3.61,1197
2021-06-09,19540,18866,674,3.57,1197
2021-06-10,19540,18873,667,3.53,1197
2021-06-11,20037,20101,-64,-0.32,1197
2021-06-12,16895,17583,-688,-3.91,1197
2021-06-13,12176,11434,742,6.49,1197
2021-06-14,18962,19070,-108,-0.57,1197
2021-06-15,19540,18876,664,3.52,1197
2021-06-16,19540,18874,666,3.53,1197
2021-06-17,19540,18868,672,3.56,1197
2021-06-18,20037,20078,-41,-0.2,1197
2021-06-19,16895,17539,-644,-3.67,1197
2021-06-20,12176,11366,810,7.13,1197
2021-06-21,18962,18973,-11,-0.06,1197
2021-06-22,19540,18748,792,4.22,1197
2021-06-23,19540,18713,827,4.42,1197
2021-06-24,19540,18673,867,4.64,1197
2021-06-25,20037,19849,188,0.95,1197
2021-06-26,16895,17277,-382,-2.21,1197
2021-06-27,12176,11071,1105,9.98,1197
2021-06-28,18962,18649,313,1.68,1197
2021-06-29,19540,18397,1143,6.21,1197
2021-06-30,19540,18339,1201,6.55,1197
2021-07-01,17508,18281,-773,-4.23,1197
2021-07-02,18282,19444,-1162,-5.98,1197
2021-07-03,15598,16864,-1266,-7.51,1197
2021-07-04,10851,10656,195,1.83,1197
2021-07-05,18000,18238,-238,-1.3,1197
2021-07-06,17508,17996,-488,-2.71,1197
2021-07-07,17508,17953,-445,-2.48,1197
2021-07-08,17508,17915,-407,-2.27,1197
2021-07-09,18282,19103,-821,-4.3,1197
2021-07-10,15598,16551,-953,-5.76,1197
2021-07-11,10851,10375,476,4.59,1197
2021-07-12,18000,17991,9,0.05,1197
2021-07-13,17508,17784,-276,-1.55,1197
2021-07-14,17508,17777,-269,-1.51,1197
2021-07-15,17508,17773,-265,-1.49,1197
2021-07-16,18282,18995,-713,-3.75,1197
2021-07-17,15598,16473,-875,-5.31,1197
2021-07-18,10851,10324,527,5.1,1197
2021-07-19,18000,17961,39,0.22,1197
2021-07-20,17508,17771,-263,-1.48,1197
2021-07-21,17508,17775,-267,-1.5,1197
2021-07-22,17508,17777,-269,-1.51,1197
2021-07-23,18282,18997,-715,-3.76,1197
2021-07-24,15598,16468,-870,-5.28,1197
2021-07-25,10851,10305,546,5.3,1197
2021-07-26,18000,17923,77,0.43,1197
2021-07-27,17508,17708,-200,-1.13,1197
2021-07-28,17508,17683,-175,-0.99,1197
2021-07-29,17508,17652,-144,-0.82,1197
2021-07-30,18282,18836,-554,-2.94,1197
2021-07-31,15598,16269,-671,-4.12,1197
2021-08-01,10679,10068,611,6.07,1197
2021-08-02,17508,17649,-141,-0.8,1197
2021-08-03,16947,17399,-452,-2.6,1197
2021-08-04,16947,17341,-394,-2.27,1197
2021-08-05,16947,17282,-335,-1.94,1197
2021-08-06,17560,18443,-883,-4.79,1197
2021-08-07,15028,15860,-832,-5.25,1197
2021-08-08,10679,9649,1030,10.67,1197
2021-08-09,17508,17227,281,1.63,1197
2021-08-10,16947,16982,-35,-0.21,1197
2021-08-11,16947,16939,8,0.05,1197
2021-08-12,16947,16901,46,0.27,1197
2021-08-13,17560,18092,-532,-2.94,1197
2021-08-14,15028,15547,-519,-3.34,1197
2021-08-15,10679,9381,1298,13.84,1197
2021-08-16,17508,17011,497,2.92,1197
2021-08-17,16947,16824,123,0.73,1197
2021-08-18,16947,16841,106,0.63,1197
2021-08-19,16947,16869,78,0.46,1197
2021-08-20,17560,18127,-567,-3.13,1197
2021-08-21,15028,15649,-621,-3.97,1197
2021-08-22,10679,9549,1130,11.83,1197
2021-08-23,17508,17244,264,1.53,1197
2021-08-24,16947,17118,-171,-1.0,1197
2021-08-25,16947,17192,-245,-1.43,1197
2021-08-26,16947,17270,-323,-1.87,1197
2021-08-27,17560,18572,-1012,-5.45,1197
2021-08-28,15028,16131,-1103,-6.84,1197
2021-08-29,10679,10060,619,6.15,1197
2021-08-30,17508,17775,-267,-1.5,1197
2021-08-31,16947,17661,-714,-4.04,1197
2021-09-01,18531,17738,793,4.47,1197
2021-09-02,18531,17810,721,4.05,1197
2021-09-03,19171,19099,72,0.38,1197
2021-09-04,16939,16637,302,1.82,1197
2021-09-05,12302,10538,1764,16.74,1197
2021-09-06,18767,18219,548,3.01,1197
2021-09-07,18531,18066,465,2.57,1197
2021-09-08,18531,18101,430,2.38,1197
2021-09-09,18531,18129,402,2.22,1197
2021-09-10,19171,19372,-201,-1.04,1197
2021-09-11,16939,16863,76,0.45,1197
2021-09-12,12302,10720,1582,14.76,1197
2021-09-13,18767,18358,409,2.23,1197
2021-09-14,18531,18166,365,2.01,1197
2021-09-15,18531,18165,366,2.01,1197
2021-09-16,18531,18162,369,2.03,1197
2021-09-17,19171,19379,-208,-1.07,1197
2021-09-18,16939,16851,88,0.52,1197
2021-09-19,12302,10695,1607,15.03,1197
2021-09-20,18767,18325,442,2.41,1197
2021-09-21,18531,18131,400,2.21,1197
2021-09-22,18531,18135,396,2.18,1197
2021-09-23,18531,18142,389,2.14,1197
2021-09-24,19171,19373,-202,-1.04,1197
2021-09-25,16939,16863,76,0.45,1197
2021-09-26,12302,10727,1575,14.68,1197
2021-09-27,18767,18381,386,2.1,1197
2021-09-28,18531,18212,319,1.75,1197
2021-09-29,18531,18240,291,1.6,1197
2021-09-30,18531,18271,260,1.42,1197
2021-10-01,19849,19525,324,1.66,1197
2021-10-02,17766,17035,731,4.29,1197
2021-10-03,12010,10916,1094,10.02,1197
2021-10-04,18862,18583,279,1.5,1197
2021-10-05,19006,18423,583,3.16,1197
2021-10-06,19006,18456,550,2.98,1197
2021-10-07,19006,18487,519,2.81,1197
2021-10-08,19849,19736,113,0.57,1197
2021-10-09,17766,17237,529,3.07,1197
2021-10-10,12010,11105,905,8.15,1197
2021-10-11,18862,18755,107,0.57,1197
2021-10-12,19006,18574,432,2.33,1197
2021-10-13,19006,18584,422,2.27,1197
2021-10-14,19006,18589,417,2.24,1197
2021-10-15,19849,19812,37,0.19,1197
2021-10-16,17766,17287,479,2.77,1197
2021-10-17,12010,11128,882,7.93,1197
2021-10-18,18862,18753,109,0.58,1197
2021-10-19,19006,18549,457,2.46,1197
2021-10-20,19006,18539,467,2.52,1197
2021-10-21,19006,18528,478,2.58,1197
2021-10-22,19849,19738,111,0.56,1197
2021-10-23,17766,17203,563,3.27,1197
2021-10-24,12010,11040,970,8.79,1197
2021-10-25,18862,18666,196,1.05,1197
2021-10-26,19006,18466,540,2.92,1197
2021-10-27,19006,18465,541,2.93,1197
2021-10-28,19006,18466,540,2.92,1197
2021-10-29,19849,19692,157,0.8,1197
2021-10-30,17766,17177,589,3.43,1197
2021-10-31,12010,11035,975,8.84,1197
2021-11-01,16685,18682,-1997,-10.69,1197
2021-11-02,17494,18506,-1012,-5.47,1197
2021-11-03,17494,18527,-1033,-5.58,1197
2021-11-04,17494,18549,-1055,-5.69,1197
2021-11-05,18815,19794,-979,-4.95,1197
2021-11-06,16163,17295,-1132,-6.55,1197
2021-11-07,10736,11167,-431,-3.86,1197
2021-11-08,16685,18824,-2139,-11.36,1197
2021-11-09,17494,18652,-1158,-6.21,1197
2021-11-10,17494,18673,-1179,-6.31,1197
2021-11-11,17494,18691,-1197,-6.4,1197
2021-11-12,18815,19927,-1112,-5.58,1197
2021-11-13,16163,17414,-1251,-7.18,1197
2021-11-14,10736,11267,-531,-4.71,1197
2021-11-15,16685,18901,-2216,-11.72,1197
2021-11-16,17494,18704,-1210,-6.47,1197
2021-11-17,17494,18696,-1202,-6.43,1197
2021-11-18,17494,18683,-1189,-6.36,1197
2021-11-19,18815,19887,-1072,-5.39,1197
2021-11-20,16163,17341,-1178,-6.79,1197
2021-11-21,10736,11162,-426,-3.82,1197
2021-11-22,16685,18766,-2081,-11.09,1197
2021-11-23,17494,18540,-1046,-5.64,1197
2021-11-24,17494,18508,-1014,-5.48,1197
2021-11-25,17494,18474,-980,-5.3,1197
2021-11-26,18815,19660,-845,-4.3,1197
2021-11-27,16163,17103,-940,-5.5,1197
2021-11-28,10736,10917,-181,-1.66,1197
2021-11-29,16685,18519,-1834,-9.9,1197
2021-11-30,17494,18297,-803,-4.39,1197
2021-12-01,16864,18273,-1409,-7.71,1197
2021-12-02,16864,18253,-1389,-7.61,1197
2021-12-03,16047,19458,-3411,-17.53,1197
2021-12-04,14104,16922,-2818,-16.65,1197
2021-12-05,9915,10760,-845,-7.85,1197
2021-12-06,17748,18389,-641,-3.49,1197
2021-12-07,16864,18195,-1331,-7.32,1197
2021-12-08,16864,18199,-1335,-7.34,1197
2021-12-09,16864,18205,-1341,-7.37,1197
2021-12-10,16047,19435,-3388,-17.43,1197
2021-12-11,14104,16922,-2818,-16.65,1197
2021-12-12,9915,10779,-864,-8.02,1197
2021-12-13,17748,18422,-674,-3.66,1197
2021-12-14,16864,18236,-1372,-7.52,1197
2021-12-15,16864,18243,-1379,-7.56,1197
2021-12-16,16864,18246,-1382,-7.57,1197
2021-12-17,16047,19466,-3419,-17.56,1197
2021-12-18,14104,16936,-2832,-16.72,1197
2021-12-19,9915,10770,-855,-7.94,1197
2021-12-20,17748,18384,-636,-3.46,1197
2021-12-21,16864,18163,-1299,-7.15,1197
2021-12-22,16864,18131,-1267,-6.99,1197
2021-12-23,16864,18090,-1226,-6.78,1197
2021-12-24,16047,19264,-3217,-16.7,1197
2021-12-25,14104,16685,-2581,-15.47,1197
2021-12-26,9915,10469,-554,-5.29,1197
2021-12-27,17748,18034,-286,-1.59,1197
2021-12-28,16864,17766,-902,-5.08,1197
2021-12-29,16864,17688,-824,-4.66,1197
2021-12-30,16864,17606,-742,-4.21,1197
2021-12-31,16047,18743,-2696,-14.38,1197
2022-01-01,15518,16134,-616,-3.82,1197
2022-01-02,9382,9895,-513,-5.18,1197
2022-01-03,16744,17444,-700,-4.01,1197
2022-01-04,16326,17168,-842,-4.9,1197
2022-01-05,16326,17090,-764,-4.47,1197
2022-01-06,16326,17018,-692,-4.07,1197
2022-01-07,17680,18172,-492,-2.71,1197
2022-01-08,15518,15588,-70,-0.45,1197
2022-01-09,9382,9382,0,0.0,1197
2022-01-10,16744,16971,-227,-1.34,1197
2022-01-11,16326,16741,-415,-2.48,1197
2022-01-12,16326,16715,-389,-2.33,1197
2022-01-13,16326,16698,-372,-2.23,1197
2022-01-14,17680,17911,-231,-1.29,1197
2022-01-15,15518,15388,130,0.84,1197
2022-01-16,9382,9244,138,1.49,1197
2022-01-17,16744,16893,-149,-0.88,1197
2022-01-18,16326,16722,-396,-2.37,1197
2022-01-19,16326,16752,-426,-2.54,1197
2022-01-20,16326,16787,-461,-2.75,1197
2022-01-21,17680,18047,-367,-2.03,1197
2022-01-22,15518,15565,-47,-0.3,1197
2022-01-23,9382,9455,-73,-0.77,1197
2022-01-24,16744,17133,-389,-2.27,1197
2022-01-25,16326,16983,-657,-3.87,1197
2022-01-26,16326,17027,-701,-4.12,1197
2022-01-27,16326,17069,-743,-4.35,1197
2022-01-28,17680,18330,-650,-3.55,1197
2022-01-29,15518,15843,-325,-2.05,1197
2022-01-30,9382,9722,-340,-3.5,1197
2020-02-01,16608,15105,1503,9.95,1199
2020-02-02,11867,11183,684,6.12,1199
2020-02-03,17407,17116,291,1.7,1199
2020-02-04,17900,17454,446,2.56,1199
2020-02-05,17900,17474,426,2.44,1199
2020-02-06,17900,17482,418,2.39,1199
2020-02-07,19384,18665,719,3.85,1199
2020-02-08,16608,15241,1367,8.97,1199
2020-02-09,11867,11305,562,4.97,1199
2020-02-10,17407,17227,180,1.04,1199
2020-02-11,17900,17558,342,1.95,1199
2020-02-12,17900,17575,325,1.85,1199
2020-02-13,17900,17584,316,1.8,1199
2020-02-14,19384,18772,612,3.26,1199
2020-02-15,16608,15357,1251,8.15,1199
2020-02-16,11867,11435,432,3.78,1199
2020-02-17,17407,17375,32,0.18,1199
2020-02-18,17900,17727,173,0.98,1199
2020-02-19,17900,17767,133,0.75,1199
2020-02-20,17900,17801,99,0.56,1199
2020-02-21,19384,19016,368,1.94,1199
2020-02-22,16608,15629,979,6.26,1199
2020-02-23,11867,11734,133,1.13,1199
2020-02-24,17407,17700,-293,-1.66,1199
2020-02-25,17900,18076,-176,-0.97,1199
2020-02-26,17900,18138,-238,-1.31,1199
2020-02-27,17900,18192,-292,-1.61,1199
2020-02-28,19384,19423,-39,-0.2,1199
2020-02-29,16608,16047,561,3.5,1199
2020-03-01,8836,12159,-3323,-27.33,1199
2020-03-02,13731,18128,-4397,-24.26,1199
2020-03-03,14256,18503,-4247,-22.95,1199
2020-03-04,14256,18559,-4303,-23.19,1199
2020-03-05,14256,18602,-4346,-23.36,1199
2020-03-06,16017,19818,-3801,-19.18,1199
2020-03-07,12329,16424,-4095,-24.93,1199
2020-03-08,8836,12515,-3679,-29.4,1199
2020-03-09,13731,18461,-4730,-25.62,1199
2020-03-10,14256,18810,-4554,-24.21,1199
2020-03-11,14256,18839,-4583,-24.33,1199
2020-03-12,14256,18856,-4600,-24.4,1199
2020-03-13,16017,20045,-4028,-20.09,1199
2020-03-14,12329,16626,-4297,-25.85,1199
2020-03-15,8836,12694,-3858,-30.39,1199
2020-03-16,13731,18618,-4887,-26.25,1199
2020-03-17,14256,18950,-4694,-24.77,1199
2020-03-18,14256,18965,-4709,-24.83,1199
2020-03-19,14256,18971,-4715,-24.85,1199
2020-03-20,16017,20155,-4138,-20.53,1199
2020-03-21,12329,16733,-4404,-26.32,1199
2020-03-22,8836,12803,-3967,-30.98,1199
2020-03-23,13731,18734,-5003,-26.71,1199
2020-03-24,14256,19076,-4820,-25.27,1199
2020-03-25,14256,19104,-4848,-25.38,1199
2020-03-26,14256,19127,-4871,-25.47,1199
2020-03-27,16017,20329,-4312,-21.21,1199
2020-03-28,12329,16928,-4599,-27.17,1199
2020-03-29,8836,13019,-4183,-32.13,1199
2020-03-30,13731,18972,-5241,-27.62,1199
2020-03-31,14256,19334,-5078,-26.26,1199
2020-04-01,14416,19383,-4967,-25.63,1199
2020-04-02,14416,19424,-5008,-25.78,1199
2020-04-03,14809,20642,-5833,-28.26,1199
2020-04-04,12735,17254,-4519,-26.19,1199
2020-04-05,7731,13354,-5623,-42.11,1199
2020-04-06,14043,19312,-5269,-27.28,1199
2020-04-07,14416,19676,-5260,-26.73,1199
2020-04-08,14416,19722,-5306,-26.9,1199
2020-04-09,14416,19756,-5340,-27.03,1199
2020-04-10,14809,20963,-6154,-29.36,1199
2020-04-11,12735,17560,-4825,-27.48,1199
2020-04-12,7731,13642,-5911,-43.33,1199
2020-04-13,14043,19578,-5535,-28.27,1199
2020-04-14,14416,19917,-5501,-27.62,1199
2020-04-15,14416,19936,-5520,-27.69,1199
2020-04-16,14416,19942,-5526,-27.71,1199
2020-04-17,14809,21120,-6311,-29.88,1199
2020-04-18,12735,17688,-4953,-28.0,1199
2020-04-19,7731,13741,-6010,-43.74,1199
2020-04-20,14043,19650,-5607,-28.53,1199
2020-04-21,14416,19964,-5548,-27.79,1199
2020-04-22,14416,19961,-5545,-27.78,1199
2020-04-23,14416,19946,-5530,-27.72,1199
2020-04-24,14809,21108,-6299,-29.84,1199
2020-04-25,12735,17663,-4928,-27.9,1199
2020-04-26,7731,13707,-5976,-43.6,1199
2020-04-27,14043,19611,-5568,-28.39,1199
2020-04-28,14416,19923,-5507,-27.64,1199
2020-04-29,14416,19921,-5505,-27.63,1199
2020-04-30,14416,19912,-5496,-27.6,1199
2020-05-01,19872,21081,-1209,-5.74,1199
2020-05-02,17425,17647,-222,-1.26,1199
2020-05-03,12056,13704,-1648,-12.03,1199
2020-05-04,17667,19621,-1954,-9.96,1199
2020-05-05,18308,19948,-1640,-8.22,1199
2020-05-06,18308,19962,-1654,-8.29,1199
2020-05-07,18308,19967,-1659,-8.31,1199
2020-05-08,19872,21150,-1278,-6.04,1199
2020-05-09,17425,17728,-303,-1.71,1199
2020-05-10,12056,13795,-1739,-12.61,1199
2020-05-11,17667,19720,-2053,-10.41,1199
2020-05-12,18308,20053,-1745,-8.7,1199
2020-05-13,18308,20068,-1760,-8.77,1199
2020-05-14,18308,20073,-1765,-8.79,1199
2020-05-15,19872,21252,-1380,-6.49,1199
2020-05-16,17425,17822,-397,-2.23,1199
2020-05-17,12056,13879,-1823,-13.13,1199
2020-05-18,17667,19792,-2125,-10.74,1199
2020-05-19,18308,20109,-1801,-8.96,1199
2020-05-20,18308,20108,-1800,-8.95,1199
2020-05-21,18308,20094,-1786,-8.89,1199
2020-05-22,19872,21254,-1382,-6.5,1199
2020-05-23,17425,17805,-380,-2.13,1199
2020-05-24,12056,13843,-1787,-12.91,1199
2020-05-25,17667,19737,-2070,-10.49,1199
2020-05-26,18308,20037,-1729,-8.63,1199
2020-05-27,18308,20020,-1712,-8.55,1199
2020-05-28,18308,19992,-1684,-8.42,1199
2020-05-29,19872,21141,-1269,-6.0,1199
2020-05-30,17425,17684,-259,-1.46,1199
2020-05-31,12056,13716,-1660,-12.1,1199
2020-06-01,18664,19607,-943,-4.81,1199
2020-06-02,19659,19907,-248,-1.25,1199
2020-06-03,19659,19893,-234,-1.18,1199
2020-06-04,19659,19871,-212,-1.07,1199
2020-06-05,20780,21028,-248,-1.18,1199
2020-06-06,18370,17580,790,4.49,1199
2020-06-07,13677,13623,54,0.4,1199
2020-06-08,18664,19526,-862,-4.41,1199
2020-06-09,19659,19839,-180,-0.91,1199
2020-06-10,19659,19837,-178,-0.9,1199
2020-06-11,19659,19826,-167,-0.84,1199
2020-06-12,20780,20993,-213,-1.01,1199
2020-06-13,18370,17553,817,4.65,1199
2020-06-14,13677,13602,75,0.55,1199
2020-06-15,18664,19508,-844,-4.33,1199
2020-06-16,19659,19821,-162,-0.82,1199
2020-06-17,19659,19817,-158,-0.8,1199
2020-06-18,19659,19800,-141,-0.71,1199
2020-06-19,20780,20958,-178,-0.85,1199
2020-06-20,18370,17506,864,4.94,1199
2020-06-21,13677,13540,137,1.01,1199
2020-06-22,18664,19429,-765,-3.94,1199
2020-06-23,19659,19723,-64,-0.32,1199
2020-06-24,19659,19697,-38,-0.19,1199
2020-06-25,19659,19658,1,0.01,1199
2020-06-26,20780,20793,-13,-0.06,1199
2020-06-27,18370,17318,1052,6.07,1199
2020-06-28,13677,13330,347,2.6,1199
2020-06-29,18664,19199,-535,-2.79,1199
2020-06-30,19659,19473,186,0.96,1199
2020-07-01,19222,19431,-209,-1.08,1199
2020-07-02,19222,19380,-158,-0.82,1199
2020-07-03,20388,20505,-117,-0.57,1199
2020-07-04,17091,17025,66,0.39,1199
2020-07-05,13852,13035,817,6.27,1199
2020-07-06,18533,18906,-373,-1.97,1199
2020-07-07,19222,19188,34,0.18,1199
2020-07-08,19222,19157,65,0.34,1199
2020-07-09,19222,19119,103,0.54,1199
2020-07-10,20388,20263,125,0.62,1199
2020-07-11,17091,16803,288,1.71,1199
2020-07-12,13852,12838,1014,7.9,1199
2020-07-13,18533,18734,-201,-1.07,1199
2020-07-14,19222,19042,180,0.95,1199
2020-07-15,19222,19038,184,0.97,1199
2020-07-16,19222,19028,194,1.02,1199
2020-07-17,20388,20197,191,0.95,1199
2020-07-18,17091,16762,329,1.96,1199
2020-07-19,13852,12817,1035,8.08,1199
2020-07-20,18533,18732,-199,-1.06,1199
2020-07-21,19222,19055,167,0.88,1199
2020-07-22,19222,19063,159,0.83,1199
2020-07-23,19222,19059,163,0.86,1199
2020-07-24,20388,20230,158,0.78,1199
2020-07-25,17091,16793,298,1.77,1199
2020-07-26,13852,12842,1010,7.86,1199
2020-07-27,18533,18747,-214,-1.14,1199
2020-07-28,19222,19055,167,0.88,1199
2020-07-29,19222,19044,178,0.93,1199
2020-07-30,19222,19019,203,1.07,1199
2020-07-31,20388,20167,221,1.1,1199
2020-08-01,17380,16705,675,4.04,1199
2020-08-02,13422,12729,693,5.44,1199
2020-08-03,17968,18608,-640,-3.44,1199
2020-08-04,18482,18892,-410,-2.17,1199
2020-08-05,18482,18857,-375,-1.99,1199
2020-08-06,18482,18812,-330,-1.75,1199
2020-08-07,20053,19943,110,0.55,1199
2020-08-08,17380,16467,913,5.54,1199
2020-08-09,13422,12481,941,7.54,1199
2020-08-10,17968,18356,-388,-2.11,1199
2020-08-11,18482,18640,-158,-0.85,1199
2020-08-12,18482,18612,-130,-0.7,1199
2020-08-13,18482,18577,-95,-0.51,1199
2020-08-14,20053,19724,329,1.67,1199
2020-08-15,17380,16270,1110,6.82,1199
2020-08-16,13422,12309,1113,9.04,1199
2020-08-17,17968,18213,-245,-1.35,1199
2020-08-18,18482,18530,-48,-0.26,1199
2020-08-19,18482,18538,-56,-0.3,1199
2020-08-20,18482,18541,-59,-0.32,1199
2020-08-21,20053,19726,327,1.66,1199
2020-08-22,17380,16310,1070,6.56,1199
2020-08-23,13422,12388,1034,8.35,1199
2020-08-24,17968,18328,-360,-1.96,1199
2020-08-25,18482,18679,-197,-1.05,1199
2020-08-26,18482,18717,-235,-1.26,1199
2020-08-27,18482,18747,-265,-1.41,1199
2020-08-28,20053,19955,98,0.49,1199
2020-08-29,17380,16557,823,4.97,1199
2020-08-30,13422,12647,775,6.13,1199
2020-08-31,17968,18594,-626,-3.37,1199
2020-09-01,19326,18946,380,2.01,1199
2020-09-02,19326,18980,346,1.82,1199
2020-09-03,19326,19001,325,1.71,1199
2020-09-04,20602,20195,407,2.02,1199
2020-09-05,17933,16778,1155,6.88,1199
2020-09-06,13349,12846,503,3.92,1199
2020-09-07,18381,18767,-386,-2.06,1199
2020-09-08,19326,19092,234,1.23,1199
2020-09-09,19326,19097,229,1.2,1199
2020-09-10,19326,19087,239,1.25,1199
2020-09-11,20602,20251,351,1.73,1199
2020-09-12,17933,16805,1128,6.71,1199
2020-09-13,13349,12845,504,3.92,1199
2020-09-14,18381,18740,-359,-1.92,1199
2020-09-15,19326,19042,284,1.49,1199
2020-09-16,19326,19028,298,1.57,1199
2020-09-17,19326,19002,324,1.71,1199
2020-09-18,20602,20154,448,2.22,1199
2020-09-19,17933,16701,1232,7.38,1199
2020-09-20,13349,12737,612,4.8,1199
2020-09-21,18381,18634,-253,-1.36,1199
2020-09-22,19326,18941,385,2.03,1199
2020-09-23,19326,18935,391,2.06,1199
2020-09-24,19326,18921,405,2.14,1199
2020-09-25,20602,20088,514,2.56,1199
2020-09-26,17933,16650,1283,7.71,1199
2020-09-27,13349,12705,644,5.07,1199
2020-09-28,18381,18620,-239,-1.28,1199
2020-09-29,19326,18945,381,2.01,1199
2020-09-30,19326,18957,369,1.95,1199
2020-10-01,18777,18960,-183,-0.97,1199
2020-10-02,20262,20140,122,0.61,1199
2020-10-03,17355,16715,640,3.83,1199
2020-10-04,12274,12779,-505,-3.95,1199
2020-10-05,18159,18700,-541,-2.89,1199
2020-10-06,18777,19028,-251,-1.32,1199
2020-10-07,18777,19038,-261,-1.37,1199
2020-10-08,18777,19036,-259,-1.36,1199
2020-10-09,20262,20209,53,0.26,1199
2020-10-10,17355,16772,583,3.48,1199
2020-10-11,12274,12821,-547,-4.27,1199
2020-10-12,18159,18725,-566,-3.02,1199
2020-10-13,18777,19033,-256,-1.35,1199
2020-10-14,18777,19022,-245,-1.29,1199
2020-10-15,18777,18998,-221,-1.16,1199
2020-10-16,20262,20148,114,0.57,1199
2020-10-17,17355,16689,666,3.99,1199
2020-10-18,12274,12717,-443,-3.48,1199
2020-10-19,18159,18601,-442,-2.38,1199
2020-10-20,18777,18892,-115,-0.61,1199
2020-10-21,18777,18866,-89,-0.47,1199
2020-10-22,18777,18830,-53,-0.28,1199
2020-10-23,20262,19971,291,1.46,1199
2020-10-24,17355,16506,849,5.14,1199
2020-10-25,12274,12532,-258,-2.06,1199
2020-10-26,18159,18417,-258,-1.4,1199
2020-10-27,18777,18712,65,0.35,1199
2020-10-28,18777,18694,83,0.44,1199
2020-10-29,18777,18668,109,0.58,1199
2020-10-30,20262,19822,440,2.22,1199
2020-10-31,17355,16372,983,6.0,1199
2020-11-01,9758,12413,-2655,-21.39,1199
2020-11-02,16852,18315,-1463,-7.99,1199
2020-11-03,15875,18627,-2752,-14.77,1199
2020-11-04,15875,18625,-2750,-14.77,1199
2020-11-05,15875,18614,-2739,-14.71,1199
2020-11-06,17489,19781,-2292,-11.59,1199
2020-11-07,14500,16342,-1842,-11.27,1199
2020-11-08,9758,12391,-2633,-21.25,1199
2020-11-09,16852,18299,-1447,-7.91,1199
2020-11-10,15875,18613,-2738,-14.71,1199
2020-11-11,15875,18609,-2734,-14.69,1199
2020-11-12,15875,18594,-2719,-14.62,1199
2020-11-13,17489,19753,-2264,-11.46,1199
2020-11-14,14500,16303,-1803,-11.06,1199
2020-11-15,9758,12340,-2582,-20.92,1199
2020-11-16,16852,18231,-1379,-7.56,1199
2020-11-17,15875,18527,-2652,-14.31,1199
2020-11-18,15875,18505,-2630,-14.21,1199
2020-11-19,15875,18470,-2595,-14.05,1199
2020-11-20,17489,19609,-2120,-10.81,1199
2020-11-21,14500,16140,-1640,-10.16,1199
2020-11-22,9758,12158,-2400,-19.74,1199
2020-11-23,16852,18033,-1181,-6.55,1199
2020-11-24,15875,18315,-2440,-13.32,1199
2020-11-25,15875,18281,-2406,-13.16,1199
2020-11-26,15875,18238,-2363,-12.96,1199
2020-11-27,17489,19373,-1884,-9.72,1199
2020-11-28,14500,15903,-1403,-8.82,1199
2020-11-29,9758,11924,-2166,-18.17,1199
2020-11-30,16852,17806,-954,-5.36,1199
2020-12-01,16442,18099,-1657,-9.16,1199
2020-12-02,16442,18079,-1637,-9.05,1199
2020-12-03,16442,18053,-1611,-8.92,1199
2020-12-04,17983,19207,-1224,-6.37,1199
2020-12-05,15083,15758,-675,-4.28,1199
2020-12-06,9388,11801,-2413,-20.45,1199
2020-12-07,16534,17706,-1172,-6.62,1199
2020-12-08,16442,18020,-1578,-8.76,1199
2020-12-09,16442,18021,-1579,-8.76,1199
2020-12-10,16442,18014,-1572,-8.73,1199
2020-12-11,17983,19183,-1200,-6.26,1199
2020-12-12,15083,15746,-663,-4.21,1199
2020-12-13,9388,11798,-2410,-20.43,1199
2020-12-14,16534,17706,-1172,-6.62,1199
2020-12-15,16442,18019,-1577,-8.75,1199
2020-12-16,16442,18013,-1571,-8.72,1199
2020-12-17,16442,17993,-1551,-8.62,1199
2020-12-18,17983,19145,-1162,-6.07,1199
2020-12-19,15083,15685,-602,-3.84,1199
2020-12-20,9388,11709,-2321,-19.82,1199
2020-12-21,16534,17584,-1050,-5.97,1199
2020-12-22,16442,17861,-1419,-7.94,1199
2020-12-23,16442,17816,-1374,-7.71,1199
2020-12-24,16442,17754,-1312,-7.39,1199
2020-12-25,17983,18864,-881,-4.67,1199
2020-12-26,15083,15361,-278,-1.81,1199
2020-12-27,9388,11342,-1954,-17.23,1199
2020-12-28,16534,17177,-643,-3.74,1199
2020-12-29,16442,17415,-973,-5.59,1199
2020-12-30,16442,17336,-894,-5.16,1199
2020-12-31,16442,17245,-803,-4.66,1199
2021-01-01,16201,18330,-2129,-11.61,1199
2021-01-02,12747,14808,-2061,-13.92,1199
2021-01-03,8055,10778,-2723,-25.26,1199
2021-01-04,14807,16609,-1802,-10.85,1199
2021-01-05,15327,16851,-1524,-9.04,1199
2021-01-06,15327,16781,-1454,-8.66,1199
2021-01-07,15327,16708,-1381,-8.27,1199
2021-01-08,16201,17818,-1617,-9.08,1199
2021-01-09,12747,14329,-1582,-11.04,1199
2021-01-10,8055,10337,-2282,-22.08,1199
2021-01-11,14807,16211,-1404,-8.66,1199
2021-01-12,15327,16501,-1174,-7.11,1199
2021-01-13,15327,16484,-1157,-7.02,1199
2021-01-14,15327,16465,-1138,-6.91,1199
2021-01-15,16201,17631,-1430,-8.11,1199
2021-01-16,12747,14199,-1452,-10.23,1199
2021-01-17,8055,10263,-2208,-21.51,1199
2021-01-18,14807,16191,-1384,-8.55,1199
2021-01-19,15327,16534,-1207,-7.3,1199
2021-01-20,15327,16565,-1238,-7.47,1199
2021-01-21,15327,16591,-1264,-7.62,1199
2021-01-22,16201,17797,-1596,-8.97,1199
2021-01-23,12747,14398,-1651,-11.47,1199
2021-01-24,8055,10491,-2436,-23.22,1199
2021-01-25,14807,16441,-1634,-9.94,1199
2021-01-26,15327,16800,-1473,-8.77,1199
2021-01-27,15327,16841,-1514,-8.99,1199
2021-01-28,15327,16871,-1544,-9.15,1199
2021-01-29,16201,18076,-1875,-10.37,1199
2021-01-30,12747,14671,-1924,-13.11,1199
2021-01-31,8055,10753,-2698,-25.09,1199
2021-02-01,16299,16690,-391,-2.34,1199
2021-02-02,16691,17032,-341,-2.0,1199
2021-02-03,16691,17055,-364,-2.13,1199
2021-02-04,16691,17066,-375,-2.2,1199
2021-02-05,17767,18251,-484,-2.65,1199
2021-02-06,14962,14828,134,0.9,1199
2021-02-07,10178,10893,-715,-6.56,1199
2021-02-08,16299,16815,-516,-3.07,1199
2021-02-09,16691,17145,-454,-2.65,1199
2021-02-10,16691,17160,-469,-2.73,1199
2021-02-11,16691,17167,-476,-2.77,1199
2021-02-12,17767,18352,-585,-3.19,1199
2021-02-13,14962,14933,29,0.19,1199
2021-02-14,10178,11007,-829,-7.53,1199
2021-02-15,16299,16942,-643,-3.8,1199
2021-02-16,16691,17289,-598,-3.46,1199
2021-02-17,16691,17323,-632,-3.65,1199
2021-02-18,16691,17353,-662,-3.81,1199
2021-02-19,17767,18563,-796,-4.29,1199
2021-02-20,14962,15170,-208,-1.37,1199
2021-02-21,10178,11271,-1093,-9.7,1199
2021-02-22,16299,17234,-935,-5.43,1199
2021-02-23,16691,17607,-916,-5.2,1199
2021-02-24,16691,17667,-976,-5.52,1199
2021-02-25,16691,17719,-1028,-5.8,1199
2021-02-26,17767,18949,-1182,-6.24,1199
2021-02-27,14962,15573,-611,-3.92,1199
2021-02-28,10178,11687,-1509,-12.91,1199
2021-03-01,17361,17658,-297,-1.68,1199
2021-03-02,17937,18035,-98,-0.54,1199
2021-03-03,17937,18095,-158,-0.87,1199
2021-03-04,17937,18142,-205,-1.13,1199
2021-03-05,18532,19362,-830,-4.29,1199
2021-03-06,16082,15973,109,0.68,1199
2021-03-07,11110,12069,-959,-7.95,1199
2021-03-08,17361,18020,-659,-3.66,1199
2021-03-09,17937,18374,-437,-2.38,1199
2021-03-10,17937,18408,-471,-2.56,1199
2021-03-11,17937,18429,-492,-2.67,1199
2021-03-12,18532,19622,-1090,-5.55,1199
2021-03-13,16082,16207,-125,-0.77,1199
2021-03-14,11110,12277,-1167,-9.51,1199
2021-03-15,17361,18204,-843,-4.63,1199
2021-03-16,17937,18536,-599,-3.23,1199
2021-03-17,17937,18552,-615,-3.32,1199
2021-03-18,17937,18558,-621,-3.35,1199
2021-03-19,18532,19740,-1208,-6.12,1199
2021-03-20,16082,16317,-235,-1.44,1199
2021-03-21,11110,12384,-1274,-10.29,1199
2021-03-22,17361,18312,-951,-5.19,1199
2021-03-23,17937,18650,-713,-3.82,1199
2021-03-24,17937,18675,-738,-3.95,1199
2021-03-25,17937,18693,-756,-4.04,1199
2021-03-26,18532,19891,-1359,-6.83,1199
2021-03-27,16082,16486,-404,-2.45,1199
2021-03-28,11110,12574,-1464,-11.64,1199
2021-03-29,17361,18523,-1162,-6.27,1199
2021-03-30,17937,18882,-945,-5.0,1199
2021-03-31,17937,18929,-992,-5.24,1199
2021-04-01,17380,18967,-1587,-8.37,1199
2021-04-02,18736,20184,-1448,-7.17,1199
2021-04-03,15848,16796,-948,-5.64,1199
2021-04-04,10775,12897,-2122,-16.45,1199
2021-04-05,17577,18856,-1279,-6.78,1199
2021-04-06,17380,19222,-1842,-9.58,1199
2021-04-07,17380,19271,-1891,-9.81,1199
2021-04-08,17380,19307,-1927,-9.98,1199
2021-04-09,18736,20518,-1782,-8.69,1199
2021-04-10,15848,17120,-1272,-7.43,1199
2021-04-11,10775,13207,-2432,-18.41,1199
2021-04-12,17577,19148,-1571,-8.2,1199
2021-04-13,17380,19493,-2113,-10.84,1199
2021-04-14,17380,19518,-2138,-10.95,1199
2021-04-15,17380,19528,-2148,-11.0,1199
2021-04-16,18736,20711,-1975,-9.54,1199
2021-04-17,15848,17284,-1436,-8.31,1199
2021-04-18,10775,13342,-2567,-19.24,1199
2021-04-19,17577,19255,-1678,-8.71,1199
2021-04-20,17380,19572,-2192,-11.2,1199
2021-04-21,17380,19571,-2191,-11.2,1199
2021-04-22,17380,19558,-2178,-11.14,1199
2021-04-23,18736,20721,-1985,-9.58,1199
2021-04-24,15848,17276,-1428,-8.27,1199
2021-04-25,10775,13320,-2545,-19.11,1199
2021-04-26,17577,19223,-1646,-8.56,1199
2021-04-27,17380,19533,-2153,-11.02,1199
2021-04-28,17380,19530,-2150,-11.01,1199
2021-04-29,17380,19518,-2138,-10.95,1199
2021-04-30,18736,20685,-1949,-9.42,1199
2021-05-01,17574,17247,327,1.9,1199
2021-05-02,12540,13301,-761,-5.72,1199
2021-05-03,18833,19216,-383,-1.99,1199
2021-05-04,19408,19540,-132,-0.68,1199
2021-05-05,19408,19551,-143,-0.73,1199
2021-05-06,19408,19555,-147,-0.75,1199
2021-05-07,20429,20736,-307,-1.48,1199
2021-05-08,17574,17313,261,1.51,1199
2021-05-09,12540,13379,-839,-6.27,1199
2021-05-10,18833,19305,-472,-2.44,1199
2021-05-11,19408,19638,-230,-1.17,1199
2021-05-12,19408,19655,-247,-1.26,1199
2021-05-13,19408,19661,-253,-1.29,1199
2021-05-14,20429,20842,-413,-1.98,1199
2021-05-15,17574,17415,159,0.91,1199
2021-05-16,12540,13476,-936,-6.95,1199
2021-05-17,18833,19392,-559,-2.88,1199
2021-05-18,19408,19713,-305,-1.55,1199
2021-05-19,19408,19715,-307,-1.56,1199
2021-05-20,19408,19705,-297,-1.51,1199
2021-05-21,20429,20869,-440,-2.11,1199
2021-05-22,17574,17423,151,0.87,1199
2021-05-23,12540,13464,-924,-6.86,1199
2021-05-24,18833,19360,-527,-2.72,1199
2021-05-25,19408,19662,-254,-1.29,1199
2021-05-26,19408,19647,-239,-1.22,1199
2021-05-27,19408,19620,-212,-1.08,1199
2021-05-28,20429,20770,-341,-1.64,1199
2021-05-29,17574,17312,262,1.51,1199
2021-05-30,12540,13344,-804,-6.03,1199
2021-05-31,18833,19234,-401,-2.08,1199
2021-06-01,20484,19533,951,4.87,1199
2021-06-02,20484,19517,967,4.95,1199
2021-06-03,20484,19493,991,5.08,1199
2021-06-04,20938,20647,291,1.41,1199
2021-06-05,18406,17197,1209,7.03,1199
2021-06-06,15125,13238,1887,14.25,1199
2021-06-07,19657,19139,518,2.71,1199
2021-06-08,20484,19449,1035,5.32,1199
2021-06-09,20484,19445,1039,5.34,1199
2021-06-10,20484,19433,1051,5.41,1199
2021-06-11,20938,20599,339,1.65,1199
2021-06-12,18406,17159,1247,7.27,1199
2021-06-13,15125,13209,1916,14.51,1199
2021-06-14,19657,19116,541,2.83,1199
2021-06-15,20484,19431,1053,5.42,1199
2021-06-16,20484,19428,1056,5.44,1199
2021-06-17,20484,19414,1070,5.51,1199
2021-06-18,20938,20575,363,1.76,1199
2021-06-19,18406,17127,1279,7.47,1199
2021-06-20,15125,13165,1960,14.89,1199
2021-06-21,19657,19059,598,3.14,1199
2021-06-22,20484,19356,1128,5.83,1199
2021-06-23,20484,19335,1149,5.94,1199
2021-06-24,20484,19300,1184,6.13,1199
2021-06-25,20938,20439,499,2.44,1199
2021-06-26,18406,16968,1438,8.47,1199
2021-06-27,15125,12983,2142,16.5,1199
2021-06-28,19657,18854,803,4.26,1199
2021-06-29,20484,19130,1354,7.08,1199
2021-06-30,20484,19090,1394,7.3,1199
2021-07-01,19450,19038,412,2.16,1199
2021-07-02,20320,20163,157,0.78,1199
2021-07-03,16962,16682,280,1.68,1199
2021-07-04,13879,12690,1189,9.37,1199
2021-07-05,18187,18559,-372,-2.0,1199
2021-07-06,19450,18837,613,3.25,1199
2021-07-07,19450,18802,648,3.45,1199
2021-07-08,19450,18760,690,3.68,1199
2021-07-09,20320,19899,421,2.12,1199
2021-07-10,16962,16435,527,3.21,1199
2021-07-11,13879,12464,1415,11.35,1199
2021-07-12,18187,18355,-168,-0.92,1199
2021-07-13,19450,18658,792,4.24,1199
2021-07-14,19450,18650,800,4.29,1199
2021-07-15,19450,18635,815,4.37,1199
2021-07-16,20320,19801,519,2.62,1199
2021-07-17,16962,16363,599,3.66,1199
2021-07-18,13879,12416,1463,11.78,1199
2021-07-19,18187,18330,-143,-0.78,1199
2021-07-20,19450,18652,798,4.28,1199
2021-07-21,19450,18660,790,4.23,1199
2021-07-22,19450,18657,793,4.25,1199
2021-07-23,20320,19831,489,2.47,1199
2021-07-24,16962,16396,566,3.45,1199
2021-07-25,13879,12449,1430,11.49,1199
2021-07-26,18187,18357,-170,-0.93,1199
2021-07-27,19450,18670,780,4.18,1199
2021-07-28,19450,18663,787,4.22,1199
2021-07-29,19450,18643,807,4.33,1199
2021-07-30,20320,19796,524,2.65,1199
2021-07-31,16962,16339,623,3.81,1199
2021-08-01,12929,12367,562,4.54,1199
2021-08-02,17677,18250,-573,-3.14,1199
2021-08-03,18337,18537,-200,-1.08,1199
2021-08-04,18337,18506,-169,-0.91,1199
2021-08-05,18337,18462,-125,-0.68,1199
2021-08-06,19213,19594,-381,-1.94,1199
2021-08-07,16326,16119,207,1.28,1199
2021-08-08,12929,12132,797,6.57,1199
2021-08-09,17677,18004,-327,-1.82,1199
2021-08-10,18337,18286,51,0.28,1199
2021-08-11,18337,18254,83,0.45,1199
2021-08-12,18337,18215,122,0.67,1199
2021-08-13,19213,19356,-143,-0.74,1199
2021-08-14,16326,15895,431,2.71,1199
2021-08-15,12929,11929,1000,8.38,1199
2021-08-16,17677,17825,-148,-0.83,1199
2021-08-17,18337,18136,201,1.11,1199
2021-08-18,18337,18136,201,1.11,1199
2021-08-19,18337,18132,205,1.13,1199
2021-08-20,19213,19310,-97,-0.5,1199
2021-08-21,16326,15888,438,2.76,1199
2021-08-22,12929,11960,969,8.1,1199
2021-08-23,17677,17895,-218,-1.22,1199
2021-08-24,18337,18241,96,0.53,1199
2021-08-25,18337,18276,61,0.33,1199
2021-08-26,18337,18304,33,0.18,1199
2021-08-27,19213,19510,-297,-1.52,1199
2021-08-28,16326,16111,215,1.33,1199
2021-08-29,12929,12202,727,5.96,1199
2021-08-30,17677,18151,-474,-2.61,1199
2021-08-31,18337,18506,-169,-0.91,1199
2021-09-01,19210,18543,667,3.6,1199
2021-09-02,19210,18568,642,3.46,1199
2021-09-03,20468,19767,701,3.55,1199
2021-09-04,17846,16355,1491,9.12,1199
2021-09-05,14858,12429,2429,19.54,1199
2021-09-06,18530,18356,174,0.95,1199
2021-09-07,19210,18686,524,2.8,1199
2021-09-08,19210,18696,514,2.75,1199
2021-09-09,19210,18692,518,2.77,1199
2021-09-10,20468,19861,607,3.06,1199
2021-09-11,17846,16419,1427,8.69,1199
2021-09-12,14858,12462,2396,19.23,1199
2021-09-13,18530,18361,169,0.92,1199
2021-09-14,19210,18665,545,2.92,1199
2021-09-15,19210,18652,558,2.99,1199
2021-09-16,19210,18628,582,3.12,1199
2021-09-17,20468,19779,689,3.48,1199
2021-09-18,17846,16325,1521,9.32,1199
2021-09-19,14858,12360,2498,20.21,1199
2021-09-20,18530,18255,275,1.51,1199
2021-09-21,19210,18559,651,3.51,1199
2021-09-22,19210,18549,661,3.56,1199
2021-09-23,19210,18532,678,3.66,1199
2021-09-24,20468,19695,773,3.92,1199
2021-09-25,17846,16254,1592,9.79,1199
2021-09-26,14858,12305,2553,20.75,1199
2021-09-27,18530,18217,313,1.72,1199
2021-09-28,19210,18540,670,3.61,1199
2021-09-29,19210,18549,661,3.56,1199
2021-09-30,19210,18550,660,3.56,1199
2021-10-01,20260,19729,531,2.69,1199
2021-10-02,17539,16304,1235,7.57,1199
2021-10-03,13895,12367,1528,12.36,1199
2021-10-04,18236,18290,-54,-0.3,1199
2021-10-05,18727,18619,108,0.58,1199
2021-10-06,18727,18631,96,0.52,1199
2021-10-07,18727,18632,95,0.51,1199
2021-10-08,20260,19808,452,2.28,1199
2021-10-09,17539,16374,1165,7.11,1199
2021-10-10,13895,12427,1468,11.81,1199
2021-10-11,18236,18335,-99,-0.54,1199
2021-10-12,18727,18648,79,0.42,1199
2021-10-13,18727,18641,86,0.46,1199
2021-10-14,18727,18622,105,0.56,1199
2021-10-15,20260,19775,485,2.45,1199
2021-10-16,17539,16320,1219,7.47,1199
2021-10-17,13895,12350,1545,12.51,1199
2021-10-18,18236,18237,-1,-0.01,1199
2021-10-19,18727,18529,198,1.07,1199
2021-10-20,18727,18504,223,1.21,1199
2021-10-21,18727,18469,258,1.4,1199
2021-10-22,20260,19610,650,3.31,1199
2021-10-23,17539,16144,1395,8.64,1199
2021-10-24,13895,12168,1727,14.19,1199
2021-10-25,18236,18052,184,1.02,1199
2021-10-26,18727,18345,382,2.08,1199
2021-10-27,18727,18323,404,2.2,1199
2021-10-28,18727,18295,432,2.36,1199
2021-10-29,20260,19445,815,4.19,1199
2021-10-30,17539,15992,1547,9.67,1199
2021-10-31,13895,12030,1865,15.5,1199
2021-11-01,16946,17929,-983,-5.48,1199
2021-11-02,17666,18238,-572,-3.14,1199
2021-11-03,17666,18234,-568,-3.12,1199
2021-11-04,17666,18221,-555,-3.05,1199
2021-11-05,18999,19387,-388,-2.0,1199
2021-11-06,16374,15947,427,2.68,1199
2021-11-07,12123,11997,126,1.05,1199
2021-11-08,16946,17905,-959,-5.36,1199
2021-11-09,17666,18221,-555,-3.05,1199
2021-11-10,17666,18219,-553,-3.04,1199
2021-11-11,17666,18207,-541,-2.97,1199
2021-11-12,18999,19369,-370,-1.91,1199
2021-11-13,16374,15922,452,2.84,1199
2021-11-14,12123,11962,161,1.35,1199
2021-11-15,16946,17857,-911,-5.1,1199
2021-11-16,17666,18157,-491,-2.7,1199
2021-11-17,17666,18139,-473,-2.61,1199
2021-11-18,17666,18107,-441,-2.44,1199
2021-11-19,18999,19249,-250,-1.3,1199
2021-11-20,16374,15783,591,3.74,1199
2021-11-21,12123,11803,320,2.71,1199
2021-11-22,16946,17680,-734,-4.15,1199
2021-11-23,17666,17963,-297,-1.65,1199
2021-11-24,17666,17929,-263,-1.47,1199
2021-11-25,17666,17886,-220,-1.23,1199
2021-11-26,18999,19019,-20,-0.11,1199
2021-11-27,16374,15547,827,5.32,1199
2021-11-28,12123,11566,557,4.82,1199
2021-11-29,16946,17445,-499,-2.86,1199
2021-11-30,17666,17734,-68,-0.38,1199
2021-12-01,16990,17710,-720,-4.07,1199
2021-12-02,16990,17680,-690,-3.9,1199
2021-12-03,17019,18830,-1811,-9.62,1199
2021-12-04,15469,15377,92,0.6,1199
2021-12-05,10530,11416,-886,-7.76,1199
2021-12-06,16909,17317,-408,-2.36,1199
2021-12-07,16990,17628,-638,-3.62,1199
2021-12-08,16990,17626,-636,-3.61,1199
2021-12-09,16990,17617,-627,-3.56,1199
2021-12-10,17019,18786,-1767,-9.41,1199
2021-12-11,15469,15349,120,0.78,1199
2021-12-12,10530,11402,-872,-7.65,1199
2021-12-13,16909,17312,-403,-2.33,1199
2021-12-14,16990,17628,-638,-3.62,1199
2021-12-15,16990,17626,-636,-3.61,1199
2021-12-16,16990,17611,-621,-3.53,1199
2021-12-17,17019,18769,-1750,-9.32,1199
2021-12-18,15469,15316,153,1.0,1199
2021-12-19,10530,11347,-817,-7.2,1199
2021-12-20,16909,17230,-321,-1.86,1199
2021-12-21,16990,17515,-525,-3.0,1199
2021-12-22,16990,17478,-488,-2.79,1199
2021-12-23,16990,17424,-434,-2.49,1199
2021-12-24,17019,18541,-1522,-8.21,1199
2021-12-25,15469,15045,424,2.82,1199
2021-12-26,10530,11033,-503,-4.56,1199
2021-12-27,16909,16873,36,0.21,1199
2021-12-28,16990,17117,-127,-0.74,1199
2021-12-29,16990,17041,-51,-0.3,1199
2021-12-30,16990,16952,38,0.22,1199
2021-12-31,17019,18038,-1019,-5.65,1199
2022-01-01,14930,14517,413,2.84,1199
2022-01-02,10009,10485,-476,-4.54,1199
2022-01-03,16025,16312,-287,-1.76,1199
2022-01-04,16554,16549,5,0.03,1199
2022-01-05,16554,16475,79,0.48,1199
2022-01-06,16554,16394,160,0.98,1199
2022-01-07,17587,17497,90,0.51,1199
2022-01-08,14930,13998,932,6.66,1199
2022-01-09,10009,9997,12,0.12,1199
2022-01-10,16025,15860,165,1.04,1199
2022-01-11,16554,16140,414,2.57,1199
2022-01-12,16554,16112,442,2.74,1199
2022-01-13,16554,16083,471,2.93,1199
2022-01-14,17587,17239,348,2.02,1199
2022-01-15,14930,13797,1133,8.21,1199
2022-01-16,10009,9852,157,1.59,1199
2022-01-17,16025,15772,253,1.6,1199
2022-01-18,16554,16107,447,2.78,1199
2022-01-19,16554,16133,421,2.61,1199
2022-01-20,16554,16153,401,2.48,1199
2022-01-21,17587,17355,232,1.34,1199
2022-01-22,14930,13953,977,7.0,1199
2022-01-23,10009,10044,-35,-0.35,1199
2022-01-24,16025,15994,31,0.19,1199
2022-01-25,16554,16353,201,1.23,1199
2022-01-26,16554,16395,159,0.97,1199
2022-01-27,16554,16427,127,0.77,1199
2022-01-28,17587,17635,-48,-0.27,1199
2022-01-29,14930,14233,697,4.9,1199
2022-01-30,10009,10319,-310,-3.0,1199
2020-02-01,18218,16900,1318,7.8,1212
2020-02-02,14122,13309,813,6.11,1212
2020-02-03,21325,21432,-107,-0.5,1212
2020-02-04,22129,22089,40,0.18,1212
2020-02-05,22129,22093,36,0.16,1212
2020-02-06,22129,22075,54,0.24,1212
2020-02-07,23204,22603,601,2.66,1212
2020-02-08,18218,16946,1272,7.51,1212
2020-02-09,14122,13343,779,5.84,1212
2020-02-10,21325,21458,-133,-0.62,1212
2020-02-11,22129,22109,20,0.09,1212
2020-02-12,22129,22112,17,0.08,1212
2020-02-13,22129,22095,34,0.15,1212
2020-02-14,23204,22628,576,2.55,1212
2020-02-15,18218,16979,1239,7.3,1212
2020-02-16,14122,13388,734,5.48,1212
2020-02-17,21325,21516,-191,-0.89,1212
2020-02-18,22129,22185,-56,-0.25,1212
2020-02-19,22129,22205,-76,-0.34,1212
2020-02-20,22129,22209,-80,-0.36,1212
2020-02-21,23204,22763,441,1.94,1212
2020-02-22,18218,17135,1083,6.32,1212
2020-02-23,14122,13564,558,4.11,1212
2020-02-24,21325,21713,-388,-1.79,1212
2020-02-25,22129,22400,-271,-1.21,1212
2020-02-26,22129,22438,-309,-1.38,1212
2020-02-27,22129,22456,-327,-1.46,1212
2020-02-28,23204,23021,183,0.79,1212
2020-02-29,18218,17401,817,4.7,1212
2020-03-01,9876,13835,-3959,-28.62,1212
2020-03-02,15673,21986,-6313,-28.71,1212
2020-03-03,15956,22670,-6714,-29.62,1212
2020-03-04,15956,22702,-6746,-29.72,1212
2020-03-05,15956,22710,-6754,-29.74,1212
2020-03-06,16596,23263,-6667,-28.66,1212
2020-03-07,11188,17629,-6441,-36.54,1212
2020-03-08,9876,14046,-4170,-29.69,1212
2020-03-09,15673,22177,-6504,-29.33,1212
2020-03-10,15956,22842,-6886,-30.15,1212
2020-03-11,15956,22853,-6897,-30.18,1212
2020-03-12,15956,22841,-6885,-30.14,1212
2020-03-13,16596,23374,-6778,-29.0,1212
2020-03-14,11188,17720,-6532,-36.86,1212
2020-03-15,9876,14120,-4244,-30.06,1212
2020-03-16,15673,22236,-6563,-29.52,1212
2020-03-17,15956,22889,-6933,-30.29,1212
2020-03-18,15956,22890,-6934,-30.29,1212
2020-03-19,15956,22872,-6916,-30.24,1212
2020-03-20,16596,23403,-6807,-29.09,1212
2020-03-21,11188,17750,-6562,-36.97,1212
2020-03-22,9876,14155,-4279,-30.23,1212
2020-03-23,15673,22280,-6607,-29.65,1212
2020-03-24,15956,22943,-6987,-30.45,1212
2020-03-25,15956,22959,-7003,-30.5,1212
2020-03-26,15956,22958,-7002,-30.5,1212
2020-03-27,16596,23507,-6911,-29.4,1212
2020-03-28,11188,17875,-6687,-37.41,1212
2020-03-29,9876,14301,-4425,-30.94,1212
2020-03-30,15673,22447,-6774,-30.18,1212
2020-03-31,15956,23132,-7176,-31.02,1212
2020-04-01,14033,23168,-9135,-39.43,1212
2020-04-02,14033,23186,-9153,-39.48,1212
2020-04-03,13099,23752,-10653,-44.85,1212
2020-04-04,9150,18134,-8984,-49.54,1212
2020-04-05,6965,14571,-7606,-52.2,1212
2020-04-06,14480,22724,-8244,-36.28,1212
2020-04-07,14033,23412,-9379,-40.06,1212
2020-04-08,14033,23448,-9415,-40.15,1212
2020-04-09,14033,23461,-9428,-40.19,1212
2020-04-10,13099,24018,-10919,-45.46,1212
2020-04-11,9150,18387,-9237,-50.24,1212
2020-04-12,6965,14807,-7842,-52.96,1212
2020-04-13,14480,22940,-8460,-36.88,1212
2020-04-14,14033,23605,-9572,-40.55,1212
2020-04-15,14033,23615,-9582,-40.58,1212
2020-04-16,14033,23599,-9566,-40.54,1212
2020-04-17,13099,24126,-11027,-45.71,1212
2020-04-18,9150,18463,-9313,-50.44,1212
2020-04-19,6965,14852,-7887,-53.1,1212
2020-04-20,14480,22953,-8473,-36.91,1212
2020-04-21,14033,23587,-9554,-40.51,1212
2020-04-22,14033,23567,-9534,-40.45,1212
2020-04-23,14033,23523,-9490,-40.34,1212
2020-04-24,13099,24024,-10925,-45.48,1212
2020-04-25,9150,18339,-9189,-50.11,1212
2020-04-26,6965,14707,-7742,-52.64,1212
2020-04-27,14480,22792,-8312,-36.47,1212
2020-04-28,14033,23413,-9380,-40.06,1212
2020-04-29,14033,23383,-9350,-39.99,1212
2020-04-30,14033,23334,-9301,-39.86,1212
2020-05-01,20541,23832,-3291,-13.81,1212
2020-05-02,15211,18148,-2937,-16.18,1212
2020-05-03,11867,14521,-2654,-18.28,1212
2020-05-04,20145,22613,-2468,-10.91,1212
2020-05-05,20872,23243,-2371,-10.2,1212
2020-05-06,20872,23225,-2353,-10.13,1212
2020-05-07,20872,23189,-2317,-9.99,1212
2020-05-08,20541,23703,-3162,-13.34,1212
2020-05-09,15211,18034,-2823,-15.65,1212
2020-05-10,11867,14423,-2556,-17.72,1212
2020-05-11,20145,22531,-2386,-10.59,1212
2020-05-12,20872,23177,-2305,-9.95,1212
2020-05-13,20872,23174,-2302,-9.93,1212
2020-05-14,20872,23152,-2280,-9.85,1212
2020-05-15,20541,23678,-3137,-13.25,1212
2020-05-16,15211,18019,-2808,-15.58,1212
2020-05-17,11867,14417,-2550,-17.69,1212
2020-05-18,20145,22531,-2386,-10.59,1212
2020-05-19,20872,23182,-2310,-9.96,1212
2020-05-20,20872,23181,-2309,-9.96,1212
2020-05-21,20872,23160,-2288,-9.88,1212
2020-05-22,20541,23684,-3143,-13.27,1212
2020-05-23,15211,18024,-2813,-15.61,1212
2020-05-24,11867,14417,-2550,-17.69,1212
2020-05-25,20145,22526,-2381,-10.57,1212
2020-05-26,20872,23170,-2298,-9.92,1212
2020-05-27,20872,23162,-2290,-9.89,1212
2020-05-28,20872,23133,-2261,-9.77,1212
2020-05-29,20541,23650,-3109,-13.15,1212
2020-05-30,15211,17981,-2770,-15.41,1212
2020-05-31,11867,14367,-2500,-17.4,1212
2020-06-01,22305,22470,-165,-0.73,1212
2020-06-02,23376,23108,268,1.16,1212
2020-06-03,23376,23095,281,1.22,1212
2020-06-04,23376,23062,314,1.36,1212
2020-06-05,22320,23576,-1256,-5.33,1212
2020-06-06,18509,17906,603,3.37,1212
2020-06-07,13722,14291,-569,-3.98,1212
2020-06-08,22305,22394,-89,-0.4,1212
2020-06-09,23376,23034,342,1.48,1212
2020-06-10,23376,23024,352,1.53,1212
2020-06-11,23376,22994,382,1.66,1212
2020-06-12,22320,23513,-1193,-5.07,1212
2020-06-13,18509,17847,662,3.71,1212
2020-06-14,13722,14238,-516,-3.62,1212
2020-06-15,22305,22346,-41,-0.18,1212
2020-06-16,23376,22992,384,1.67,1212
2020-06-17,23376,22988,388,1.69,1212
2020-06-18,23376,22964,412,1.79,1212
2020-06-19,22320,23488,-1168,-4.97,1212
2020-06-20,18509,17828,681,3.82,1212
2020-06-21,13722,14223,-501,-3.52,1212
2020-06-22,22305,22336,-31,-0.14,1212
2020-06-23,23376,22986,390,1.7,1212
2020-06-24,23376,22986,390,1.7,1212
2020-06-25,23376,22966,410,1.79,1212
2020-06-26,22320,23492,-1172,-4.99,1212
2020-06-27,18509,17835,674,3.78,1212
2020-06-28,13722,14233,-511,-3.59,1212
2020-06-29,22305,22349,-44,-0.2,1212
2020-06-30,23376,23001,375,1.63,1212
2020-07-01,22342,23003,-661,-2.87,1212
2020-07-02,22342,22984,-642,-2.79,1212
2020-07-03,22231,23513,-1282,-5.45,1212
2020-07-04,16956,17858,-902,-5.05,1212
2020-07-05,14916,14258,658,4.61,1212
2020-07-06,21582,22375,-793,-3.54,1212
2020-07-07,22342,23029,-687,-2.98,1212
2020-07-08,22342,23033,-691,-3.0,1212
2020-07-09,22342,23016,-674,-2.93,1212
2020-07-10,22231,23546,-1315,-5.58,1212
2020-07-11,16956,17891,-935,-5.23,1212
2020-07-12,14916,14292,624,4.37,1212
2020-07-13,21582,22409,-827,-3.69,1212
2020-07-14,22342,23063,-721,-3.13,1212
2020-07-15,22342,23065,-723,-3.13,1212
2020-07-16,22342,23046,-704,-3.05,1212
2020-07-17,22231,23573,-1342,-5.69,1212
2020-07-18,16956,17915,-959,-5.35,1212
2020-07-19,14916,14311,605,4.23,1212
2020-07-20,21582,22423,-841,-3.75,1212
2020-07-21,22342,23071,-729,-3.16,1212
2020-07-22,22342,23066,-724,-3.14,1212
2020-07-23,22342,23040,-698,-3.03,1212
2020-07-24,22231,23559,-1328,-5.64,1212
2020-07-25,16956,17893,-937,-5.24,1212
2020-07-26,14916,14280,636,4.45,1212
2020-07-27,21582,22384,-802,-3.58,1212
2020-07-28,22342,23023,-681,-2.96,1212
2020-07-29,22342,23011,-669,-2.91,1212
2020-07-30,22342,22977,-635,-2.76,1212
2020-07-31,22231,23490,-1259,-5.36,1212
2020-08-01,18252,17818,434,2.44,1212
2020-08-02,15154,14202,952,6.7,1212
2020-08-03,21209,22302,-1093,-4.9,1212
2020-08-04,21304,22940,-1636,-7.13,1212
2020-08-05,21304,22927,-1623,-7.08,1212
2020-08-06,21304,22894,-1590,-6.95,1212
2020-08-07,21849,23410,-1561,-6.67,1212
2020-08-08,18252,17742,510,2.87,1212
2020-08-09,15154,14130,1024,7.25,1212
2020-08-10,21209,22237,-1028,-4.62,1212
2020-08-11,21304,22881,-1577,-6.89,1212
2020-08-12,21304,22875,-1571,-6.87,1212
2020-08-13,21304,22851,-1547,-6.77,1212
2020-08-14,21849,23374,-1525,-6.52,1212
2020-08-15,18252,17714,538,3.04,1212
2020-08-16,15154,14109,1045,7.41,1212
2020-08-17,21209,22222,-1013,-4.56,1212
2020-08-18,21304,22871,-1567,-6.85,1212
2020-08-19,21304,22869,-1565,-6.84,1212
2020-08-20,21304,22846,-1542,-6.75,1212
2020-08-21,21849,23369,-1520,-6.5,1212
2020-08-22,18252,17707,545,3.08,1212
2020-08-23,15154,14097,1057,7.5,1212
2020-08-24,21209,22204,-995,-4.48,1212
2020-08-25,21304,22844,-1540,-6.74,1212
2020-08-26,21304,22831,-1527,-6.69,1212
2020-08-27,21304,22795,-1491,-6.54,1212
2020-08-28,21849,23304,-1455,-6.24,1212
2020-08-29,18252,17625,627,3.56,1212
2020-08-30,15154,13999,1155,8.25,1212
2020-08-31,21209,22088,-879,-3.98,1212
2020-09-01,23563,22710,853,3.76,1212
2020-09-02,23563,22679,884,3.9,1212
2020-09-03,23563,22627,936,4.14,1212
2020-09-04,23337,23120,217,0.94,1212
2020-09-05,17534,17427,107,0.61,1212
2020-09-06,14297,13789,508,3.68,1212
2020-09-07,22296,21869,427,1.95,1212
2020-09-08,23563,22485,1078,4.79,1212
2020-09-09,23563,22452,1111,4.95,1212
2020-09-10,23563,22401,1162,5.19,1212
2020-09-11,23337,22899,438,1.91,1212
2020-09-12,17534,17215,319,1.85,1212
2020-09-13,14297,13590,707,5.2,1212
2020-09-14,22296,21686,610,2.81,1212
2020-09-15,23563,22323,1240,5.55,1212
2020-09-16,23563,22314,1249,5.6,1212
2020-09-17,23563,22290,1273,5.71,1212
2020-09-18,23337,22817,520,2.28,1212
2020-09-19,17534,17165,369,2.15,1212
2020-09-20,14297,13574,723,5.33,1212
2020-09-21,22296,21704,592,2.73,1212
2020-09-22,23563,22375,1188,5.31,1212
2020-09-23,23563,22400,1163,5.19,1212
2020-09-24,23563,22408,1155,5.15,1212
2020-09-25,23337,22967,370,1.61,1212
2020-09-26,17534,17343,191,1.1,1212
2020-09-27,14297,13777,520,3.77,1212
2020-09-28,22296,21930,366,1.67,1212
2020-09-29,23563,22619,944,4.17,1212
2020-09-30,23563,22657,906,4.0,1212
2020-10-01,22734,22674,60,0.26,1212
2020-10-02,22487,23237,-750,-3.23,1212
2020-10-03,16988,17613,-625,-3.55,1212
2020-10-04,13551,14042,-491,-3.5,1212
2020-10-05,22158,22184,-26,-0.12,1212
2020-10-06,22734,22859,-125,-0.55,1212
2020-10-07,22734,22880,-146,-0.64,1212
2020-10-08,22734,22875,-141,-0.62,1212
2020-10-09,22487,23414,-927,-3.96,1212
2020-10-10,16988,17764,-776,-4.37,1212
2020-10-11,13551,14164,-613,-4.33,1212
2020-10-12,22158,22278,-120,-0.54,1212
2020-10-13,22734,22924,-190,-0.83,1212
2020-10-14,22734,22916,-182,-0.79,1212
2020-10-15,22734,22885,-151,-0.66,1212
2020-10-16,22487,23398,-911,-3.89,1212
2020-10-17,16988,17725,-737,-4.16,1212
2020-10-18,13551,14106,-555,-3.93,1212
2020-10-19,22158,22203,-45,-0.2,1212
2020-10-20,22734,22837,-103,-0.45,1212
2020-10-21,22734,22820,-86,-0.38,1212
2020-10-22,22734,22784,-50,-0.22,1212
2020-10-23,22487,23296,-809,-3.47,1212
2020-10-24,16988,17626,-638,-3.62,1212
2020-10-25,13551,14013,-462,-3.3,1212
2020-10-26,22158,22121,37,0.17,1212
2020-10-27,22734,22767,-33,-0.14,1212
2020-10-28,22734,22765,-31,-0.14,1212
2020-10-29,22734,22746,-12,-0.05,1212
2020-10-30,22487,23276,-789,-3.39,1212
2020-10-31,16988,17625,-637,-3.61,1212
2020-11-01,10977,14031,-3054,-21.77,1212
2020-11-02,19192,22155,-2963,-13.37,1212
2020-11-03,17774,22817,-5043,-22.1,1212
2020-11-04,17774,22830,-5056,-22.15,1212
2020-11-05,17774,22822,-5048,-22.12,1212
2020-11-06,18396,23361,-4965,-21.25,1212
2020-11-07,13000,17715,-4715,-26.62,1212
2020-11-08,10977,14122,-3145,-22.27,1212
2020-11-09,19192,22244,-3052,-13.72,1212
2020-11-10,17774,22900,-5126,-22.38,1212
2020-11-11,17774,22903,-5129,-22.39,1212
2020-11-12,17774,22881,-5107,-22.32,1212
2020-11-13,18396,23403,-5007,-21.39,1212
2020-11-14,13000,17737,-4737,-26.71,1212
2020-11-15,10977,14121,-3144,-22.26,1212
2020-11-16,19192,22219,-3027,-13.62,1212
2020-11-17,17774,22849,-5075,-22.21,1212
2020-11-18,17774,22825,-5051,-22.13,1212
2020-11-19,17774,22777,-5003,-21.97,1212
2020-11-20,18396,23273,-4877,-20.96,1212
2020-11-21,13000,17582,-4582,-26.06,1212
2020-11-22,10977,13944,-2967,-21.28,1212
2020-11-23,19192,22022,-2830,-12.85,1212
2020-11-24,17774,22635,-4861,-21.48,1212
2020-11-25,17774,22597,-4823,-21.34,1212
2020-11-26,17774,22539,-4765,-21.14,1212
2020-11-27,18396,23029,-4633,-20.12,1212
2020-11-28,13000,17336,-4336,-25.01,1212
2020-11-29,10977,13700,-2723,-19.88,1212
2020-11-30,19192,21784,-2592,-11.9,1212
2020-12-01,18302,22407,-4105,-18.32,1212
2020-12-02,18302,22382,-4080,-18.23,1212
2020-12-03,18302,22339,-4037,-18.07,1212
2020-12-04,19968,22847,-2879,-12.6,1212
2020-12-05,14554,17174,-2620,-15.26,1212
2020-12-06,10801,13559,-2758,-20.34,1212
2020-12-07,18450,21663,-3213,-14.83,1212
2020-12-08,18302,22306,-4004,-17.95,1212
2020-12-09,18302,22301,-3999,-17.93,1212
2020-12-10,18302,22276,-3974,-17.84,1212
2020-12-11,19968,22799,-2831,-12.42,1212
2020-12-12,14554,17137,-2583,-15.07,1212
2020-12-13,10801,13530,-2729,-20.17,1212
2020-12-14,18450,21639,-3189,-14.74,1212
2020-12-15,18302,22282,-3980,-17.86,1212
2020-12-16,18302,22272,-3970,-17.83,1212
2020-12-17,18302,22238,-3936,-17.7,1212
2020-12-18,19968,22747,-2779,-12.22,1212
2020-12-19,14554,17067,-2513,-14.72,1212
2020-12-20,10801,13438,-2637,-19.62,1212
2020-12-21,18450,21522,-3072,-14.27,1212
2020-12-22,18302,22136,-3834,-17.32,1212
2020-12-23,18302,22095,-3793,-17.17,1212
2020-12-24,18302,22028,-3726,-16.91,1212
2020-12-25,19968,22504,-2536,-11.27,1212
2020-12-26,14554,16790,-2236,-13.32,1212
2020-12-27,10801,13128,-2327,-17.73,1212
2020-12-28,18450,21180,-2730,-12.89,1212
2020-12-29,18302,21766,-3464,-15.91,1212
2020-12-30,18302,21699,-3397,-15.66,1212
2020-12-31,18302,21610,-3308,-15.31,1212
2021-01-01,17653,22068,-4415,-20.01,1212
2021-01-02,11754,16342,-4588,-28.07,1212
2021-01-03,9736,12673,-2937,-23.18,1212
2021-01-04,16408,20724,-4316,-20.83,1212
2021-01-05,17236,21314,-4078,-19.13,1212
2021-01-06,17236,21257,-4021,-18.92,1212
2021-01-07,17236,21184,-3948,-18.64,1212
2021-01-08,17653,21663,-4010,-18.51,1212
2021-01-09,11754,15964,-4210,-26.37,1212
2021-01-10,9736,12326,-2590,-21.01,1212
2021-01-11,16408,20411,-4003,-19.61,1212
2021-01-12,17236,21038,-3802,-18.07,1212
2021-01-13,17236,21022,-3786,-18.01,1212
2021-01-14,17236,20991,-3755,-17.89,1212
2021-01-15,17653,21514,-3861,-17.95,1212
2021-01-16,11754,15857,-4103,-25.88,1212
2021-01-17,9736,12261,-2525,-20.59,1212
2021-01-18,16408,20387,-3979,-19.52,1212
2021-01-19,17236,21053,-3817,-18.13,1212
2021-01-20,17236,21072,-3836,-18.2,1212
2021-01-21,17236,21073,-3837,-18.21,1212
2021-01-22,17653,21622,-3969,-18.36,1212
2021-01-23,11754,15989,-4235,-26.49,1212
2021-01-24,9736,12411,-2675,-21.55,1212
2021-01-25,16408,20551,-4143,-20.16,1212
2021-01-26,17236,21225,-3989,-18.79,1212
2021-01-27,17236,21248,-4012,-18.88,1212
2021-01-28,17236,21249,-4013,-18.89,1212
2021-01-29,17653,21795,-4142,-19.0,1212
2021-01-30,11754,16154,-4400,-27.24,1212
2021-01-31,9736,12565,-2829,-22.51,1212
2021-02-01,19268,20691,-1423,-6.88,1212
2021-02-02,19687,21351,-1664,-7.79,1212
2021-02-03,19687,21358,-1671,-7.82,1212
2021-02-04,19687,21342,-1655,-7.75,1212
2021-02-05,19890,21872,-1982,-9.06,1212
2021-02-06,14599,16216,-1617,-9.97,1212
2021-02-07,11519,12614,-1095,-8.68,1212
2021-02-08,19268,20728,-1460,-7.04,1212
2021-02-09,19687,21379,-1692,-7.91,1212
2021-02-10,19687,21380,-1693,-7.92,1212
2021-02-11,19687,21362,-1675,-7.84,1212
2021-02-12,19890,21892,-2002,-9.14,1212
2021-02-13,14599,16239,-1640,-10.1,1212
2021-02-14,11519,12645,-1126,-8.9,1212
2021-02-15,19268,20770,-1502,-7.23,1212
2021-02-16,19687,21434,-1747,-8.15,1212
2021-02-17,19687,21451,-1764,-8.22,1212
2021-02-18,19687,21450,-1763,-8.22,1212
2021-02-19,19890,22000,-2110,-9.59,1212
2021-02-20,14599,16369,-1770,-10.81,1212
2021-02-21,11519,12795,-1276,-9.97,1212
2021-02-22,19268,20941,-1673,-7.99,1212
2021-02-23,19687,21626,-1939,-8.97,1212
2021-02-24,19687,21662,-1975,-9.12,1212
2021-02-25,19687,21679,-1992,-9.19,1212
2021-02-26,19890,22243,-2353,-10.58,1212
2021-02-27,14599,16624,-2025,-12.18,1212
2021-02-28,11519,13060,-1541,-11.8,1212
2021-03-01,20404,21211,-807,-3.8,1212
2021-03-02,20794,21898,-1104,-5.04,1212
2021-03-03,20794,21933,-1139,-5.19,1212
2021-03-04,20794,21945,-1151,-5.24,1212
2021-03-05,20542,22501,-1959,-8.71,1212
2021-03-06,15888,16870,-982,-5.82,1212
2021-03-07,11842,13291,-1449,-10.9,1212
2021-03-08,20404,21427,-1023,-4.77,1212
2021-03-09,20794,22095,-1301,-5.89,1212
2021-03-10,20794,22110,-1316,-5.95,1212
2021-03-11,20794,22101,-1307,-5.91,1212
2021-03-12,20542,22636,-2094,-9.25,1212
2021-03-13,15888,16985,-1097,-6.46,1212
2021-03-14,11842,13387,-1545,-11.54,1212
2021-03-15,20404,21505,-1101,-5.12,1212
2021-03-16,20794,22157,-1363,-6.15,1212
2021-03-17,20794,22159,-1365,-6.16,1212
2021-03-18,20794,22140,-1346,-6.08,1212
2021-03-19,20542,22669,-2127,-9.38,1212
2021-03-20,15888,17015,-1127,-6.62,1212
2021-03-21,11842,13417,-1575,-11.74,1212
2021-03-22,20404,21538,-1134,-5.27,1212
2021-03-23,20794,22198,-1404,-6.32,1212
2021-03-24,20794,22211,-1417,-6.38,1212
2021-03-25,20794,22205,-1411,-6.35,1212
2021-03-26,20542,22751,-2209,-9.71,1212
2021-03-27,15888,17114,-1226,-7.16,1212
2021-03-28,11842,13537,-1695,-12.52,1212
2021-03-29,20404,21679,-1275,-5.88,1212
2021-03-30,20794,22361,-1567,-7.01,1212
2021-03-31,20794,22394,-1600,-7.14,1212
2021-04-01,16959,22410,-5451,-24.32,1212
2021-04-02,17300,22974,-5674,-24.7,1212
2021-04-03,13006,17355,-4349,-25.06,1212
2021-04-04,10852,13792,-2940,-21.32,1212
2021-04-05,16856,21946,-5090,-23.19,1212
2021-04-06,16959,22636,-5677,-25.08,1212
2021-04-07,16959,22674,-5715,-25.21,1212
2021-04-08,16959,22690,-5731,-25.26,1212
2021-04-09,17300,23250,-5950,-25.59,1212
2021-04-10,13006,17624,-4618,-26.2,1212
2021-04-11,10852,14049,-3197,-22.76,1212
2021-04-12,16856,22187,-5331,-24.03,1212
2021-04-13,16959,22857,-5898,-25.8,1212
2021-04-14,16959,22873,-5914,-25.86,1212
2021-04-15,16959,22863,-5904,-25.82,1212
2021-04-16,17300,23396,-6096,-26.06,1212
2021-04-17,13006,17739,-4733,-26.68,1212
2021-04-18,10852,14133,-3281,-23.22,1212
2021-04-19,16856,22240,-5384,-24.21,1212
2021-04-20,16959,22878,-5919,-25.87,1212
2021-04-21,16959,22862,-5903,-25.82,1212
2021-04-22,16959,22823,-5864,-25.69,1212
2021-04-23,17300,23327,-6027,-25.84,1212
2021-04-24,13006,17644,-4638,-26.29,1212
2021-04-25,10852,14014,-3162,-22.56,1212
2021-04-26,16856,22100,-5244,-23.73,1212
2021-04-27,16959,22721,-5762,-25.36,1212
2021-04-28,16959,22691,-5732,-25.26,1212
2021-04-29,16959,22641,-5682,-25.1,1212
2021-04-30,17300,23138,-5838,-25.23,1212
2021-05-01,15713,17452,-1739,-9.96,1212
2021-05-02,11702,13823,-2121,-15.34,1212
2021-05-03,18013,21912,-3899,-17.79,1212
2021-05-04,18375,22540,-4165,-18.48,1212
2021-05-05,18375,22519,-4144,-18.4,1212
2021-05-06,18375,22480,-4105,-18.26,1212
2021-05-07,18871,22990,-4119,-17.92,1212
2021-05-08,15713,17319,-1606,-9.27,1212
2021-05-09,11702,13705,-2003,-14.62,1212
2021-05-10,18013,21810,-3797,-17.41,1212
2021-05-11,18375,22454,-4079,-18.17,1212
2021-05-12,18375,22449,-4074,-18.15,1212
2021-05-13,18375,22425,-4050,-18.06,1212
2021-05-14,18871,22950,-4079,-17.77,1212
2021-05-15,15713,17291,-1578,-9.13,1212
2021-05-16,11702,13688,-1986,-14.51,1212
2021-05-17,18013,21802,-3789,-17.38,1212
2021-05-18,18375,22453,-4078,-18.16,1212
2021-05-19,18375,22453,-4078,-18.16,1212
2021-05-20,18375,22432,-4057,-18.09,1212
2021-05-21,18871,22958,-4087,-17.8,1212
2021-05-22,15713,17298,-1585,-9.16,1212
2021-05-23,11702,13693,-1991,-14.54,1212
2021-05-24,18013,21803,-3790,-17.38,1212
2021-05-25,18375,22449,-4074,-18.15,1212
2021-05-26,18375,22443,-4068,-18.13,1212
2021-05-27,18375,22415,-4040,-18.02,1212
2021-05-28,18871,22933,-4062,-17.71,1212
2021-05-29,15713,17266,-1553,-8.99,1212
2021-05-30,11702,13652,-1950,-14.28,1212
2021-05-31,18013,21756,-3743,-17.2,1212
2021-06-01,20955,22394,-1439,-6.43,1212
2021-06-02,20955,22382,-1427,-6.38,1212
2021-06-03,20955,22349,-1394,-6.24,1212
2021-06-04,20825,22863,-2038,-8.91,1212
2021-06-05,16403,17192,-789,-4.59,1212
2021-06-06,14403,13577,826,6.08,1212
2021-06-07,19341,21679,-2338,-10.78,1212
2021-06-08,20955,22318,-1363,-6.11,1212
2021-06-09,20955,22308,-1353,-6.07,1212
2021-06-10,20955,22277,-1322,-5.93,1212
2021-06-11,20825,22794,-1969,-8.64,1212
2021-06-12,16403,17128,-725,-4.23,1212
2021-06-13,14403,13517,886,6.55,1212
2021-06-14,19341,21625,-2284,-10.56,1212
2021-06-15,20955,22269,-1314,-5.9,1212
2021-06-16,20955,22264,-1309,-5.88,1212
2021-06-17,20955,22239,-1284,-5.77,1212
2021-06-18,20825,22762,-1937,-8.51,1212
2021-06-19,16403,17101,-698,-4.08,1212
2021-06-20,14403,13496,907,6.72,1212
2021-06-21,19341,21609,-2268,-10.5,1212
2021-06-22,20955,22258,-1303,-5.85,1212
2021-06-23,20955,22257,-1302,-5.85,1212
2021-06-24,20955,22237,-1282,-5.77,1212
2021-06-25,20825,22763,-1938,-8.51,1212
2021-06-26,16403,17105,-702,-4.1,1212
2021-06-27,14403,13503,900,6.67,1212
2021-06-28,19341,21618,-2277,-10.53,1212
2021-06-29,20955,22270,-1315,-5.9,1212
2021-06-30,20955,22272,-1317,-5.91,1212
2021-07-01,19646,22253,-2607,-11.72,1212
2021-07-02,19937,22781,-2844,-12.48,1212
2021-07-03,16401,17126,-725,-4.23,1212
2021-07-04,13343,13525,-182,-1.35,1212
2021-07-05,19443,21643,-2200,-10.16,1212
2021-07-06,19646,22296,-2650,-11.89,1212
2021-07-07,19646,22299,-2653,-11.9,1212
2021-07-08,19646,22282,-2636,-11.83,1212
2021-07-09,19937,22812,-2875,-12.6,1212
2021-07-10,16401,17158,-757,-4.41,1212
2021-07-11,13343,13559,-216,-1.59,1212
2021-07-12,19443,21676,-2233,-10.3,1212
2021-07-13,19646,22330,-2684,-12.02,1212
2021-07-14,19646,22333,-2687,-12.03,1212
2021-07-15,19646,22315,-2669,-11.96,1212
2021-07-16,19937,22843,-2906,-12.72,1212
2021-07-17,16401,17186,-785,-4.57,1212
2021-07-18,13343,13583,-240,-1.77,1212
2021-07-19,19443,21697,-2254,-10.39,1212
2021-07-20,19646,22346,-2700,-12.08,1212
2021-07-21,19646,22342,-2696,-12.07,1212
2021-07-22,19646,22318,-2672,-11.97,1212
2021-07-23,19937,22839,-2902,-12.71,1212
2021-07-24,16401,17174,-773,-4.5,1212
2021-07-25,13343,13563,-220,-1.62,1212
2021-07-26,19443,21668,-2225,-10.27,1212
2021-07-27,19646,22308,-2662,-11.93,1212
2021-07-28,19646,22297,-2651,-11.89,1212
2021-07-29,19646,22264,-2618,-11.76,1212
2021-07-30,19937,22778,-2841,-12.47,1212
2021-07-31,16401,17107,-706,-4.13,1212
2021-08-01,12954,13490,-536,-3.97,1212
2021-08-02,18752,21591,-2839,-13.15,1212
2021-08-03,18835,22227,-3392,-15.26,1212
2021-08-04,18835,22214,-3379,-15.21,1212
2021-08-05,18835,22180,-3345,-15.08,1212
2021-08-06,18850,22695,-3845,-16.94,1212
2021-08-07,15552,17026,-1474,-8.66,1212
2021-08-08,12954,13412,-458,-3.41,1212
2021-08-09,18752,21518,-2766,-12.85,1212
2021-08-10,18835,22160,-3325,-15.0,1212
2021-08-11,18835,22153,-3318,-14.98,1212
2021-08-12,18835,22127,-3292,-14.88,1212
2021-08-13,18850,22649,-3799,-16.77,1212
2021-08-14,15552,16988,-1436,-8.45,1212
2021-08-15,12954,13382,-428,-3.2,1212
2021-08-16,18752,21495,-2743,-12.76,1212
2021-08-17,18835,22144,-3309,-14.94,1212
2021-08-18,18835,22142,-3307,-14.94,1212
2021-08-19,18835,22120,-3285,-14.85,1212
2021-08-20,18850,22644,-3794,-16.75,1212
2021-08-21,15552,16983,-1431,-8.43,1212
2021-08-22,12954,13376,-422,-3.15,1212
2021-08-23,18752,21485,-2733,-12.72,1212
2021-08-24,18835,22127,-3292,-14.88,1212
2021-08-25,18835,22117,-3282,-14.84,1212
2021-08-26,18835,22085,-3250,-14.72,1212
2021-08-27,18850,22597,-3747,-16.58,1212
2021-08-28,15552,16922,-1370,-8.1,1212
2021-08-29,12954,13299,-345,-2.59,1212
2021-08-30,18752,21391,-2639,-12.34,1212
2021-08-31,18835,22016,-3181,-14.45,1212
2021-09-01,21371,21988,-617,-2.81,1212
2021-09-02,21371,21938,-567,-2.58,1212
2021-09-03,21374,22432,-1058,-4.72,1212
2021-09-04,17441,16741,700,4.18,1212
2021-09-05,15257,13104,2153,16.43,1212
2021-09-06,20524,21184,-660,-3.12,1212
2021-09-07,21371,21799,-428,-1.96,1212
2021-09-08,21371,21765,-394,-1.81,1212
2021-09-09,21371,21711,-340,-1.57,1212
2021-09-10,21374,22206,-832,-3.75,1212
2021-09-11,17441,16519,922,5.58,1212
2021-09-12,15257,12889,2368,18.37,1212
2021-09-13,20524,20981,-457,-2.18,1212
2021-09-14,21371,21612,-241,-1.12,1212
2021-09-15,21371,21597,-226,-1.05,1212
2021-09-16,21371,21567,-196,-0.91,1212
2021-09-17,21374,22088,-714,-3.23,1212
2021-09-18,17441,16430,1011,6.15,1212
2021-09-19,15257,12832,2425,18.9,1212
2021-09-20,20524,20956,-432,-2.06,1212
2021-09-21,21371,21621,-250,-1.16,1212
2021-09-22,21371,21641,-270,-1.25,1212
2021-09-23,21371,21644,-273,-1.26,1212
2021-09-24,21374,22198,-824,-3.71,1212
2021-09-25,17441,16572,869,5.24,1212
2021-09-26,15257,13003,2254,17.33,1212
2021-09-27,20524,21153,-629,-2.97,1212
2021-09-28,21371,21841,-470,-2.15,1212
2021-09-29,21371,21880,-509,-2.33,1212
2021-09-30,21371,21898,-527,-2.41,1212
2021-10-01,21733,22463,-730,-3.25,1212
2021-10-02,18814,16841,1973,11.72,1212
2021-10-03,14919,13273,1646,12.4,1212
2021-10-04,20323,21419,-1096,-5.12,1212
2021-10-05,21216,22099,-883,-4.0,1212
2021-10-06,21216,22124,-908,-4.1,1212
2021-10-07,21216,22125,-909,-4.11,1212
2021-10-08,21733,22669,-936,-4.13,1212
2021-10-09,18814,17025,1789,10.51,1212
2021-10-10,14919,13430,1489,11.09,1212
2021-10-11,20323,21549,-1226,-5.69,1212
2021-10-12,21216,22200,-984,-4.43,1212
2021-10-13,21216,22197,-981,-4.42,1212
2021-10-14,21216,22169,-953,-4.3,1212
2021-10-15,21733,22685,-952,-4.2,1212
2021-10-16,18814,17015,1799,10.57,1212
2021-10-17,14919,13397,1522,11.36,1212
2021-10-18,20323,21496,-1173,-5.46,1212
2021-10-19,21216,22129,-913,-4.13,1212
2021-10-20,21216,22112,-896,-4.05,1212
2021-10-21,21216,22074,-858,-3.89,1212
2021-10-22,21733,22585,-852,-3.77,1212
2021-10-23,18814,16913,1901,11.24,1212
2021-10-24,14919,13297,1622,12.2,1212
2021-10-25,20323,21401,-1078,-5.04,1212
2021-10-26,21216,22044,-828,-3.76,1212
2021-10-27,21216,22038,-822,-3.73,1212
2021-10-28,21216,22016,-800,-3.63,1212
2021-10-29,21733,22543,-810,-3.59,1212
2021-10-30,18814,16888,1926,11.4,1212
2021-10-31,14919,13291,1628,12.25,1212
2021-11-01,18700,21414,-2714,-12.67,1212
2021-11-02,20027,22074,-2047,-9.27,1212
2021-11-03,20027,22085,-2058,-9.32,1212
2021-11-04,20027,22077,-2050,-9.29,1212
2021-11-05,20811,22616,-1805,-7.98,1212
2021-11-06,16141,16971,-830,-4.89,1212
2021-11-07,12870,13380,-510,-3.81,1212
2021-11-08,18700,21505,-2805,-13.04,1212
2021-11-09,20027,22164,-2137,-9.64,1212
2021-11-10,20027,22170,-2143,-9.67,1212
2021-11-11,20027,22153,-2126,-9.6,1212
2021-11-12,20811,22679,-1868,-8.24,1212
2021-11-13,16141,17018,-877,-5.15,1212
2021-11-14,12870,13407,-537,-4.01,1212
2021-11-15,18700,21510,-2810,-13.06,1212
2021-11-16,20027,22145,-2118,-9.56,1212
2021-11-17,20027,22126,-2099,-9.49,1212
2021-11-18,20027,22082,-2055,-9.31,1212
2021-11-19,20811,22582,-1771,-7.84,1212
2021-11-20,16141,16894,-753,-4.46,1212
2021-11-21,12870,13259,-389,-2.93,1212
2021-11-22,18700,21339,-2639,-12.37,1212
2021-11-23,20027,21953,-1926,-8.77,1212
2021-11-24,20027,21916,-1889,-8.62,1212
2021-11-25,20027,21857,-1830,-8.37,1212
2021-11-26,20811,22346,-1535,-6.87,1212
2021-11-27,16141,16651,-510,-3.06,1212
2021-11-28,12870,13013,-143,-1.1,1212
2021-11-29,18700,21094,-2394,-11.35,1212
2021-11-30,20027,21713,-1686,-7.76,1212
2021-12-01,18999,21684,-2685,-12.38,1212
2021-12-02,18999,21638,-2639,-12.2,1212
2021-12-03,17537,22142,-4605,-20.8,1212
2021-12-04,14252,16465,-2213,-13.44,1212
2021-12-05,12009,12846,-837,-6.52,1212
2021-12-06,19112,20947,-1835,-8.76,1212
2021-12-07,18999,21587,-2588,-11.99,1212
2021-12-08,18999,21579,-2580,-11.96,1212
2021-12-09,18999,21552,-2553,-11.85,1212
2021-12-10,17537,22074,-4537,-20.55,1212
2021-12-11,14252,16413,-2161,-13.17,1212
2021-12-12,12009,12806,-797,-6.22,1212
2021-12-13,19112,20917,-1805,-8.63,1212
2021-12-14,18999,21562,-2563,-11.89,1212
2021-12-15,18999,21555,-2556,-11.86,1212
2021-12-16,18999,21525,-2526,-11.74,1212
2021-12-17,17537,22039,-4502,-20.43,1212
2021-12-18,14252,16365,-2113,-12.91,1212
2021-12-19,12009,12741,-732,-5.75,1212
2021-12-20,19112,20831,-1719,-8.25,1212
2021-12-21,18999,21451,-2452,-11.43,1212
2021-12-22,18999,21416,-2417,-11.29,1212
2021-12-23,18999,21356,-2357,-11.04,1212
2021-12-24,17537,21837,-4300,-19.69,1212
2021-12-25,14252,16130,-1878,-11.64,1212
2021-12-26,12009,12473,-464,-3.72,1212
2021-12-27,19112,20529,-1417,-6.9,1212
2021-12-28,18999,21118,-2119,-10.03,1212
2021-12-29,18999,21053,-2054,-9.76,1212
2021-12-30,18999,20966,-1967,-9.38,1212
2021-12-31,17537,21425,-3888,-18.15,1212
2022-01-01,15132,15698,-566,-3.61,1212
2022-01-02,11405,12028,-623,-5.18,1212
2022-01-03,18137,20075,-1938,-9.65,1212
2022-01-04,18470,20661,-2191,-10.6,1212
2022-01-05,18470,20599,-2129,-10.34,1212
2022-01-06,18470,20521,-2051,-9.99,1212
2022-01-07,19404,20994,-1590,-7.57,1212
2022-01-08,15132,15288,-156,-1.02,1212
2022-01-09,11405,11642,-237,-2.04,1212
2022-01-10,18137,19719,-1582,-8.02,1212
2022-01-11,18470,20339,-1869,-9.19,1212
2022-01-12,18470,20315,-1845,-9.08,1212
2022-01-13,18470,20276,-1806,-8.91,1212
2022-01-14,19404,20791,-1387,-6.67,1212
2022-01-15,15132,15127,5,0.03,1212
2022-01-16,11405,11525,-120,-1.04,1212
2022-01-17,18137,19645,-1508,-7.68,1212
2022-01-18,18470,20305,-1835,-9.04,1212
2022-01-19,18470,20320,-1850,-9.1,1212
2022-01-20,18470,20317,-1847,-9.09,1212
2022-01-21,19404,20865,-1461,-7.0,1212
2022-01-22,15132,15230,-98,-0.64,1212
2022-01-23,11405,11651,-246,-2.11,1212
2022-01-24,18137,19790,-1653,-8.35,1212
2022-01-25,18470,20466,-1996,-9.75,1212
2022-01-26,18470,20490,-2020,-9.86,1212
2022-01-27,18470,20493,-2023,-9.87,1212
2022-01-28,19404,21042,-1638,-7.78,1212
2022-01-29,15132,15403,-271,-1.76,1212
2022-01-30,11405,11818,-413,-3.49,1212
2020-02-01,25216,23936,1280,5.35,1215
2020-02-02,20175,19627,548,2.79,1215
2020-02-03,26738,26463,275,1.04,1215
2020-02-04,27441,27029,412,1.52,1215
2020-02-05,27441,27052,389,1.44,1215
2020-02-06,27441,27095,346,1.28,1215
2020-02-07,29120,28378,742,2.61,1215
2020-02-08,25216,24131,1085,4.5,1215
2020-02-09,20175,19796,379,1.91,1215
2020-02-10,26738,26612,126,0.47,1215
2020-02-11,27441,27162,279,1.03,1215
2020-02-12,27441,27174,267,0.98,1215
2020-02-13,27441,27212,229,0.84,1215
2020-02-14,29120,28497,623,2.19,1215
2020-02-15,25216,24258,958,3.95,1215
2020-02-16,20175,19936,239,1.2,1215
2020-02-17,26738,26770,-32,-0.12,1215
2020-02-18,27441,27343,98,0.36,1215
2020-02-19,27441,27383,58,0.21,1215
2020-02-20,27441,27451,-10,-0.04,1215
2020-02-21,29120,28769,351,1.22,1215
2020-02-22,25216,24563,653,2.66,1215
2020-02-23,20175,20275,-100,-0.49,1215
2020-02-24,26738,27141,-403,-1.48,1215
2020-02-25,27441,27744,-303,-1.09,1215
2020-02-26,27441,27810,-369,-1.33,1215
2020-02-27,27441,27902,-461,-1.65,1215
2020-02-28,29120,29237,-117,-0.4,1215
2020-02-29,25216,25044,172,0.69,1215
2020-03-01,14294,20762,-6468,-31.15,1215
2020-03-02,20915,27630,-6715,-24.3,1215
2020-03-03,20993,28227,-7234,-25.63,1215
2020-03-04,20993,28283,-7290,-25.78,1215
2020-03-05,20993,28358,-7365,-25.97,1215
2020-03-06,22500,29671,-7171,-24.17,1215
2020-03-07,17002,25452,-8450,-33.2,1215
2020-03-08,14294,21140,-6846,-32.38,1215
2020-03-09,20915,27974,-7059,-25.23,1215
2020-03-10,20993,28537,-7544,-26.44,1215
2020-03-11,20993,28557,-7564,-26.49,1215
2020-03-12,20993,28596,-7603,-26.59,1215
2020-03-13,22500,29876,-7376,-24.69,1215
2020-03-14,17002,25624,-8622,-33.65,1215
2020-03-15,14294,21284,-6990,-32.84,1215
2020-03-16,20915,28093,-7178,-25.55,1215
2020-03-17,20993,28636,-7643,-26.69,1215
2020-03-18,20993,28641,-7648,-26.7,1215
2020-03-19,20993,28671,-7678,-26.78,1215
2020-03-20,22500,29947,-7447,-24.87,1215
2020-03-21,17002,25698,-8696,-33.84,1215
2020-03-22,14294,21366,-7072,-33.1,1215
2020-03-23,20915,28188,-7273,-25.8,1215
2020-03-24,20993,28749,-7756,-26.98,1215
2020-03-25,20993,28777,-7784,-27.05,1215
2020-03-26,20993,28833,-7840,-27.19,1215
2020-03-27,22500,30137,-7637,-25.34,1215
2020-03-28,17002,25918,-8916,-34.4,1215
2020-03-29,14294,21616,-7322,-33.87,1215
2020-03-30,20915,28469,-7554,-26.53,1215
2020-03-31,20993,29058,-8065,-27.75,1215
2020-04-01,21490,29112,-7622,-26.18,1215
2020-04-02,21490,29190,-7700,-26.38,1215
2020-04-03,20921,30513,-9592,-31.44,1215
2020-04-04,16147,26308,-10161,-38.62,1215
2020-04-05,11514,22014,-10500,-47.7,1215
2020-04-06,21330,28869,-7539,-26.11,1215
2020-04-07,21490,29455,-7965,-27.04,1215
2020-04-08,21490,29500,-8010,-27.15,1215
2020-04-09,21490,29563,-8073,-27.31,1215
2020-04-10,20921,30865,-9944,-32.22,1215
2020-04-11,16147,26633,-10486,-39.37,1215
2020-04-12,11514,22309,-10795,-48.39,1215
2020-04-13,21330,29131,-7801,-26.78,1215
2020-04-14,21490,29680,-8190,-27.59,1215
2020-04-15,21490,29686,-8196,-27.61,1215
2020-04-16,21490,29709,-8219,-27.67,1215
2020-04-17,20921,30972,-10051,-32.45,1215
2020-04-18,16147,26702,-10555,-39.53,1215
2020-04-19,11514,22342,-10828,-48.46,1215
2020-04-20,21330,29130,-7800,-26.78,1215
2020-04-21,21490,29649,-8159,-27.52,1215
2020-04-22,21490,29628,-8138,-27.47,1215
2020-04-23,21490,29630,-8140,-27.47,1215
2020-04-24,20921,30877,-9956,-32.24,1215
2020-04-25,16147,26596,-10449,-39.29,1215
2020-04-26,11514,22229,-10715,-48.2,1215
2020-04-27,21330,29016,-7686,-26.49,1215
2020-04-28,21490,29539,-8049,-27.25,1215
2020-04-29,21490,29526,-8036,-27.22,1215
2020-04-30,21490,29540,-8050,-27.25,1215
2020-05-01,28775,30801,-2026,-6.58,1215
2020-05-02,24262,26537,-2275,-8.57,1215
2020-05-03,18367,22190,-3823,-17.23,1215
2020-05-04,27098,28996,-1898,-6.55,1215
2020-05-05,27815,29538,-1723,-5.83,1215
2020-05-06,27815,29544,-1729,-5.85,1215
2020-05-07,27815,29575,-1760,-5.95,1215
2020-05-08,28775,30851,-2076,-6.73,1215
2020-05-09,24262,26598,-2336,-8.78,1215
2020-05-10,18367,22259,-3892,-17.49,1215
2020-05-11,27098,29071,-1973,-6.79,1215
2020-05-12,27815,29614,-1799,-6.07,1215
2020-05-13,27815,29619,-1804,-6.09,1215
2020-05-14,27815,29644,-1829,-6.17,1215
2020-05-15,28775,30911,-2136,-6.91,1215
2020-05-16,24262,26648,-2386,-8.95,1215
2020-05-17,18367,22297,-3930,-17.63,1215
2020-05-18,27098,29094,-1996,-6.86,1215
2020-05-19,27815,29623,-1808,-6.1,1215
2020-05-20,27815,29613,-1798,-6.07,1215
2020-05-21,27815,29626,-1811,-6.11,1215
2020-05-22,28775,30882,-2107,-6.82,1215
2020-05-23,24262,26611,-2349,-8.83,1215
2020-05-24,18367,22254,-3887,-17.47,1215
2020-05-25,27098,29051,-1953,-6.72,1215
2020-05-26,27815,29584,-1769,-5.98,1215
2020-05-27,27815,29582,-1767,-5.97,1215
2020-05-28,27815,29607,-1792,-6.05,1215
2020-05-29,28775,30881,-2106,-6.82,1215
2020-05-30,24262,26632,-2370,-8.9,1215
2020-05-31,18367,22302,-3935,-17.64,1215
2020-06-01,28010,29128,-1118,-3.84,1215
2020-06-02,28804,29693,-889,-2.99,1215
2020-06-03,28804,29724,-920,-3.1,1215
2020-06-04,28804,29783,-979,-3.29,1215
2020-06-05,29772,31090,-1318,-4.24,1215
2020-06-06,25772,26872,-1100,-4.09,1215
2020-06-07,20455,22569,-2114,-9.37,1215
2020-06-08,28010,29417,-1407,-4.78,1215
2020-06-09,28804,29999,-1195,-3.98,1215
2020-06-10,28804,30039,-1235,-4.11,1215
2020-06-11,28804,30100,-1296,-4.31,1215
2020-06-12,29772,31399,-1627,-5.18,1215
2020-06-13,25772,27162,-1390,-5.12,1215
2020-06-14,20455,22831,-2376,-10.41,1215
2020-06-15,28010,29640,-1630,-5.5,1215
2020-06-16,28804,30172,-1368,-4.53,1215
2020-06-17,28804,30154,-1350,-4.48,1215
2020-06-18,28804,30146,-1342,-4.45,1215
2020-06-19,29772,31367,-1595,-5.08,1215
2020-06-20,25772,27046,-1274,-4.71,1215
2020-06-21,20455,22624,-2169,-9.59,1215
2020-06-22,28010,29338,-1328,-4.53,1215
2020-06-23,28804,29773,-969,-3.25,1215
2020-06-24,28804,29656,-852,-2.87,1215
2020-06-25,28804,29550,-746,-2.52,1215
2020-06-26,29772,30677,-905,-2.95,1215
2020-06-27,25772,26267,-495,-1.88,1215
2020-06-28,20455,21763,-1308,-6.01,1215
2020-06-29,28010,28405,-395,-1.39,1215
2020-06-30,28804,28777,27,0.09,1215
2020-07-01,27997,28610,-613,-2.14,1215
2020-07-02,27997,28467,-470,-1.65,1215
2020-07-03,29060,29572,-512,-1.73,1215
2020-07-04,24941,25154,-213,-0.85,1215
2020-07-05,21345,20658,687,3.33,1215
2020-07-06,27560,27321,239,0.87,1215
2020-07-07,27997,27730,267,0.96,1215
2020-07-08,27997,27614,383,1.39,1215
2020-07-09,27997,27534,463,1.68,1215
2020-07-10,29060,28714,346,1.2,1215
2020-07-11,24941,24380,561,2.3,1215
2020-07-12,21345,19975,1370,6.86,1215
2020-07-13,27560,26735,825,3.09,1215
2020-07-14,27997,27244,753,2.76,1215
2020-07-15,27997,27229,768,2.82,1215
2020-07-16,27997,27249,748,2.75,1215
2020-07-17,29060,28524,536,1.88,1215
2020-07-18,24941,24279,662,2.73,1215
2020-07-19,21345,19956,1389,6.96,1215
2020-07-20,27560,26788,772,2.88,1215
2020-07-21,27997,27358,639,2.34,1215
2020-07-22,27997,27390,607,2.22,1215
2020-07-23,27997,27444,553,2.02,1215
2020-07-24,29060,28739,321,1.12,1215
2020-07-25,24941,24501,440,1.8,1215
2020-07-26,21345,20169,1176,5.83,1215
2020-07-27,27560,26981,579,2.15,1215
2020-07-28,27997,27516,481,1.75,1215
2020-07-29,27997,27503,494,1.8,1215
2020-07-30,27997,27503,494,1.8,1215
2020-07-31,29060,28735,325,1.13,1215
2020-08-01,24786,24429,357,1.46,1215
2020-08-02,20750,20027,723,3.61,1215
2020-08-03,26785,26766,19,0.07,1215
2020-08-04,27355,27231,124,0.46,1215
2020-08-05,27355,27152,203,0.75,1215
2020-08-06,27355,27091,264,0.97,1215
2020-08-07,28596,28272,324,1.15,1215
2020-08-08,24786,23925,861,3.6,1215
2020-08-09,20750,19493,1257,6.45,1215
2020-08-10,26785,26217,568,2.17,1215
2020-08-11,27355,26681,674,2.53,1215
2020-08-12,27355,26616,739,2.78,1215
2020-08-13,27355,26586,769,2.89,1215
2020-08-14,28596,27813,783,2.82,1215
2020-08-15,24786,23527,1259,5.35,1215
2020-08-16,20750,19170,1580,8.24,1215
2020-08-17,26785,25982,803,3.09,1215
2020-08-18,27355,26547,808,3.04,1215
2020-08-19,27355,26591,764,2.87,1215
2020-08-20,27355,26678,677,2.54,1215
2020-08-21,28596,28027,569,2.03,1215
2020-08-22,24786,23866,920,3.85,1215
2020-08-23,20750,19634,1116,5.68,1215
2020-08-24,26785,26569,216,0.81,1215
2020-08-25,27355,27251,104,0.38,1215
2020-08-26,27355,27406,-51,-0.19,1215
2020-08-27,27355,27593,-238,-0.86,1215
2020-08-28,28596,29032,-436,-1.5,1215
2020-08-29,24786,24946,-160,-0.64,1215
2020-08-30,20750,20776,-26,-0.13,1215
2020-08-31,26785,27756,-971,-3.5,1215
2020-09-01,27829,28466,-637,-2.24,1215
2020-09-02,27829,28633,-804,-2.81,1215
2020-09-03,27829,28815,-986,-3.42,1215
2020-09-04,29148,30232,-1084,-3.59,1215
2020-09-05,25846,26109,-263,-1.01,1215
2020-09-06,20751,21886,-1135,-5.19,1215
2020-09-07,26955,28801,-1846,-6.41,1215
2020-09-08,27829,29434,-1605,-5.45,1215
2020-09-09,27829,29514,-1685,-5.71,1215
2020-09-10,27829,29602,-1773,-5.99,1215
2020-09-11,29148,30919,-1771,-5.73,1215
2020-09-12,25846,26694,-848,-3.18,1215
2020-09-13,20751,22368,-1617,-7.23,1215
2020-09-14,26955,29180,-2225,-7.63,1215
2020-09-15,27829,29714,-1885,-6.34,1215
2020-09-16,27829,29701,-1872,-6.3,1215
2020-09-17,27829,29702,-1873,-6.31,1215
2020-09-18,29148,30941,-1793,-5.79,1215
2020-09-19,25846,26647,-801,-3.01,1215
2020-09-20,20751,22263,-1512,-6.79,1215
2020-09-21,26955,29028,-2073,-7.14,1215
2020-09-22,27829,29527,-1698,-5.75,1215
2020-09-23,27829,29490,-1661,-5.63,1215
2020-09-24,27829,29478,-1649,-5.59,1215
2020-09-25,29148,30714,-1566,-5.1,1215
2020-09-26,25846,26427,-581,-2.2,1215
2020-09-27,20751,22059,-1308,-5.93,1215
2020-09-28,26955,28847,-1892,-6.56,1215
2020-09-29,27829,29374,-1545,-5.26,1215
2020-09-30,27829,29370,-1541,-5.25,1215
2020-10-01,27222,29394,-2172,-7.39,1215
2020-10-02,28901,30667,-1766,-5.76,1215
2020-10-03,24587,26417,-1830,-6.93,1215
2020-10-04,19623,22083,-2460,-11.14,1215
2020-10-05,26522,28903,-2381,-8.24,1215
2020-10-06,27222,29459,-2237,-7.59,1215
2020-10-07,27222,29477,-2255,-7.65,1215
2020-10-08,27222,29519,-2297,-7.78,1215
2020-10-09,28901,30803,-1902,-6.17,1215
2020-10-10,24587,26557,-1970,-7.42,1215
2020-10-11,19623,22222,-2599,-11.7,1215
2020-10-12,26522,29034,-2512,-8.65,1215
2020-10-13,27222,29575,-2353,-7.96,1215
2020-10-14,27222,29574,-2352,-7.95,1215
2020-10-15,27222,29591,-2369,-8.01,1215
2020-10-16,28901,30848,-1947,-6.31,1215
2020-10-17,24587,26571,-1984,-7.47,1215
2020-10-18,19623,22203,-2580,-11.62,1215
2020-10-19,26522,28982,-2460,-8.49,1215
2020-10-20,27222,29491,-2269,-7.69,1215
2020-10-21,27222,29459,-2237,-7.59,1215
2020-10-22,27222,29448,-2226,-7.56,1215
2020-10-23,28901,30680,-1779,-5.8,1215
2020-10-24,24587,26383,-1796,-6.81,1215
2020-10-25,19623,21999,-2376,-10.8,1215
2020-10-26,26522,28767,-2245,-7.8,1215
2020-10-27,27222,29271,-2049,-7.0,1215
2020-10-28,27222,29239,-2017,-6.9,1215
2020-10-29,27222,29233,-2011,-6.88,1215
2020-10-30,28901,30475,-1574,-5.16,1215
2020-10-31,24587,26192,-1605,-6.13,1215
2020-11-01,16180,21826,-5646,-25.87,1215
2020-11-02,25328,28616,-3288,-11.49,1215
2020-11-03,23970,29143,-5173,-17.75,1215
2020-11-04,23970,29135,-5165,-17.73,1215
2020-11-05,23970,29154,-5184,-17.78,1215
2020-11-06,25148,30419,-5271,-17.33,1215
2020-11-07,19973,26159,-6186,-23.65,1215
2020-11-08,16180,21813,-5633,-25.82,1215
2020-11-09,25328,28618,-3290,-11.5,1215
2020-11-10,23970,29158,-5188,-17.79,1215
2020-11-11,23970,29158,-5188,-17.79,1215
2020-11-12,23970,29179,-5209,-17.85,1215
2020-11-13,25148,30443,-5295,-17.39,1215
2020-11-14,19973,26175,-6202,-23.69,1215
2020-11-15,16180,21817,-5637,-25.84,1215
2020-11-16,25328,28606,-3278,-11.46,1215
2020-11-17,23970,29124,-5154,-17.7,1215
2020-11-18,23970,29100,-5130,-17.63,1215
2020-11-19,23970,29096,-5126,-17.62,1215
2020-11-20,25148,30331,-5183,-17.09,1215
2020-11-21,19973,26034,-6061,-23.28,1215
2020-11-22,16180,21647,-5467,-25.26,1215
2020-11-23,25328,28409,-3081,-10.85,1215
2020-11-24,23970,28902,-4932,-17.06,1215
2020-11-25,23970,28856,-4886,-16.93,1215
2020-11-26,23970,28833,-4863,-16.87,1215
2020-11-27,25148,30055,-4907,-16.33,1215
2020-11-28,19973,25749,-5776,-22.43,1215
2020-11-29,16180,21359,-5179,-24.25,1215
2020-11-30,25328,28123,-2795,-9.94,1215
2020-12-01,24651,28625,-3974,-13.88,1215
2020-12-02,24651,28592,-3941,-13.78,1215
2020-12-03,24651,28588,-3937,-13.77,1215
2020-12-04,26939,29832,-2893,-9.7,1215
2020-12-05,21593,25554,-3961,-15.5,1215
2020-12-06,16278,21193,-4915,-23.19,1215
2020-12-07,24834,27989,-3155,-11.27,1215
2020-12-08,24651,28523,-3872,-13.58,1215
2020-12-09,24651,28522,-3871,-13.57,1215
2020-12-10,24651,28548,-3897,-13.65,1215
2020-12-11,26939,29820,-2881,-9.66,1215
2020-12-12,21593,25565,-3972,-15.54,1215
2020-12-13,16278,21223,-4945,-23.3,1215
2020-12-14,24834,28031,-3197,-11.41,1215
2020-12-15,24651,28571,-3920,-13.72,1215
2020-12-16,24651,28570,-3919,-13.72,1215
2020-12-17,24651,28587,-3936,-13.77,1215
2020-12-18,26939,29843,-2904,-9.73,1215
2020-12-19,21593,25564,-3971,-15.53,1215
2020-12-20,16278,21191,-4913,-23.18,1215
2020-12-21,24834,27961,-3127,-11.18,1215
2020-12-22,24651,28456,-3805,-13.37,1215
2020-12-23,24651,28404,-3753,-13.21,1215
2020-12-24,24651,28367,-3716,-13.1,1215
2020-12-25,26939,29565,-2626,-8.88,1215
2020-12-26,21593,25227,-3634,-14.41,1215
2020-12-27,16278,20795,-4517,-21.72,1215
2020-12-28,24834,27507,-2673,-9.72,1215
2020-12-29,24651,27947,-3296,-11.79,1215
2020-12-30,24651,27844,-3193,-11.47,1215
2020-12-31,24651,27761,-3110,-11.2,1215
2021-01-01,24298,28920,-4622,-15.98,1215
2021-01-02,18159,24552,-6393,-26.04,1215
2021-01-03,14170,20097,-5927,-29.49,1215
2021-01-04,22360,26797,-4437,-16.56,1215
2021-01-05,23472,27235,-3763,-13.82,1215
2021-01-06,23472,27141,-3669,-13.52,1215
2021-01-07,23472,27078,-3606,-13.32,1215
2021-01-08,24298,28267,-3969,-14.04,1215
2021-01-09,18159,23938,-5779,-24.14,1215
2021-01-10,14170,19532,-5362,-27.45,1215
2021-01-11,22360,26289,-3929,-14.95,1215
2021-01-12,23472,26791,-3319,-12.39,1215
2021-01-13,23472,26767,-3295,-12.31,1215
2021-01-14,23472,26778,-3306,-12.35,1215
2021-01-15,24298,28045,-3747,-13.36,1215
2021-01-16,18159,23794,-5635,-23.68,1215
2021-01-17,14170,19467,-5297,-27.21,1215
2021-01-18,22360,26301,-3941,-14.98,1215
2021-01-19,23472,26877,-3405,-12.67,1215
2021-01-20,23472,26921,-3449,-12.81,1215
2021-01-21,23472,26996,-3524,-13.05,1215
2021-01-22,24298,28318,-4020,-14.2,1215
2021-01-23,18159,24117,-5958,-24.7,1215
2021-01-24,14170,19830,-5660,-28.54,1215
2021-01-25,22360,26695,-4335,-16.24,1215
2021-01-26,23472,27293,-3821,-14.0,1215
2021-01-27,23472,27352,-3880,-14.19,1215
2021-01-28,23472,27431,-3959,-14.43,1215
2021-01-29,24298,28750,-4452,-15.49,1215
2021-01-30,18159,24538,-6379,-26.0,1215
2021-01-31,14170,20234,-6064,-29.97,1215
2021-02-01,25708,27077,-1369,-5.06,1215
2021-02-02,26245,27649,-1404,-5.08,1215
2021-02-03,26245,27677,-1432,-5.17,1215
2021-02-04,26245,27725,-1480,-5.34,1215
2021-02-05,27443,29013,-1570,-5.41,1215
2021-02-06,22280,24769,-2489,-10.05,1215
2021-02-07,17244,20436,-3192,-15.62,1215
2021-02-08,25708,27253,-1545,-5.67,1215
2021-02-09,26245,27802,-1557,-5.6,1215
2021-02-10,26245,27814,-1569,-5.64,1215
2021-02-11,26245,27849,-1604,-5.76,1215
2021-02-12,27443,29131,-1688,-5.79,1215
2021-02-13,22280,24887,-2607,-10.48,1215
2021-02-14,17244,20561,-3317,-16.13,1215
2021-02-15,25708,27389,-1681,-6.14,1215
2021-02-16,26245,27956,-1711,-6.12,1215
2021-02-17,26245,27989,-1744,-6.23,1215
2021-02-18,26245,28051,-1806,-6.44,1215
2021-02-19,27443,29362,-1919,-6.54,1215
2021-02-20,22280,25151,-2871,-11.42,1215
2021-02-21,17244,20857,-3613,-17.32,1215
2021-02-22,25708,27719,-2011,-7.25,1215
2021-02-23,26245,28318,-2073,-7.32,1215
2021-02-24,26245,28382,-2137,-7.53,1215
2021-02-25,26245,28472,-2227,-7.82,1215
2021-02-26,27443,29807,-2364,-7.93,1215
2021-02-27,22280,25615,-3335,-13.02,1215
2021-02-28,17244,21335,-4091,-19.18,1215
2021-03-01,27168,28206,-1038,-3.68,1215
2021-03-02,27774,28807,-1033,-3.59,1215
2021-03-03,27774,28868,-1094,-3.79,1215
2021-03-04,27774,28948,-1174,-4.06,1215
2021-03-05,28760,30268,-1508,-4.98,1215
2021-03-06,23927,26055,-2128,-8.17,1215
2021-03-07,17505,21750,-4245,-19.52,1215
2021-03-08,27168,28591,-1423,-4.98,1215
2021-03-09,27774,29160,-1386,-4.75,1215
2021-03-10,27774,29187,-1413,-4.84,1215
2021-03-11,27774,29231,-1457,-4.98,1215
2021-03-12,28760,30515,-1755,-5.75,1215
2021-03-13,23927,26268,-2341,-8.91,1215
2021-03-14,17505,21930,-4425,-20.18,1215
2021-03-15,27168,28742,-1574,-5.48,1215
2021-03-16,27774,29285,-1511,-5.16,1215
2021-03-17,27774,29290,-1516,-5.18,1215
2021-03-18,27774,29318,-1544,-5.27,1215
2021-03-19,28760,30592,-1832,-5.99,1215
2021-03-20,23927,26339,-2412,-9.16,1215
2021-03-21,17505,22003,-4498,-20.44,1215
2021-03-22,27168,28821,-1653,-5.74,1215
2021-03-23,27774,29376,-1602,-5.45,1215
2021-03-24,27774,29398,-1624,-5.52,1215
2021-03-25,27774,29448,-1674,-5.68,1215
2021-03-26,28760,30747,-1987,-6.46,1215
2021-03-27,23927,26522,-2595,-9.78,1215
2021-03-28,17505,22215,-4710,-21.2,1215
2021-03-29,27168,29064,-1896,-6.52,1215
2021-03-30,27774,29649,-1875,-6.32,1215
2021-03-31,27774,29700,-1926,-6.48,1215
2021-04-01,26792,29777,-2985,-10.02,1215
2021-04-02,27474,31099,-3625,-11.66,1215
2021-04-03,21603,26894,-5291,-19.67,1215
2021-04-04,17283,22602,-5319,-23.53,1215
2021-04-05,26779,29460,-2681,-9.1,1215
2021-04-06,26792,30050,-3258,-10.84,1215
2021-04-07,26792,30099,-3307,-10.99,1215
2021-04-08,26792,30167,-3375,-11.19,1215
2021-04-09,27474,31476,-4002,-12.71,1215
2021-04-10,21603,27251,-5648,-20.73,1215
2021-04-11,17283,22935,-5652,-24.64,1215
2021-04-12,26779,29763,-2984,-10.03,1215
2021-04-13,26792,30320,-3528,-11.64,1215
2021-04-14,26792,30333,-3541,-11.67,1215
2021-04-15,26792,30364,-3572,-11.76,1215
2021-04-16,27474,31633,-4159,-13.15,1215
2021-04-17,21603,27368,-5765,-21.06,1215
2021-04-18,17283,23013,-5730,-24.9,1215
2021-04-19,26779,29805,-3026,-10.15,1215
2021-04-20,26792,30327,-3535,-11.66,1215
2021-04-21,26792,30309,-3517,-11.6,1215
2021-04-22,26792,30312,-3520,-11.61,1215
2021-04-23,27474,31558,-4084,-12.94,1215
2021-04-24,21603,27277,-5674,-20.8,1215
2021-04-25,17283,22909,-5626,-24.56,1215
2021-04-26,26779,29693,-2914,-9.81,1215
2021-04-27,26792,30213,-3421,-11.32,1215
2021-04-28,26792,30197,-3405,-11.28,1215
2021-04-29,26792,30208,-3416,-11.31,1215
2021-04-30,27474,31465,-3991,-12.68,1215
2021-05-01,26057,27197,-1140,-4.19,1215
2021-05-02,20006,22846,-2840,-12.43,1215
2021-05-03,28547,29649,-1102,-3.72,1215
2021-05-04,29422,30188,-766,-2.54,1215
2021-05-05,29422,30192,-770,-2.55,1215
2021-05-06,29422,30221,-799,-2.64,1215
2021-05-07,30450,31496,-1046,-3.32,1215
2021-05-08,26057,27243,-1186,-4.35,1215
2021-05-09,20006,22904,-2898,-12.65,1215
2021-05-10,28547,29717,-1170,-3.94,1215
2021-05-11,29422,30262,-840,-2.78,1215
2021-05-12,29422,30268,-846,-2.8,1215
2021-05-13,29422,30296,-874,-2.88,1215
2021-05-14,30450,31566,-1116,-3.54,1215
2021-05-15,26057,27306,-1249,-4.57,1215
2021-05-16,20006,22957,-2951,-12.85,1215
2021-05-17,28547,29757,-1210,-4.07,1215
2021-05-18,29422,30289,-867,-2.86,1215
2021-05-19,29422,30281,-859,-2.84,1215
2021-05-20,29422,30294,-872,-2.88,1215
2021-05-21,30450,31551,-1101,-3.49,1215
2021-05-22,26057,27279,-1222,-4.48,1215
2021-05-23,20006,22922,-2916,-12.72,1215
2021-05-24,28547,29716,-1169,-3.93,1215
2021-05-25,29422,30245,-823,-2.72,1215
2021-05-26,29422,30240,-818,-2.71,1215
2021-05-27,29422,30260,-838,-2.77,1215
2021-05-28,30450,31529,-1079,-3.42,1215
2021-05-29,26057,27274,-1217,-4.46,1215
2021-05-30,20006,22937,-2931,-12.78,1215
2021-05-31,28547,29757,-1210,-4.07,1215
2021-06-01,29928,30315,-387,-1.28,1215
2021-06-02,29928,30341,-413,-1.36,1215
2021-06-03,29928,30394,-466,-1.53,1215
2021-06-04,30582,31697,-1115,-3.52,1215
2021-06-05,26625,27475,-850,-3.09,1215
2021-06-06,22915,23170,-255,-1.1,1215
2021-06-07,29168,30017,-849,-2.83,1215
2021-06-08,29928,30599,-671,-2.19,1215
2021-06-09,29928,30643,-715,-2.33,1215
2021-06-10,29928,30708,-780,-2.54,1215
2021-06-11,30582,32014,-1432,-4.47,1215
2021-06-12,26625,27786,-1161,-4.18,1215
2021-06-13,22915,23465,-550,-2.34,1215
2021-06-14,29168,30287,-1119,-3.69,1215
2021-06-15,29928,30833,-905,-2.94,1215
2021-06-16,29928,30830,-902,-2.93,1215
2021-06-17,29928,30838,-910,-2.95,1215
2021-06-18,30582,32078,-1496,-4.66,1215
2021-06-19,26625,27775,-1150,-4.14,1215
2021-06-20,22915,23371,-456,-1.95,1215
2021-06-21,29168,30103,-935,-3.11,1215
2021-06-22,29928,30555,-627,-2.05,1215
2021-06-23,29928,30455,-527,-1.73,1215
2021-06-24,29928,30364,-436,-1.44,1215
2021-06-25,30582,31506,-924,-2.93,1215
2021-06-26,26625,27108,-483,-1.78,1215
2021-06-27,22915,22613,302,1.34,1215
2021-06-28,29168,29262,-94,-0.32,1215
2021-06-29,29928,29639,289,0.98,1215
2021-06-30,29928,29474,454,1.54,1215
2021-07-01,28370,29330,-960,-3.27,1215
2021-07-02,29285,30431,-1146,-3.77,1215
2021-07-03,24861,26007,-1146,-4.41,1215
2021-07-04,21108,21501,-393,-1.83,1215
2021-07-05,27751,28153,-402,-1.43,1215
2021-07-06,28370,28549,-179,-0.63,1215
2021-07-07,28370,28417,-47,-0.17,1215
2021-07-08,28370,28320,50,0.18,1215
2021-07-09,29285,29482,-197,-0.67,1215
2021-07-10,24861,25129,-268,-1.07,1215
2021-07-11,21108,20705,403,1.95,1215
2021-07-12,27751,27447,304,1.11,1215
2021-07-13,28370,27938,432,1.55,1215
2021-07-14,28370,27906,464,1.66,1215
2021-07-15,28370,27910,460,1.65,1215
2021-07-16,29285,29171,114,0.39,1215
2021-07-17,24861,24916,-55,-0.22,1215
2021-07-18,21108,20583,525,2.55,1215
2021-07-19,27751,27409,342,1.25,1215
2021-07-20,28370,27974,396,1.42,1215
2021-07-21,28370,28005,365,1.3,1215
2021-07-22,28370,28060,310,1.1,1215
2021-07-23,29285,29359,-74,-0.25,1215
2021-07-24,24861,25128,-267,-1.06,1215
2021-07-25,21108,20804,304,1.46,1215
2021-07-26,27751,27626,125,0.45,1215
2021-07-27,28370,28173,197,0.7,1215
2021-07-28,28370,28173,197,0.7,1215
2021-07-29,28370,28186,184,0.65,1215
2021-07-30,29285,29432,-147,-0.5,1215
2021-07-31,24861,25140,-279,-1.11,1215
2021-08-01,20366,20750,-384,-1.85,1215
2021-08-02,27329,27501,-172,-0.63,1215
2021-08-03,27739,27976,-237,-0.85,1215
2021-08-04,27739,27905,-166,-0.59,1215
2021-08-05,27739,27850,-111,-0.4,1215
2021-08-06,28360,29035,-675,-2.32,1215
2021-08-07,24152,24689,-537,-2.18,1215
2021-08-08,20366,20255,111,0.55,1215
2021-08-09,27329,26973,356,1.32,1215
2021-08-10,27739,27430,309,1.13,1215
2021-08-11,27739,27354,385,1.41,1215
2021-08-12,27739,27310,429,1.57,1215
2021-08-13,28360,28521,-161,-0.56,1215
2021-08-14,24152,24217,-65,-0.27,1215
2021-08-15,20366,19840,526,2.65,1215
2021-08-16,27329,26630,699,2.62,1215
2021-08-17,27739,27172,567,2.09,1215
2021-08-18,27739,27194,545,2.0,1215
2021-08-19,27739,27257,482,1.77,1215
2021-08-20,28360,28583,-223,-0.78,1215
2021-08-21,24152,24400,-248,-1.02,1215
2021-08-22,20366,20148,218,1.08,1215
2021-08-23,27329,27063,266,0.98,1215
2021-08-24,27739,27728,11,0.04,1215
2021-08-25,27739,27869,-130,-0.47,1215
2021-08-26,27739,28045,-306,-1.09,1215
2021-08-27,28360,29474,-1114,-3.78,1215
2021-08-28,24152,25383,-1231,-4.85,1215
2021-08-29,20366,21210,-844,-3.98,1215
2021-08-30,27329,28191,-862,-3.06,1215
2021-08-31,27739,28905,-1166,-4.03,1215
2021-09-01,28901,29079,-178,-0.61,1215
2021-09-02,28901,29270,-369,-1.26,1215
2021-09-03,30230,30699,-469,-1.53,1215
2021-09-04,26411,26590,-179,-0.67,1215
2021-09-05,22508,22384,124,0.55,1215
2021-09-06,28103,29315,-1212,-4.13,1215
2021-09-07,28901,29967,-1066,-3.56,1215
2021-09-08,28901,30067,-1166,-3.88,1215
2021-09-09,28901,30174,-1273,-4.22,1215
2021-09-10,30230,31510,-1280,-4.06,1215
2021-09-11,26411,27303,-892,-3.27,1215
2021-09-12,22508,22994,-486,-2.11,1215
2021-09-13,28103,29823,-1720,-5.77,1215
2021-09-14,28901,30372,-1471,-4.84,1215
2021-09-15,28901,30371,-1470,-4.84,1215
2021-09-16,28901,30384,-1483,-4.88,1215
2021-09-17,30230,31631,-1401,-4.43,1215
2021-09-18,26411,27344,-933,-3.41,1215
2021-09-19,22508,22964,-456,-1.99,1215
2021-09-20,28103,29732,-1629,-5.48,1215
2021-09-21,28901,30231,-1330,-4.4,1215
2021-09-22,28901,30192,-1291,-4.28,1215
2021-09-23,28901,30177,-1276,-4.23,1215
2021-09-24,30230,31409,-1179,-3.75,1215
2021-09-25,26411,27117,-706,-2.6,1215
2021-09-26,22508,22742,-234,-1.03,1215
2021-09-27,28103,29523,-1420,-4.81,1215
2021-09-28,28901,30043,-1142,-3.8,1215
2021-09-29,28901,30032,-1131,-3.77,1215
2021-09-30,28901,30049,-1148,-3.82,1215
2021-10-01,30126,31316,-1190,-3.8,1215
2021-10-02,26662,27060,-398,-1.47,1215
2021-10-03,22055,22722,-667,-2.94,1215
2021-10-04,27982,29539,-1557,-5.27,1215
2021-10-05,28391,30092,-1701,-5.65,1215
2021-10-06,28391,30110,-1719,-5.71,1215
2021-10-07,28391,30151,-1760,-5.84,1215
2021-10-08,30126,31437,-1311,-4.17,1215
2021-10-09,26662,27194,-532,-1.96,1215
2021-10-10,22055,22862,-807,-3.53,1215
2021-10-11,27982,29679,-1697,-5.72,1215
2021-10-12,28391,30226,-1835,-6.07,1215
2021-10-13,28391,30230,-1839,-6.08,1215
2021-10-14,28391,30253,-1862,-6.15,1215
2021-10-15,30126,31516,-1390,-4.41,1215
2021-10-16,26662,27246,-584,-2.14,1215
2021-10-17,22055,22884,-829,-3.62,1215
2021-10-18,27982,29668,-1686,-5.68,1215
2021-10-19,28391,30182,-1791,-5.93,1215
2021-10-20,28391,30154,-1763,-5.85,1215
2021-10-21,28391,30146,-1755,-5.82,1215
2021-10-22,30126,31380,-1254,-4.0,1215
2021-10-23,26662,27084,-422,-1.56,1215
2021-10-24,22055,22700,-645,-2.84,1215
2021-10-25,27982,29467,-1485,-5.04,1215
2021-10-26,28391,29969,-1578,-5.27,1215
2021-10-27,28391,29934,-1543,-5.15,1215
2021-10-28,28391,29925,-1534,-5.13,1215
2021-10-29,30126,31163,-1037,-3.33,1215
2021-10-30,26662,26875,-213,-0.79,1215
2021-10-31,22055,22505,-450,-2.0,1215
2021-11-01,26126,29290,-3164,-10.8,1215
2021-11-02,27207,29812,-2605,-8.74,1215
2021-11-03,27207,29800,-2593,-8.7,1215
2021-11-04,27207,29815,-2608,-8.75,1215
2021-11-05,28954,31077,-2123,-6.83,1215
2021-11-06,24964,26814,-1850,-6.9,1215
2021-11-07,20557,22467,-1910,-8.5,1215
2021-11-08,26126,29272,-3146,-10.75,1215
2021-11-09,27207,29811,-2604,-8.74,1215
2021-11-10,27207,29812,-2605,-8.74,1215
2021-11-11,27207,29836,-2629,-8.81,1215
2021-11-12,28954,31103,-2149,-6.91,1215
2021-11-13,24964,26839,-1875,-6.99,1215
2021-11-14,20557,22485,-1928,-8.57,1215
2021-11-15,26126,29279,-3153,-10.77,1215
2021-11-16,27207,29803,-2596,-8.71,1215
2021-11-17,27207,29785,-2578,-8.66,1215
2021-11-18,27207,29785,-2578,-8.66,1215
2021-11-19,28954,31026,-2072,-6.68,1215
2021-11-20,24964,26734,-1770,-6.62,1215
2021-11-21,20557,22352,-1795,-8.03,1215
2021-11-22,26126,29117,-2991,-10.27,1215
2021-11-23,27207,29613,-2406,-8.12,1215
2021-11-24,27207,29569,-2362,-7.99,1215
2021-11-25,27207,29546,-2339,-7.92,1215
2021-11-26,28954,30768,-1814,-5.9,1215
2021-11-27,24964,26461,-1497,-5.66,1215
2021-11-28,20557,22068,-1511,-6.85,1215
2021-11-29,26126,28829,-2703,-9.38,1215
2021-11-30,27207,29326,-2119,-7.23,1215
2021-12-01,26353,29289,-2936,-10.02,1215
2021-12-02,26353,29279,-2926,-9.99,1215
2021-12-03,26140,30517,-4377,-14.34,1215
2021-12-04,23280,26232,-2952,-11.25,1215
2021-12-05,19150,21866,-2716,-12.42,1215
2021-12-06,26448,28655,-2207,-7.7,1215
2021-12-07,26353,29184,-2831,-9.7,1215
2021-12-08,26353,29178,-2825,-9.68,1215
2021-12-09,26353,29200,-2847,-9.75,1215
2021-12-10,26140,30470,-4330,-14.21,1215
2021-12-11,23280,26213,-2933,-11.19,1215
2021-12-12,19150,21871,-2721,-12.44,1215
2021-12-13,26448,28681,-2233,-7.79,1215
2021-12-14,26353,29224,-2871,-9.82,1215
2021-12-15,26353,29226,-2873,-9.83,1215
2021-12-16,26353,29249,-2896,-9.9,1215
2021-12-17,26140,30512,-4372,-14.33,1215
2021-12-18,23280,26241,-2961,-11.28,1215
2021-12-19,19150,21877,-2727,-12.47,1215
2021-12-20,26448,28657,-2209,-7.71,1215
2021-12-21,26353,29163,-2810,-9.64,1215
2021-12-22,26353,29123,-2770,-9.51,1215
2021-12-23,26353,29097,-2744,-9.43,1215
2021-12-24,26140,30306,-4166,-13.75,1215
2021-12-25,23280,25978,-2698,-10.39,1215
2021-12-26,19150,21556,-2406,-11.16,1215
2021-12-27,26448,28276,-1828,-6.46,1215
2021-12-28,26353,28724,-2371,-8.25,1215
2021-12-29,26353,28627,-2274,-7.94,1215
2021-12-30,26353,28548,-2195,-7.69,1215
2021-12-31,26140,29710,-3570,-12.02,1215
2022-01-01,23114,25342,-2228,-8.79,1215
2022-01-02,17775,20887,-3112,-14.9,1215
2022-01-03,25040,27583,-2543,-9.22,1215
2022-01-04,25887,28016,-2129,-7.6,1215
2022-01-05,25887,27915,-2028,-7.26,1215
2022-01-06,25887,27843,-1956,-7.03,1215
2022-01-07,27242,29021,-1779,-6.13,1215
2022-01-08,23114,24680,-1566,-6.35,1215
2022-01-09,17775,20262,-2487,-12.27,1215
2022-01-10,25040,27005,-1965,-7.28,1215
2022-01-11,25887,27493,-1606,-5.84,1215
2022-01-12,25887,27454,-1567,-5.71,1215
2022-01-13,25887,27450,-1563,-5.69,1215
2022-01-14,27242,28703,-1461,-5.09,1215
2022-01-15,23114,24438,-1324,-5.42,1215
2022-01-16,17775,20099,-2324,-11.56,1215
2022-01-17,25040,26920,-1880,-6.98,1215
2022-01-18,25887,27486,-1599,-5.82,1215
2022-01-19,25887,27522,-1635,-5.94,1215
2022-01-20,25887,27588,-1701,-6.17,1215
2022-01-21,27242,28905,-1663,-5.75,1215
2022-01-22,23114,24699,-1585,-6.42,1215
2022-01-23,17775,20410,-2635,-12.91,1215
2022-01-24,25040,27274,-2234,-8.19,1215
2022-01-25,25887,27873,-1986,-7.13,1215
2022-01-26,25887,27933,-2046,-7.32,1215
2022-01-27,25887,28016,-2129,-7.6,1215
2022-01-28,27242,29340,-2098,-7.15,1215
2022-01-29,23114,25133,-2019,-8.03,1215
2022-01-30,17775,20835,-3060,-14.69,1215
2020-02-01,18906,17219,1687,9.8,1224
2020-02-02,12143,9907,2236,22.57,1224
2020-02-03,22033,20991,1042,4.96,1224
2020-02-04,22285,20842,1443,6.92,1224
2020-02-05,22285,20595,1690,8.21,1224
2020-02-06,22285,20428,1857,9.09,1224
2020-02-07,23675,21526,2149,9.98,1224
2020-02-08,18906,15915,2991,18.79,1224
2020-02-09,12143,8602,3541,41.16,1224
2020-02-10,22033,19715,2318,11.76,1224
2020-02-11,22285,19628,2657,13.54,1224
2020-02-12,22285,19474,2811,14.43,1224
2020-02-13,22285,19432,2853,14.68,1224
2020-02-14,23675,20686,2989,14.45,1224
2020-02-15,18906,15258,3648,23.91,1224
2020-02-16,12143,8155,3988,48.9,1224
2020-02-17,22033,19498,2535,13.0,1224
2020-02-18,22285,19658,2627,13.36,1224
2020-02-19,22285,19764,2521,12.76,1224
2020-02-20,22285,19988,2297,11.49,1224
2020-02-21,23675,21508,2167,10.08,1224
2020-02-22,18906,16341,2565,15.7,1224
2020-02-23,12143,9487,2656,28.0,1224
2020-02-24,22033,21062,971,4.61,1224
2020-02-25,22285,21431,854,3.98,1224
2020-02-26,22285,21717,568,2.62,1224
2020-02-27,22285,22087,198,0.9,1224
2020-02-28,23675,23717,-42,-0.18,1224
2020-02-29,18906,18619,287,1.54,1224
2020-03-01,8265,11791,-3526,-29.9,1224
2020-03-02,15877,23348,-7471,-32.0,1224
2020-03-03,16019,23654,-7635,-32.28,1224
2020-03-04,16019,23834,-7815,-32.79,1224
2020-03-05,16019,24056,-8037,-33.41,1224
2020-03-06,17170,25498,-8328,-32.66,1224
2020-03-07,12060,20177,-8117,-40.23,1224
2020-03-08,8265,13096,-4831,-36.89,1224
2020-03-09,15877,24374,-8497,-34.86,1224
2020-03-10,16019,24383,-8364,-34.3,1224
2020-03-11,16019,24252,-8233,-33.95,1224
2020-03-12,16019,24159,-8140,-33.69,1224
2020-03-13,17170,25287,-8117,-32.1,1224
2020-03-14,12060,19661,-7601,-38.66,1224
2020-03-15,8265,12290,-4025,-32.75,1224
2020-03-16,15877,23301,-7424,-31.86,1224
2020-03-17,16019,23070,-7051,-30.56,1224
2020-03-18,16019,22733,-6714,-29.53,1224
2020-03-19,16019,22471,-6452,-28.71,1224
2020-03-20,17170,23473,-6303,-26.85,1224
2020-03-21,12060,17764,-5704,-32.11,1224
2020-03-22,8265,10355,-2090,-20.18,1224
2020-03-23,15877,21375,-5498,-25.72,1224
2020-03-24,16019,21197,-5178,-24.43,1224
2020-03-25,16019,20957,-4938,-23.56,1224
2020-03-26,16019,20831,-4812,-23.1,1224
2020-03-27,17170,22005,-4835,-21.97,1224
2020-03-28,12060,16500,-4440,-26.91,1224
2020-03-29,8265,9321,-1056,-11.33,1224
2020-03-30,15877,20588,-4711,-22.88,1224
2020-03-31,16019,20671,-4652,-22.5,1224
2020-04-01,14027,20697,-6670,-32.23,1224
2020-04-02,14027,20836,-6809,-32.68,1224
2020-04-03,13452,22267,-8815,-39.59,1224
2020-04-04,10068,17003,-6935,-40.79,1224
2020-04-05,6136,10044,-3908,-38.91,1224
2020-04-06,13967,21505,-7538,-35.05,1224
2020-04-07,14027,21750,-7723,-35.51,1224
2020-04-08,14027,21902,-7875,-35.96,1224
2020-04-09,14027,22129,-8102,-36.61,1224
2020-04-10,13452,23607,-10155,-43.02,1224
2020-04-11,10068,18350,-8282,-45.13,1224
2020-04-12,6136,11356,-5220,-45.97,1224
2020-04-13,13967,22743,-8776,-38.59,1224
2020-04-14,14027,22878,-8851,-38.69,1224
2020-04-15,14027,22886,-8859,-38.71,1224
2020-04-16,14027,22940,-8913,-38.85,1224
2020-04-17,13452,24220,-10768,-44.46,1224
2020-04-18,10068,18747,-8679,-46.3,1224
2020-04-19,6136,11525,-5389,-46.76,1224
2020-04-20,13967,22679,-8712,-38.41,1224
2020-04-21,14027,22580,-8553,-37.88,1224
2020-04-22,14027,22362,-8335,-37.27,1224
2020-04-23,14027,22203,-8176,-36.82,1224
2020-04-24,13452,23291,-9839,-42.24,1224
2020-04-25,10068,17648,-7580,-42.95,1224
2020-04-26,6136,10286,-4150,-40.35,1224
2020-04-27,13967,21331,-7364,-34.52,1224
2020-04-28,14027,21159,-7132,-33.71,1224
2020-04-29,14027,20905,-6878,-32.9,1224
2020-04-30,14027,20747,-6720,-32.39,1224
2020-05-01,23260,21872,1388,6.35,1224
2020-05-02,17794,16303,1491,9.15,1224
2020-05-03,10004,9048,956,10.57,1224
2020-05-04,22109,20230,1879,9.29,1224
2020-05-05,22431,20221,2210,10.93,1224
2020-05-06,22431,20150,2281,11.32,1224
2020-05-07,22431,20191,2240,11.09,1224
2020-05-08,23260,21526,1734,8.06,1224
2020-05-09,17794,16170,1624,10.04,1224
2020-05-10,10004,9125,879,9.63,1224
2020-05-11,22109,20510,1599,7.8,1224
2020-05-12,22431,20689,1742,8.42,1224
2020-05-13,22431,20788,1643,7.9,1224
2020-05-14,22431,20976,1455,6.94,1224
2020-05-15,23260,22428,832,3.71,1224
2020-05-16,17794,17160,634,3.69,1224
2020-05-17,10004,10169,-165,-1.62,1224
2020-05-18,22109,21573,536,2.48,1224
2020-05-19,22431,21737,694,3.19,1224
2020-05-20,22431,21787,644,2.96,1224
2020-05-21,22431,21892,539,2.46,1224
2020-05-22,23260,23233,27,0.12,1224
2020-05-23,17794,17826,-32,-0.18,1224
2020-05-24,10004,10674,-670,-6.28,1224
2020-05-25,22109,21900,209,0.95,1224
2020-05-26,22431,21874,557,2.55,1224
2020-05-27,22431,21726,705,3.24,1224
2020-05-28,22431,21632,799,3.69,1224
2020-05-29,23260,22779,481,2.11,1224
2020-05-30,17794,17188,606,3.53,1224
2020-05-31,10004,9867,137,1.39,1224
2020-06-01,24253,20944,3309,15.8,1224
2020-06-02,24751,20793,3958,19.04,1224
2020-06-03,24751,20548,4203,20.45,1224
2020-06-04,24751,20388,4363,21.4,1224
2020-06-05,24363,21500,2863,13.32,1224
2020-06-06,18922,15908,3014,18.95,1224
2020-06-07,11774,8618,3156,36.62,1224
2020-06-08,24253,19759,4494,22.74,1224
2020-06-09,24751,19700,5051,25.64,1224
2020-06-10,24751,19575,5176,26.44,1224
2020-06-11,24751,19558,5193,26.55,1224
2020-06-12,24363,20832,3531,16.95,1224
2020-06-13,18922,15417,3505,22.73,1224
2020-06-14,11774,8313,3461,41.63,1224
2020-06-15,24253,19644,4609,23.46,1224
2020-06-16,24751,19774,4977,25.17,1224
2020-06-17,24751,19830,4921,24.82,1224
2020-06-18,24751,19982,4769,23.87,1224
2020-06-19,24363,21409,2954,13.8,1224
2020-06-20,18922,16124,2798,17.35,1224
2020-06-21,11774,9127,2647,29.0,1224
2020-06-22,24253,20535,3718,18.11,1224
2020-06-23,24751,20713,4038,19.5,1224
2020-06-24,24751,20786,3965,19.08,1224
2020-06-25,24751,20923,3828,18.3,1224
2020-06-26,24363,22303,2060,9.24,1224
2020-06-27,18922,16942,1980,11.69,1224
2020-06-28,11774,9842,1932,19.63,1224
2020-06-29,24253,21122,3131,14.82,1224
2020-06-30,24751,21151,3600,17.02,1224
2020-07-01,23875,21059,2816,13.37,1224
2020-07-02,23875,21019,2856,13.59,1224
2020-07-03,24206,22216,1990,8.96,1224
2020-07-04,18499,16670,1829,10.97,1224
2020-07-05,12488,9389,3099,33.01,1224
2020-07-06,23408,20497,2911,14.2,1224
2020-07-07,23875,20369,3506,17.21,1224
2020-07-08,23875,20138,3737,18.56,1224
2020-07-09,23875,19982,3893,19.48,1224
2020-07-10,24206,21088,3118,14.79,1224
2020-07-11,18499,15480,3019,19.5,1224
2020-07-12,12488,8166,4322,52.93,1224
2020-07-13,23408,19272,4136,21.46,1224
2020-07-14,23875,19173,4702,24.52,1224
2020-07-15,23875,19000,4875,25.66,1224
2020-07-16,23875,18931,4944,26.12,1224
2020-07-17,24206,20150,4056,20.13,1224
2020-07-18,18499,14677,3822,26.04,1224
2020-07-19,12488,7516,4972,66.15,1224
2020-07-20,23408,18790,4618,24.58,1224
2020-07-21,23875,18868,5007,26.54,1224
2020-07-22,23875,18877,4998,26.48,1224
2020-07-23,23875,18988,4887,25.74,1224
2020-07-24,24206,20382,3824,18.76,1224
2020-07-25,18499,15072,3427,22.74,1224
2020-07-26,12488,8060,4428,54.94,1224
2020-07-27,23408,19464,3944,20.26,1224
2020-07-28,23875,19648,4227,21.51,1224
2020-07-29,23875,19737,4138,20.97,1224
2020-07-30,23875,19901,3974,19.97,1224
2020-07-31,24206,21317,2889,13.55,1224
2020-08-01,17836,16000,1836,11.48,1224
2020-08-02,12454,8951,3503,39.14,1224
2020-08-03,22715,20289,2426,11.96,1224
2020-08-04,22614,20380,2234,10.96,1224
2020-08-05,22614,20353,2261,11.11,1224
2020-08-06,22614,20380,2234,10.96,1224
2020-08-07,23081,21641,1440,6.65,1224
2020-08-08,17836,16158,1678,10.38,1224
2020-08-09,12454,8934,3520,39.4,1224
2020-08-10,22715,20094,2621,13.04,1224
2020-08-11,22614,20009,2605,13.02,1224
2020-08-12,22614,19813,2801,14.14,1224
2020-08-13,22614,19681,2933,14.9,1224
2020-08-14,23081,20800,2281,10.97,1224
2020-08-15,17836,15193,2643,17.4,1224
2020-08-16,12454,7868,4586,58.29,1224
2020-08-17,22715,18953,3762,19.85,1224
2020-08-18,22614,18819,3795,20.17,1224
2020-08-19,22614,18602,4012,21.57,1224
2020-08-20,22614,18478,4136,22.38,1224
2020-08-21,23081,19633,3448,17.56,1224
2020-08-22,17836,14089,3747,26.6,1224
2020-08-23,12454,6852,5602,81.76,1224
2020-08-24,22715,18046,4669,25.87,1224
2020-08-25,22614,18042,4572,25.34,1224
2020-08-26,22614,17969,4645,25.85,1224
2020-08-27,22614,18001,4613,25.63,1224
2020-08-28,23081,19319,3762,19.47,1224
2020-08-29,17836,13940,3896,27.95,1224
2020-08-30,12454,6867,5587,81.36,1224
2020-08-31,22715,18217,4498,24.69,1224
2020-09-01,24078,18359,5719,31.15,1224
2020-09-02,24078,18417,5661,30.74,1224
2020-09-03,24078,18562,5516,29.72,1224
2020-09-04,24346,19972,4374,21.9,1224
2020-09-05,19080,14662,4418,30.13,1224
2020-09-06,12413,7632,4781,62.64,1224
2020-09-07,23662,19000,4662,24.54,1224
2020-09-08,24078,19133,4945,25.85,1224
2020-09-09,24078,19156,4922,25.69,1224
2020-09-10,24078,19242,4836,25.13,1224
2020-09-11,24346,20569,3777,18.36,1224
2020-09-12,19080,15156,3924,25.89,1224
2020-09-13,12413,8005,4408,55.07,1224
2020-09-14,23662,19238,4424,23.0,1224
2020-09-15,24078,19224,4854,25.25,1224
2020-09-16,24078,19095,4983,26.1,1224
2020-09-17,24078,19024,5054,26.57,1224
2020-09-18,24346,20196,4150,20.55,1224
2020-09-19,19080,14632,4448,30.4,1224
2020-09-20,12413,7339,5074,69.14,1224
2020-09-21,23662,18442,5220,28.3,1224
2020-09-22,24078,18312,5766,31.49,1224
2020-09-23,24078,18084,5994,33.15,1224
2020-09-24,24078,17934,6144,34.26,1224
2020-09-25,24346,19048,5298,27.81,1224
2020-09-26,19080,13446,5634,41.9,1224
2020-09-27,12413,6137,6276,102.26,1224
2020-09-28,23662,17246,6416,37.2,1224
2020-09-29,24078,17143,6935,40.45,1224
2020-09-30,24078,16959,7119,41.98,1224
2020-10-01,23711,16872,6839,40.53,1224
2020-10-02,24331,18062,6269,34.71,1224
2020-10-03,18941,12550,6391,50.92,1224
2020-10-04,11459,5340,6119,114.59,1224
2020-10-05,23524,16554,6970,42.1,1224
2020-10-06,23711,16559,7152,43.19,1224
2020-10-07,23711,16486,7225,43.83,1224
2020-10-08,23711,16505,7206,43.66,1224
2020-10-09,24331,17798,6533,36.71,1224
2020-10-10,18941,12381,6560,52.98,1224
2020-10-11,11459,5257,6202,117.98,1224
2020-10-12,23524,16545,6979,42.18,1224
2020-10-13,23711,16613,7098,42.73,1224
2020-10-14,23711,16589,7122,42.93,1224
2020-10-15,23711,16644,7067,42.46,1224
2020-10-16,24331,17959,6372,35.48,1224
2020-10-17,18941,12551,6390,50.91,1224
2020-10-18,11459,5424,6035,111.26,1224
2020-10-19,23524,16699,6825,40.87,1224
2020-10-20,23711,16744,6967,41.61,1224
2020-10-21,23711,16689,7022,42.08,1224
2020-10-22,23711,16707,7004,41.92,1224
2020-10-23,24331,17982,6349,35.31,1224
2020-10-24,18941,12532,6409,51.14,1224
2020-10-25,11459,5362,6097,113.71,1224
2020-10-26,23524,16597,6927,41.74,1224
2020-10-27,23711,16605,7106,42.79,1224
2020-10-28,23711,16518,7193,43.55,1224
2020-10-29,23711,16511,7200,43.61,1224
2020-10-30,24331,17767,6564,36.94,1224
2020-10-31,18941,12306,6635,53.92,1224
2020-11-01,8834,5134,3700,72.07,1224
2020-11-02,20236,16373,3863,23.59,1224
2020-11-03,17950,16393,1557,9.5,1224
2020-11-04,17950,16324,1626,9.96,1224
2020-11-05,17950,16341,1609,9.85,1224
2020-11-06,19230,17626,1604,9.1,1224
2020-11-07,13942,12197,1745,14.31,1224
2020-11-08,8834,5057,3777,74.69,1224
2020-11-09,20236,16330,3906,23.92,1224
2020-11-10,17950,16382,1568,9.57,1224
2020-11-11,17950,16343,1607,9.83,1224
2020-11-12,17950,16385,1565,9.55,1224
2020-11-13,19230,17689,1541,8.71,1224
2020-11-14,13942,12273,1669,13.6,1224
2020-11-15,8834,5140,3694,71.87,1224
2020-11-16,20236,16411,3825,23.31,1224
2020-11-17,17950,16455,1495,9.09,1224
2020-11-18,17950,16400,1550,9.45,1224
2020-11-19,17950,16419,1531,9.32,1224
2020-11-20,19230,17694,1536,8.68,1224
2020-11-21,13942,12244,1698,13.87,1224
2020-11-22,8834,5073,3761,74.14,1224
2020-11-23,20236,16303,3933,24.12,1224
2020-11-24,17950,16304,1646,10.1,1224
2020-11-25,17950,16207,1743,10.75,1224
2020-11-26,17950,16186,1764,10.9,1224
2020-11-27,19230,17424,1806,10.37,1224
2020-11-28,13942,11941,2001,16.76,1224
2020-11-29,8834,4743,4091,86.25,1224
2020-11-30,20236,15953,4283,26.85,1224
2020-12-01,19217,15942,3275,20.54,1224
2020-12-02,19217,15841,3376,21.31,1224
2020-12-03,19217,15823,3394,21.45,1224
2020-12-04,20975,17074,3901,22.85,1224
2020-12-05,16054,11611,4443,38.27,1224
2020-12-06,9104,4440,4664,105.05,1224
2020-12-07,20547,15684,4863,31.01,1224
2020-12-08,19217,15711,3506,22.32,1224
2020-12-09,19217,15651,3566,22.78,1224
2020-12-10,19217,15678,3539,22.57,1224
2020-12-11,20975,16971,4004,23.59,1224
2020-12-12,16054,11551,4503,38.98,1224
2020-12-13,9104,4419,4685,106.02,1224
2020-12-14,20547,15696,4851,30.91,1224
2020-12-15,19217,15750,3467,22.01,1224
2020-12-16,19217,15709,3508,22.33,1224
2020-12-17,19217,15746,3471,22.04,1224
2020-12-18,20975,17040,3935,23.09,1224
2020-12-19,16054,11610,4444,38.28,1224
2020-12-20,9104,4457,4647,104.26,1224
2020-12-21,20547,15704,4843,30.84,1224
2020-12-22,19217,15718,3499,22.26,1224
2020-12-23,19217,15629,3588,22.96,1224
2020-12-24,19217,15610,3607,23.11,1224
2020-12-25,20975,16844,4131,24.53,1224
2020-12-26,16054,11349,4705,41.46,1224
2020-12-27,9104,4130,4974,120.44,1224
2020-12-28,20547,15310,5237,34.21,1224
2020-12-29,19217,15261,3956,25.92,1224
2020-12-30,19217,15113,4104,27.16,1224
2020-12-31,19217,15043,4174,27.75,1224
2021-01-01,16575,16233,342,2.11,1224
2021-01-02,11149,10705,444,4.15,1224
2021-01-03,7481,3465,4016,115.9,1224
2021-01-04,15546,14638,908,6.2,1224
2021-01-05,15999,14594,1405,9.63,1224
2021-01-06,15999,14465,1534,10.6,1224
2021-01-07,15999,14427,1572,10.9,1224
2021-01-08,16575,15662,913,5.83,1224
2021-01-09,11149,10190,959,9.41,1224
2021-01-10,7481,3017,4464,147.96,1224
2021-01-11,15546,14264,1282,8.99,1224
2021-01-12,15999,14299,1700,11.89,1224
2021-01-13,15999,14253,1746,12.25,1224
2021-01-14,15999,14297,1702,11.9,1224
2021-01-15,16575,15612,963,6.17,1224
2021-01-16,11149,10214,935,9.15,1224
2021-01-17,7481,3106,4375,140.86,1224
2021-01-18,15546,14406,1140,7.91,1224
2021-01-19,15999,14482,1517,10.48,1224
2021-01-20,15999,14460,1539,10.64,1224
2021-01-21,15999,14510,1489,10.26,1224
2021-01-22,16575,15813,762,4.82,1224
2021-01-23,11149,10384,765,7.37,1224
2021-01-24,7481,3225,4256,131.97,1224
2021-01-25,15546,14457,1089,7.53,1224
2021-01-26,15999,14446,1553,10.75,1224
2021-01-27,15999,14323,1676,11.7,1224
2021-01-28,15999,14259,1740,12.2,1224
2021-01-29,16575,15437,1138,7.37,1224
2021-01-30,11149,9877,1272,12.88,1224
2021-01-31,7481,2585,4896,189.4,1224
2021-02-01,20203,13684,6519,47.64,1224
2021-02-02,20082,13547,6535,48.24,1224
2021-02-03,20082,13307,6775,50.91,1224
2021-02-04,20082,13141,6941,52.82,1224
2021-02-05,20694,14235,6459,45.37,1224
2021-02-06,15781,8614,7167,83.2,1224
2021-02-07,9310,1285,8025,624.51,1224
2021-02-08,20203,12376,7827,63.24,1224
2021-02-09,20082,12261,7821,63.79,1224
2021-02-10,20082,12074,8008,66.32,1224
2021-02-11,20082,11994,8088,67.43,1224
2021-02-12,20694,13206,7488,56.7,1224
2021-02-13,15781,7732,8049,104.1,1224
2021-02-14,9310,581,8729,1502.41,1224
2021-02-15,20203,11875,8328,70.13,1224
2021-02-16,20082,11985,8097,67.56,1224
2021-02-17,20082,12042,8040,66.77,1224
2021-02-18,20082,12218,7864,64.36,1224
2021-02-19,20694,13695,6999,51.11,1224
2021-02-20,15781,8488,7293,85.92,1224
2021-02-21,9310,1599,7711,482.24,1224
2021-02-22,20203,13146,7057,53.68,1224
2021-02-23,20082,13493,6589,48.83,1224
2021-02-24,20082,13765,6317,45.89,1224
2021-02-25,20082,14129,5953,42.13,1224
2021-02-26,20694,15761,4933,31.3,1224
2021-02-27,15781,10673,5108,47.86,1224
2021-02-28,9310,3864,5446,140.94,1224
2021-03-01,21827,15447,6380,41.3,1224
2021-03-02,21941,15788,6153,38.97,1224
2021-03-03,21941,16008,5933,37.06,1224
2021-03-04,21941,16276,5665,34.81,1224
2021-03-05,22039,17770,4269,24.02,1224
2021-03-06,17413,12505,4908,39.25,1224
2021-03-07,9757,5481,4276,78.01,1224
2021-03-08,21827,16818,5009,29.78,1224
2021-03-09,21941,16886,5055,29.94,1224
2021-03-10,21941,16812,5129,30.51,1224
2021-03-11,21941,16773,5168,30.81,1224
2021-03-12,22039,17952,4087,22.77,1224
2021-03-13,17413,12372,5041,40.75,1224
2021-03-14,9757,5039,4718,93.63,1224
2021-03-15,21827,16083,5744,35.71,1224
2021-03-16,21941,15876,6065,38.2,1224
2021-03-17,21941,15556,6385,41.05,1224
2021-03-18,21941,15302,6639,43.39,1224
2021-03-19,22039,16303,5736,35.18,1224
2021-03-20,17413,10585,6828,64.51,1224
2021-03-21,9757,3159,6598,208.86,1224
2021-03-22,21827,14153,7674,54.22,1224
2021-03-23,21941,13944,7997,57.35,1224
2021-03-24,21941,13666,8275,60.55,1224
2021-03-25,21941,13498,8443,62.55,1224
2021-03-26,22039,14625,7414,50.69,1224
2021-03-27,17413,9071,8342,91.96,1224
2021-03-28,9757,1842,7915,429.7,1224
2021-03-29,21827,13059,8768,67.14,1224
2021-03-30,21941,13094,8847,67.57,1224
2021-03-31,21941,13074,8867,67.82,1224
2021-04-01,18577,13171,5406,41.04,1224
2021-04-02,19119,14565,4554,31.27,1224
2021-04-03,13718,9270,4448,47.98,1224
2021-04-04,9733,2286,7447,325.77,1224
2021-04-05,19193,13730,5463,39.79,1224
2021-04-06,18577,13965,4612,33.03,1224
2021-04-07,18577,14115,4462,31.61,1224
2021-04-08,18577,14348,4229,29.47,1224
2021-04-09,19119,15839,3280,20.71,1224
2021-04-10,13718,10602,3116,29.39,1224
2021-04-11,9733,3635,6098,167.76,1224
2021-04-12,19193,15054,4139,27.49,1224
2021-04-13,18577,15225,3352,22.02,1224
2021-04-14,18577,15274,3303,21.62,1224
2021-04-15,18577,15371,3206,20.86,1224
2021-04-16,19119,16696,2423,14.51,1224
2021-04-17,13718,11267,2451,21.75,1224
2021-04-18,9733,4088,5645,138.09,1224
2021-04-19,19193,15282,3911,25.59,1224
2021-04-20,18577,15220,3357,22.06,1224
2021-04-21,18577,15034,3543,23.57,1224
2021-04-22,18577,14903,3674,24.65,1224
2021-04-23,19119,16011,3108,19.41,1224
2021-04-24,13718,10383,3335,32.12,1224
2021-04-25,9733,3028,6705,221.43,1224
2021-04-26,19193,14074,5119,36.37,1224
2021-04-27,18577,13896,4681,33.69,1224
2021-04-28,18577,13628,4949,36.31,1224
2021-04-29,18577,13451,5126,38.11,1224
2021-04-30,19119,14551,4568,31.39,1224
2021-05-01,19591,8952,10639,118.84,1224
2021-05-02,11236,1662,9574,576.05,1224
2021-05-03,23856,12807,11049,86.27,1224
2021-05-04,24039,12758,11281,88.42,1224
2021-05-05,24039,12647,11392,90.08,1224
2021-05-06,24039,12648,11391,90.06,1224
2021-05-07,23874,13944,9930,71.21,1224
2021-05-08,19591,8553,11038,129.05,1224
2021-05-09,11236,1475,9761,661.76,1224
2021-05-10,23856,12832,11024,85.91,1224
2021-05-11,24039,12988,11051,85.09,1224
2021-05-12,24039,13070,10969,83.93,1224
2021-05-13,24039,13247,10792,81.47,1224
2021-05-14,23874,14695,9179,62.46,1224
2021-05-15,19591,9428,10163,107.8,1224
2021-05-16,11236,2446,8790,359.36,1224
2021-05-17,23856,13865,9991,72.06,1224
2021-05-18,24039,14050,9989,71.1,1224
2021-05-19,24039,14125,9914,70.19,1224
2021-05-20,24039,14260,9779,68.58,1224
2021-05-21,23874,15634,8240,52.71,1224
2021-05-22,19591,10263,9328,90.89,1224
2021-05-23,11236,3149,8087,256.81,1224
2021-05-24,23856,14413,9443,65.52,1224
2021-05-25,24039,14423,9616,66.67,1224
2021-05-26,24039,14310,9729,67.99,1224
2021-05-27,24039,14249,9790,68.71,1224
2021-05-28,23874,15424,8450,54.78,1224
2021-05-29,19591,9857,9734,98.75,1224
2021-05-30,11236,2556,8680,339.59,1224
2021-05-31,23856,13646,10210,74.82,1224
2021-06-01,24288,13502,10786,79.88,1224
2021-06-02,24288,13258,11030,83.2,1224
2021-06-03,24288,13093,11195,85.5,1224
2021-06-04,24246,14194,10052,70.82,1224
2021-06-05,19070,8584,10486,122.16,1224
2021-06-06,13445,1273,12172,956.17,1224
2021-06-07,23852,12387,11465,92.56,1224
2021-06-08,24288,12298,11990,97.5,1224
2021-06-09,24288,12139,12149,100.08,1224
2021-06-10,24288,12088,12200,100.93,1224
2021-06-11,24246,13326,10920,81.95,1224
2021-06-12,19070,7874,11196,142.19,1224
2021-06-13,13445,737,12708,1724.29,1224
2021-06-14,23852,12034,11818,98.21,1224
2021-06-15,24288,12135,12153,100.15,1224
2021-06-16,24288,12166,12122,99.64,1224
2021-06-17,24288,12298,11990,97.5,1224
2021-06-18,24246,13709,10537,76.86,1224
2021-06-19,19070,8414,10656,126.65,1224
2021-06-20,13445,1413,12032,851.52,1224
2021-06-21,23852,12824,11028,86.0,1224
2021-06-22,24288,13010,11278,86.69,1224
2021-06-23,24288,13097,11191,85.45,1224
2021-06-24,24288,13253,11035,83.26,1224
2021-06-25,24246,14657,9589,65.42,1224
2021-06-26,19070,9323,9747,104.55,1224
2021-06-27,13445,2254,11191,496.5,1224
2021-06-28,23852,13567,10285,75.81,1224
2021-06-29,24288,13631,10657,78.18,1224
2021-06-30,24288,13573,10715,78.94,1224
2021-07-01,21870,13568,8302,61.19,1224
2021-07-02,19521,14798,4723,31.92,1224
2021-07-03,13774,9282,4492,48.39,1224
2021-07-04,9448,2027,7421,366.11,1224
2021-07-05,21966,13159,8807,66.93,1224
2021-07-06,21870,13048,8822,67.61,1224
2021-07-07,21870,12829,9041,70.47,1224
2021-07-08,21870,12680,9190,72.48,1224
2021-07-09,19521,13787,5734,41.59,1224
2021-07-10,13774,8174,5600,68.51,1224
2021-07-11,9448,850,8598,1011.53,1224
2021-07-12,21966,11941,10025,83.95,1224
2021-07-13,21870,11821,10049,85.01,1224
2021-07-14,21870,11623,10247,88.16,1224
2021-07-15,21870,11525,10345,89.76,1224
2021-07-16,19521,12712,6809,53.56,1224
2021-07-17,13774,7206,6568,91.15,1224
2021-07-18,9448,11,9437,85790.91,1224
2021-07-19,21966,11251,10715,95.24,1224
2021-07-20,21870,11296,10574,93.61,1224
2021-07-21,21870,11273,10597,94.0,1224
2021-07-22,21870,11356,10514,92.59,1224
2021-07-23,19521,12725,6796,53.41,1224
2021-07-24,13774,7395,6379,86.26,1224
2021-07-25,9448,367,9081,2474.39,1224
2021-07-26,21966,11760,10206,86.79,1224
2021-07-27,21870,11939,9931,83.18,1224
2021-07-28,21870,12029,9841,81.81,1224
2021-07-29,21870,12199,9671,79.28,1224
2021-07-30,19521,13627,5894,43.25,1224
2021-07-31,13774,8327,5447,65.41,1224
2021-08-01,11199,1300,9899,761.46,1224
2021-08-02,20585,12663,7922,62.56,1224
2021-08-03,21159,12783,8376,65.52,1224
2021-08-04,21159,12787,8372,65.47,1224
2021-08-05,21159,12846,8313,64.71,1224
2021-08-06,20672,14142,6530,46.17,1224
2021-08-07,16286,8691,7595,87.39,1224
2021-08-08,11199,1500,9699,646.6,1224
2021-08-09,20585,12690,7895,62.21,1224
2021-08-10,21159,12633,8526,67.49,1224
2021-08-11,21159,12460,8699,69.82,1224
2021-08-12,21159,12347,8812,71.37,1224
2021-08-13,20672,13481,7191,53.34,1224
2021-08-14,16286,7884,8402,106.57,1224
2021-08-15,11199,564,10635,1885.64,1224
2021-08-16,20585,11647,8938,76.74,1224
2021-08-17,21159,11507,9652,83.88,1224
2021-08-18,21159,11279,9880,87.6,1224
2021-08-19,21159,11139,10020,89.95,1224
2021-08-20,20672,12273,8399,68.43,1224
2021-08-21,16286,6705,9581,142.89,1224
2021-08-22,11199,6705,4494,67.02,1224
2021-08-23,20585,10607,9978,94.07,1224
2021-08-24,21159,10572,10587,100.14,1224
2021-08-25,21159,10468,10691,102.13,1224
2021-08-26,21159,10469,10690,102.11,1224
2021-08-27,20672,11757,8915,75.83,1224
2021-08-28,16286,6351,9935,156.43,1224
2021-08-29,11199,6351,4848,76.33,1224
2021-08-30,20585,10581,10004,94.55,1224
2021-08-31,21159,10705,10454,97.66,1224
2021-09-01,22814,10750,12064,112.22,1224
2021-09-02,22814,10886,11928,109.57,1224
2021-09-03,23387,12292,11095,90.26,1224
2021-09-04,17832,6983,10849,155.36,1224
2021-09-05,12468,222,12246,5516.22,1224
2021-09-06,23066,11338,11728,103.44,1224
2021-09-07,22814,11485,11329,98.64,1224
2021-09-08,22814,11528,11286,97.9,1224
2021-09-09,22814,11636,11178,96.06,1224
2021-09-10,23387,12988,10399,80.07,1224
2021-09-11,17832,7602,10230,134.57,1224
2021-09-12,12468,480,11988,2497.5,1224
2021-09-13,23066,11742,11324,96.44,1224
2021-09-14,22814,11758,11056,94.03,1224
2021-09-15,22814,11657,11157,95.71,1224
2021-09-16,22814,11613,11201,96.45,1224
2021-09-17,23387,12810,10577,82.57,1224
2021-09-18,17832,7268,10564,145.35,1224
2021-09-19,12468,231,12237,5297.4,1224
2021-09-20,23066,11111,11955,107.6,1224
2021-09-21,22814,10993,11821,107.53,1224
2021-09-22,22814,10772,12042,111.79,1224
2021-09-23,22814,10626,12188,114.7,1224
2021-09-24,23387,11738,11649,99.24,1224
2021-09-25,17832,6132,11700,190.8,1224
2021-09-26,12468,6132,6336,103.33,1224
2021-09-27,23066,9912,13154,132.71,1224
2021-09-28,22814,9794,13020,132.94,1224
2021-09-29,22814,9594,13220,137.79,1224
2021-09-30,22814,9488,13326,140.45,1224
2021-10-01,23914,10658,13256,124.38,1224
2021-10-02,19727,5126,14601,284.84,1224
2021-10-03,12506,5126,7380,143.97,1224
2021-10-04,22622,9089,13533,148.89,1224
2021-10-05,23244,9075,14169,156.13,1224
2021-10-06,23244,8984,14260,158.73,1224
2021-10-07,23244,8987,14257,158.64,1224
2021-10-08,23914,10265,13649,132.97,1224
2021-10-09,19727,4837,14890,307.84,1224
2021-10-10,12506,4837,7669,158.55,1224
2021-10-11,22622,8985,13637,151.78,1224
2021-10-12,23244,9049,14195,156.87,1224
2021-10-13,23244,9023,14221,157.61,1224
2021-10-14,23244,9079,14165,156.02,1224
2021-10-15,23914,10396,13518,130.03,1224
2021-10-16,19727,4993,14734,295.09,1224
2021-10-17,12506,4993,7513,150.47,1224
2021-10-18,22622,9154,13468,147.13,1224
2021-10-19,23244,9207,14037,152.46,1224
2021-10-20,23244,9160,14084,153.76,1224
2021-10-21,23244,9187,14057,153.01,1224
2021-10-22,23914,10469,13445,128.43,1224
2021-10-23,19727,5027,14700,292.42,1224
2021-10-24,12506,5027,7479,148.78,1224
2021-10-25,22622,9103,13519,148.51,1224
2021-10-26,23244,9115,14129,155.01,1224
2021-10-27,23244,9030,14214,157.41,1224
2021-10-28,23244,9024,14220,157.58,1224
2021-10-29,23914,10279,13635,132.65,1224
2021-10-30,19727,4816,14911,309.61,1224
2021-10-31,12506,4816,7690,159.68,1224
2021-11-01,19948,8874,11074,124.79,1224
2021-11-02,21283,8889,12394,139.43,1224
2021-11-03,21283,8814,12469,141.47,1224
2021-11-04,21283,8825,12458,141.17,1224
2021-11-05,22664,10103,12561,124.33,1224
2021-11-06,17469,4667,12802,274.31,1224
2021-11-07,11379,4667,6712,143.82,1224
2021-11-08,19948,8790,11158,126.94,1224
2021-11-09,21283,8838,12445,140.81,1224
2021-11-10,21283,8796,12487,141.96,1224
2021-11-11,21283,8836,12447,140.87,1224
2021-11-12,22664,10140,12524,123.51,1224
2021-11-13,17469,4726,12743,269.64,1224
2021-11-14,11379,4726,6653,140.77,1224
2021-11-15,19948,8871,11077,124.87,1224
2021-11-16,21283,8920,12363,138.6,1224
2021-11-17,21283,8872,12411,139.89,1224
2021-11-18,21283,8898,12385,139.19,1224
2021-11-19,22664,10181,12483,122.61,1224
2021-11-20,17469,4739,12730,268.62,1224
2021-11-21,11379,4739,6640,140.11,1224
2021-11-22,19948,8814,11134,126.32,1224
2021-11-23,21283,8823,12460,141.22,1224
2021-11-24,21283,8732,12551,143.74,1224
2021-11-25,21283,8716,12567,144.18,1224
2021-11-26,22664,9958,12706,127.6,1224
2021-11-27,17469,4478,12991,290.11,1224
2021-11-28,11379,4478,6901,154.11,1224
2021-11-29,19948,8490,11458,134.96,1224
2021-11-30,21283,8477,12806,151.07,1224
2021-12-01,19887,8372,11515,137.54,1224
2021-12-02,19887,8349,11538,138.2,1224
2021-12-03,18399,9593,8806,91.8,1224
2021-12-04,14963,4124,10839,262.83,1224
2021-12-05,10222,4124,6098,147.87,1224
2021-12-06,20745,8180,12565,153.61,1224
2021-12-07,19887,8199,11688,142.55,1224
2021-12-08,19887,8131,11756,144.58,1224
2021-12-09,19887,8149,11738,144.04,1224
2021-12-10,18399,9437,8962,94.97,1224
2021-12-11,14963,4011,10952,273.05,1224
2021-12-12,10222,4011,6211,154.85,1224
2021-12-13,20745,8149,12596,154.57,1224
2021-12-14,19887,8203,11684,142.44,1224
2021-12-15,19887,8164,11723,143.59,1224
2021-12-16,19887,8203,11684,142.44,1224
2021-12-17,18399,9503,8896,93.61,1224
2021-12-18,14963,4080,10883,266.74,1224
2021-12-19,10222,4080,6142,150.54,1224
2021-12-20,20745,8194,12551,153.17,1224
2021-12-21,19887,8220,11667,141.93,1224
2021-12-22,19887,8143,11744,144.22,1224
2021-12-23,19887,8136,11751,144.43,1224
2021-12-24,18399,9382,9017,96.11,1224
2021-12-25,14963,3899,11064,283.77,1224
2021-12-26,10222,3899,6323,162.17,1224
2021-12-27,20745,7883,12862,163.16,1224
2021-12-28,19887,7842,12045,153.6,1224
2021-12-29,19887,7701,12186,158.24,1224
2021-12-30,19887,7635,12252,160.47,1224
2021-12-31,18399,8827,9572,108.44,1224
2022-01-01,16423,3298,13125,397.97,1224
2022-01-02,9696,3298,6398,194.0,1224
2022-01-03,19255,7222,12033,166.62,1224
2022-01-04,19020,7170,11850,165.27,1224
2022-01-05,19020,7031,11989,170.52,1224
2022-01-06,19020,6980,12040,172.49,1224
2022-01-07,20174,8201,11973,145.99,1224
2022-01-08,16423,2715,13708,504.9,1224
2022-01-09,9696,2715,6981,257.13,1224
2022-01-10,19255,6757,12498,184.96,1224
2022-01-11,19020,6777,12243,180.66,1224
2022-01-12,19020,6716,12304,183.2,1224
2022-01-13,19020,6748,12272,181.86,1224
2022-01-14,20174,8051,12123,150.58,1224
2022-01-15,16423,2646,13777,520.67,1224
2022-01-16,9696,2646,7050,266.44,1224
2022-01-17,19255,6830,12425,181.92,1224
2022-01-18,19020,6907,12113,175.37,1224
2022-01-19,19020,6890,12130,176.05,1224
2022-01-20,19020,6950,12070,173.67,1224
2022-01-21,20174,8265,11909,144.09,1224
2022-01-22,16423,2852,13571,475.84,1224
2022-01-23,9696,2852,6844,239.97,1224
2022-01-24,19255,6964,12291,176.49,1224
2022-01-25,19020,6977,12043,172.61,1224
2022-01-26,19020,6878,12142,176.53,1224
2022-01-27,19020,6839,12181,178.11,1224
2022-01-28,20174,8043,12131,150.83,1224
2022-01-29,16423,2507,13916,555.09,1224
2022-01-30,9696,2507,7189,286.76,1224
2020-02-01,14158,13848,310,2.24,1603
2020-02-02,9995,9423,572,6.07,1603
2020-02-03,15511,16026,-515,-3.21,1603
2020-02-04,15855,15901,-46,-0.29,1603
2020-02-05,15855,15916,-61,-0.38,1603
2020-02-06,15855,15944,-89,-0.56,1603
2020-02-07,16585,16388,197,1.2,1603
2020-02-08,14158,13958,200,1.43,1603
2020-02-09,9995,9512,483,5.08,1603
2020-02-10,15511,16098,-587,-3.65,1603
2020-02-11,15855,15960,-105,-0.66,1603
2020-02-12,15855,15966,-111,-0.7,1603
2020-02-13,15855,15991,-136,-0.85,1603
2020-02-14,16585,16436,149,0.91,1603
2020-02-15,14158,14012,146,1.04,1603
2020-02-16,9995,9577,418,4.36,1603
2020-02-17,15511,16178,-667,-4.12,1603
2020-02-18,15855,16060,-205,-1.28,1603
2020-02-19,15855,16089,-234,-1.45,1603
2020-02-20,15855,16140,-285,-1.77,1603
2020-02-21,16585,16613,-28,-0.17,1603
2020-02-22,14158,14218,-60,-0.42,1603
2020-02-23,9995,9813,182,1.85,1603
2020-02-24,15511,16444,-933,-5.67,1603
2020-02-25,15855,16354,-499,-3.05,1603
2020-02-26,15855,16409,-554,-3.38,1603
2020-02-27,15855,16483,-628,-3.81,1603
2020-02-28,16585,16975,-390,-2.3,1603
2020-02-29,14158,14595,-437,-2.99,1603
2020-03-01,6881,10200,-3319,-32.54,1603
2020-03-02,11661,16837,-5176,-30.74,1603
2020-03-03,11606,16746,-5140,-30.69,1603
2020-03-04,11606,16796,-5190,-30.9,1603
2020-03-05,11606,16859,-5253,-31.16,1603
2020-03-06,12264,17335,-5071,-29.25,1603
2020-03-07,9525,14934,-5409,-36.22,1603
2020-03-08,6881,10515,-3634,-34.56,1603
2020-03-09,11661,17122,-5461,-31.89,1603
2020-03-10,11606,17000,-5394,-31.73,1603
2020-03-11,11606,17017,-5411,-31.8,1603
2020-03-12,11606,17044,-5438,-31.91,1603
2020-03-13,12264,17486,-5222,-29.86,1603
2020-03-14,9525,15050,-5525,-36.71,1603
2020-03-15,6881,10597,-3716,-35.07,1603
2020-03-16,11661,17173,-5512,-32.1,1603
2020-03-17,11606,17023,-5417,-31.82,1603
2020-03-18,11606,17014,-5408,-31.79,1603
2020-03-19,11606,17021,-5415,-31.81,1603
2020-03-20,12264,17446,-5182,-29.7,1603
2020-03-21,9525,14999,-5474,-36.5,1603
2020-03-22,6881,10539,-3658,-34.71,1603
2020-03-23,11661,17113,-5452,-31.86,1603
2020-03-24,11606,16966,-5360,-31.59,1603
2020-03-25,11606,16965,-5359,-31.59,1603
2020-03-26,11606,16983,-5377,-31.66,1603
2020-03-27,12264,17424,-5160,-29.61,1603
2020-03-28,9525,14994,-5469,-36.47,1603
2020-03-29,6881,10555,-3674,-34.81,1603
2020-03-30,11661,17151,-5490,-32.01,1603
2020-03-31,11606,17026,-5420,-31.83,1603
2020-04-01,11236,17047,-5811,-34.09,1603
2020-04-02,11236,17087,-5851,-34.24,1603
2020-04-03,10783,17547,-6764,-38.55,1603
2020-04-04,8421,15135,-6714,-44.36,1603
2020-04-05,5067,10710,-5643,-52.69,1603
2020-04-06,11662,17317,-5655,-32.66,1603
2020-04-07,11236,17199,-5963,-34.67,1603
2020-04-08,11236,17223,-5987,-34.76,1603
2020-04-09,11236,17261,-6025,-34.91,1603
2020-04-10,10783,17714,-6931,-39.13,1603
2020-04-11,8421,15292,-6871,-44.93,1603
2020-04-12,5067,10852,-5785,-53.31,1603
2020-04-13,11662,17440,-5778,-33.13,1603
2020-04-14,11236,17299,-6063,-35.05,1603
2020-04-15,11236,17298,-6062,-35.04,1603
2020-04-16,11236,17308,-6072,-35.08,1603
2020-04-17,10783,17733,-6950,-39.19,1603
2020-04-18,8421,15280,-6859,-44.89,1603
2020-04-19,5067,10809,-5742,-53.12,1603
2020-04-20,11662,17368,-5706,-32.85,1603
2020-04-21,11236,17199,-5963,-34.67,1603
2020-04-22,11236,17170,-5934,-34.56,1603
2020-04-23,11236,17157,-5921,-34.51,1603
2020-04-24,10783,17560,-6777,-38.59,1603
2020-04-25,8421,15089,-6668,-44.19,1603
2020-04-26,5067,10604,-5537,-52.22,1603
2020-04-27,11662,17152,-5490,-32.01,1603
2020-04-28,11236,16976,-5740,-33.81,1603
2020-04-29,11236,16945,-5709,-33.69,1603
2020-04-30,11236,16933,-5697,-33.64,1603
2020-05-01,15355,17341,-1986,-11.45,1603
2020-05-02,13032,14878,-1846,-12.41,1603
2020-05-03,7913,10403,-2490,-23.94,1603
2020-05-04,15284,16964,-1680,-9.9,1603
2020-05-05,15387,16803,-1416,-8.43,1603
2020-05-06,15387,16788,-1401,-8.35,1603
2020-05-07,15387,16791,-1404,-8.36,1603
2020-05-08,15355,17216,-1861,-10.81,1603
2020-05-09,13032,14768,-1736,-11.76,1603
2020-05-10,7913,10309,-2396,-23.24,1603
2020-05-11,15284,16883,-1599,-9.47,1603
2020-05-12,15387,16733,-1346,-8.04,1603
2020-05-13,15387,16727,-1340,-8.01,1603
2020-05-14,15387,16737,-1350,-8.07,1603
2020-05-15,15355,17166,-1811,-10.55,1603
2020-05-16,13032,14720,-1688,-11.47,1603
2020-05-17,7913,10260,-2347,-22.88,1603
2020-05-18,15284,16831,-1547,-9.19,1603
2020-05-19,15387,16677,-1290,-7.74,1603
2020-05-20,15387,16665,-1278,-7.67,1603
2020-05-21,15387,16668,-1281,-7.69,1603
2020-05-22,15355,17088,-1733,-10.14,1603
2020-05-23,13032,14634,-1602,-10.95,1603
2020-05-24,7913,10165,-2252,-22.15,1603
2020-05-25,15284,16729,-1445,-8.64,1603
2020-05-26,15387,16568,-1181,-7.13,1603
2020-05-27,15387,16551,-1164,-7.03,1603
2020-05-28,15387,16550,-1163,-7.03,1603
2020-05-29,15355,16970,-1615,-9.52,1603
2020-05-30,13032,14517,-1485,-10.23,1603
2020-05-31,7913,10052,-2139,-21.28,1603
2020-06-01,15652,16621,-969,-5.83,1603
2020-06-02,14852,16467,-1615,-9.81,1603
2020-06-03,14852,16460,-1608,-9.77,1603
2020-06-04,14852,16470,-1618,-9.82,1603
2020-06-05,15179,16901,-1722,-10.19,1603
2020-06-06,11874,14461,-2587,-17.89,1603
2020-06-07,7556,10009,-2453,-24.51,1603
2020-06-08,15652,16590,-938,-5.65,1603
2020-06-09,14852,16448,-1596,-9.7,1603
2020-06-10,14852,16450,-1598,-9.71,1603
2020-06-11,14852,16467,-1615,-9.81,1603
2020-06-12,15179,16902,-1723,-10.19,1603
2020-06-13,11874,14462,-2588,-17.9,1603
2020-06-14,7556,10007,-2451,-24.49,1603
2020-06-15,15652,16580,-928,-5.6,1603
2020-06-16,14852,16426,-1574,-9.58,1603
2020-06-17,14852,16411,-1559,-9.5,1603
2020-06-18,14852,16407,-1555,-9.48,1603
2020-06-19,15179,16816,-1637,-9.73,1603
2020-06-20,11874,14347,-2473,-17.24,1603
2020-06-21,7556,9858,-2302,-23.35,1603
2020-06-22,15652,16395,-743,-4.53,1603
2020-06-23,14852,16203,-1351,-8.34,1603
2020-06-24,14852,16147,-1295,-8.02,1603
2020-06-25,14852,16102,-1250,-7.76,1603
2020-06-26,15179,16471,-1292,-7.84,1603
2020-06-27,11874,13962,-2088,-14.95,1603
2020-06-28,7556,9435,-1879,-19.92,1603
2020-06-29,15652,15938,-286,-1.79,1603
2020-06-30,14852,15714,-862,-5.49,1603
2020-07-01,14398,15632,-1234,-7.89,1603
2020-07-02,14398,15567,-1169,-7.51,1603
2020-07-03,14961,15920,-959,-6.02,1603
2020-07-04,12512,13403,-891,-6.65,1603
2020-07-05,8721,8874,-153,-1.72,1603
2020-07-06,15241,15381,-140,-0.91,1603
2020-07-07,14398,15169,-771,-5.08,1603
2020-07-08,14398,15106,-708,-4.69,1603
2020-07-09,14398,15065,-667,-4.43,1603
2020-07-10,14961,15449,-488,-3.16,1603
2020-07-11,12512,12967,-455,-3.51,1603
2020-07-12,8721,8479,242,2.85,1603
2020-07-13,15241,15029,212,1.41,1603
2020-07-14,14398,14863,-465,-3.13,1603
2020-07-15,14398,14847,-449,-3.02,1603
2020-07-16,14398,14853,-455,-3.06,1603
2020-07-17,14961,15283,-322,-2.11,1603
2020-07-18,12512,12845,-333,-2.59,1603
2020-07-19,8721,8397,324,3.86,1603
2020-07-20,15241,14984,257,1.72,1603
2020-07-21,14398,14849,-451,-3.04,1603
2020-07-22,14398,14859,-461,-3.1,1603
2020-07-23,14398,14885,-487,-3.27,1603
2020-07-24,14961,15328,-367,-2.39,1603
2020-07-25,12512,12896,-384,-2.98,1603
2020-07-26,8721,8447,274,3.24,1603
2020-07-27,15241,15027,214,1.42,1603
2020-07-28,14398,14879,-481,-3.23,1603
2020-07-29,14398,14869,-471,-3.17,1603
2020-07-30,14398,14870,-472,-3.17,1603
2020-07-31,14961,15285,-324,-2.12,1603
2020-08-01,11882,12821,-939,-7.32,1603
2020-08-02,8462,8339,123,1.47,1603
2020-08-03,14490,14885,-395,-2.65,1603
2020-08-04,13498,14702,-1204,-8.19,1603
2020-08-05,13498,14660,-1162,-7.93,1603
2020-08-06,13498,14632,-1134,-7.75,1603
2020-08-07,13440,15022,-1582,-10.53,1603
2020-08-08,11882,12538,-656,-5.23,1603
2020-08-09,8462,8042,420,5.22,1603
2020-08-10,14490,14581,-91,-0.62,1603
2020-08-11,13498,14399,-901,-6.26,1603
2020-08-12,13498,14366,-868,-6.04,1603
2020-08-13,13498,14355,-857,-5.97,1603
2020-08-14,13440,14770,-1330,-9.0,1603
2020-08-15,11882,12320,-438,-3.56,1603
2020-08-16,8462,7865,597,7.59,1603
2020-08-17,14490,14452,38,0.26,1603
2020-08-18,13498,14325,-827,-5.77,1603
2020-08-19,13498,14352,-854,-5.95,1603
2020-08-20,13498,14406,-908,-6.3,1603
2020-08-21,13440,14889,-1449,-9.73,1603
2020-08-22,11882,12508,-626,-5.0,1603
2020-08-23,8462,8124,338,4.16,1603
2020-08-24,14490,14780,-290,-1.96,1603
2020-08-25,13498,14720,-1222,-8.3,1603
2020-08-26,13498,14810,-1312,-8.86,1603
2020-08-27,13498,14922,-1424,-9.54,1603
2020-08-28,13440,15457,-2017,-13.05,1603
2020-08-29,11882,13122,-1240,-9.45,1603
2020-08-30,8462,8775,-313,-3.57,1603
2020-08-31,14490,15460,-970,-6.27,1603
2020-09-01,14747,15420,-673,-4.36,1603
2020-09-02,14747,15520,-773,-4.98,1603
2020-09-03,14747,15633,-886,-5.67,1603
2020-09-04,14870,16160,-1290,-7.98,1603
2020-09-05,12820,13808,-988,-7.16,1603
2020-09-06,9092,9436,-344,-3.65,1603
2020-09-07,15371,16089,-718,-4.46,1603
2020-09-08,14747,16009,-1262,-7.88,1603
2020-09-09,14747,16065,-1318,-8.2,1603
2020-09-10,14747,16130,-1383,-8.57,1603
2020-09-11,14870,16605,-1735,-10.45,1603
2020-09-12,12820,14199,-1379,-9.71,1603
2020-09-13,9092,9772,-680,-6.96,1603
2020-09-14,15371,16370,-999,-6.1,1603
2020-09-15,14747,16238,-1491,-9.18,1603
2020-09-16,14747,16245,-1498,-9.22,1603
2020-09-17,14747,16263,-1516,-9.32,1603
2020-09-18,14870,16697,-1827,-10.94,1603
2020-09-19,12820,14255,-1435,-10.07,1603
2020-09-20,9092,9798,-706,-7.21,1603
2020-09-21,15371,16373,-1002,-6.12,1603
2020-09-22,14747,16224,-1477,-9.1,1603
2020-09-23,14747,16220,-1473,-9.08,1603
2020-09-24,14747,16233,-1486,-9.15,1603
2020-09-25,14870,16668,-1798,-10.79,1603
2020-09-26,12820,14232,-1412,-9.92,1603
2020-09-27,9092,9786,-694,-7.09,1603
2020-09-28,15371,16376,-1005,-6.14,1603
2020-09-29,14747,16246,-1499,-9.23,1603
2020-09-30,14747,16262,-1515,-9.32,1603
2020-10-01,16092,16297,-205,-1.26,1603
2020-10-02,16111,16754,-643,-3.84,1603
2020-10-03,13819,14341,-522,-3.64,1603
2020-10-04,9200,9916,-716,-7.22,1603
2020-10-05,16181,16524,-343,-2.08,1603
2020-10-06,16092,16410,-318,-1.94,1603
2020-10-07,16092,16439,-347,-2.11,1603
2020-10-08,16092,16483,-391,-2.37,1603
2020-10-09,16111,16946,-835,-4.93,1603
2020-10-10,13819,14533,-714,-4.91,1603
2020-10-11,9200,10105,-905,-8.96,1603
2020-10-12,16181,16707,-526,-3.15,1603
2020-10-13,16092,16581,-489,-2.95,1603
2020-10-14,16092,16596,-504,-3.04,1603
2020-10-15,16092,16624,-532,-3.2,1603
2020-10-16,16111,17067,-956,-5.6,1603
2020-10-17,13819,14634,-815,-5.57,1603
2020-10-18,9200,10184,-984,-9.66,1603
2020-10-19,16181,16764,-583,-3.48,1603
2020-10-20,16092,16616,-524,-3.15,1603
2020-10-21,16092,16611,-519,-3.12,1603
2020-10-22,16092,16620,-528,-3.18,1603
2020-10-23,16111,17046,-935,-5.49,1603
2020-10-24,13819,14599,-780,-5.34,1603
2020-10-25,9200,10138,-938,-9.25,1603
2020-10-26,16181,16710,-529,-3.17,1603
2020-10-27,16092,16559,-467,-2.82,1603
2020-10-28,16092,16553,-461,-2.78,1603
2020-10-29,16092,16565,-473,-2.86,1603
2020-10-30,16111,16997,-886,-5.21,1603
2020-10-31,13819,14559,-740,-5.08,1603
2020-11-01,7640,10110,-2470,-24.43,1603
2020-11-02,15159,16696,-1537,-9.21,1603
2020-11-03,14187,16560,-2373,-14.33,1603
2020-11-04,14187,16569,-2382,-14.38,1603
2020-11-05,14187,16597,-2410,-14.52,1603
2020-11-06,14216,17046,-2830,-16.6,1603
2020-11-07,11142,14622,-3480,-23.8,1603
2020-11-08,7640,10186,-2546,-25.0,1603
2020-11-09,15159,16782,-1623,-9.67,1603
2020-11-10,14187,16654,-2467,-14.81,1603
2020-11-11,14187,16669,-2482,-14.89,1603
2020-11-12,14187,16698,-2511,-15.04,1603
2020-11-13,14216,17145,-2929,-17.08,1603
2020-11-14,11142,14716,-3574,-24.29,1603
2020-11-15,7640,10271,-2631,-25.62,1603
2020-11-16,15159,16855,-1696,-10.06,1603
2020-11-17,14187,16712,-2525,-15.11,1603
2020-11-18,14187,16710,-2523,-15.1,1603
2020-11-19,14187,16720,-2533,-15.15,1603
2020-11-20,14216,17146,-2930,-17.09,1603
2020-11-21,11142,14696,-3554,-24.18,1603
2020-11-22,7640,10229,-2589,-25.31,1603
2020-11-23,15159,16793,-1634,-9.73,1603
2020-11-24,14187,16630,-2443,-14.69,1603
2020-11-25,14187,16609,-2422,-14.58,1603
2020-11-26,14187,16605,-2418,-14.56,1603
2020-11-27,14216,17018,-2802,-16.46,1603
2020-11-28,11142,14559,-3417,-23.47,1603
2020-11-29,7640,10086,-2446,-24.25,1603
2020-11-30,15159,16648,-1489,-8.94,1603
2020-12-01,14073,16488,-2415,-14.65,1603
2020-12-02,14073,16473,-2400,-14.57,1603
2020-12-03,14073,16478,-2405,-14.6,1603
2020-12-04,15130,16904,-1774,-10.49,1603
2020-12-05,12483,14460,-1977,-13.67,1603
2020-12-06,7876,10006,-2130,-21.29,1603
2020-12-07,14577,16587,-2010,-12.12,1603
2020-12-08,14073,16447,-2374,-14.43,1603
2020-12-09,14073,16453,-2380,-14.47,1603
2020-12-10,14073,16478,-2405,-14.6,1603
2020-12-11,15130,16923,-1793,-10.6,1603
2020-12-12,12483,14495,-2012,-13.88,1603
2020-12-13,7876,10054,-2178,-21.66,1603
2020-12-14,14577,16645,-2068,-12.42,1603
2020-12-15,14073,16511,-2438,-14.77,1603
2020-12-16,14073,16518,-2445,-14.8,1603
2020-12-17,14073,16538,-2465,-14.91,1603
2020-12-18,15130,16974,-1844,-10.86,1603
2020-12-19,12483,14532,-2049,-14.1,1603
2020-12-20,7876,10072,-2196,-21.8,1603
2020-12-21,14577,16639,-2062,-12.39,1603
2020-12-22,14073,16476,-2403,-14.58,1603
2020-12-23,14073,16451,-2378,-14.46,1603
2020-12-24,14073,16436,-2363,-14.38,1603
2020-12-25,15130,16833,-1703,-10.12,1603
2020-12-26,12483,14352,-1869,-13.02,1603
2020-12-27,7876,9852,-1976,-20.06,1603
2020-12-28,14577,16379,-1802,-11.0,1603
2020-12-29,14073,16177,-2104,-13.01,1603
2020-12-30,14073,16116,-2043,-12.68,1603
2020-12-31,14073,16069,-1996,-12.42,1603
2021-01-01,13038,16438,-3400,-20.68,1603
2021-01-02,9349,13934,-4585,-32.91,1603
2021-01-03,6619,9416,-2797,-29.7,1603
2021-01-04,12260,15932,-3672,-23.05,1603
2021-01-05,12692,15727,-3035,-19.3,1603
2021-01-06,12692,15669,-2977,-19.0,1603
2021-01-07,12692,15632,-2940,-18.81,1603
2021-01-08,13038,16018,-2980,-18.6,1603
2021-01-09,9349,13538,-4189,-30.94,1603
2021-01-10,6619,9051,-2432,-26.87,1603
2021-01-11,12260,15604,-3344,-21.43,1603
2021-01-12,12692,15440,-2748,-17.8,1603
2021-01-13,12692,15427,-2735,-17.73,1603
2021-01-14,12692,15439,-2747,-17.79,1603
2021-01-15,13038,15877,-2839,-17.88,1603
2021-01-16,9349,13450,-4101,-30.49,1603
2021-01-17,6619,9015,-2396,-26.58,1603
2021-01-18,12260,15620,-3360,-21.51,1603
2021-01-19,12692,15506,-2814,-18.15,1603
2021-01-20,12692,15540,-2848,-18.33,1603
2021-01-21,12692,15595,-2903,-18.61,1603
2021-01-22,13038,16071,-3033,-18.87,1603
2021-01-23,9349,13677,-4328,-31.64,1603
2021-01-24,6619,9270,-2651,-28.6,1603
2021-01-25,12260,15895,-3635,-22.87,1603
2021-01-26,12692,15796,-3104,-19.65,1603
2021-01-27,12692,15839,-3147,-19.87,1603
2021-01-28,12692,15896,-3204,-20.16,1603
2021-01-29,13038,16368,-3330,-20.34,1603
2021-01-30,9349,13965,-4616,-33.05,1603
2021-01-31,6619,9544,-2925,-30.65,1603
2021-02-01,14774,16152,-1378,-8.53,1603
2021-02-02,14618,16031,-1413,-8.81,1603
2021-02-03,14618,16051,-1433,-8.93,1603
2021-02-04,14618,16083,-1465,-9.11,1603
2021-02-05,15027,16531,-1504,-9.1,1603
2021-02-06,12466,14102,-1636,-11.6,1603
2021-02-07,8242,9658,-1416,-14.66,1603
2021-02-08,14774,16245,-1471,-9.06,1603
2021-02-09,14618,16107,-1489,-9.24,1603
2021-02-10,14618,16113,-1495,-9.28,1603
2021-02-11,14618,16135,-1517,-9.4,1603
2021-02-12,15027,16578,-1551,-9.36,1603
2021-02-13,12466,14150,-1684,-11.9,1603
2021-02-14,8242,9710,-1468,-15.12,1603
2021-02-15,14774,16307,-1533,-9.4,1603
2021-02-16,14618,16183,-1565,-9.67,1603
2021-02-17,14618,16207,-1589,-9.8,1603
2021-02-18,14618,16252,-1634,-10.05,1603
2021-02-19,15027,16720,-1693,-10.13,1603
2021-02-20,12466,14319,-1853,-12.94,1603
2021-02-21,8242,9909,-1667,-16.82,1603
2021-02-22,14774,16536,-1762,-10.66,1603
2021-02-23,14618,16442,-1824,-11.09,1603
2021-02-24,14618,16494,-1876,-11.37,1603
2021-02-25,14618,16566,-1948,-11.76,1603
2021-02-26,15027,17057,-2030,-11.9,1603
2021-02-27,12466,14677,-2211,-15.06,1603
2021-02-28,8242,10283,-2041,-19.85,1603
2021-03-01,15670,16921,-1251,-7.39,1603
2021-03-02,15218,16834,-1616,-9.6,1603
2021-03-03,15218,16887,-1669,-9.88,1603
2021-03-04,15218,16955,-1737,-10.24,1603
2021-03-05,15532,17437,-1905,-10.93,1603
2021-03-06,13667,15042,-1375,-9.14,1603
2021-03-07,8627,10628,-2001,-18.83,1603
2021-03-08,15670,17242,-1572,-9.12,1603
2021-03-09,15218,17127,-1909,-11.15,1603
2021-03-10,15218,17150,-1932,-11.27,1603
2021-03-11,15218,17184,-1966,-11.44,1603
2021-03-12,15532,17631,-2099,-11.91,1603
2021-03-13,13667,15201,-1534,-10.09,1603
2021-03-14,8627,10752,-2125,-19.76,1603
2021-03-15,15670,17333,-1663,-9.59,1603
2021-03-16,15218,17185,-1967,-11.45,1603
2021-03-17,15218,17179,-1961,-11.42,1603
2021-03-18,15218,17187,-1969,-11.46,1603
2021-03-19,15532,17613,-2081,-11.82,1603
2021-03-20,13667,15165,-1498,-9.88,1603
2021-03-21,8627,10704,-2077,-19.4,1603
2021-03-22,15670,17276,-1606,-9.3,1603
2021-03-23,15218,17126,-1908,-11.14,1603
2021-03-24,15218,17121,-1903,-11.12,1603
2021-03-25,15218,17136,-1918,-11.19,1603
2021-03-26,15532,17572,-2040,-11.61,1603
2021-03-27,13667,15138,-1471,-9.72,1603
2021-03-28,8627,10694,-2067,-19.33,1603
2021-03-29,15670,17286,-1616,-9.35,1603
2021-03-30,15218,17158,-1940,-11.31,1603
2021-03-31,15218,17175,-1957,-11.39,1603
2021-04-01,13844,17212,-3368,-19.57,1603
2021-04-02,14438,17670,-3232,-18.29,1603
2021-04-03,10859,15257,-4398,-28.83,1603
2021-04-04,7976,10831,-2855,-26.36,1603
2021-04-05,14473,17438,-2965,-17.0,1603
2021-04-06,13844,17321,-3477,-20.07,1603
2021-04-07,13844,17347,-3503,-20.19,1603
2021-04-08,13844,17388,-3544,-20.38,1603
2021-04-09,14438,17845,-3407,-19.09,1603
2021-04-10,10859,15426,-4567,-29.61,1603
2021-04-11,7976,10991,-3015,-27.43,1603
2021-04-12,14473,17584,-3111,-17.69,1603
2021-04-13,13844,17449,-3605,-20.66,1603
2021-04-14,13844,17453,-3609,-20.68,1603
2021-04-15,13844,17469,-3625,-20.75,1603
2021-04-16,14438,17899,-3461,-19.34,1603
2021-04-17,10859,15452,-4593,-29.72,1603
2021-04-18,7976,10986,-3010,-27.4,1603
2021-04-19,14473,17549,-3076,-17.53,1603
2021-04-20,13844,17384,-3540,-20.36,1603
2021-04-21,13844,17360,-3516,-20.25,1603
2021-04-22,13844,17348,-3504,-20.2,1603
2021-04-23,14438,17754,-3316,-18.68,1603
2021-04-24,10859,15284,-4425,-28.95,1603
2021-04-25,7976,10800,-2824,-26.15,1603
2021-04-26,14473,17347,-2874,-16.57,1603
2021-04-27,13844,17171,-3327,-19.38,1603
2021-04-28,13844,17139,-3295,-19.23,1603
2021-04-29,13844,17124,-3280,-19.15,1603
2021-04-30,14438,17529,-3091,-17.63,1603
2021-05-01,14504,15063,-559,-3.71,1603
2021-05-02,9482,10586,-1104,-10.43,1603
2021-05-03,17416,17144,272,1.59,1603
2021-05-04,17030,16980,50,0.29,1603
2021-05-05,17030,16962,68,0.4,1603
2021-05-06,17030,16962,68,0.4,1603
2021-05-07,16536,17384,-848,-4.88,1603
2021-05-08,14504,14934,-430,-2.88,1603
2021-05-09,9482,10473,-991,-9.46,1603
2021-05-10,17416,17046,370,2.17,1603
2021-05-11,17030,16895,135,0.8,1603
2021-05-12,17030,16889,141,0.83,1603
2021-05-13,17030,16899,131,0.78,1603
2021-05-14,16536,17328,-792,-4.57,1603
2021-05-15,14504,14884,-380,-2.55,1603
2021-05-16,9482,10425,-943,-9.05,1603
2021-05-17,17416,16997,419,2.47,1603
2021-05-18,17030,16845,185,1.1,1603
2021-05-19,17030,16834,196,1.16,1603
2021-05-20,17030,16839,191,1.13,1603
2021-05-21,16536,17260,-724,-4.19,1603
2021-05-22,14504,14808,-304,-2.05,1603
2021-05-23,9482,10340,-858,-8.3,1603
2021-05-24,17416,16905,511,3.02,1603
2021-05-25,17030,16744,286,1.71,1603
2021-05-26,17030,16727,303,1.81,1603
2021-05-27,17030,16726,304,1.82,1603
2021-05-28,16536,17144,-608,-3.55,1603
2021-05-29,14504,14690,-186,-1.27,1603
2021-05-30,9482,10223,-741,-7.25,1603
2021-05-31,17416,16790,626,3.73,1603
2021-06-01,17694,16634,1060,6.37,1603
2021-06-02,17694,16624,1070,6.44,1603
2021-06-03,17694,16632,1062,6.39,1603
2021-06-04,16884,17061,-177,-1.04,1603
2021-06-05,14638,14619,19,0.13,1603
2021-06-06,11090,10164,926,9.11,1603
2021-06-07,17955,16744,1211,7.23,1603
2021-06-08,17694,16601,1093,6.58,1603
2021-06-09,17694,16602,1092,6.58,1603
2021-06-10,17694,16620,1074,6.46,1603
2021-06-11,16884,17056,-172,-1.01,1603
2021-06-12,14638,14619,19,0.13,1603
2021-06-13,11090,10166,924,9.09,1603
2021-06-14,17955,16743,1212,7.24,1603
2021-06-15,17694,16593,1101,6.64,1603
2021-06-16,17694,16583,1111,6.7,1603
2021-06-17,17694,16586,1108,6.68,1603
2021-06-18,16884,17002,-118,-0.69,1603
2021-06-19,14638,14540,98,0.67,1603
2021-06-20,11090,10058,1032,10.26,1603
2021-06-21,17955,16603,1352,8.14,1603
2021-06-22,17694,16418,1276,7.77,1603
2021-06-23,17694,16370,1324,8.09,1603
2021-06-24,17694,16332,1362,8.34,1603
2021-06-25,16884,16707,177,1.06,1603
2021-06-26,14638,14204,434,3.06,1603
2021-06-27,11090,9683,1407,14.53,1603
2021-06-28,17955,16189,1766,10.91,1603
2021-06-29,17694,15968,1726,10.81,1603
2021-06-30,17694,15889,1805,11.36,1603
2021-07-01,16375,15823,552,3.49,1603
2021-07-02,16057,16176,-119,-0.74,1603
2021-07-03,13506,13657,-151,-1.11,1603
2021-07-04,10118,9125,993,10.88,1603
2021-07-05,16693,15628,1065,6.81,1603
2021-07-06,16375,15410,965,6.26,1603
2021-07-07,16375,15340,1035,6.75,1603
2021-07-08,16375,15292,1083,7.08,1603
2021-07-09,16057,15668,389,2.48,1603
2021-07-10,13506,13178,328,2.49,1603
2021-07-11,10118,8680,1438,16.57,1603
2021-07-12,16693,15222,1471,9.66,1603
2021-07-13,16375,15047,1328,8.83,1603
2021-07-14,16375,15022,1353,9.01,1603
2021-07-15,16375,15021,1354,9.01,1603
2021-07-16,16057,15444,613,3.97,1603
2021-07-17,13506,13000,506,3.89,1603
2021-07-18,10118,8547,1571,18.38,1603
2021-07-19,16693,15131,1562,10.32,1603
2021-07-20,16375,14993,1382,9.22,1603
2021-07-21,16375,15001,1374,9.16,1603
2021-07-22,16375,15027,1348,8.97,1603
2021-07-23,16057,15472,585,3.78,1603
2021-07-24,13506,13042,464,3.56,1603
2021-07-25,10118,8597,1521,17.69,1603
2021-07-26,16693,15182,1511,9.95,1603
2021-07-27,16375,15039,1336,8.88,1603
2021-07-28,16375,15035,1340,8.91,1603
2021-07-29,16375,15043,1332,8.85,1603
2021-07-30,16057,15464,593,3.83,1603
2021-07-31,13506,13007,499,3.84,1603
2021-08-01,9599,8531,1068,12.52,1603
2021-08-02,15947,15082,865,5.74,1603
2021-08-03,15650,14905,745,5.0,1603
2021-08-04,15650,14867,783,5.27,1603
2021-08-05,15650,14842,808,5.44,1603
2021-08-06,14966,15233,-267,-1.75,1603
2021-08-07,12748,12749,-1,-0.01,1603
2021-08-08,9599,8252,1347,16.32,1603
2021-08-09,15947,14788,1159,7.84,1603
2021-08-10,15650,14602,1048,7.18,1603
2021-08-11,15650,14562,1088,7.47,1603
2021-08-12,15650,14544,1106,7.6,1603
2021-08-13,14966,14950,16,0.11,1603
2021-08-14,12748,12490,258,2.07,1603
2021-08-15,9599,8024,1575,19.63,1603
2021-08-16,15947,14600,1347,9.23,1603
2021-08-17,15650,14460,1190,8.23,1603
2021-08-18,15650,14474,1176,8.12,1603
2021-08-19,15650,14515,1135,7.82,1603
2021-08-20,14966,14985,-19,-0.13,1603
2021-08-21,12748,12592,156,1.24,1603
2021-08-22,9599,8195,1404,17.13,1603
2021-08-23,15947,14841,1106,7.45,1603
2021-08-24,15650,14771,879,5.95,1603
2021-08-25,15650,14853,797,5.37,1603
2021-08-26,15650,14958,692,4.63,1603
2021-08-27,14966,15487,-521,-3.36,1603
2021-08-28,12748,13148,-400,-3.04,1603
2021-08-29,9599,8799,800,9.09,1603
2021-08-30,15947,15484,463,2.99,1603
2021-08-31,15650,15445,205,1.33,1603
2021-09-01,15820,15548,272,1.75,1603
2021-09-02,15820,15666,154,0.98,1603
2021-09-03,15690,16199,-509,-3.14,1603
2021-09-04,14004,13854,150,1.08,1603
2021-09-05,10242,9490,752,7.92,1603
2021-09-06,17036,16152,884,5.47,1603
2021-09-07,15820,16082,-262,-1.63,1603
2021-09-08,15820,16148,-328,-2.03,1603
2021-09-09,15820,16223,-403,-2.48,1603
2021-09-10,15690,16708,-1018,-6.09,1603
2021-09-11,14004,14312,-308,-2.15,1603
2021-09-12,10242,9894,348,3.52,1603
2021-09-13,17036,16501,535,3.24,1603
2021-09-14,15820,16377,-557,-3.4,1603
2021-09-15,15820,16390,-570,-3.48,1603
2021-09-16,15820,16414,-594,-3.62,1603
2021-09-17,15690,16853,-1163,-6.9,1603
2021-09-18,14004,14414,-410,-2.84,1603
2021-09-19,10242,9959,283,2.84,1603
2021-09-20,17036,16535,501,3.03,1603
2021-09-21,15820,16385,-565,-3.45,1603
2021-09-22,15820,16380,-560,-3.42,1603
2021-09-23,15820,16391,-571,-3.48,1603
2021-09-24,15690,16823,-1133,-6.73,1603
2021-09-25,14004,14384,-380,-2.64,1603
2021-09-26,10242,9934,308,3.1,1603
2021-09-27,17036,16520,516,3.12,1603
2021-09-28,15820,16385,-565,-3.45,1603
2021-09-29,15820,16396,-576,-3.51,1603
2021-09-30,15820,16428,-608,-3.7,1603
2021-10-01,16385,16882,-497,-2.94,1603
2021-10-02,14692,14465,227,1.57,1603
2021-10-03,10434,10037,397,3.96,1603
2021-10-04,16644,16644,0,0.0,1603
2021-10-05,16572,16528,44,0.27,1603
2021-10-06,16572,16557,15,0.09,1603
2021-10-07,16572,16602,-30,-0.18,1603
2021-10-08,16385,17066,-681,-3.99,1603
2021-10-09,14692,14655,37,0.25,1603
2021-10-10,10434,10230,204,1.99,1603
2021-10-11,16644,16835,-191,-1.13,1603
2021-10-12,16572,16713,-141,-0.84,1603
2021-10-13,16572,16732,-160,-0.96,1603
2021-10-14,16572,16764,-192,-1.15,1603
2021-10-15,16385,17211,-826,-4.8,1603
2021-10-16,14692,14782,-90,-0.61,1603
2021-10-17,10434,10336,98,0.95,1603
2021-10-18,16644,16919,-275,-1.63,1603
2021-10-19,16572,16775,-203,-1.21,1603
2021-10-20,16572,16772,-200,-1.19,1603
2021-10-21,16572,16783,-211,-1.26,1603
2021-10-22,16385,17211,-826,-4.8,1603
2021-10-23,14692,14765,-73,-0.49,1603
2021-10-24,10434,10304,130,1.26,1603
2021-10-25,16644,16875,-231,-1.37,1603
2021-10-26,16572,16723,-151,-0.9,1603
2021-10-27,16572,16715,-143,-0.86,1603
2021-10-28,16572,16725,-153,-0.91,1603
2021-10-29,16385,17155,-770,-4.49,1603
2021-10-30,14692,14714,-22,-0.15,1603
2021-10-31,10434,10262,172,1.68,1603
2021-11-01,14776,16844,-2068,-12.28,1603
2021-11-02,15430,16705,-1275,-7.63,1603
2021-11-03,15430,16712,-1282,-7.67,1603
2021-11-04,15430,16738,-1308,-7.81,1603
2021-11-05,15817,17184,-1367,-7.96,1603
2021-11-06,13557,14759,-1202,-8.14,1603
2021-11-07,9741,10321,-580,-5.62,1603
2021-11-08,14776,16917,-2141,-12.66,1603
2021-11-09,15430,16789,-1359,-8.09,1603
2021-11-10,15430,16805,-1375,-8.18,1603
2021-11-11,15430,16836,-1406,-8.35,1603
2021-11-12,15817,17284,-1467,-8.49,1603
2021-11-13,13557,14858,-1301,-8.76,1603
2021-11-14,9741,10416,-675,-6.48,1603
2021-11-15,14776,17004,-2228,-13.1,1603
2021-11-16,15430,16865,-1435,-8.51,1603
2021-11-17,15430,16867,-1437,-8.52,1603
2021-11-18,15430,16881,-1451,-8.6,1603
2021-11-19,15817,17311,-1494,-8.63,1603
2021-11-20,13557,14865,-1308,-8.8,1603
2021-11-21,9741,10401,-660,-6.35,1603
2021-11-22,14776,16968,-2192,-12.92,1603
2021-11-23,15430,16808,-1378,-8.2,1603
2021-11-24,15430,16789,-1359,-8.09,1603
2021-11-25,15430,16785,-1355,-8.07,1603
2021-11-26,15817,17199,-1382,-8.04,1603
2021-11-27,13557,14740,-1183,-8.03,1603
2021-11-28,9741,10266,-525,-5.11,1603
2021-11-29,14776,16826,-2050,-12.18,1603
2021-11-30,15430,16664,-1234,-7.41,1603
2021-12-01,14974,16646,-1672,-10.04,1603
2021-12-02,14974,16647,-1673,-10.05,1603
2021-12-03,13270,17070,-3800,-22.26,1603
2021-12-04,12269,14622,-2353,-16.09,1603
2021-12-05,9176,10164,-988,-9.72,1603
2021-12-06,15435,16741,-1306,-7.8,1603
2021-12-07,14974,16598,-1624,-9.78,1603
2021-12-08,14974,16601,-1627,-9.8,1603
2021-12-09,14974,16622,-1648,-9.91,1603
2021-12-10,13270,17065,-3795,-22.24,1603
2021-12-11,12269,14636,-2367,-16.17,1603
2021-12-12,9176,10195,-1019,-10.0,1603
2021-12-13,15435,16786,-1351,-8.05,1603
2021-12-14,14974,16654,-1680,-10.09,1603
2021-12-15,14974,16663,-1689,-10.14,1603
2021-12-16,14974,16687,-1713,-10.27,1603
2021-12-17,13270,17127,-3857,-22.52,1603
2021-12-18,12269,14691,-2422,-16.49,1603
2021-12-19,9176,10236,-1060,-10.36,1603
2021-12-20,15435,16810,-1375,-8.18,1603
2021-12-21,14974,16654,-1680,-10.09,1603
2021-12-22,14974,16636,-1662,-9.99,1603
2021-12-23,14974,16628,-1654,-9.95,1603
2021-12-24,13270,17033,-3763,-22.09,1603
2021-12-25,12269,14559,-2290,-15.73,1603
2021-12-26,9176,10066,-890,-8.84,1603
2021-12-27,15435,16599,-1164,-7.01,1603
2021-12-28,14974,16403,-1429,-8.71,1603
2021-12-29,14974,16347,-1373,-8.4,1603
2021-12-30,14974,16302,-1328,-8.15,1603
2021-12-31,13270,16674,-3404,-20.42,1603
2022-01-01,12852,14171,-1319,-9.31,1603
2022-01-02,8075,9653,-1578,-16.35,1603
2022-01-03,14138,16168,-2030,-12.56,1603
2022-01-04,14452,15959,-1507,-9.44,1603
2022-01-05,14452,15897,-1445,-9.09,1603
2022-01-06,14452,15854,-1402,-8.84,1603
2022-01-07,15066,16234,-1168,-7.19,1603
2022-01-08,12852,13746,-894,-6.5,1603
2022-01-09,8075,9251,-1176,-12.71,1603
2022-01-10,14138,15794,-1656,-10.48,1603
2022-01-11,14452,15621,-1169,-7.48,1603
2022-01-12,14452,15599,-1147,-7.35,1603
2022-01-13,14452,15600,-1148,-7.36,1603
2022-01-14,15066,16029,-963,-6.01,1603
2022-01-15,12852,13592,-740,-5.44,1603
2022-01-16,8075,9149,-1074,-11.74,1603
2022-01-17,14138,15745,-1607,-10.21,1603
2022-01-18,14452,15624,-1172,-7.5,1603
2022-01-19,14452,15652,-1200,-7.67,1603
2022-01-20,14452,15702,-1250,-7.96,1603
2022-01-21,15066,16174,-1108,-6.85,1603
2022-01-22,12852,13777,-925,-6.71,1603
2022-01-23,8075,9368,-1293,-13.8,1603
2022-01-24,14138,15994,-1856,-11.6,1603
2022-01-25,14452,15895,-1443,-9.08,1603
2022-01-26,14452,15939,-1487,-9.33,1603
2022-01-27,14452,15999,-1547,-9.67,1603
2022-01-28,15066,16475,-1409,-8.55,1603
2022-01-29,12852,14076,-1224,-8.7,1603
2022-01-30,8075,9659,-1584,-16.4,1603
2020-02-01,10883,10236,647,6.32,1623
2020-02-02,7668,7161,507,7.08,1623
2020-02-03,13466,13053,413,3.16,1623
2020-02-04,13893,13274,619,4.66,1623
2020-02-05,13893,13284,609,4.58,1623
2020-02-06,13893,13303,590,4.44,1623
2020-02-07,14233,13787,446,3.23,1623
2020-02-08,10883,10296,587,5.7,1623
2020-02-09,7668,7203,465,6.46,1623
2020-02-10,13466,13082,384,2.94,1623
2020-02-11,13893,13294,599,4.51,1623
2020-02-12,13893,13300,593,4.46,1623
2020-02-13,13893,13319,574,4.31,1623
2020-02-14,14233,13810,423,3.06,1623
2020-02-15,10883,10329,554,5.36,1623
2020-02-16,7668,7252,416,5.74,1623
2020-02-17,13466,13150,316,2.4,1623
2020-02-18,13893,13386,507,3.79,1623
2020-02-19,13893,13418,475,3.54,1623
2020-02-20,13893,13466,427,3.17,1623
2020-02-21,14233,13986,247,1.77,1623
2020-02-22,10883,10535,348,3.3,1623
2020-02-23,7668,7487,181,2.42,1623
2020-02-24,13466,13414,52,0.39,1623
2020-02-25,13893,13675,218,1.59,1623
2020-02-26,13893,13729,164,1.19,1623
2020-02-27,13893,13796,97,0.7,1623
2020-02-28,14233,14330,-97,-0.68,1623
2020-02-29,10883,10889,-6,-0.06,1623
2020-03-01,5645,7847,-2202,-28.06,1623
2020-03-02,10326,13773,-3447,-25.03,1623
2020-03-03,10460,14028,-3568,-25.43,1623
2020-03-04,10460,14072,-3612,-25.67,1623
2020-03-05,10460,14124,-3664,-25.94,1623
2020-03-06,10852,14640,-3788,-25.87,1623
2020-03-07,7344,11176,-3832,-34.29,1623
2020-03-08,5645,8108,-2463,-30.38,1623
2020-03-09,10326,14007,-3681,-26.28,1623
2020-03-10,10460,14233,-3773,-26.51,1623
2020-03-11,10460,14249,-3789,-26.59,1623
2020-03-12,10460,14272,-3812,-26.71,1623
2020-03-13,10852,14761,-3909,-26.48,1623
2020-03-14,7344,11272,-3928,-34.85,1623
2020-03-15,5645,8182,-2537,-31.01,1623
2020-03-16,10326,14062,-3736,-26.57,1623
2020-03-17,10460,14275,-3815,-26.73,1623
2020-03-18,10460,14280,-3820,-26.75,1623
2020-03-19,10460,14298,-3838,-26.84,1623
2020-03-20,10852,14786,-3934,-26.61,1623
2020-03-21,7344,11301,-3957,-35.01,1623
2020-03-22,5645,8220,-2575,-31.33,1623
2020-03-23,10326,14112,-3786,-26.83,1623
2020-03-24,10460,14341,-3881,-27.06,1623
2020-03-25,10460,14365,-3905,-27.18,1623
2020-03-26,10460,14404,-3944,-27.38,1623
2020-03-27,10852,14915,-4063,-27.24,1623
2020-03-28,7344,11455,-4111,-35.89,1623
2020-03-29,5645,8397,-2752,-32.77,1623
2020-03-30,10326,14313,-3987,-27.86,1623
2020-03-31,10460,14562,-4102,-28.17,1623
2020-04-01,10413,14606,-4193,-28.71,1623
2020-04-02,10413,14662,-4249,-28.98,1623
2020-04-03,10065,15185,-5120,-33.72,1623
2020-04-04,7309,11733,-4424,-37.71,1623
2020-04-05,4786,8680,-3894,-44.86,1623
2020-04-06,10386,14595,-4209,-28.84,1623
2020-04-07,10413,14840,-4427,-29.83,1623
2020-04-08,10413,14875,-4462,-30.0,1623
2020-04-09,10413,14917,-4504,-30.19,1623
2020-04-10,10065,15423,-5358,-34.74,1623
2020-04-11,7309,11951,-4642,-38.84,1623
2020-04-12,4786,8874,-4088,-46.07,1623
2020-04-13,10386,14764,-4378,-29.65,1623
2020-04-14,10413,14983,-4570,-30.5,1623
2020-04-15,10413,14990,-4577,-30.53,1623
2020-04-16,10413,15006,-4593,-30.61,1623
2020-04-17,10065,15486,-5421,-35.01,1623
2020-04-18,7309,11989,-4680,-39.04,1623
2020-04-19,4786,8891,-4105,-46.17,1623
2020-04-20,10386,14763,-4377,-29.65,1623
2020-04-21,10413,14966,-4553,-30.42,1623
2020-04-22,10413,14963,-4550,-30.41,1623
2020-04-23,10413,14971,-4558,-30.45,1623
2020-04-24,10065,15449,-5384,-34.85,1623
2020-04-25,7309,11954,-4645,-38.86,1623
2020-04-26,4786,8862,-4076,-45.99,1623
2020-04-27,10386,14743,-4357,-29.55,1623
2020-04-28,10413,14960,-4547,-30.39,1623
2020-04-29,10413,14972,-4559,-30.45,1623
2020-04-30,10413,14998,-4585,-30.57,1623
2020-05-01,14266,15495,-1229,-7.93,1623
2020-05-02,11241,12021,-780,-6.49,1623
2020-05-03,7661,8948,-1287,-14.38,1623
2020-05-04,13983,14849,-866,-5.83,1623
2020-05-05,14053,15083,-1030,-6.83,1623
2020-05-06,14053,15110,-1057,-7.0,1623
2020-05-07,14053,15148,-1095,-7.23,1623
2020-05-08,14266,15654,-1388,-8.87,1623
2020-05-09,11241,12184,-943,-7.74,1623
2020-05-10,7661,9111,-1450,-15.91,1623
2020-05-11,13983,15008,-1025,-6.83,1623
2020-05-12,14053,15233,-1180,-7.75,1623
2020-05-13,14053,15247,-1194,-7.83,1623
2020-05-14,14053,15269,-1216,-7.96,1623
2020-05-15,14266,15754,-1488,-9.45,1623
2020-05-16,11241,12261,-1020,-8.32,1623
2020-05-17,7661,9163,-1502,-16.39,1623
2020-05-18,13983,15032,-1049,-6.98,1623
2020-05-19,14053,15229,-1176,-7.72,1623
2020-05-20,14053,15216,-1163,-7.64,1623
2020-05-21,14053,15211,-1158,-7.61,1623
2020-05-22,14266,15672,-1406,-8.97,1623
2020-05-23,11241,12156,-915,-7.53,1623
2020-05-24,7661,9040,-1379,-15.25,1623
2020-05-25,13983,14894,-911,-6.12,1623
2020-05-26,14053,15082,-1029,-6.82,1623
2020-05-27,14053,15064,-1011,-6.71,1623
2020-05-28,14053,15059,-1006,-6.68,1623
2020-05-29,14266,15525,-1259,-8.11,1623
2020-05-30,11241,12021,-780,-6.49,1623
2020-05-31,7661,8920,-1259,-14.11,1623
2020-06-01,14464,14794,-330,-2.23,1623
2020-06-02,14839,15005,-166,-1.11,1623
2020-06-03,14839,15013,-174,-1.16,1623
2020-06-04,14839,15036,-197,-1.31,1623
2020-06-05,14853,15531,-678,-4.37,1623
2020-06-06,11680,12055,-375,-3.11,1623
2020-06-07,8258,8982,-724,-8.06,1623
2020-06-08,14464,14881,-417,-2.8,1623
2020-06-09,14839,15113,-274,-1.81,1623
2020-06-10,14839,15137,-298,-1.97,1623
2020-06-11,14839,15172,-333,-2.19,1623
2020-06-12,14853,15671,-818,-5.22,1623
2020-06-13,11680,12192,-512,-4.2,1623
2020-06-14,8258,9108,-850,-9.33,1623
2020-06-15,14464,14989,-525,-3.5,1623
2020-06-16,14839,15194,-355,-2.34,1623
2020-06-17,14839,15184,-345,-2.27,1623
2020-06-18,14839,15175,-336,-2.21,1623
2020-06-19,14853,15625,-772,-4.94,1623
2020-06-20,11680,12090,-410,-3.39,1623
2020-06-21,8258,8944,-686,-7.67,1623
2020-06-22,14464,14759,-295,-2.0,1623
2020-06-23,14839,14896,-57,-0.38,1623
2020-06-24,14839,14815,24,0.16,1623
2020-06-25,14839,14736,103,0.7,1623
2020-06-26,14853,15117,-264,-1.75,1623
2020-06-27,11680,11516,164,1.42,1623
2020-06-28,8258,8309,-51,-0.61,1623
2020-06-29,14464,14068,396,2.81,1623
2020-06-30,14839,14157,682,4.82,1623
2020-07-01,14945,14036,909,6.48,1623
2020-07-02,14945,13927,1018,7.31,1623
2020-07-03,14899,14288,611,4.28,1623
2020-07-04,10824,10677,147,1.38,1623
2020-07-05,8498,7471,1027,13.75,1623
2020-07-06,14575,13243,1332,10.06,1623
2020-07-07,14945,13354,1591,11.91,1623
2020-07-08,14945,13267,1678,12.65,1623
2020-07-09,14945,13201,1744,13.21,1623
2020-07-10,14899,13613,1286,9.45,1623
2020-07-11,10824,10061,763,7.58,1623
2020-07-12,8498,6920,1578,22.8,1623
2020-07-13,14575,12760,1815,14.22,1623
2020-07-14,14945,12944,2001,15.46,1623
2020-07-15,14945,12931,2014,15.57,1623
2020-07-16,14945,12937,2008,15.52,1623
2020-07-17,14899,13420,1479,11.02,1623
2020-07-18,10824,9936,888,8.94,1623
2020-07-19,8498,6858,1640,23.91,1623
2020-07-20,14575,12754,1821,14.28,1623
2020-07-21,14945,12987,1958,15.08,1623
2020-07-22,14945,13013,1932,14.85,1623
2020-07-23,14945,13051,1894,14.51,1623
2020-07-24,14899,13555,1344,9.92,1623
2020-07-25,10824,10082,742,7.36,1623
2020-07-26,8498,7006,1492,21.3,1623
2020-07-27,14575,12895,1680,13.03,1623
2020-07-28,14945,13111,1834,13.99,1623
2020-07-29,14945,13113,1832,13.97,1623
2020-07-30,14945,13120,1825,13.91,1623
2020-07-31,14899,13588,1311,9.65,1623
2020-08-01,10410,10074,336,3.34,1623
2020-08-02,8132,6954,1178,16.94,1623
2020-08-03,13548,12799,749,5.85,1623
2020-08-04,13684,12971,713,5.5,1623
2020-08-05,13684,12931,753,5.82,1623
2020-08-06,13684,12899,785,6.09,1623
2020-08-07,14059,13333,726,5.45,1623
2020-08-08,10410,9792,618,6.31,1623
2020-08-09,8132,6651,1481,22.27,1623
2020-08-10,13548,12484,1064,8.52,1623
2020-08-11,13684,12652,1032,8.16,1623
2020-08-12,13684,12618,1066,8.45,1623
2020-08-13,13684,12601,1083,8.59,1623
2020-08-14,14059,13059,1000,7.66,1623
2020-08-15,10410,9551,859,8.99,1623
2020-08-16,8132,6451,1681,26.06,1623
2020-08-17,13548,12332,1216,9.86,1623
2020-08-18,13684,12555,1129,8.99,1623
2020-08-19,13684,12581,1103,8.77,1623
2020-08-20,13684,12628,1056,8.36,1623
2020-08-21,14059,13152,907,6.9,1623
2020-08-22,10410,9711,699,7.2,1623
2020-08-23,8132,6678,1454,21.77,1623
2020-08-24,13548,12623,925,7.33,1623
2020-08-25,13684,12907,777,6.02,1623
2020-08-26,13684,12988,696,5.36,1623
2020-08-27,13684,13085,599,4.58,1623
2020-08-28,14059,13651,408,2.99,1623
2020-08-29,10410,10244,166,1.62,1623
2020-08-30,8132,7236,896,12.38,1623
2020-08-31,13548,13198,350,2.65,1623
2020-09-01,13942,13489,453,3.36,1623
2020-09-02,13942,13568,374,2.76,1623
2020-09-03,13942,13654,288,2.11,1623
2020-09-04,14135,14201,-66,-0.46,1623
2020-09-05,10996,10767,229,2.13,1623
2020-09-06,7952,7726,226,2.93,1623
2020-09-07,13577,13649,-72,-0.53,1623
2020-09-08,13942,13896,46,0.33,1623
2020-09-09,13942,13929,13,0.09,1623
2020-09-10,13942,13966,-24,-0.17,1623
2020-09-11,14135,14465,-330,-2.28,1623
2020-09-12,10996,10983,13,0.12,1623
2020-09-13,7952,7897,55,0.7,1623
2020-09-14,13577,13777,-200,-1.45,1623
2020-09-15,13942,13986,-44,-0.31,1623
2020-09-16,13942,13986,-44,-0.31,1623
2020-09-17,13942,13996,-54,-0.39,1623
2020-09-18,14135,14474,-339,-2.34,1623
2020-09-19,10996,10978,18,0.16,1623
2020-09-20,7952,7884,68,0.86,1623
2020-09-21,13577,13763,-186,-1.35,1623
2020-09-22,13942,13978,-36,-0.26,1623
2020-09-23,13942,13989,-47,-0.34,1623
2020-09-24,13942,14015,-73,-0.52,1623
2020-09-25,14135,14513,-378,-2.6,1623
2020-09-26,10996,11041,-45,-0.41,1623
2020-09-27,7952,7973,-21,-0.26,1623
2020-09-28,13577,13880,-303,-2.18,1623
2020-09-29,13942,14122,-180,-1.27,1623
2020-09-30,13942,14160,-218,-1.54,1623
2020-10-01,14091,14211,-120,-0.84,1623
2020-10-02,14377,14731,-354,-2.4,1623
2020-10-03,10707,11277,-570,-5.05,1623
2020-10-04,7527,8223,-696,-8.46,1623
2020-10-05,13906,14139,-233,-1.65,1623
2020-10-06,14091,14386,-295,-2.05,1623
2020-10-07,14091,14422,-331,-2.3,1623
2020-10-08,14091,14466,-375,-2.59,1623
2020-10-09,14377,14975,-598,-3.99,1623
2020-10-10,10707,11504,-797,-6.93,1623
2020-10-11,7527,8430,-903,-10.71,1623
2020-10-12,13906,14321,-415,-2.9,1623
2020-10-13,14091,14540,-449,-3.09,1623
2020-10-14,14091,14547,-456,-3.13,1623
2020-10-15,14091,14562,-471,-3.23,1623
2020-10-16,14377,15040,-663,-4.41,1623
2020-10-17,10707,11540,-833,-7.22,1623
2020-10-18,7527,8438,-911,-10.8,1623
2020-10-19,13906,14305,-399,-2.79,1623
2020-10-20,14091,14504,-413,-2.85,1623
2020-10-21,14091,14495,-404,-2.79,1623
2020-10-22,14091,14498,-407,-2.81,1623
2020-10-23,14377,14970,-593,-3.96,1623
2020-10-24,10707,11470,-763,-6.65,1623
2020-10-25,7527,8373,-846,-10.1,1623
2020-10-26,13906,14250,-344,-2.41,1623
2020-10-27,14091,14464,-373,-2.58,1623
2020-10-28,14091,14475,-384,-2.65,1623
2020-10-29,14091,14502,-411,-2.83,1623
2020-10-30,14377,15001,-624,-4.16,1623
2020-10-31,10707,11530,-823,-7.14,1623
2020-11-01,6327,8464,-2137,-25.25,1623
2020-11-02,13054,14372,-1318,-9.17,1623
2020-11-03,12351,14616,-2265,-15.5,1623
2020-11-04,12351,14654,-2303,-15.72,1623
2020-11-05,12351,14706,-2355,-16.01,1623
2020-11-06,13066,15226,-2160,-14.19,1623
2020-11-07,8990,11771,-2781,-23.63,1623
2020-11-08,6327,8715,-2388,-27.4,1623
2020-11-09,13054,14627,-1573,-10.75,1623
2020-11-10,12351,14867,-2516,-16.92,1623
2020-11-11,12351,14896,-2545,-17.09,1623
2020-11-12,12351,14931,-2580,-17.28,1623
2020-11-13,13066,15427,-2361,-15.3,1623
2020-11-14,8990,11943,-2953,-24.73,1623
2020-11-15,6327,8850,-2523,-28.51,1623
2020-11-16,13054,14721,-1667,-11.32,1623
2020-11-17,12351,14917,-2566,-17.2,1623
2020-11-18,12351,14897,-2546,-17.09,1623
2020-11-19,12351,14881,-2530,-17.0,1623
2020-11-20,13066,15325,-2259,-14.74,1623
2020-11-21,8990,11788,-2798,-23.74,1623
2020-11-22,6327,8646,-2319,-26.82,1623
2020-11-23,13054,14469,-1415,-9.78,1623
2020-11-24,12351,14620,-2269,-15.52,1623
2020-11-25,12351,14561,-2210,-15.18,1623
2020-11-26,12351,14511,-2160,-14.89,1623
2020-11-27,13066,14928,-1862,-12.47,1623
2020-11-28,8990,11371,-2381,-20.94,1623
2020-11-29,6327,8216,-1889,-22.99,1623
2020-11-30,13054,14033,-979,-6.98,1623
2020-12-01,11890,14187,-2297,-16.19,1623
2020-12-02,11890,14137,-2247,-15.89,1623
2020-12-03,11890,14103,-2213,-15.69,1623
2020-12-04,13573,14543,-970,-6.67,1623
2020-12-05,9608,11013,-1405,-12.76,1623
2020-12-06,6371,7890,-1519,-19.25,1623
2020-12-07,12319,13743,-1424,-10.36,1623
2020-12-08,11890,13935,-2045,-14.68,1623
2020-12-09,11890,13924,-2034,-14.61,1623
2020-12-10,11890,13929,-2039,-14.64,1623
2020-12-11,13573,14406,-833,-5.78,1623
2020-12-12,9608,10911,-1303,-11.94,1623
2020-12-13,6371,7818,-1447,-18.51,1623
2020-12-14,12319,13698,-1379,-10.07,1623
2020-12-15,11890,13910,-2020,-14.52,1623
2020-12-16,11890,13913,-2023,-14.54,1623
2020-12-17,11890,13925,-2035,-14.61,1623
2020-12-18,13573,14402,-829,-5.76,1623
2020-12-19,9608,10901,-1293,-11.86,1623
2020-12-20,6371,7794,-1423,-18.26,1623
2020-12-21,12319,13653,-1334,-9.77,1623
2020-12-22,11890,13838,-1948,-14.08,1623
2020-12-23,11890,13809,-1919,-13.9,1623
2020-12-24,11890,13785,-1895,-13.75,1623
2020-12-25,13573,14221,-648,-4.56,1623
2020-12-26,9608,10677,-1069,-10.01,1623
2020-12-27,6371,7527,-1156,-15.36,1623
2020-12-28,12319,13341,-1022,-7.66,1623
2020-12-29,11890,13484,-1594,-11.82,1623
2020-12-30,11890,13415,-1525,-11.37,1623
2020-12-31,11890,13355,-1465,-10.97,1623
2021-01-01,11208,13760,-2552,-18.55,1623
2021-01-02,7589,10191,-2602,-25.53,1623
2021-01-03,5343,7022,-1679,-23.91,1623
2021-01-04,10670,12825,-2155,-16.8,1623
2021-01-05,11154,12965,-1811,-13.97,1623
2021-01-06,11154,12900,-1746,-13.53,1623
2021-01-07,11154,12853,-1699,-13.22,1623
2021-01-08,11208,13279,-2071,-15.6,1623
2021-01-09,7589,9738,-2149,-22.07,1623
2021-01-10,5343,6604,-1261,-19.09,1623
2021-01-11,10670,12449,-1779,-14.29,1623
2021-01-12,11154,12636,-1482,-11.73,1623
2021-01-13,11154,12623,-1469,-11.64,1623
2021-01-14,11154,12629,-1475,-11.68,1623
2021-01-15,11208,13112,-1904,-14.52,1623
2021-01-16,7589,9628,-2039,-21.18,1623
2021-01-17,5343,6551,-1208,-18.44,1623
2021-01-18,10670,12451,-1781,-14.3,1623
2021-01-19,11154,12690,-1536,-12.1,1623
2021-01-20,11154,12725,-1571,-12.35,1623
2021-01-21,11154,12775,-1621,-12.69,1623
2021-01-22,11208,13296,-2088,-15.7,1623
2021-01-23,7589,9844,-2255,-22.91,1623
2021-01-24,5343,6792,-1449,-21.33,1623
2021-01-25,10670,12710,-2040,-16.05,1623
2021-01-26,11154,12960,-1806,-13.94,1623
2021-01-27,11154,12999,-1845,-14.19,1623
2021-01-28,11154,13048,-1894,-14.52,1623
2021-01-29,11208,13560,-2352,-17.35,1623
2021-01-30,7589,10095,-2506,-24.82,1623
2021-01-31,5343,7025,-1682,-23.94,1623
2021-02-01,12790,12922,-132,-1.02,1623
2021-02-02,12972,13148,-176,-1.34,1623
2021-02-03,12972,13162,-190,-1.44,1623
2021-02-04,12972,13184,-212,-1.61,1623
2021-02-05,13312,13671,-359,-2.63,1623
2021-02-06,9546,10182,-636,-6.25,1623
2021-02-07,6506,7090,-584,-8.24,1623
2021-02-08,12790,12969,-179,-1.38,1623
2021-02-09,12972,13180,-208,-1.58,1623
2021-02-10,12972,13183,-211,-1.6,1623
2021-02-11,12972,13200,-228,-1.73,1623
2021-02-12,13312,13687,-375,-2.74,1623
2021-02-13,9546,10202,-656,-6.43,1623
2021-02-14,6506,7120,-614,-8.62,1623
2021-02-15,12790,13013,-223,-1.71,1623
2021-02-16,12972,13243,-271,-2.05,1623
2021-02-17,12972,13269,-297,-2.24,1623
2021-02-18,12972,13311,-339,-2.55,1623
2021-02-19,13312,13826,-514,-3.72,1623
2021-02-20,9546,10370,-824,-7.95,1623
2021-02-21,6506,7319,-813,-11.11,1623
2021-02-22,12790,13241,-451,-3.41,1623
2021-02-23,12972,13499,-527,-3.9,1623
2021-02-24,12972,13552,-580,-4.28,1623
2021-02-25,12972,13618,-646,-4.74,1623
2021-02-26,13312,14152,-840,-5.94,1623
2021-02-27,9546,10712,-1166,-10.88,1623
2021-02-28,6506,7671,-1165,-15.19,1623
2021-03-01,13980,13600,380,2.79,1623
2021-03-02,14109,13859,250,1.8,1623
2021-03-03,14109,13907,202,1.45,1623
2021-03-04,14109,13964,145,1.04,1623
2021-03-05,14118,14484,-366,-2.53,1623
2021-03-06,10645,11026,-381,-3.46,1623
2021-03-07,7158,7964,-806,-10.12,1623
2021-03-08,13980,13868,112,0.81,1623
2021-03-09,14109,14100,9,0.06,1623
2021-03-10,14109,14120,-11,-0.08,1623
2021-03-11,14109,14147,-38,-0.27,1623
2021-03-12,14118,14639,-521,-3.56,1623
2021-03-13,10645,11154,-509,-4.56,1623
2021-03-14,7158,8066,-908,-11.26,1623
2021-03-15,13980,13947,33,0.24,1623
2021-03-16,14109,14160,-51,-0.36,1623
2021-03-17,14109,14164,-55,-0.39,1623
2021-03-18,14109,14181,-72,-0.51,1623
2021-03-19,14118,14666,-548,-3.74,1623
2021-03-20,10645,11179,-534,-4.78,1623
2021-03-21,7158,8093,-935,-11.55,1623
2021-03-22,13980,13982,-2,-0.01,1623
2021-03-23,14109,14206,-97,-0.68,1623
2021-03-24,14109,14226,-117,-0.82,1623
2021-03-25,14109,14261,-152,-1.07,1623
2021-03-26,14118,14767,-649,-4.39,1623
2021-03-27,10645,11302,-657,-5.81,1623
2021-03-28,7158,8241,-1083,-13.14,1623
2021-03-29,13980,14153,-173,-1.22,1623
2021-03-30,14109,14401,-292,-2.03,1623
2021-03-31,14109,14442,-333,-2.31,1623
2021-04-01,13530,14497,-967,-6.67,1623
2021-04-02,13945,15020,-1075,-7.16,1623
2021-04-03,9975,11569,-1594,-13.78,1623
2021-04-04,7126,8518,-1392,-16.34,1623
2021-04-05,13632,14435,-803,-5.56,1623
2021-04-06,13530,14684,-1154,-7.86,1623
2021-04-07,13530,14722,-1192,-8.1,1623
2021-04-08,13530,14769,-1239,-8.39,1623
2021-04-09,13945,15280,-1335,-8.74,1623
2021-04-10,9975,11812,-1837,-15.55,1623
2021-04-11,7126,8741,-1615,-18.48,1623
2021-04-12,13632,14636,-1004,-6.86,1623
2021-04-13,13530,14859,-1329,-8.94,1623
2021-04-14,13530,14871,-1341,-9.02,1623
2021-04-15,13530,14891,-1361,-9.14,1623
2021-04-16,13945,15375,-1430,-9.3,1623
2021-04-17,9975,11881,-1906,-16.04,1623
2021-04-18,7126,8785,-1659,-18.88,1623
2021-04-19,13632,14658,-1026,-7.0,1623
2021-04-20,13530,14862,-1332,-8.96,1623
2021-04-21,13530,14858,-1328,-8.94,1623
2021-04-22,13530,14866,-1336,-8.99,1623
2021-04-23,13945,15342,-1397,-9.11,1623
2021-04-24,9975,11844,-1869,-15.78,1623
2021-04-25,7126,8749,-1623,-18.55,1623
2021-04-26,13632,14627,-995,-6.8,1623
2021-04-27,13530,14840,-1310,-8.83,1623
2021-04-28,13530,14848,-1318,-8.88,1623
2021-04-29,13530,14871,-1341,-9.02,1623
2021-04-30,13945,15364,-1419,-9.24,1623
2021-05-01,12691,11886,805,6.77,1623
2021-05-02,8439,8810,-371,-4.21,1623
2021-05-03,15404,14708,696,4.73,1623
2021-05-04,15937,14941,996,6.67,1623
2021-05-05,15937,14967,970,6.48,1623
2021-05-06,15937,15005,932,6.21,1623
2021-05-07,16022,15511,511,3.29,1623
2021-05-08,12691,12043,648,5.38,1623
2021-05-09,8439,8973,-534,-5.95,1623
2021-05-10,15404,14872,532,3.58,1623
2021-05-11,15937,15101,836,5.54,1623
2021-05-12,15937,15120,817,5.4,1623
2021-05-13,15937,15146,791,5.22,1623
2021-05-14,16022,15637,385,2.46,1623
2021-05-15,12691,12148,543,4.47,1623
2021-05-16,8439,9056,-617,-6.81,1623
2021-05-17,15404,14930,474,3.17,1623
2021-05-18,15937,15132,805,5.32,1623
2021-05-19,15937,15123,814,5.38,1623
2021-05-20,15937,15122,815,5.39,1623
2021-05-21,16022,15585,437,2.8,1623
2021-05-22,12691,12072,619,5.13,1623
2021-05-23,8439,8956,-517,-5.77,1623
2021-05-24,15404,14811,593,4.0,1623
2021-05-25,15937,14998,939,6.26,1623
2021-05-26,15937,14978,959,6.4,1623
2021-05-27,15937,14970,967,6.46,1623
2021-05-28,16022,15433,589,3.82,1623
2021-05-29,12691,11924,767,6.43,1623
2021-05-30,8439,8818,-379,-4.3,1623
2021-05-31,15404,14687,717,4.88,1623
2021-06-01,15064,14892,172,1.15,1623
2021-06-02,15064,14894,170,1.14,1623
2021-06-03,15064,14913,151,1.01,1623
2021-06-04,14916,15403,-487,-3.16,1623
2021-06-05,11508,11922,-414,-3.47,1623
2021-06-06,9165,8845,320,3.62,1623
2021-06-07,14125,14742,-617,-4.19,1623
2021-06-08,15064,14973,91,0.61,1623
2021-06-09,15064,14998,66,0.44,1623
2021-06-10,15064,15034,30,0.2,1623
2021-06-11,14916,15536,-620,-3.99,1623
2021-06-12,11508,12062,-554,-4.59,1623
2021-06-13,9165,8984,181,2.01,1623
2021-06-14,14125,14872,-747,-5.02,1623
2021-06-15,15064,15086,-22,-0.15,1623
2021-06-16,15064,15086,-22,-0.15,1623
2021-06-17,15064,15089,-25,-0.17,1623
2021-06-18,14916,15551,-635,-4.08,1623
2021-06-19,11508,12029,-521,-4.33,1623
2021-06-20,9165,8896,269,3.02,1623
2021-06-21,14125,14724,-599,-4.07,1623
2021-06-22,15064,14873,191,1.28,1623
2021-06-23,15064,14805,259,1.75,1623
2021-06-24,15064,14738,326,2.21,1623
2021-06-25,14916,15130,-214,-1.41,1623
2021-06-26,11508,11538,-30,-0.26,1623
2021-06-27,9165,8338,827,9.92,1623
2021-06-28,14125,14104,21,0.15,1623
2021-06-29,15064,14196,868,6.11,1623
2021-06-30,15064,14078,986,7.0,1623
2021-07-01,13553,13969,-416,-2.98,1623
2021-07-02,13839,14327,-488,-3.41,1623
2021-07-03,10107,10712,-605,-5.65,1623
2021-07-04,8047,7501,546,7.28,1623
2021-07-05,12848,13264,-416,-3.14,1623
2021-07-06,13553,13366,187,1.4,1623
2021-07-07,13553,13268,285,2.15,1623
2021-07-08,13553,13190,363,2.75,1623
2021-07-09,13839,13589,250,1.84,1623
2021-07-10,10107,10024,83,0.83,1623
2021-07-11,8047,6869,1178,17.15,1623
2021-07-12,12848,12696,152,1.2,1623
2021-07-13,13553,12866,687,5.34,1623
2021-07-14,13553,12840,713,5.55,1623
2021-07-15,13553,12835,718,5.59,1623
2021-07-16,13839,13308,531,3.99,1623
2021-07-17,10107,9814,293,2.99,1623
2021-07-18,8047,6728,1319,19.6,1623
2021-07-19,12848,12619,229,1.81,1623
2021-07-20,13553,12847,706,5.5,1623
2021-07-21,13553,12871,682,5.3,1623
2021-07-22,13553,12909,644,4.99,1623
2021-07-23,13839,13414,425,3.17,1623
2021-07-24,10107,9944,163,1.64,1623
2021-07-25,8047,6872,1175,17.1,1623
2021-07-26,12848,12767,81,0.63,1623
2021-07-27,13553,12990,563,4.33,1623
2021-07-28,13553,13000,553,4.25,1623
2021-07-29,13553,13016,537,4.13,1623
2021-07-30,13839,13492,347,2.57,1623
2021-07-31,10107,9987,120,1.2,1623
2021-08-01,7014,6875,139,2.02,1623
2021-08-02,12543,12727,-184,-1.45,1623
2021-08-03,12775,12906,-131,-1.02,1623
2021-08-04,12775,12871,-96,-0.75,1623
2021-08-05,12775,12843,-68,-0.53,1623
2021-08-06,12173,13280,-1107,-8.34,1623
2021-08-07,9060,9740,-680,-6.98,1623
2021-08-08,7014,6599,415,6.29,1623
2021-08-09,12543,12429,114,0.92,1623
2021-08-10,12775,12593,182,1.45,1623
2021-08-11,12775,12552,223,1.78,1623
2021-08-12,12775,12528,247,1.97,1623
2021-08-13,12173,12977,-804,-6.2,1623
2021-08-14,9060,9459,-399,-4.22,1623
2021-08-15,7014,6348,666,10.49,1623
2021-08-16,12543,12217,326,2.67,1623
2021-08-17,12775,12428,347,2.79,1623
2021-08-18,12775,12441,334,2.68,1623
2021-08-19,12775,12476,299,2.4,1623
2021-08-20,12173,12988,-815,-6.28,1623
2021-08-21,9060,9535,-475,-4.98,1623
2021-08-22,7014,6492,522,8.04,1623
2021-08-23,12543,12428,115,0.93,1623
2021-08-24,12775,12703,72,0.57,1623
2021-08-25,12775,12778,-3,-0.02,1623
2021-08-26,12775,12870,-95,-0.74,1623
2021-08-27,12173,13433,-1260,-9.38,1623
2021-08-28,9060,10024,-964,-9.62,1623
2021-08-29,7014,7017,-3,-0.04,1623
2021-08-30,12543,12980,-437,-3.37,1623
2021-08-31,12775,13275,-500,-3.77,1623
2021-09-01,14152,13359,793,5.94,1623
2021-09-02,14152,13451,701,5.21,1623
2021-09-03,13505,14005,-500,-3.57,1623
2021-09-04,10651,10580,71,0.67,1623
2021-09-05,8192,7547,645,8.55,1623
2021-09-06,13650,13479,171,1.27,1623
2021-09-07,14152,13736,416,3.03,1623
2021-09-08,14152,13778,374,2.71,1623
2021-09-09,14152,13824,328,2.37,1623
2021-09-10,13505,14330,-825,-5.76,1623
2021-09-11,10651,10856,-205,-1.89,1623
2021-09-12,8192,7775,417,5.36,1623
2021-09-13,13650,13661,-11,-0.08,1623
2021-09-14,14152,13874,278,2.0,1623
2021-09-15,14152,13877,275,1.98,1623
2021-09-16,14152,13888,264,1.9,1623
2021-09-17,13505,14366,-861,-5.99,1623
2021-09-18,10651,10869,-218,-2.01,1623
2021-09-19,8192,7773,419,5.39,1623
2021-09-20,13650,13649,1,0.01,1623
2021-09-21,14152,13860,292,2.11,1623
2021-09-22,14152,13866,286,2.06,1623
2021-09-23,14152,13888,264,1.9,1623
2021-09-24,13505,14381,-876,-6.09,1623
2021-09-25,10651,10903,-252,-2.31,1623
2021-09-26,8192,7830,362,4.62,1623
2021-09-27,13650,13732,-82,-0.6,1623
2021-09-28,14152,13970,182,1.3,1623
2021-09-29,14152,14004,148,1.06,1623
2021-09-30,14152,14052,100,0.71,1623
2021-10-01,14504,14570,-66,-0.45,1623
2021-10-02,11565,11116,449,4.04,1623
2021-10-03,8196,8062,134,1.66,1623
2021-10-04,14048,13979,69,0.49,1623
2021-10-05,14597,14227,370,2.6,1623
2021-10-06,14597,14267,330,2.31,1623
2021-10-07,14597,14315,282,1.97,1623
2021-10-08,14504,14828,-324,-2.19,1623
2021-10-09,11565,11363,202,1.78,1623
2021-10-10,8196,8294,-98,-1.18,1623
2021-10-11,14048,14191,-143,-1.01,1623
2021-10-12,14597,14416,181,1.26,1623
2021-10-13,14597,14428,169,1.17,1623
2021-10-14,14597,14448,149,1.03,1623
2021-10-15,14504,14931,-427,-2.86,1623
2021-10-16,11565,11436,129,1.13,1623
2021-10-17,8196,8337,-141,-1.69,1623
2021-10-18,14048,14206,-158,-1.11,1623
2021-10-19,14597,14406,191,1.33,1623
2021-10-20,14597,14397,200,1.39,1623
2021-10-21,14597,14399,198,1.38,1623
2021-10-22,14504,14869,-365,-2.45,1623
2021-10-23,11565,11366,199,1.75,1623
2021-10-24,8196,8266,-70,-0.85,1623
2021-10-25,14048,14139,-91,-0.64,1623
2021-10-26,14597,14348,249,1.74,1623
2021-10-27,14597,14353,244,1.7,1623
2021-10-28,14597,14374,223,1.55,1623
2021-10-29,14504,14867,-363,-2.44,1623
2021-10-30,11565,11391,174,1.53,1623
2021-10-31,8196,8319,-123,-1.48,1623
2021-11-01,13244,14222,-978,-6.88,1623
2021-11-02,13798,14462,-664,-4.59,1623
2021-11-03,13798,14497,-699,-4.82,1623
2021-11-04,13798,14547,-749,-5.15,1623
2021-11-05,14116,15066,-950,-6.31,1623
2021-11-06,10660,11611,-951,-8.19,1623
2021-11-07,7543,8556,-1013,-11.84,1623
2021-11-08,13244,14471,-1227,-8.48,1623
2021-11-09,13798,14716,-918,-6.24,1623
2021-11-10,13798,14750,-952,-6.45,1623
2021-11-11,13798,14792,-994,-6.72,1623
2021-11-12,14116,15296,-1180,-7.71,1623
2021-11-13,10660,11819,-1159,-9.81,1623
2021-11-14,7543,8736,-1193,-13.66,1623
2021-11-15,13244,14616,-1372,-9.39,1623
2021-11-16,13798,14821,-1023,-6.9,1623
2021-11-17,13798,14811,-1013,-6.84,1623
2021-11-18,13798,14805,-1007,-6.8,1623
2021-11-19,14116,15258,-1142,-7.48,1623
2021-11-20,10660,11730,-1070,-9.12,1623
2021-11-21,7543,8594,-1051,-12.23,1623
2021-11-22,13244,14424,-1180,-8.18,1623
2021-11-23,13798,14581,-783,-5.37,1623
2021-11-24,13798,14525,-727,-5.01,1623
2021-11-25,13798,14478,-680,-4.7,1623
2021-11-26,14116,14896,-780,-5.24,1623
2021-11-27,10660,11339,-679,-5.99,1623
2021-11-28,7543,8182,-639,-7.81,1623
2021-11-29,13244,13996,-752,-5.37,1623
2021-11-30,13798,14146,-348,-2.46,1623
2021-12-01,13151,14091,-940,-6.67,1623
2021-12-02,13151,14051,-900,-6.41,1623
2021-12-03,12498,14484,-1986,-13.71,1623
2021-12-04,10163,10947,-784,-7.16,1623
2021-12-05,7444,7816,-372,-4.76,1623
2021-12-06,13701,13662,39,0.29,1623
2021-12-07,13151,13847,-696,-5.03,1623
2021-12-08,13151,13829,-678,-4.9,1623
2021-12-09,13151,13828,-677,-4.9,1623
2021-12-10,12498,14300,-1802,-12.6,1623
2021-12-11,10163,10801,-638,-5.91,1623
2021-12-12,7444,7706,-262,-3.4,1623
2021-12-13,13701,13583,118,0.87,1623
2021-12-14,13151,13795,-644,-4.67,1623
2021-12-15,13151,13799,-648,-4.7,1623
2021-12-16,13151,13814,-663,-4.8,1623
2021-12-17,12498,14295,-1797,-12.57,1623
2021-12-18,10163,10798,-635,-5.88,1623
2021-12-19,7444,7698,-254,-3.3,1623
2021-12-20,13701,13563,138,1.02,1623
2021-12-21,13151,13756,-605,-4.4,1623
2021-12-22,13151,13735,-584,-4.25,1623
2021-12-23,13151,13719,-568,-4.14,1623
2021-12-24,12498,14164,-1666,-11.76,1623
2021-12-25,10163,10628,-465,-4.38,1623
2021-12-26,7444,7485,-41,-0.55,1623
2021-12-27,13701,13307,394,2.96,1623
2021-12-28,13151,13455,-304,-2.26,1623
2021-12-29,13151,13391,-240,-1.79,1623
2021-12-30,13151,13335,-184,-1.38,1623
2021-12-31,12498,13743,-1245,-9.06,1623
2022-01-01,9897,10174,-277,-2.72,1623
2022-01-02,6563,7004,-441,-6.3,1623
2022-01-03,12383,12806,-423,-3.3,1623
2022-01-04,12623,12942,-319,-2.46,1623
2022-01-05,12623,12872,-249,-1.93,1623
2022-01-06,12623,12818,-195,-1.52,1623
2022-01-07,12848,13237,-389,-2.94,1623
2022-01-08,9897,9687,210,2.17,1623
2022-01-09,6563,6544,19,0.29,1623
2022-01-10,12383,12379,4,0.03,1623
2022-01-11,12623,12555,68,0.54,1623
2022-01-12,12623,12531,92,0.73,1623
2022-01-13,12623,12527,96,0.77,1623
2022-01-14,12848,13000,-152,-1.17,1623
2022-01-15,9897,9506,391,4.11,1623
2022-01-16,6563,6420,143,2.23,1623
2022-01-17,12383,12312,71,0.58,1623
2022-01-18,12623,12543,80,0.64,1623
2022-01-19,12623,12572,51,0.41,1623
2022-01-20,12623,12618,5,0.04,1623
2022-01-21,12848,13135,-287,-2.19,1623
2022-01-22,9897,9681,216,2.23,1623
2022-01-23,6563,6628,-65,-0.98,1623
2022-01-24,12383,12547,-164,-1.31,1623
2022-01-25,12623,12798,-175,-1.37,1623
2022-01-26,12623,12840,-217,-1.69,1623
2022-01-27,12623,12892,-269,-2.09,1623
2022-01-28,12848,13409,-561,-4.18,1623
2022-01-29,9897,9948,-51,-0.51,1623
2022-01-30,6563,6883,-320,-4.65,1623
2020-02-01,26190,24108,2082,8.64,1179
2020-02-02,17966,16227,1739,10.72,1179
2020-02-03,32942,33174,-232,-0.7,1179
2020-02-04,33869,33796,73,0.22,1179
2020-02-05,33869,33832,37,0.11,1179
2020-02-06,33869,33850,19,0.06,1179
2020-02-07,34521,34060,461,1.35,1179
2020-02-08,26190,24293,1897,7.81,1179
2020-02-09,17966,16380,1586,9.68,1179
2020-02-10,32942,33302,-360,-1.08,1179
2020-02-11,33869,33906,-37,-0.11,1179
2020-02-12,33869,33931,-62,-0.18,1179
2020-02-13,33869,33947,-78,-0.23,1179
2020-02-14,34521,34163,358,1.05,1179
2020-02-15,26190,24410,1780,7.29,1179
2020-02-16,17966,16520,1446,8.75,1179
2020-02-17,32942,33472,-530,-1.58,1179
2020-02-18,33869,34113,-244,-0.72,1179
2020-02-19,33869,34179,-310,-0.91,1179
2020-02-20,33869,34242,-373,-1.09,1179
2020-02-21,34521,34508,13,0.04,1179
2020-02-22,26190,24806,1384,5.58,1179
2020-02-23,17966,16967,999,5.89,1179
2020-02-24,32942,33969,-1027,-3.02,1179
2020-02-25,33869,34656,-787,-2.27,1179
2020-02-26,33869,34766,-897,-2.58,1179
2020-02-27,33869,34865,-996,-2.86,1179
2020-02-28,34521,35162,-641,-1.82,1179
2020-02-29,26190,25482,708,2.78,1179
2020-03-01,12442,17658,-5216,-29.54,1179
2020-03-02,24227,34665,-10438,-30.11,1179
2020-03-03,24608,35350,-10742,-30.39,1179
2020-03-04,24608,35447,-10839,-30.58,1179
2020-03-05,24608,35526,-10918,-30.73,1179
2020-03-06,25470,35794,-10324,-28.84,1179
2020-03-07,16338,26079,-9741,-37.35,1179
2020-03-08,12442,18214,-5772,-31.69,1179
2020-03-09,24227,35175,-10948,-31.12,1179
2020-03-10,24608,35810,-11202,-31.28,1179
2020-03-11,24608,35857,-11249,-31.37,1179
2020-03-12,24608,35885,-11277,-31.43,1179
2020-03-13,25470,36103,-10633,-29.45,1179
2020-03-14,16338,26341,-10003,-37.98,1179
2020-03-15,12442,18433,-5991,-32.5,1179
2020-03-16,24227,35358,-11131,-31.48,1179
2020-03-17,24608,35963,-11355,-31.57,1179
2020-03-18,24608,35987,-11379,-31.62,1179
2020-03-19,24608,36001,-11393,-31.65,1179
2020-03-20,25470,36215,-10745,-29.67,1179
2020-03-21,16338,26457,-10119,-38.25,1179
2020-03-22,12442,18562,-6120,-32.97,1179
2020-03-23,24227,35508,-11281,-31.77,1179
2020-03-24,24608,36143,-11535,-31.91,1179
2020-03-25,24608,36204,-11596,-32.03,1179
2020-03-26,24608,36261,-11653,-32.14,1179
2020-03-27,25470,36522,-11052,-30.26,1179
2020-03-28,16338,26815,-10477,-39.07,1179
2020-03-29,12442,18973,-6531,-34.42,1179
2020-03-30,24227,35973,-11746,-32.65,1179
2020-03-31,24608,36659,-12051,-32.87,1179
2020-04-01,23107,36769,-13662,-37.16,1179
2020-04-02,23107,36869,-13762,-37.33,1179
2020-04-03,21238,37168,-15930,-42.86,1179
2020-04-04,14608,27491,-12883,-46.86,1179
2020-04-05,9186,19671,-10485,-53.3,1179
2020-04-06,23958,36683,-12725,-34.69,1179
2020-04-07,23107,37372,-14265,-38.17,1179
2020-04-08,23107,37474,-14367,-38.34,1179
2020-04-09,23107,37556,-14449,-38.47,1179
2020-04-10,21238,37826,-16588,-43.85,1179
2020-04-11,14608,28111,-13503,-48.03,1179
2020-04-12,9186,20244,-11058,-54.62,1179
2020-04-13,23958,37200,-13242,-35.6,1179
2020-04-14,23107,37826,-14719,-38.91,1179
2020-04-15,23107,37859,-14752,-38.97,1179
2020-04-16,23107,37869,-14762,-38.98,1179
2020-04-17,21238,38064,-16826,-44.2,1179
2020-04-18,14608,28274,-13666,-48.33,1179
2020-04-19,9186,20331,-11145,-54.82,1179
2020-04-20,23958,37214,-13256,-35.62,1179
2020-04-21,23107,37771,-14664,-38.82,1179
2020-04-22,23107,37741,-14634,-38.77,1179
2020-04-23,23107,37693,-14586,-38.7,1179
2020-04-24,21238,37838,-16600,-43.87,1179
2020-04-25,14608,28006,-13398,-47.84,1179
2020-04-26,9186,20030,-10844,-54.14,1179
2020-04-27,23958,36890,-12932,-35.06,1179
2020-04-28,23107,37433,-14326,-38.27,1179
2020-04-29,23107,37397,-14290,-38.21,1179
2020-04-30,23107,37354,-14247,-38.14,1179
2020-05-01,33126,37511,-4385,-11.69,1179
2020-05-02,23996,27698,-3702,-13.37,1179
2020-05-03,15423,19749,-4326,-21.9,1179
2020-05-04,32778,36640,-3862,-10.54,1179
2020-05-05,33349,37219,-3870,-10.4,1179
2020-05-06,33349,37221,-3872,-10.4,1179
2020-05-07,33349,37218,-3869,-10.4,1179
2020-05-08,33126,37415,-4289,-11.46,1179
2020-05-09,23996,27641,-3645,-13.19,1179
2020-05-10,15423,19728,-4305,-21.82,1179
2020-05-11,32778,36652,-3874,-10.57,1179
2020-05-12,33349,37260,-3911,-10.5,1179
2020-05-13,33349,37287,-3938,-10.56,1179
2020-05-14,33349,37302,-3953,-10.6,1179
2020-05-15,33126,37512,-4386,-11.69,1179
2020-05-16,23996,27746,-3750,-13.52,1179
2020-05-17,15423,19834,-4411,-22.24,1179
2020-05-18,32778,36755,-3977,-10.82,1179
2020-05-19,33349,37354,-4005,-10.72,1179
2020-05-20,33349,37369,-4020,-10.76,1179
2020-05-21,33349,37368,-4019,-10.76,1179
2020-05-22,33126,37559,-4433,-11.8,1179
2020-05-23,23996,27772,-3776,-13.6,1179
2020-05-24,15423,19840,-4417,-22.26,1179
2020-05-25,32778,36741,-3963,-10.79,1179
2020-05-26,33349,37321,-3972,-10.64,1179
2020-05-27,33349,37318,-3969,-10.64,1179
2020-05-28,33349,37303,-3954,-10.6,1179
2020-05-29,33126,37484,-4358,-11.63,1179
2020-05-30,23996,27691,-3695,-13.34,1179
2020-05-31,15423,19757,-4334,-21.94,1179
2020-06-01,35240,36660,-1420,-3.87,1179
2020-06-02,35652,37247,-1595,-4.28,1179
2020-06-03,35652,37256,-1604,-4.31,1179
2020-06-04,35652,37256,-1604,-4.31,1179
2020-06-05,35080,37455,-2375,-6.34,1179
2020-06-06,25649,27682,-2033,-7.34,1179
2020-06-07,17666,19769,-2103,-10.64,1179
2020-06-08,35240,36693,-1453,-3.96,1179
2020-06-09,35652,37301,-1649,-4.42,1179
2020-06-10,35652,37328,-1676,-4.49,1179
2020-06-11,35652,37344,-1692,-4.53,1179
2020-06-12,35080,37555,-2475,-6.59,1179
2020-06-13,25649,27789,-2140,-7.7,1179
2020-06-14,17666,19877,-2211,-11.12,1179
2020-06-15,35240,36797,-1557,-4.23,1179
2020-06-16,35652,37392,-1740,-4.65,1179
2020-06-17,35652,37401,-1749,-4.68,1179
2020-06-18,35652,37390,-1738,-4.65,1179
2020-06-19,35080,37567,-2487,-6.62,1179
2020-06-20,25649,27761,-2112,-7.61,1179
2020-06-21,17666,19804,-2138,-10.8,1179
2020-06-22,35240,36672,-1432,-3.9,1179
2020-06-23,35652,37213,-1561,-4.19,1179
2020-06-24,35652,37163,-1511,-4.07,1179
2020-06-25,35652,37092,-1440,-3.88,1179
2020-06-26,35080,37210,-2130,-5.72,1179
2020-06-27,25649,27345,-1696,-6.2,1179
2020-06-28,17666,19332,-1666,-8.62,1179
2020-06-29,35240,36148,-908,-2.51,1179
2020-06-30,35652,36643,-991,-2.7,1179
2020-07-01,35340,36553,-1213,-3.32,1179
2020-07-02,35340,36452,-1112,-3.05,1179
2020-07-03,35298,36547,-1249,-3.42,1179
2020-07-04,25448,26669,-1221,-4.58,1179
2020-07-05,19171,18653,518,2.78,1179
2020-07-06,34723,35477,-754,-2.13,1179
2020-07-07,35340,35989,-649,-1.8,1179
2020-07-08,35340,35927,-587,-1.63,1179
2020-07-09,35340,35862,-522,-1.46,1179
2020-07-10,35298,36002,-704,-1.96,1179
2020-07-11,25448,26176,-728,-2.78,1179
2020-07-12,19171,18217,954,5.24,1179
2020-07-13,34723,35102,-379,-1.08,1179
2020-07-14,35340,35677,-337,-0.94,1179
2020-07-15,35340,35680,-340,-0.95,1179
2020-07-16,35340,35678,-338,-0.95,1179
2020-07-17,35298,35878,-580,-1.62,1179
2020-07-18,25448,26107,-659,-2.52,1179
2020-07-19,19171,18198,973,5.35,1179
2020-07-20,34723,35125,-402,-1.14,1179
2020-07-21,35340,35733,-393,-1.1,1179
2020-07-22,35340,35759,-419,-1.17,1179
2020-07-23,35340,35769,-429,-1.2,1179
2020-07-24,35298,35971,-673,-1.87,1179
2020-07-25,25448,26191,-743,-2.84,1179
2020-07-26,19171,18262,909,4.98,1179
2020-07-27,34723,35159,-436,-1.24,1179
2020-07-28,35340,35728,-388,-1.09,1179
2020-07-29,35340,35706,-366,-1.03,1179
2020-07-30,35340,35663,-323,-0.91,1179
2020-07-31,35298,35806,-508,-1.42,1179
2020-08-01,25172,25964,-792,-3.05,1179
2020-08-02,18865,17971,894,4.97,1179
2020-08-03,34032,34806,-774,-2.22,1179
2020-08-04,34244,35316,-1072,-3.04,1179
2020-08-05,34244,35240,-996,-2.83,1179
2020-08-06,34244,35150,-906,-2.58,1179
2020-08-07,34298,35254,-956,-2.71,1179
2020-08-08,25172,25385,-213,-0.84,1179
2020-08-09,18865,17376,1489,8.57,1179
2020-08-10,34032,34207,-175,-0.51,1179
2020-08-11,34244,34728,-484,-1.39,1179
2020-08-12,34244,34677,-433,-1.25,1179
2020-08-13,34244,34625,-381,-1.1,1179
2020-08-14,34298,34782,-484,-1.39,1179
2020-08-15,25172,24978,194,0.78,1179
2020-08-16,18865,17047,1818,10.66,1179
2020-08-17,34032,33967,65,0.19,1179
2020-08-18,34244,34585,-341,-0.99,1179
2020-08-19,34244,34639,-395,-1.14,1179
2020-08-20,34244,34697,-453,-1.31,1179
2020-08-21,34298,34967,-669,-1.91,1179
2020-08-22,25172,25277,-105,-0.42,1179
2020-08-23,18865,17458,1407,8.06,1179
2020-08-24,34032,34486,-454,-1.32,1179
2020-08-25,34244,35205,-961,-2.73,1179
2020-08-26,34244,35352,-1108,-3.13,1179
2020-08-27,34244,35492,-1248,-3.52,1179
2020-08-28,34298,35833,-1535,-4.28,1179
2020-08-29,25172,26200,-1028,-3.92,1179
2020-08-30,18865,18423,442,2.4,1179
2020-08-31,34032,35479,-1447,-4.08,1179
2020-09-01,35800,36210,-410,-1.13,1179
2020-09-02,35800,36353,-553,-1.52,1179
2020-09-03,35800,36475,-675,-1.85,1179
2020-09-04,36225,36783,-558,-1.52,1179
2020-09-05,26848,27104,-256,-0.94,1179
2020-09-06,19581,19270,311,1.61,1179
2020-09-07,34987,36258,-1271,-3.51,1179
2020-09-08,35800,36914,-1114,-3.02,1179
2020-09-09,35800,36976,-1176,-3.18,1179
2020-09-10,35800,37012,-1212,-3.27,1179
2020-09-11,36225,37233,-1008,-2.71,1179
2020-09-12,26848,27468,-620,-2.26,1179
2020-09-13,19581,19550,31,0.16,1179
2020-09-14,34987,36459,-1472,-4.04,1179
2020-09-15,35800,37043,-1243,-3.36,1179
2020-09-16,35800,37040,-1240,-3.35,1179
2020-09-17,35800,37022,-1222,-3.3,1179
2020-09-18,36225,37198,-973,-2.62,1179
2020-09-19,26848,27399,-551,-2.01,1179
2020-09-20,19581,19460,121,0.62,1179
2020-09-21,34987,36359,-1372,-3.77,1179
2020-09-22,35800,36943,-1143,-3.09,1179
2020-09-23,35800,36952,-1152,-3.12,1179
2020-09-24,35800,36955,-1155,-3.13,1179
2020-09-25,36225,37161,-936,-2.52,1179
2020-09-26,26848,27399,-551,-2.01,1179
2020-09-27,19581,19502,79,0.41,1179
2020-09-28,34987,36446,-1459,-4.0,1179
2020-09-29,35800,37079,-1279,-3.45,1179
2020-09-30,35800,37135,-1335,-3.59,1179
2020-10-01,35958,37184,-1226,-3.3,1179
2020-10-02,36486,37433,-947,-2.53,1179
2020-10-03,26709,27708,-999,-3.61,1179
2020-10-04,18261,19842,-1581,-7.97,1179
2020-10-05,35067,36809,-1742,-4.73,1179
2020-10-06,35958,37456,-1498,-4.0,1179
2020-10-07,35958,37518,-1560,-4.16,1179
2020-10-08,35958,37562,-1604,-4.27,1179
2020-10-09,36486,37796,-1310,-3.47,1179
2020-10-10,26709,28048,-1339,-4.77,1179
2020-10-11,18261,20149,-1888,-9.37,1179
2020-10-12,35067,37075,-2008,-5.42,1179
2020-10-13,35958,37674,-1716,-4.55,1179
2020-10-14,35958,37682,-1724,-4.58,1179
2020-10-15,35958,37668,-1710,-4.54,1179
2020-10-16,36486,37841,-1355,-3.58,1179
2020-10-17,26709,28030,-1321,-4.71,1179
2020-10-18,18261,20069,-1808,-9.01,1179
2020-10-19,35067,36935,-1868,-5.06,1179
2020-10-20,35958,37477,-1519,-4.05,1179
2020-10-21,35958,37434,-1476,-3.94,1179
2020-10-22,35958,37375,-1417,-3.79,1179
2020-10-23,36486,37510,-1024,-2.73,1179
2020-10-24,26709,27670,-961,-3.47,1179
2020-10-25,18261,19688,-1427,-7.25,1179
2020-10-26,35067,36543,-1476,-4.04,1179
2020-10-27,35958,37083,-1125,-3.03,1179
2020-10-28,35958,37046,-1088,-2.94,1179
2020-10-29,35958,37002,-1044,-2.82,1179
2020-10-30,36486,37160,-674,-1.81,1179
2020-10-31,26709,27349,-640,-2.34,1179
2020-11-01,14284,19402,-5118,-26.38,1179
2020-11-02,31743,36296,-4553,-12.54,1179
2020-11-03,29487,36876,-7389,-20.04,1179
2020-11-04,29487,36881,-7394,-20.05,1179
2020-11-05,29487,36878,-7391,-20.04,1179
2020-11-06,29998,37075,-7077,-19.09,1179
2020-11-07,20332,27298,-6966,-25.52,1179
2020-11-08,14284,19381,-5097,-26.3,1179
2020-11-09,31743,36298,-4555,-12.55,1179
2020-11-10,29487,36894,-7407,-20.08,1179
2020-11-11,29487,36906,-7419,-20.1,1179
2020-11-12,29487,36902,-7415,-20.09,1179
2020-11-13,29998,37088,-7090,-19.12,1179
2020-11-14,20332,27293,-6961,-25.5,1179
2020-11-15,14284,19347,-5063,-26.17,1179
2020-11-16,31743,36228,-4485,-12.38,1179
2020-11-17,29487,36781,-7294,-19.83,1179
2020-11-18,29487,36744,-7257,-19.75,1179
2020-11-19,29487,36685,-7198,-19.62,1179
2020-11-20,29998,36814,-6816,-18.51,1179
2020-11-21,20332,26958,-6626,-24.58,1179
2020-11-22,14284,18953,-4669,-24.63,1179
2020-11-23,31743,35774,-4031,-11.27,1179
2020-11-24,29487,36272,-6785,-18.71,1179
2020-11-25,29487,36183,-6696,-18.51,1179
2020-11-26,29487,36079,-6592,-18.27,1179
2020-11-27,29998,36169,-6171,-17.06,1179
2020-11-28,20332,26284,-5952,-22.64,1179
2020-11-29,14284,18257,-3973,-21.76,1179
2020-11-30,31743,35067,-3324,-9.48,1179
2020-12-01,28033,35563,-7530,-21.17,1179
2020-12-02,28033,35482,-7449,-20.99,1179
2020-12-03,28033,35395,-7362,-20.8,1179
2020-12-04,31857,35512,-3655,-10.29,1179
2020-12-05,21303,25661,-4358,-16.98,1179
2020-12-06,13608,17675,-4067,-23.01,1179
2020-12-07,29368,34532,-5164,-14.95,1179
2020-12-08,28033,35078,-7045,-20.08,1179
2020-12-09,28033,35051,-7018,-20.02,1179
2020-12-10,28033,35018,-6985,-19.95,1179
2020-12-11,31857,35188,-3331,-9.47,1179
2020-12-12,21303,25387,-4084,-16.09,1179
2020-12-13,13608,17448,-3840,-22.01,1179
2020-12-14,29368,34345,-4977,-14.49,1179
2020-12-15,28033,34925,-6892,-19.73,1179
2020-12-16,28033,34922,-6889,-19.73,1179
2020-12-17,28033,34906,-6873,-19.69,1179
2020-12-18,31857,35081,-3224,-9.19,1179
2020-12-19,21303,25276,-3973,-15.72,1179
2020-12-20,13608,17322,-3714,-21.44,1179
2020-12-21,29368,34196,-4828,-14.12,1179
2020-12-22,28033,34742,-6709,-19.31,1179
2020-12-23,28033,34698,-6665,-19.21,1179
2020-12-24,28033,34632,-6599,-19.05,1179
2020-12-25,31857,34752,-2895,-8.33,1179
2020-12-26,21303,24888,-3585,-14.4,1179
2020-12-27,13608,16872,-3264,-19.35,1179
2020-12-28,29368,33682,-4314,-12.81,1179
2020-12-29,28033,34166,-6133,-17.95,1179
2020-12-30,28033,34063,-6030,-17.7,1179
2020-12-31,28033,33943,-5910,-17.41,1179
2021-01-01,26568,34016,-7448,-21.9,1179
2021-01-02,16479,24112,-7633,-31.66,1179
2021-01-03,11794,16066,-4272,-26.59,1179
2021-01-04,25859,32857,-6998,-21.3,1179
2021-01-05,26882,33334,-6452,-19.36,1179
2021-01-06,26882,33235,-6353,-19.12,1179
2021-01-07,26882,33132,-6250,-18.86,1179
2021-01-08,26568,33234,-6666,-20.06,1179
2021-01-09,16479,23371,-6892,-29.49,1179
2021-01-10,11794,15378,-3584,-23.31,1179
2021-01-11,25859,32232,-6373,-19.77,1179
2021-01-12,26882,32781,-5899,-18.0,1179
2021-01-13,26882,32762,-5880,-17.95,1179
2021-01-14,26882,32744,-5862,-17.9,1179
2021-01-15,26568,32936,-6368,-19.33,1179
2021-01-16,16479,23166,-6687,-28.87,1179
2021-01-17,11794,15265,-3471,-22.74,1179
2021-01-18,25859,32211,-6352,-19.72,1179
2021-01-19,26882,32848,-5966,-18.16,1179
2021-01-20,26882,32911,-6029,-18.32,1179
2021-01-21,26882,32970,-6088,-18.47,1179
2021-01-22,26568,33231,-6663,-20.05,1179
2021-01-23,16479,23519,-7040,-29.93,1179
2021-01-24,11794,15668,-3874,-24.73,1179
2021-01-25,25859,32651,-6792,-20.8,1179
2021-01-26,26882,33315,-6433,-19.31,1179
2021-01-27,26882,33395,-6513,-19.5,1179
2021-01-28,26882,33460,-6578,-19.66,1179
2021-01-29,26568,33716,-7148,-21.2,1179
2021-01-30,16479,23991,-7512,-31.31,1179
2021-01-31,11794,16117,-4323,-26.82,1179
2021-02-01,31182,33072,-1890,-5.71,1179
2021-02-02,31231,33702,-2471,-7.33,1179
2021-02-03,31231,33744,-2513,-7.45,1179
2021-02-04,31231,33768,-2537,-7.51,1179
2021-02-05,31774,33984,-2210,-6.5,1179
2021-02-06,21924,24220,-2296,-9.48,1179
2021-02-07,14698,16310,-1612,-9.88,1179
2021-02-08,31182,33233,-2051,-6.17,1179
2021-02-09,31231,33836,-2605,-7.7,1179
2021-02-10,31231,33858,-2627,-7.76,1179
2021-02-11,31231,33870,-2639,-7.79,1179
2021-02-12,31774,34081,-2307,-6.77,1179
2021-02-13,21924,24320,-2396,-9.85,1179
2021-02-14,14698,16423,-1725,-10.5,1179
2021-02-15,31182,33366,-2184,-6.55,1179
2021-02-16,31231,33997,-2766,-8.14,1179
2021-02-17,31231,34054,-2823,-8.29,1179
2021-02-18,31231,34107,-2876,-8.43,1179
2021-02-19,31774,34364,-2590,-7.54,1179
2021-02-20,21924,24652,-2728,-11.07,1179
2021-02-21,14698,16806,-2108,-12.54,1179
2021-02-22,31182,33800,-2618,-7.75,1179
2021-02-23,31231,34482,-3251,-9.43,1179
2021-02-24,31231,34587,-3356,-9.7,1179
2021-02-25,31231,34683,-3452,-9.95,1179
2021-02-26,31774,34978,-3204,-9.16,1179
2021-02-27,21924,25299,-3375,-13.34,1179
2021-02-28,14698,17477,-2779,-15.9,1179
2021-03-01,33293,34488,-1195,-3.46,1179
2021-03-02,33552,35178,-1626,-4.62,1179
2021-03-03,33552,35282,-1730,-4.9,1179
2021-03-04,33552,35368,-1816,-5.13,1179
2021-03-05,33442,35645,-2203,-6.18,1179
2021-03-06,24505,25939,-1434,-5.53,1179
2021-03-07,15010,18083,-3073,-16.99,1179
2021-03-08,33293,35055,-1762,-5.03,1179
2021-03-09,33552,35699,-2147,-6.01,1179
2021-03-10,33552,35755,-2203,-6.16,1179
2021-03-11,33552,35791,-2239,-6.26,1179
2021-03-12,33442,36016,-2574,-7.15,1179
2021-03-13,24505,26260,-1755,-6.68,1179
2021-03-14,15010,18357,-3347,-18.23,1179
2021-03-15,33293,35285,-1992,-5.65,1179
2021-03-16,33552,35891,-2339,-6.52,1179
2021-03-17,33552,35915,-2363,-6.58,1179
2021-03-18,33552,35926,-2374,-6.61,1179
2021-03-19,33442,36136,-2694,-7.46,1179
2021-03-20,24505,26372,-1867,-7.08,1179
2021-03-21,15010,18471,-3461,-18.74,1179
2021-03-22,33293,35409,-2116,-5.98,1179
2021-03-23,33552,36035,-2483,-6.89,1179
2021-03-24,33552,36086,-2534,-7.02,1179
2021-03-25,33552,36133,-2581,-7.14,1179
2021-03-26,33442,36384,-2942,-8.09,1179
2021-03-27,24505,26668,-2163,-8.11,1179
2021-03-28,15010,18816,-3806,-20.23,1179
2021-03-29,33293,35807,-2514,-7.02,1179
2021-03-30,33552,36486,-2934,-8.04,1179
2021-03-31,33552,36590,-3038,-8.3,1179
2021-04-01,30566,36686,-6120,-16.68,1179
2021-04-02,30706,36982,-6276,-16.97,1179
2021-04-03,19678,27305,-7627,-27.93,1179
2021-04-04,14484,19486,-5002,-25.67,1179
2021-04-05,31389,36501,-5112,-14.01,1179
2021-04-06,30566,37194,-6628,-17.82,1179
2021-04-07,30566,37303,-6737,-18.06,1179
2021-04-08,30566,37394,-6828,-18.26,1179
2021-04-09,30706,37674,-6968,-18.5,1179
2021-04-10,19678,27971,-8293,-29.65,1179
2021-04-11,14484,20116,-5632,-28.0,1179
2021-04-12,31389,37085,-5696,-15.36,1179
2021-04-13,30566,37726,-7160,-18.98,1179
2021-04-14,30566,37773,-7207,-19.08,1179
2021-04-15,30566,37797,-7231,-19.13,1179
2021-04-16,30706,38006,-7300,-19.21,1179
2021-04-17,19678,28228,-8550,-30.29,1179
2021-04-18,14484,20297,-5813,-28.64,1179
2021-04-19,31389,37191,-5802,-15.6,1179
2021-04-20,30566,37758,-7192,-19.05,1179
2021-04-21,30566,37735,-7169,-19.0,1179
2021-04-22,30566,37694,-7128,-18.91,1179
2021-04-23,30706,37843,-7137,-18.86,1179
2021-04-24,19678,28014,-8336,-29.76,1179
2021-04-25,14484,20039,-5555,-27.72,1179
2021-04-26,31389,36898,-5509,-14.93,1179
2021-04-27,30566,37439,-6873,-18.36,1179
2021-04-28,30566,37400,-6834,-18.27,1179
2021-04-29,30566,37351,-6785,-18.17,1179
2021-04-30,30706,37502,-6796,-18.12,1179
2021-05-01,26978,27683,-705,-2.55,1179
2021-05-02,16615,19726,-3111,-15.77,1179
2021-05-03,35341,36610,-1269,-3.47,1179
2021-05-04,36022,37181,-1159,-3.12,1179
2021-05-05,36022,37176,-1154,-3.1,1179
2021-05-06,36022,37165,-1143,-3.08,1179
2021-05-07,36036,37356,-1320,-3.53,1179
2021-05-08,26978,27577,-599,-2.17,1179
2021-05-09,16615,19659,-3044,-15.48,1179
2021-05-10,35341,36580,-1239,-3.39,1179
2021-05-11,36022,37185,-1163,-3.13,1179
2021-05-12,36022,37211,-1189,-3.2,1179
2021-05-13,36022,37225,-1203,-3.23,1179
2021-05-14,36036,37436,-1400,-3.74,1179
2021-05-15,26978,27671,-693,-2.5,1179
2021-05-16,16615,19762,-3147,-15.92,1179
2021-05-17,35341,36686,-1345,-3.67,1179
2021-05-18,36022,37289,-1267,-3.4,1179
2021-05-19,36022,37307,-1285,-3.44,1179
2021-05-20,36022,37310,-1288,-3.45,1179
2021-05-21,36036,37506,-1470,-3.92,1179
2021-05-22,26978,27723,-745,-2.69,1179
2021-05-23,16615,19794,-3179,-16.06,1179
2021-05-24,35341,36698,-1357,-3.7,1179
2021-05-25,36022,37280,-1258,-3.37,1179
2021-05-26,36022,37278,-1256,-3.37,1179
2021-05-27,36022,37264,-1242,-3.33,1179
2021-05-28,36036,37445,-1409,-3.76,1179
2021-05-29,26978,27651,-673,-2.43,1179
2021-05-30,16615,19715,-3100,-15.72,1179
2021-05-31,35341,36615,-1274,-3.48,1179
2021-06-01,37273,37198,75,0.2,1179
2021-06-02,37273,37203,70,0.19,1179
2021-06-03,37273,37199,74,0.2,1179
2021-06-04,36672,37393,-721,-1.93,1179
2021-06-05,27896,27616,280,1.01,1179
2021-06-06,20661,19700,961,4.88,1179
2021-06-07,37056,36621,435,1.19,1179
2021-06-08,37273,37226,47,0.13,1179
2021-06-09,37273,37252,21,0.06,1179
2021-06-10,37273,37267,6,0.02,1179
2021-06-11,36672,37478,-806,-2.15,1179
2021-06-12,27896,27714,182,0.66,1179
2021-06-13,20661,19806,855,4.32,1179
2021-06-14,37056,36729,327,0.89,1179
2021-06-15,37273,37331,-58,-0.16,1179
2021-06-16,37273,37347,-74,-0.2,1179
2021-06-17,37273,37344,-71,-0.19,1179
2021-06-18,36672,37531,-859,-2.29,1179
2021-06-19,27896,27735,161,0.58,1179
2021-06-20,20661,19789,872,4.41,1179
2021-06-21,37056,36668,388,1.06,1179
2021-06-22,37273,37220,53,0.14,1179
2021-06-23,37273,37181,92,0.25,1179
2021-06-24,37273,37121,152,0.41,1179
2021-06-25,36672,37249,-577,-1.55,1179
2021-06-26,27896,27393,503,1.84,1179
2021-06-27,20661,19387,1274,6.57,1179
2021-06-28,37056,36210,846,2.34,1179
2021-06-29,37273,36708,565,1.54,1179
2021-06-30,37273,36622,651,1.78,1179
2021-07-01,35806,36521,-715,-1.96,1179
2021-07-02,35843,36615,-772,-2.11,1179
2021-07-03,26324,26735,-411,-1.54,1179
2021-07-04,18969,18714,255,1.36,1179
2021-07-05,35306,35531,-225,-0.63,1179
2021-07-06,35806,36035,-229,-0.64,1179
2021-07-07,35806,35963,-157,-0.44,1179
2021-07-08,35806,35887,-81,-0.23,1179
2021-07-09,35843,36016,-173,-0.48,1179
2021-07-10,26324,26178,146,0.56,1179
2021-07-11,18969,18206,763,4.19,1179
2021-07-12,35306,35080,226,0.64,1179
2021-07-13,35806,35644,162,0.45,1179
2021-07-14,35806,35635,171,0.48,1179
2021-07-15,35806,35624,182,0.51,1179
2021-07-16,35843,35816,27,0.08,1179
2021-07-17,26324,26039,285,1.09,1179
2021-07-18,18969,18124,845,4.66,1179
2021-07-19,35306,35049,257,0.73,1179
2021-07-20,35806,35657,149,0.42,1179
2021-07-21,35806,35684,122,0.34,1179
2021-07-22,35806,35698,108,0.3,1179
2021-07-23,35843,35905,-62,-0.17,1179
2021-07-24,26324,26132,192,0.73,1179
2021-07-25,18969,18212,757,4.16,1179
2021-07-26,35306,35119,187,0.53,1179
2021-07-27,35806,35699,107,0.3,1179
2021-07-28,35806,35689,117,0.33,1179
2021-07-29,35806,35658,148,0.42,1179
2021-07-30,35843,35813,30,0.08,1179
2021-07-31,26324,25982,342,1.32,1179
2021-08-01,17802,18000,-198,-1.1,1179
2021-08-02,33259,34844,-1585,-4.55,1179
2021-08-03,33693,35362,-1669,-4.72,1179
2021-08-04,33693,35292,-1599,-4.53,1179
2021-08-05,33693,35205,-1512,-4.29,1179
2021-08-06,33094,35310,-2216,-6.28,1179
2021-08-07,24574,25440,-866,-3.4,1179
2021-08-08,17802,17427,375,2.15,1179
2021-08-09,33259,34252,-993,-2.9,1179
2021-08-10,33693,34763,-1070,-3.08,1179
2021-08-11,33693,34700,-1007,-2.9,1179
2021-08-12,33693,34634,-941,-2.72,1179
2021-08-13,33094,34774,-1680,-4.83,1179
2021-08-14,24574,24953,-379,-1.52,1179
2021-08-15,17802,17002,800,4.71,1179
2021-08-16,33259,33902,-643,-1.9,1179
2021-08-17,33693,34499,-806,-2.34,1179
2021-08-18,33693,34532,-839,-2.43,1179
2021-08-19,33693,34569,-876,-2.53,1179
2021-08-20,33094,34819,-1725,-4.95,1179
2021-08-21,24574,25110,-536,-2.13,1179
2021-08-22,17802,17273,529,3.06,1179
2021-08-23,33259,34285,-1026,-2.99,1179
2021-08-24,33693,34991,-1298,-3.71,1179
2021-08-25,33693,35127,-1434,-4.08,1179
2021-08-26,33693,35260,-1567,-4.44,1179
2021-08-27,33094,35595,-2501,-7.03,1179
2021-08-28,24574,25959,-1385,-5.34,1179
2021-08-29,17802,18183,-381,-2.1,1179
2021-08-30,33259,35242,-1983,-5.63,1179
2021-08-31,33693,35979,-2286,-6.35,1179
2021-09-01,35968,36130,-162,-0.45,1179
2021-09-02,35968,36263,-295,-0.81,1179
2021-09-03,36957,36584,373,1.02,1179
2021-09-04,28591,26919,1672,6.21,1179
2021-09-05,21287,19100,2187,11.45,1179
2021-09-06,35019,36104,-1085,-3.01,1179
2021-09-07,35968,36776,-808,-2.2,1179
2021-09-08,35968,36854,-886,-2.4,1179
2021-09-09,35968,36907,-939,-2.54,1179
2021-09-10,36957,37142,-185,-0.5,1179
2021-09-11,28591,27391,1200,4.38,1179
2021-09-12,21287,19485,1802,9.25,1179
2021-09-13,35019,36405,-1386,-3.81,1179
2021-09-14,35968,36996,-1028,-2.78,1179
2021-09-15,35968,37000,-1032,-2.79,1179
2021-09-16,35968,36986,-1018,-2.75,1179
2021-09-17,36957,37164,-207,-0.56,1179
2021-09-18,28591,27366,1225,4.48,1179
2021-09-19,21287,19424,1863,9.59,1179
2021-09-20,35019,36319,-1300,-3.58,1179
2021-09-21,35968,36897,-929,-2.52,1179
2021-09-22,35968,36899,-931,-2.52,1179
2021-09-23,35968,36894,-926,-2.51,1179
2021-09-24,36957,37091,-134,-0.36,1179
2021-09-25,28591,27320,1271,4.65,1179
2021-09-26,21287,19414,1873,9.65,1179
2021-09-27,35019,36349,-1330,-3.66,1179
2021-09-28,35968,36973,-1005,-2.72,1179
2021-09-29,35968,37023,-1055,-2.85,1179
2021-09-30,35968,37066,-1098,-2.96,1179
2021-10-01,37145,37309,-164,-0.44,1179
2021-10-02,28422,27582,840,3.05,1179
2021-10-03,20177,19714,463,2.35,1179
2021-10-04,35316,36682,-1366,-3.72,1179
2021-10-05,35953,37331,-1378,-3.69,1179
2021-10-06,35953,37397,-1444,-3.86,1179
2021-10-07,35953,37448,-1495,-3.99,1179
2021-10-08,37145,37690,-545,-1.45,1179
2021-10-09,28422,27950,472,1.69,1179
2021-10-10,20177,20061,116,0.58,1179
2021-10-11,35316,36998,-1682,-4.55,1179
2021-10-12,35953,37609,-1656,-4.4,1179
2021-10-13,35953,37628,-1675,-4.45,1179
2021-10-14,35953,37626,-1673,-4.45,1179
2021-10-15,37145,37810,-665,-1.76,1179
2021-10-16,28422,28010,412,1.47,1179
2021-10-17,20177,20058,119,0.59,1179
2021-10-18,35316,36934,-1618,-4.38,1179
2021-10-19,35953,37483,-1530,-4.08,1179
2021-10-20,35953,37445,-1492,-3.98,1179
2021-10-21,35953,37390,-1437,-3.84,1179
2021-10-22,37145,37528,-383,-1.02,1179
2021-10-23,28422,27688,734,2.65,1179
2021-10-24,20177,19705,472,2.4,1179
2021-10-25,35316,36557,-1241,-3.39,1179
2021-10-26,35953,37093,-1140,-3.07,1179
2021-10-27,35953,37051,-1098,-2.96,1179
2021-10-28,35953,37000,-1047,-2.83,1179
2021-10-29,37145,37151,-6,-0.02,1179
2021-10-30,28422,27332,1090,3.99,1179
2021-10-31,20177,19376,801,4.13,1179
2021-11-01,31659,36262,-4603,-12.69,1179
2021-11-02,33496,36835,-3339,-9.06,1179
2021-11-03,33496,36833,-3337,-9.06,1179
2021-11-04,33496,36825,-3329,-9.04,1179
2021-11-05,34343,37017,-2674,-7.22,1179
2021-11-06,25542,27237,-1695,-6.22,1179
2021-11-07,17636,19317,-1681,-8.7,1179
2021-11-08,31659,36234,-4575,-12.63,1179
2021-11-09,33496,36832,-3336,-9.06,1179
2021-11-10,33496,36848,-3352,-9.1,1179
2021-11-11,33496,36849,-3353,-9.1,1179
2021-11-12,34343,37042,-2699,-7.29,1179
2021-11-13,25542,27254,-1712,-6.28,1179
2021-11-14,17636,19317,-1681,-8.7,1179
2021-11-15,31659,36208,-4549,-12.56,1179
2021-11-16,33496,36772,-3276,-8.91,1179
2021-11-17,33496,36746,-3250,-8.84,1179
2021-11-18,33496,36699,-3203,-8.73,1179
2021-11-19,34343,36839,-2496,-6.78,1179
2021-11-20,25542,26994,-1452,-5.38,1179
2021-11-21,17636,18998,-1362,-7.17,1179
2021-11-22,31659,35829,-4170,-11.64,1179
2021-11-23,33496,36333,-2837,-7.81,1179
2021-11-24,33496,36251,-2755,-7.6,1179
2021-11-25,33496,36151,-2655,-7.34,1179
2021-11-26,34343,36243,-1900,-5.24,1179
2021-11-27,25542,26358,-816,-3.1,1179
2021-11-28,17636,18330,-694,-3.79,1179
2021-11-29,31659,35137,-3478,-9.9,1179
2021-11-30,33496,35628,-2132,-5.98,1179
2021-12-01,30554,35541,-4987,-14.03,1179
2021-12-02,30554,35447,-4893,-13.8,1179
2021-12-03,28072,35554,-7482,-21.04,1179
2021-12-04,22212,25694,-3482,-13.55,1179
2021-12-05,16242,17698,-1456,-8.23,1179
2021-12-06,31749,34545,-2796,-8.09,1179
2021-12-07,30554,35081,-4527,-12.9,1179
2021-12-08,30554,35044,-4490,-12.81,1179
2021-12-09,30554,35002,-4448,-12.71,1179
2021-12-10,28072,35164,-7092,-20.17,1179
2021-12-11,22212,25357,-3145,-12.4,1179
2021-12-12,16242,17412,-1170,-6.72,1179
2021-12-13,31749,34306,-2557,-7.45,1179
2021-12-14,30554,34884,-4330,-12.41,1179
2021-12-15,30554,34882,-4328,-12.41,1179
2021-12-16,30554,34868,-4314,-12.37,1179
2021-12-17,28072,35048,-6976,-19.9,1179
2021-12-18,22212,25249,-3037,-12.03,1179
2021-12-19,16242,17303,-1061,-6.13,1179
2021-12-20,31749,34186,-2437,-7.13,1179
2021-12-21,30554,34742,-4188,-12.05,1179
2021-12-22,30554,34709,-4155,-11.97,1179
2021-12-23,30554,34655,-4101,-11.83,1179
2021-12-24,28072,34787,-6715,-19.3,1179
2021-12-25,22212,24934,-2722,-10.92,1179
2021-12-26,16242,16930,-688,-4.06,1179
2021-12-27,31749,33751,-2002,-5.93,1179
2021-12-28,30554,34244,-3690,-10.78,1179
2021-12-29,30554,34149,-3595,-10.53,1179
2021-12-30,30554,34035,-3481,-10.23,1179
2021-12-31,28072,34112,-6040,-17.71,1179
2022-01-01,22822,24210,-1388,-5.73,1179
2022-01-02,14910,16163,-1253,-7.75,1179
2022-01-03,29459,32952,-3493,-10.6,1179
2022-01-04,30571,33423,-2852,-8.53,1179
2022-01-05,30571,33317,-2746,-8.24,1179
2022-01-06,30571,33204,-2633,-7.93,1179
2022-01-07,30624,33295,-2671,-8.02,1179
2022-01-08,22822,23419,-597,-2.55,1179
2022-01-09,14910,15411,-501,-3.25,1179
2022-01-10,29459,32249,-2790,-8.65,1179
2022-01-11,30571,32781,-2210,-6.74,1179
2022-01-12,30571,32745,-2174,-6.64,1179
2022-01-13,30571,32710,-2139,-6.54,1179
2022-01-14,30624,32885,-2261,-6.88,1179
2022-01-15,22822,23098,-276,-1.19,1179
2022-01-16,14910,15182,-272,-1.79,1179
2022-01-17,29459,32114,-2655,-8.27,1179
2022-01-18,30571,32737,-2166,-6.62,1179
2022-01-19,30571,32790,-2219,-6.77,1179
2022-01-20,30571,32840,-2269,-6.91,1179
2022-01-21,30624,33093,-2469,-7.46,1179
2022-01-22,22822,23377,-555,-2.37,1179
2022-01-23,14910,15522,-612,-3.94,1179
2022-01-24,29459,32505,-3046,-9.37,1179
2022-01-25,30571,33169,-2598,-7.83,1179
2022-01-26,30571,33252,-2681,-8.06,1179
2022-01-27,30571,33321,-2750,-8.25,1179
2022-01-28,30624,33582,-2958,-8.81,1179
2022-01-29,22822,23864,-1042,-4.37,1179
2022-01-30,14910,15998,-1088,-6.8,1179
2020-02-01,9583,9091,492,5.41,1180
2020-02-02,7788,7615,173,2.27,1180
2020-02-03,10990,11060,-70,-0.63,1180
2020-02-04,11415,11369,46,0.4,1180
2020-02-05,11415,11363,52,0.46,1180
2020-02-06,11415,11350,65,0.57,1180
2020-02-07,11764,11781,-17,-0.14,1180
2020-02-08,9583,9029,554,6.14,1180
2020-02-09,7788,7546,242,3.21,1180
2020-02-10,10990,10990,0,0.0,1180
2020-02-11,11415,11302,113,1.0,1180
2020-02-12,11415,11303,112,0.99,1180
2020-02-13,11415,11302,113,1.0,1180
2020-02-14,11764,11750,14,0.12,1180
2020-02-15,9583,9019,564,6.25,1180
2020-02-16,7788,7560,228,3.02,1180
2020-02-17,10990,11031,-41,-0.37,1180
2020-02-18,11415,11372,43,0.38,1180
2020-02-19,11415,11404,11,0.1,1180
2020-02-20,11415,11434,-19,-0.17,1180
2020-02-21,11764,11913,-149,-1.25,1180
2020-02-22,9583,9211,372,4.04,1180
2020-02-23,7788,7780,8,0.1,1180
2020-02-24,10990,11276,-286,-2.54,1180
2020-02-25,11415,11638,-223,-1.92,1180
2020-02-26,11415,11688,-273,-2.34,1180
2020-02-27,11415,11732,-317,-2.7,1180
2020-02-28,11764,12220,-456,-3.73,1180
2020-02-29,9583,9522,61,0.64,1180
2020-03-01,5853,8090,-2237,-27.65,1180
2020-03-02,8187,11581,-3394,-29.31,1180
2020-03-03,8558,11933,-3375,-28.28,1180
2020-03-04,8558,11969,-3411,-28.5,1180
2020-03-05,8558,11994,-3436,-28.65,1180
2020-03-06,9286,12461,-3175,-25.48,1180
2020-03-07,6724,9740,-3016,-30.97,1180
2020-03-08,5853,8282,-2429,-29.33,1180
2020-03-09,8187,11747,-3560,-30.31,1180
2020-03-10,8558,12073,-3515,-29.11,1180
2020-03-11,8558,12082,-3524,-29.17,1180
2020-03-12,8558,12084,-3526,-29.18,1180
2020-03-13,9286,12528,-3242,-25.88,1180
2020-03-14,6724,9787,-3063,-31.3,1180
2020-03-15,5853,8314,-2461,-29.6,1180
2020-03-16,8187,11765,-3578,-30.41,1180
2020-03-17,8558,12082,-3524,-29.17,1180
2020-03-18,8558,12088,-3530,-29.2,1180
2020-03-19,8558,12089,-3531,-29.21,1180
2020-03-20,9286,12537,-3251,-25.93,1180
2020-03-21,6724,9803,-3079,-31.41,1180
2020-03-22,5853,8341,-2488,-29.83,1180
2020-03-23,8187,11807,-3620,-30.66,1180
2020-03-24,8558,12141,-3583,-29.51,1180
2020-03-25,8558,12165,-3607,-29.65,1180
2020-03-26,8558,12187,-3629,-29.78,1180
2020-03-27,9286,12655,-3369,-26.62,1180
2020-03-28,6724,9943,-3219,-32.37,1180
2020-03-29,5853,8501,-2648,-31.15,1180
2020-03-30,8187,11985,-3798,-31.69,1180
2020-03-31,8558,12335,-3777,-30.62,1180
2020-04-01,7855,12373,-4518,-36.51,1180
2020-04-02,7855,12405,-4550,-36.68,1180
2020-04-03,7858,12881,-5023,-39.0,1180
2020-04-04,6499,10171,-3672,-36.1,1180
2020-04-05,4962,8728,-3766,-43.15,1180
2020-04-06,7628,12208,-4580,-37.52,1180
2020-04-07,7855,12551,-4696,-37.42,1180
2020-04-08,7855,12577,-4722,-37.54,1180
2020-04-09,7855,12594,-4739,-37.63,1180
2020-04-10,7858,13052,-5194,-39.79,1180
2020-04-11,6499,10324,-3825,-37.05,1180
2020-04-12,4962,8860,-3898,-44.0,1180
2020-04-13,7628,12318,-4690,-38.07,1180
2020-04-14,7855,12639,-4784,-37.85,1180
2020-04-15,7855,12644,-4789,-37.88,1180
2020-04-16,7855,12641,-4786,-37.86,1180
2020-04-17,7858,13082,-5224,-39.93,1180
2020-04-18,6499,10338,-3839,-37.13,1180
2020-04-19,4962,8861,-3899,-44.0,1180
2020-04-20,7628,12310,-4682,-38.03,1180
2020-04-21,7855,12625,-4770,-37.78,1180
2020-04-22,7855,12628,-4773,-37.8,1180
2020-04-23,7855,12626,-4771,-37.79,1180
2020-04-24,7858,13072,-5214,-39.89,1180
2020-04-25,6499,10336,-3837,-37.12,1180
2020-04-26,4962,8871,-3909,-44.06,1180
2020-04-27,7628,12334,-4706,-38.15,1180
2020-04-28,7855,12665,-4810,-37.98,1180
2020-04-29,7855,12685,-4830,-38.08,1180
2020-04-30,7855,12702,-4847,-38.16,1180
2020-05-01,11190,13166,-1976,-15.01,1180
2020-05-02,8980,10447,-1467,-14.04,1180
2020-05-03,7056,8998,-1942,-21.58,1180
2020-05-04,10314,12475,-2161,-17.32,1180
2020-05-05,10807,12818,-2011,-15.69,1180
2020-05-06,10807,12846,-2039,-15.87,1180
2020-05-07,10807,12867,-2060,-16.01,1180
2020-05-08,11190,13332,-2142,-16.07,1180
2020-05-09,8980,10611,-1631,-15.37,1180
2020-05-10,7056,9155,-2099,-22.93,1180
2020-05-11,10314,12620,-2306,-18.27,1180
2020-05-12,10807,12948,-2141,-16.54,1180
2020-05-13,10807,12959,-2152,-16.61,1180
2020-05-14,10807,12960,-2153,-16.61,1180
2020-05-15,11190,13402,-2212,-16.5,1180
2020-05-16,8980,10656,-1676,-15.73,1180
2020-05-17,7056,9175,-2119,-23.1,1180
2020-05-18,10314,12617,-2303,-18.25,1180
2020-05-19,10807,12921,-2114,-16.36,1180
2020-05-20,10807,12910,-2103,-16.29,1180
2020-05-21,10807,12892,-2085,-16.17,1180
2020-05-22,11190,13319,-2129,-15.98,1180
2020-05-23,8980,10562,-1582,-14.98,1180
2020-05-24,7056,9074,-2018,-22.24,1180
2020-05-25,10314,12514,-2200,-17.58,1180
2020-05-26,10807,12821,-2014,-15.71,1180
2020-05-27,10807,12819,-2012,-15.7,1180
2020-05-28,10807,12814,-2007,-15.66,1180
2020-05-29,11190,13260,-2070,-15.61,1180
2020-05-30,8980,10526,-1546,-14.69,1180
2020-05-31,7056,9065,-2009,-22.16,1180
2020-06-01,11742,12534,-792,-6.32,1180
2020-06-02,12140,12874,-734,-5.7,1180
2020-06-03,12140,12905,-765,-5.93,1180
2020-06-04,12140,12934,-794,-6.14,1180
2020-06-05,12198,13411,-1213,-9.04,1180
2020-06-06,9738,10707,-969,-9.05,1180
2020-06-07,7943,9273,-1330,-14.34,1180
2020-06-08,11742,12764,-1022,-8.01,1180
2020-06-09,12140,13119,-979,-7.46,1180
2020-06-10,12140,13159,-1019,-7.74,1180
2020-06-11,12140,13189,-1049,-7.95,1180
2020-06-12,12198,13659,-1461,-10.7,1180
2020-06-13,9738,10939,-1201,-10.98,1180
2020-06-14,7943,9480,-1537,-16.21,1180
2020-06-15,11742,12936,-1194,-9.23,1180
2020-06-16,12140,13249,-1109,-8.37,1180
2020-06-17,12140,13237,-1097,-8.29,1180
2020-06-18,12140,13207,-1067,-8.08,1180
2020-06-19,12198,13611,-1413,-10.38,1180
2020-06-20,9738,10819,-1081,-9.99,1180
2020-06-21,7943,9282,-1339,-14.43,1180
2020-06-22,11742,12658,-916,-7.24,1180
2020-06-23,12140,12888,-748,-5.8,1180
2020-06-24,12140,12794,-654,-5.11,1180
2020-06-25,12140,12683,-543,-4.28,1180
2020-06-26,12198,13009,-811,-6.23,1180
2020-06-27,9738,10143,-405,-3.99,1180
2020-06-28,7943,8540,-597,-6.99,1180
2020-06-29,11742,11857,-115,-0.97,1180
2020-06-30,12140,12037,103,0.86,1180
2020-07-01,11466,11902,-436,-3.66,1180
2020-07-02,11466,11763,-297,-2.52,1180
2020-07-03,11546,12071,-525,-4.35,1180
2020-07-04,8720,9201,-481,-5.23,1180
2020-07-05,7734,7604,130,1.71,1180
2020-07-06,10860,10941,-81,-0.74,1180
2020-07-07,11466,11151,315,2.82,1180
2020-07-08,11466,11059,407,3.68,1180
2020-07-09,11466,10972,494,4.5,1180
2020-07-10,11546,11341,205,1.81,1180
2020-07-11,8720,8539,181,2.12,1180
2020-07-12,7734,7018,716,10.2,1180
2020-07-13,10860,10434,426,4.08,1180
2020-07-14,11466,10726,740,6.9,1180
2020-07-15,11466,10717,749,6.99,1180
2020-07-16,11466,10713,753,7.03,1180
2020-07-17,11546,11162,384,3.44,1180
2020-07-18,8720,8436,284,3.37,1180
2020-07-19,7734,6985,749,10.72,1180
2020-07-20,10860,10465,395,3.77,1180
2020-07-21,11466,10813,653,6.04,1180
2020-07-22,11466,10851,615,5.67,1180
2020-07-23,11466,10884,582,5.35,1180
2020-07-24,11546,11361,185,1.63,1180
2020-07-25,8720,8652,68,0.79,1180
2020-07-26,7734,7208,526,7.3,1180
2020-07-27,10860,10684,176,1.65,1180
2020-07-28,11466,11021,445,4.04,1180
2020-07-29,11466,11039,427,3.87,1180
2020-07-30,11466,11044,422,3.82,1180
2020-07-31,11546,11488,58,0.5,1180
2020-08-01,9016,8741,275,3.15,1180
2020-08-02,7625,7256,369,5.09,1180
2020-08-03,10304,10691,-387,-3.62,1180
2020-08-04,10793,10985,-192,-1.75,1180
2020-08-05,10793,10961,-168,-1.53,1180
2020-08-06,10793,10929,-136,-1.24,1180
2020-08-07,11039,11338,-299,-2.64,1180
2020-08-08,9016,8563,453,5.29,1180
2020-08-09,7625,7056,569,8.06,1180
2020-08-10,10304,10475,-171,-1.63,1180
2020-08-11,10793,10763,30,0.28,1180
2020-08-12,10793,10741,52,0.48,1180
2020-08-13,10793,10718,75,0.7,1180
2020-08-14,11039,11147,-108,-0.97,1180
2020-08-15,9016,8399,617,7.35,1180
2020-08-16,7625,6927,698,10.08,1180
2020-08-17,10304,10388,-84,-0.81,1180
2020-08-18,10793,10723,70,0.65,1180
2020-08-19,10793,10754,39,0.36,1180
2020-08-20,10793,10788,5,0.05,1180
2020-08-21,11039,11276,-237,-2.1,1180
2020-08-22,9016,8588,428,4.98,1180
2020-08-23,7625,7176,449,6.26,1180
2020-08-24,10304,10695,-391,-3.66,1180
2020-08-25,10793,11086,-293,-2.64,1180
2020-08-26,10793,11168,-375,-3.36,1180
2020-08-27,10793,11248,-455,-4.05,1180
2020-08-28,11039,11775,-736,-6.25,1180
2020-08-29,9016,9120,-104,-1.14,1180
2020-08-30,7625,7732,-107,-1.38,1180
2020-08-31,10304,11269,-965,-8.56,1180
2020-09-01,12264,11668,596,5.11,1180
2020-09-02,12264,11750,514,4.37,1180
2020-09-03,12264,11822,442,3.74,1180
2020-09-04,12498,12333,165,1.34,1180
2020-09-05,9888,9654,234,2.42,1180
2020-09-06,8394,8237,157,1.91,1180
2020-09-07,11988,11738,250,2.13,1180
2020-09-08,12264,12097,167,1.38,1180
2020-09-09,12264,12135,129,1.06,1180
2020-09-10,12264,12161,103,0.85,1180
2020-09-11,12498,12624,-126,-1.0,1180
2020-09-12,9888,9898,-10,-0.1,1180
2020-09-13,8394,8433,-39,-0.46,1180
2020-09-14,11988,11889,99,0.83,1180
2020-09-15,12264,12205,59,0.48,1180
2020-09-16,12264,12203,61,0.5,1180
2020-09-17,12264,12193,71,0.58,1180
2020-09-18,12498,12626,-128,-1.01,1180
2020-09-19,9888,9873,15,0.15,1180
2020-09-20,8394,8387,7,0.08,1180
2020-09-21,11988,11826,162,1.37,1180
2020-09-22,12264,12130,134,1.1,1180
2020-09-23,12264,12122,142,1.17,1180
2020-09-24,12264,12109,155,1.28,1180
2020-09-25,12498,12543,-45,-0.36,1180
2020-09-26,9888,9794,94,0.96,1180
2020-09-27,8394,8316,78,0.94,1180
2020-09-28,11988,11763,225,1.91,1180
2020-09-29,12264,12078,186,1.54,1180
2020-09-30,12264,12081,183,1.51,1180
2020-10-01,11869,12079,-210,-1.74,1180
2020-10-02,12160,12522,-362,-2.89,1180
2020-10-03,9454,9782,-328,-3.35,1180
2020-10-04,7966,8310,-344,-4.14,1180
2020-10-05,11648,11764,-116,-0.99,1180
2020-10-06,11869,12082,-213,-1.76,1180
2020-10-07,11869,12085,-216,-1.79,1180
2020-10-08,11869,12082,-213,-1.76,1180
2020-10-09,12160,12523,-363,-2.9,1180
2020-10-10,9454,9779,-325,-3.32,1180
2020-10-11,7966,8302,-336,-4.05,1180
2020-10-12,11648,11749,-101,-0.86,1180
2020-10-13,11869,12061,-192,-1.59,1180
2020-10-14,11869,12059,-190,-1.58,1180
2020-10-15,11869,12051,-182,-1.51,1180
2020-10-16,12160,12488,-328,-2.63,1180
2020-10-17,9454,9742,-288,-2.96,1180
2020-10-18,7966,8266,-300,-3.63,1180
2020-10-19,11648,11717,-69,-0.59,1180
2020-10-20,11869,12036,-167,-1.39,1180
2020-10-21,11869,12044,-175,-1.45,1180
2020-10-22,11869,12050,-181,-1.5,1180
2020-10-23,12160,12505,-345,-2.76,1180
2020-10-24,9454,9781,-327,-3.34,1180
2020-10-25,7966,8329,-363,-4.36,1180
2020-10-26,11648,11806,-158,-1.34,1180
2020-10-27,11869,12154,-285,-2.34,1180
2020-10-28,11869,12193,-324,-2.66,1180
2020-10-29,11869,12231,-362,-2.96,1180
2020-10-30,12160,12717,-557,-4.38,1180
2020-10-31,9454,10023,-569,-5.68,1180
2020-11-01,6472,8600,-2128,-24.74,1180
2020-11-02,10004,12105,-2101,-17.36,1180
2020-11-03,9874,12475,-2601,-20.85,1180
2020-11-04,9874,12533,-2659,-21.22,1180
2020-11-05,9874,12585,-2711,-21.54,1180
2020-11-06,10284,13080,-2796,-21.38,1180
2020-11-07,7996,10389,-2393,-23.03,1180
2020-11-08,6472,8962,-2490,-27.78,1180
2020-11-09,10004,12456,-2452,-19.69,1180
2020-11-10,9874,12810,-2936,-22.92,1180
2020-11-11,9874,12845,-2971,-23.13,1180
2020-11-12,9874,12867,-2993,-23.26,1180
2020-11-13,10284,13327,-3043,-22.83,1180
2020-11-14,7996,10596,-2600,-24.54,1180
2020-11-15,6472,9125,-2653,-29.07,1180
2020-11-16,10004,12571,-2567,-20.42,1180
2020-11-17,9874,12875,-3001,-23.31,1180
2020-11-18,9874,12858,-2984,-23.21,1180
2020-11-19,9874,12828,-2954,-23.03,1180
2020-11-20,10284,13236,-2952,-22.3,1180
2020-11-21,7996,10455,-2459,-23.52,1180
2020-11-22,6472,8937,-2465,-27.58,1180
2020-11-23,10004,12340,-2336,-18.93,1180
2020-11-24,9874,12605,-2731,-21.67,1180
2020-11-25,9874,12555,-2681,-21.35,1180
2020-11-26,9874,12498,-2624,-21.0,1180
2020-11-27,10284,12886,-2602,-20.19,1180
2020-11-28,7996,10091,-2095,-20.76,1180
2020-11-29,6472,8567,-2095,-24.45,1180
2020-11-30,10004,11970,-1966,-16.42,1180
2020-12-01,10133,12242,-2109,-17.23,1180
2020-12-02,10133,12205,-2072,-16.98,1180
2020-12-03,10133,12166,-2033,-16.71,1180
2020-12-04,10914,12577,-1663,-13.22,1180
2020-12-05,8017,9810,-1793,-18.28,1180
2020-12-06,6255,8316,-2061,-24.78,1180
2020-12-07,10160,11751,-1591,-13.54,1180
2020-12-08,10133,12057,-1924,-15.96,1180
2020-12-09,10133,12053,-1920,-15.93,1180
2020-12-10,10133,12047,-1914,-15.89,1180
2020-12-11,10914,12489,-1575,-12.61,1180
2020-12-12,8017,9748,-1731,-17.76,1180
2020-12-13,6255,8277,-2022,-24.43,1180
2020-12-14,10160,11732,-1572,-13.4,1180
2020-12-15,10133,12050,-1917,-15.91,1180
2020-12-16,10133,12055,-1922,-15.94,1180
2020-12-17,10133,12050,-1917,-15.91,1180
2020-12-18,10914,12488,-1574,-12.6,1180
2020-12-19,8017,9738,-1721,-17.67,1180
2020-12-20,6255,8251,-1996,-24.19,1180
2020-12-21,10160,11685,-1525,-13.05,1180
2020-12-22,10133,11979,-1846,-15.41,1180
2020-12-23,10133,11954,-1821,-15.23,1180
2020-12-24,10133,11918,-1785,-14.98,1180
2020-12-25,10914,12322,-1408,-11.43,1180
2020-12-26,8017,9538,-1521,-15.95,1180
2020-12-27,6255,8017,-1762,-21.98,1180
2020-12-28,10160,11417,-1257,-11.01,1180
2020-12-29,10133,11680,-1547,-13.24,1180
2020-12-30,10133,11627,-1494,-12.85,1180
2020-12-31,10133,11567,-1434,-12.4,1180
2021-01-01,9921,11951,-2030,-16.99,1180
2021-01-02,7238,9152,-1914,-20.91,1180
2021-01-03,5894,7622,-1728,-22.67,1180
2021-01-04,9006,11020,-2014,-18.28,1180
2021-01-05,9527,11286,-1759,-15.59,1180
2021-01-06,9527,11243,-1716,-15.26,1180
2021-01-07,9527,11199,-1672,-14.93,1180
2021-01-08,9921,11605,-1684,-14.51,1180
2021-01-09,7238,8833,-1595,-18.06,1180
2021-01-10,5894,7335,-1441,-19.65,1180
2021-01-11,9006,10768,-1762,-16.36,1180
2021-01-12,9527,11073,-1546,-13.96,1180
2021-01-13,9527,11070,-1543,-13.94,1180
2021-01-14,9527,11067,-1540,-13.92,1180
2021-01-15,9921,11514,-1593,-13.84,1180
2021-01-16,7238,8782,-1544,-17.58,1180
2021-01-17,5894,7323,-1429,-19.51,1180
2021-01-18,9006,10792,-1786,-16.55,1180
2021-01-19,9527,11129,-1602,-14.39,1180
2021-01-20,9527,11154,-1627,-14.59,1180
2021-01-21,9527,11174,-1647,-14.74,1180
2021-01-22,9921,11640,-1719,-14.77,1180
2021-01-23,7238,8921,-1683,-18.87,1180
2021-01-24,5894,7468,-1574,-21.08,1180
2021-01-25,9006,10939,-1933,-17.67,1180
2021-01-26,9527,11273,-1746,-15.49,1180
2021-01-27,9527,11290,-1763,-15.62,1180
2021-01-28,9527,11299,-1772,-15.68,1180
2021-01-29,9921,11748,-1827,-15.55,1180
2021-01-30,7238,9011,-1773,-19.68,1180
2021-01-31,5894,7538,-1644,-21.81,1180
2021-02-01,10260,10987,-727,-6.62,1180
2021-02-02,10697,11298,-601,-5.32,1180
2021-02-03,10697,11294,-597,-5.29,1180
2021-02-04,10697,11282,-585,-5.19,1180
2021-02-05,10866,11714,-848,-7.24,1180
2021-02-06,7974,8962,-988,-11.02,1180
2021-02-07,6686,7477,-791,-10.58,1180
2021-02-08,10260,10919,-659,-6.04,1180
2021-02-09,10697,11228,-531,-4.73,1180
2021-02-10,10697,11226,-529,-4.71,1180
2021-02-11,10697,11220,-523,-4.66,1180
2021-02-12,10866,11663,-797,-6.83,1180
2021-02-13,7974,8926,-952,-10.67,1180
2021-02-14,6686,7462,-776,-10.4,1180
2021-02-15,10260,10927,-667,-6.1,1180
2021-02-16,10697,11262,-565,-5.02,1180
2021-02-17,10697,11288,-591,-5.24,1180
2021-02-18,10697,11313,-616,-5.45,1180
2021-02-19,10866,11787,-921,-7.81,1180
2021-02-20,7974,9081,-1107,-12.19,1180
2021-02-21,6686,7646,-960,-12.56,1180
2021-02-22,10260,11140,-880,-7.9,1180
2021-02-23,10697,11501,-804,-6.99,1180
2021-02-24,10697,11550,-853,-7.39,1180
2021-02-25,10697,11593,-896,-7.73,1180
2021-02-26,10866,12082,-1216,-10.06,1180
2021-02-27,7974,9386,-1412,-15.04,1180
2021-02-28,6686,7957,-1271,-15.97,1180
2021-03-01,10659,11451,-792,-6.92,1180
2021-03-02,11287,11807,-520,-4.4,1180
2021-03-03,11287,11847,-560,-4.73,1180
2021-03-04,11287,11878,-591,-4.98,1180
2021-03-05,11487,12349,-862,-6.98,1180
2021-03-06,8867,9633,-766,-7.95,1180
2021-03-07,6771,8181,-1410,-17.24,1180
2021-03-08,10659,11650,-991,-8.51,1180
2021-03-09,11287,11980,-693,-5.78,1180
2021-03-10,11287,11994,-707,-5.89,1180
2021-03-11,11287,11998,-711,-5.93,1180
2021-03-12,11487,12445,-958,-7.7,1180
2021-03-13,8867,9706,-839,-8.64,1180
2021-03-14,6771,8233,-1462,-17.76,1180
2021-03-15,10659,11685,-1026,-8.78,1180
2021-03-16,11287,12001,-714,-5.95,1180
2021-03-17,11287,12005,-718,-5.98,1180
2021-03-18,11287,12004,-717,-5.97,1180
2021-03-19,11487,12449,-962,-7.73,1180
2021-03-20,8867,9713,-846,-8.71,1180
2021-03-21,6771,8247,-1476,-17.9,1180
2021-03-22,10659,11709,-1050,-8.97,1180
2021-03-23,11287,12039,-752,-6.25,1180
2021-03-24,11287,12059,-772,-6.4,1180
2021-03-25,11287,12077,-790,-6.54,1180
2021-03-26,11487,12542,-1055,-8.41,1180
2021-03-27,8867,9826,-959,-9.76,1180
2021-03-28,6771,8381,-1610,-19.21,1180
2021-03-29,10659,11864,-1205,-10.16,1180
2021-03-30,11287,12213,-926,-7.58,1180
2021-03-31,11287,12250,-963,-7.86,1180
2021-04-01,10513,12281,-1768,-14.4,1180
2021-04-02,11083,12758,-1675,-13.13,1180
2021-04-03,8387,10050,-1663,-16.55,1180
2021-04-04,7191,8609,-1418,-16.47,1180
2021-04-05,10470,12092,-1622,-13.41,1180
2021-04-06,10513,12438,-1925,-15.48,1180
2021-04-07,10513,12467,-1954,-15.67,1180
2021-04-08,10513,12488,-1975,-15.82,1180
2021-04-09,11083,12951,-1868,-14.42,1180
2021-04-10,8387,10226,-1839,-17.98,1180
2021-04-11,7191,8767,-1576,-17.98,1180
2021-04-12,10470,12229,-1759,-14.38,1180
2021-04-13,10513,12553,-2040,-16.25,1180
2021-04-14,10513,12561,-2048,-16.3,1180
2021-04-15,10513,12561,-2048,-16.3,1180
2021-04-16,11083,13003,-1920,-14.77,1180
2021-04-17,8387,10260,-1873,-18.26,1180
2021-04-18,7191,8784,-1593,-18.14,1180
2021-04-19,10470,12233,-1763,-14.41,1180
2021-04-20,10513,12547,-2034,-16.21,1180
2021-04-21,10513,12548,-2035,-16.22,1180
2021-04-22,10513,12545,-2032,-16.2,1180
2021-04-23,11083,12988,-1905,-14.67,1180
2021-04-24,8387,10249,-1862,-18.17,1180
2021-04-25,7191,8781,-1590,-18.11,1180
2021-04-26,10470,12240,-1770,-14.46,1180
2021-04-27,10513,12567,-2054,-16.34,1180
2021-04-28,10513,12584,-2071,-16.46,1180
2021-04-29,10513,12598,-2085,-16.55,1180
2021-04-30,11083,13059,-1976,-15.13,1180
2021-05-01,9522,10338,-816,-7.89,1180
2021-05-02,7476,8887,-1411,-15.88,1180
2021-05-03,12032,12363,-331,-2.68,1180
2021-05-04,12596,12705,-109,-0.86,1180
2021-05-05,12596,12734,-138,-1.08,1180
2021-05-06,12596,12757,-161,-1.26,1180
2021-05-07,12424,13223,-799,-6.04,1180
2021-05-08,9522,10505,-983,-9.36,1180
2021-05-09,7476,9052,-1576,-17.41,1180
2021-05-10,12032,12522,-490,-3.91,1180
2021-05-11,12596,12853,-257,-2.0,1180
2021-05-12,12596,12869,-273,-2.12,1180
2021-05-13,12596,12874,-278,-2.16,1180
2021-05-14,12424,13321,-897,-6.73,1180
2021-05-15,9522,10580,-1058,-10.0,1180
2021-05-16,7476,9103,-1627,-17.87,1180
2021-05-17,12032,12549,-517,-4.12,1180
2021-05-18,12596,12856,-260,-2.02,1180
2021-05-19,12596,12847,-251,-1.95,1180
2021-05-20,12596,12831,-235,-1.83,1180
2021-05-21,12424,13258,-834,-6.29,1180
2021-05-22,9522,10500,-978,-9.31,1180
2021-05-23,7476,9011,-1535,-17.03,1180
2021-05-24,12032,12448,-416,-3.34,1180
2021-05-25,12596,12753,-157,-1.23,1180
2021-05-26,12596,12746,-150,-1.18,1180
2021-05-27,12596,12737,-141,-1.11,1180
2021-05-28,12424,13176,-752,-5.71,1180
2021-05-29,9522,10436,-914,-8.76,1180
2021-05-30,7476,8969,-1493,-16.65,1180
2021-05-31,12032,12432,-400,-3.22,1180
2021-06-01,13141,12766,375,2.94,1180
2021-06-02,13141,12791,350,2.74,1180
2021-06-03,13141,12815,326,2.54,1180
2021-06-04,12813,13288,-475,-3.57,1180
2021-06-05,10212,10580,-368,-3.48,1180
2021-06-06,8600,9144,-544,-5.95,1180
2021-06-07,12634,12634,0,0.0,1180
2021-06-08,13141,12990,151,1.16,1180
2021-06-09,13141,13032,109,0.84,1180
2021-06-10,13141,13067,74,0.57,1180
2021-06-11,12813,13543,-730,-5.39,1180
2021-06-12,10212,10831,-619,-5.72,1180
2021-06-13,8600,9380,-780,-8.32,1180
2021-06-14,12634,12848,-214,-1.67,1180
2021-06-15,13141,13172,-31,-0.24,1180
2021-06-16,13141,13174,-33,-0.25,1180
2021-06-17,13141,13159,-18,-0.14,1180
2021-06-18,12813,13577,-764,-5.63,1180
2021-06-19,10212,10800,-588,-5.44,1180
2021-06-20,8600,9278,-678,-7.31,1180
2021-06-21,12634,12670,-36,-0.28,1180
2021-06-22,13141,12914,227,1.76,1180
2021-06-23,13141,12834,307,2.39,1180
2021-06-24,13141,12736,405,3.18,1180
2021-06-25,12813,13073,-260,-1.99,1180
2021-06-26,10212,10217,-5,-0.05,1180
2021-06-27,8600,8621,-21,-0.24,1180
2021-06-28,12634,11944,690,5.78,1180
2021-06-29,13141,12127,1014,8.36,1180
2021-06-30,13141,11994,1147,9.56,1180
2021-07-01,11548,11853,-305,-2.57,1180
2021-07-02,11728,12159,-431,-3.54,1180
2021-07-03,8890,9282,-392,-4.22,1180
2021-07-04,7449,7678,-229,-2.98,1180
2021-07-05,10887,11005,-118,-1.07,1180
2021-07-06,11548,11205,343,3.06,1180
2021-07-07,11548,11100,448,4.04,1180
2021-07-08,11548,10999,549,4.99,1180
2021-07-09,11728,11354,374,3.29,1180
2021-07-10,8890,8536,354,4.15,1180
2021-07-11,7449,6999,450,6.43,1180
2021-07-12,10887,10400,487,4.68,1180
2021-07-13,11548,10678,870,8.15,1180
2021-07-14,11548,10654,894,8.39,1180
2021-07-15,11548,10636,912,8.57,1180
2021-07-16,11728,11074,654,5.91,1180
2021-07-17,8890,8338,552,6.62,1180
2021-07-18,7449,6878,571,8.3,1180
2021-07-19,10887,10350,537,5.19,1180
2021-07-20,11548,10694,854,7.99,1180
2021-07-21,11548,10728,820,7.64,1180
2021-07-22,11548,10759,789,7.33,1180
2021-07-23,11728,11237,491,4.37,1180
2021-07-24,8890,8530,360,4.22,1180
2021-07-25,7449,7090,359,5.06,1180
2021-07-26,10887,10572,315,2.98,1180
2021-07-27,11548,10915,633,5.8,1180
2021-07-28,11548,10940,608,5.56,1180
2021-07-29,11548,10953,595,5.43,1180
2021-07-30,11728,11405,323,2.83,1180
2021-07-31,8890,8666,224,2.58,1180
2021-08-01,7274,7189,85,1.18,1180
2021-08-02,10432,10631,-199,-1.87,1180
2021-08-03,10836,10932,-96,-0.88,1180
2021-08-04,10836,10914,-78,-0.71,1180
2021-08-05,10836,10885,-49,-0.45,1180
2021-08-06,10931,11298,-367,-3.25,1180
2021-08-07,9002,8524,478,5.61,1180
2021-08-08,7274,7017,257,3.66,1180
2021-08-09,10432,10435,-3,-0.03,1180
2021-08-10,10836,10719,117,1.09,1180
2021-08-11,10836,10693,143,1.34,1180
2021-08-12,10836,10664,172,1.61,1180
2021-08-13,10931,11085,-154,-1.39,1180
2021-08-14,9002,8328,674,8.09,1180
2021-08-15,7274,6846,428,6.25,1180
2021-08-16,10432,10297,135,1.31,1180
2021-08-17,10836,10621,215,2.02,1180
2021-08-18,10836,10641,195,1.83,1180
2021-08-19,10836,10664,172,1.61,1180
2021-08-20,10931,11140,-209,-1.88,1180
2021-08-21,9002,8442,560,6.63,1180
2021-08-22,7274,7020,254,3.62,1180
2021-08-23,10432,10531,-99,-0.94,1180
2021-08-24,10836,10914,-78,-0.71,1180
2021-08-25,10836,10990,-154,-1.4,1180
2021-08-26,10836,11065,-229,-2.07,1180
2021-08-27,10931,11589,-658,-5.68,1180
2021-08-28,9002,8932,70,0.78,1180
2021-08-29,7274,7544,-270,-3.58,1180
2021-08-30,10432,11082,-650,-5.87,1180
2021-08-31,10836,11484,-648,-5.64,1180
2021-09-01,12479,11570,909,7.86,1180
2021-09-02,12479,11648,831,7.13,1180
2021-09-03,12758,12165,593,4.87,1180
2021-09-04,10150,9494,656,6.91,1180
2021-09-05,8762,8085,677,8.37,1180
2021-09-06,12001,11595,406,3.5,1180
2021-09-07,12479,11962,517,4.32,1180
2021-09-08,12479,12010,469,3.91,1180
2021-09-09,12479,12044,435,3.61,1180
2021-09-10,12758,12516,242,1.93,1180
2021-09-11,10150,9798,352,3.59,1180
2021-09-12,8762,8341,421,5.05,1180
2021-09-13,12001,11803,198,1.68,1180
2021-09-14,12479,12124,355,2.93,1180
2021-09-15,12479,12128,351,2.89,1180
2021-09-16,12479,12122,357,2.95,1180
2021-09-17,12758,12557,201,1.6,1180
2021-09-18,10150,9806,344,3.51,1180
2021-09-19,8762,8321,441,5.3,1180
2021-09-20,12001,11761,240,2.04,1180
2021-09-21,12479,12065,414,3.43,1180
2021-09-22,12479,12056,423,3.51,1180
2021-09-23,12479,12042,437,3.63,1180
2021-09-24,12758,12474,284,2.28,1180
2021-09-25,10150,9723,427,4.39,1180
2021-09-26,8762,8242,520,6.31,1180
2021-09-27,12001,11688,313,2.68,1180
2021-09-28,12479,12000,479,3.99,1180
2021-09-29,12479,12001,478,3.98,1180
2021-09-30,12479,11998,481,4.01,1180
2021-10-01,12968,12440,528,4.24,1180
2021-10-02,10174,9700,474,4.89,1180
2021-10-03,8459,8228,231,2.81,1180
2021-10-04,12025,11681,344,2.94,1180
2021-10-05,12387,12000,387,3.22,1180
2021-10-06,12387,12004,383,3.19,1180
2021-10-07,12387,12002,385,3.21,1180
2021-10-08,12968,12445,523,4.2,1180
2021-10-09,10174,9702,472,4.86,1180
2021-10-10,8459,8226,233,2.83,1180
2021-10-11,12025,11674,351,3.01,1180
2021-10-12,12387,11987,400,3.34,1180
2021-10-13,12387,11985,402,3.35,1180
2021-10-14,12387,11977,410,3.42,1180
2021-10-15,12968,12414,554,4.46,1180
2021-10-16,10174,9667,507,5.24,1180
2021-10-17,8459,8189,270,3.3,1180
2021-10-18,12025,11638,387,3.33,1180
2021-10-19,12387,11953,434,3.63,1180
2021-10-20,12387,11958,429,3.59,1180
2021-10-21,12387,11960,427,3.57,1180
2021-10-22,12968,12410,558,4.5,1180
2021-10-23,10174,9680,494,5.1,1180
2021-10-24,8459,8222,237,2.88,1180
2021-10-25,12025,11694,331,2.83,1180
2021-10-26,12387,12036,351,2.92,1180
2021-10-27,12387,12069,318,2.63,1180
2021-10-28,12387,12101,286,2.36,1180
2021-10-29,12968,12582,386,3.07,1180
2021-10-30,10174,9884,290,2.93,1180
2021-10-31,8459,8457,2,0.02,1180
2021-11-01,10816,11958,-1142,-9.55,1180
2021-11-02,11669,12328,-659,-5.35,1180
2021-11-03,11669,12385,-716,-5.78,1180
2021-11-04,11669,12437,-768,-6.18,1180
2021-11-05,12078,12933,-855,-6.61,1180
2021-11-06,9639,10245,-606,-5.92,1180
2021-11-07,7815,8822,-1007,-11.41,1180
2021-11-08,10816,12322,-1506,-12.22,1180
2021-11-09,11669,12682,-1013,-7.99,1180
2021-11-10,11669,12724,-1055,-8.29,1180
2021-11-11,11669,12755,-1086,-8.51,1180
2021-11-12,12078,13223,-1145,-8.66,1180
2021-11-13,9639,10501,-862,-8.21,1180
2021-11-14,7815,9040,-1225,-13.55,1180
2021-11-15,10816,12496,-1680,-13.44,1180
2021-11-16,11669,12809,-1140,-8.9,1180
2021-11-17,11669,12802,-1133,-8.85,1180
2021-11-18,11669,12780,-1111,-8.69,1180
2021-11-19,12078,13197,-1119,-8.48,1180
2021-11-20,9639,10423,-784,-7.52,1180
2021-11-21,7815,8911,-1096,-12.3,1180
2021-11-22,10816,12320,-1504,-12.21,1180
2021-11-23,11669,12589,-920,-7.31,1180
2021-11-24,11669,12541,-872,-6.95,1180
2021-11-25,11669,12486,-817,-6.54,1180
2021-11-26,12078,12874,-796,-6.18,1180
2021-11-27,9639,10078,-439,-4.36,1180
2021-11-28,7815,8551,-736,-8.61,1180
2021-11-29,10816,11950,-1134,-9.49,1180
2021-11-30,11669,12218,-549,-4.49,1180
2021-12-01,10871,12176,-1305,-10.72,1180
2021-12-02,10871,12131,-1260,-10.39,1180
2021-12-03,10746,12536,-1790,-14.28,1180
2021-12-04,8873,9763,-890,-9.12,1180
2021-12-05,6698,8262,-1564,-18.93,1180
2021-12-06,10758,11691,-933,-7.98,1180
2021-12-07,10871,11991,-1120,-9.34,1180
2021-12-08,10871,11982,-1111,-9.27,1180
2021-12-09,10871,11971,-1100,-9.19,1180
2021-12-10,10746,12409,-1663,-13.4,1180
2021-12-11,8873,9666,-793,-8.2,1180
2021-12-12,6698,8194,-1496,-18.26,1180
2021-12-13,10758,11648,-890,-7.64,1180
2021-12-14,10871,11967,-1096,-9.16,1180
2021-12-15,10871,11973,-1102,-9.2,1180
2021-12-16,10871,11971,-1100,-9.19,1180
2021-12-17,10746,12413,-1667,-13.43,1180
2021-12-18,8873,9667,-794,-8.21,1180
2021-12-19,6698,8186,-1488,-18.18,1180
2021-12-20,10758,11626,-868,-7.47,1180
2021-12-21,10871,11926,-1055,-8.85,1180
2021-12-22,10871,11908,-1037,-8.71,1180
2021-12-23,10871,11879,-1008,-8.49,1180
2021-12-24,10746,12289,-1543,-12.56,1180
2021-12-25,8873,9510,-637,-6.7,1180
2021-12-26,6698,7995,-1297,-16.22,1180
2021-12-27,10758,11400,-642,-5.63,1180
2021-12-28,10871,11666,-795,-6.81,1180
2021-12-29,10871,11616,-745,-6.41,1180
2021-12-30,10871,11558,-687,-5.94,1180
2021-12-31,10746,11943,-1197,-10.02,1180
2022-01-01,8536,9143,-607,-6.64,1180
2022-01-02,6589,7612,-1023,-13.44,1180
2022-01-03,10267,11007,-740,-6.72,1180
2022-01-04,10840,11269,-429,-3.81,1180
2022-01-05,10840,11221,-381,-3.4,1180
2022-01-06,10840,11171,-331,-2.96,1180
2022-01-07,11131,11571,-440,-3.8,1180
2022-01-08,8536,8792,-256,-2.91,1180
2022-01-09,6589,7286,-697,-9.57,1180
2022-01-10,10267,10711,-444,-4.15,1180
2022-01-11,10840,11008,-168,-1.53,1180
2022-01-12,10840,10998,-158,-1.44,1180
2022-01-13,10840,10988,-148,-1.35,1180
2022-01-14,11131,11428,-297,-2.6,1180
2022-01-15,8536,8690,-154,-1.77,1180
2022-01-16,6589,7225,-636,-8.8,1180
2022-01-17,10267,10690,-423,-3.96,1180
2022-01-18,10840,11023,-183,-1.66,1180
2022-01-19,10840,11046,-206,-1.86,1180
2022-01-20,10840,11065,-225,-2.03,1180
2022-01-21,11131,11530,-399,-3.46,1180
2022-01-22,8536,8812,-276,-3.13,1180
2022-01-23,6589,7361,-772,-10.49,1180
2022-01-24,10267,10834,-567,-5.23,1180
2022-01-25,10840,11171,-331,-2.96,1180
2022-01-26,10840,11192,-352,-3.15,1180
2022-01-27,10840,11204,-364,-3.25,1180
2022-01-28,11131,11658,-527,-4.52,1180
2022-01-29,8536,8925,-389,-4.36,1180
2022-01-30,6589,7456,-867,-11.63,1180
2020-02-01,10978,10458,520,4.97,1181
2020-02-02,8760,8316,444,5.34,1181
2020-02-03,12730,12708,22,0.17,1181
2020-02-04,13276,13085,191,1.46,1181
2020-02-05,13276,13085,191,1.46,1181
2020-02-06,13276,13073,203,1.55,1181
2020-02-07,13648,13627,21,0.15,1181
2020-02-08,10978,10459,519,4.96,1181
2020-02-09,8760,8306,454,5.47,1181
2020-02-10,12730,12693,37,0.29,1181
2020-02-11,13276,13068,208,1.59,1181
2020-02-12,13276,13072,204,1.56,1181
2020-02-13,13276,13068,208,1.59,1181
2020-02-14,13648,13634,14,0.1,1181
2020-02-15,10978,10483,495,4.72,1181
2020-02-16,8760,8352,408,4.89,1181
2020-02-17,12730,12763,-33,-0.26,1181
2020-02-18,13276,13167,109,0.83,1181
2020-02-19,13276,13201,75,0.57,1181
2020-02-20,13276,13229,47,0.36,1181
2020-02-21,13648,13828,-180,-1.3,1181
2020-02-22,10978,10710,268,2.5,1181
2020-02-23,8760,8611,149,1.73,1181
2020-02-24,12730,13053,-323,-2.47,1181
2020-02-25,13276,13484,-208,-1.54,1181
2020-02-26,13276,13543,-267,-1.97,1181
2020-02-27,13276,13592,-316,-2.32,1181
2020-02-28,13648,14208,-560,-3.94,1181
2020-02-29,10978,11102,-124,-1.12,1181
2020-03-01,6734,9010,-2276,-25.26,1181
2020-03-02,9743,13454,-3711,-27.58,1181
2020-03-03,10122,13882,-3760,-27.09,1181
2020-03-04,10122,13933,-3811,-27.35,1181
2020-03-05,10122,13970,-3848,-27.54,1181
2020-03-06,10965,14568,-3603,-24.73,1181
2020-03-07,7961,11441,-3480,-30.42,1181
2020-03-08,6734,9325,-2591,-27.79,1181
2020-03-09,9743,13743,-4000,-29.11,1181
2020-03-10,10122,14143,-4021,-28.43,1181
2020-03-11,10122,14165,-4043,-28.54,1181
2020-03-12,10122,14172,-4050,-28.58,1181
2020-03-13,10965,14742,-3777,-25.62,1181
2020-03-14,7961,11588,-3627,-31.3,1181
2020-03-15,6734,9448,-2714,-28.73,1181
2020-03-16,9743,13843,-4100,-29.62,1181
2020-03-17,10122,14225,-4103,-28.84,1181
2020-03-18,10122,14233,-4111,-28.88,1181
2020-03-19,10122,14230,-4108,-28.87,1181
2020-03-20,10965,14794,-3829,-25.88,1181
2020-03-21,7961,11640,-3679,-31.61,1181
2020-03-22,6734,9502,-2768,-29.13,1181
2020-03-23,9743,13905,-4162,-29.93,1181
2020-03-24,10122,14298,-4176,-29.21,1181
2020-03-25,10122,14321,-4199,-29.32,1181
2020-03-26,10122,14335,-4213,-29.39,1181
2020-03-27,10965,14919,-3954,-26.5,1181
2020-03-28,7961,11786,-3825,-32.45,1181
2020-03-29,6734,9671,-2937,-30.37,1181
2020-03-30,9743,14096,-4353,-30.88,1181
2020-03-31,10122,14511,-4389,-30.25,1181
2020-04-01,9730,14554,-4824,-33.15,1181
2020-04-02,9730,14586,-4856,-33.29,1181
2020-04-03,9802,15186,-5384,-35.45,1181
2020-04-04,8012,12065,-4053,-33.59,1181
2020-04-05,6007,9958,-3951,-39.68,1181
2020-04-06,9589,14389,-4800,-33.36,1181
2020-04-07,9730,14804,-5074,-34.27,1181
2020-04-08,9730,14843,-5113,-34.45,1181
2020-04-09,9730,14868,-5138,-34.56,1181
2020-04-10,9802,15456,-5654,-36.58,1181
2020-04-11,8012,12319,-4307,-34.96,1181
2020-04-12,6007,10194,-4187,-41.07,1181
2020-04-13,9589,14602,-5013,-34.33,1181
2020-04-14,9730,14993,-5263,-35.1,1181
2020-04-15,9730,15006,-5276,-35.16,1181
2020-04-16,9730,15005,-5275,-35.15,1181
2020-04-17,9802,15566,-5764,-37.03,1181
2020-04-18,8012,12403,-4391,-35.4,1181
2020-04-19,6007,10252,-4245,-41.41,1181
2020-04-20,9589,14637,-5048,-34.49,1181
2020-04-21,9730,15007,-5277,-35.16,1181
2020-04-22,9730,15001,-5271,-35.14,1181
2020-04-23,9730,14984,-5254,-35.06,1181
2020-04-24,9802,15533,-5731,-36.9,1181
2020-04-25,8012,12362,-4350,-35.19,1181
2020-04-26,6007,10206,-4199,-41.14,1181
2020-04-27,9589,14590,-5001,-34.28,1181
2020-04-28,9730,14962,-5232,-34.97,1181
2020-04-29,9730,14962,-5232,-34.97,1181
2020-04-30,9730,14953,-5223,-34.93,1181
2020-05-01,13802,15513,-1711,-11.03,1181
2020-05-02,11283,12354,-1071,-8.67,1181
2020-05-03,8735,10212,-1477,-14.46,1181
2020-05-04,12888,14611,-1723,-11.79,1181
2020-05-05,13354,14998,-1644,-10.96,1181
2020-05-06,13354,15012,-1658,-11.04,1181
2020-05-07,13354,15017,-1663,-11.07,1181
2020-05-08,13802,15588,-1786,-11.46,1181
2020-05-09,11283,12440,-1157,-9.3,1181
2020-05-10,8735,10306,-1571,-15.24,1181
2020-05-11,12888,14709,-1821,-12.38,1181
2020-05-12,13354,15098,-1744,-11.55,1181
2020-05-13,13354,15112,-1758,-11.63,1181
2020-05-14,13354,15113,-1759,-11.64,1181
2020-05-15,13802,15678,-1876,-11.97,1181
2020-05-16,11283,12521,-1238,-9.89,1181
2020-05-17,8735,10376,-1641,-15.82,1181
2020-05-18,12888,14766,-1878,-12.72,1181
2020-05-19,13354,15141,-1787,-11.8,1181
2020-05-20,13354,15140,-1786,-11.8,1181
2020-05-21,13354,15127,-1773,-11.72,1181
2020-05-22,13802,15677,-1875,-11.96,1181
2020-05-23,11283,12506,-1223,-9.78,1181
2020-05-24,8735,10348,-1613,-15.59,1181
2020-05-25,12888,14728,-1840,-12.49,1181
2020-05-26,13354,15096,-1742,-11.54,1181
2020-05-27,13354,15089,-1735,-11.5,1181
2020-05-28,13354,15073,-1719,-11.4,1181
2020-05-29,13802,15624,-1822,-11.66,1181
2020-05-30,11283,12457,-1174,-9.42,1181
2020-05-31,8735,10306,-1571,-15.24,1181
2020-06-01,14136,14696,-560,-3.81,1181
2020-06-02,14791,15076,-285,-1.89,1181
2020-06-03,14791,15084,-293,-1.94,1181
2020-06-04,14791,15083,-292,-1.94,1181
2020-06-05,14886,15651,-765,-4.89,1181
2020-06-06,12150,12501,-351,-2.81,1181
2020-06-07,9484,10367,-883,-8.52,1181
2020-06-08,14136,14772,-636,-4.31,1181
2020-06-09,14791,15165,-374,-2.47,1181
2020-06-10,14791,15184,-393,-2.59,1181
2020-06-11,14791,15191,-400,-2.63,1181
2020-06-12,14886,15763,-877,-5.56,1181
2020-06-13,12150,12611,-461,-3.66,1181
2020-06-14,9484,10472,-988,-9.43,1181
2020-06-15,14136,14866,-730,-4.91,1181
2020-06-16,14791,15243,-452,-2.97,1181
2020-06-17,14791,15241,-450,-2.95,1181
2020-06-18,14791,15221,-430,-2.83,1181
2020-06-19,14886,15762,-876,-5.56,1181
2020-06-20,12150,12575,-425,-3.38,1181
2020-06-21,9484,10396,-912,-8.77,1181
2020-06-22,14136,14748,-612,-4.15,1181
2020-06-23,14791,15080,-289,-1.92,1181
2020-06-24,14791,15031,-240,-1.6,1181
2020-06-25,14791,14965,-174,-1.16,1181
2020-06-26,14886,15460,-574,-3.71,1181
2020-06-27,12150,12229,-79,-0.65,1181
2020-06-28,9484,10009,-525,-5.25,1181
2020-06-29,14136,14323,-187,-1.31,1181
2020-06-30,14791,14622,169,1.16,1181
2020-07-01,14497,14546,-49,-0.34,1181
2020-07-02,14497,14459,38,0.26,1181
2020-07-03,14478,14938,-460,-3.08,1181
2020-07-04,11188,11700,-512,-4.38,1181
2020-07-05,9652,9479,173,1.83,1181
2020-07-06,13931,13800,131,0.95,1181
2020-07-07,14497,14114,383,2.71,1181
2020-07-08,14497,14059,438,3.12,1181
2020-07-09,14497,13999,498,3.56,1181
2020-07-10,14478,14513,-35,-0.24,1181
2020-07-11,11188,11313,-125,-1.1,1181
2020-07-12,9652,9135,517,5.66,1181
2020-07-13,13931,13503,428,3.17,1181
2020-07-14,14497,13865,632,4.56,1181
2020-07-15,14497,13859,638,4.6,1181
2020-07-16,14497,13849,648,4.68,1181
2020-07-17,14478,14410,68,0.47,1181
2020-07-18,11188,11256,-68,-0.6,1181
2020-07-19,9652,9120,532,5.83,1181
2020-07-20,13931,13526,405,2.99,1181
2020-07-21,14497,13920,577,4.15,1181
2020-07-22,14497,13941,556,3.99,1181
2020-07-23,14497,13951,546,3.91,1181
2020-07-24,14478,14526,-48,-0.33,1181
2020-07-25,11188,11378,-190,-1.67,1181
2020-07-26,9652,9243,409,4.42,1181
2020-07-27,13931,13641,290,2.13,1181
2020-07-28,14497,14023,474,3.38,1181
2020-07-29,14497,14025,472,3.37,1181
2020-07-30,14497,14012,485,3.46,1181
2020-07-31,14478,14560,-82,-0.56,1181
2020-08-01,11646,11382,264,2.32,1181
2020-08-02,9514,9214,300,3.26,1181
2020-08-03,13492,13580,-88,-0.65,1181
2020-08-04,13888,13929,-41,-0.29,1181
2020-08-05,13888,13901,-13,-0.09,1181
2020-08-06,13888,13859,29,0.21,1181
2020-08-07,14231,14382,-151,-1.05,1181
2020-08-08,11646,11183,463,4.14,1181
2020-08-09,9514,9000,514,5.71,1181
2020-08-10,13492,13356,136,1.02,1181
2020-08-11,13888,13702,186,1.36,1181
2020-08-12,13888,13677,211,1.54,1181
2020-08-13,13888,13646,242,1.77,1181
2020-08-14,14231,14186,45,0.32,1181
2020-08-15,11646,11011,635,5.77,1181
2020-08-16,9514,8857,657,7.42,1181
2020-08-17,13492,13248,244,1.84,1181
2020-08-18,13888,13634,254,1.86,1181
2020-08-19,13888,13652,236,1.73,1181
2020-08-20,13888,13667,221,1.62,1181
2020-08-21,14231,14255,-24,-0.17,1181
2020-08-22,11646,11129,517,4.65,1181
2020-08-23,9514,9024,490,5.43,1181
2020-08-24,13492,13461,31,0.23,1181
2020-08-25,13888,13891,-3,-0.02,1181
2020-08-26,13888,13950,-62,-0.44,1181
2020-08-27,13888,14000,-112,-0.8,1181
2020-08-28,14231,14618,-387,-2.65,1181
2020-08-29,11646,11516,130,1.13,1181
2020-08-30,9514,9428,86,0.91,1181
2020-08-31,13492,13877,-385,-2.77,1181
2020-09-01,14686,14310,376,2.63,1181
2020-09-02,14686,14366,320,2.23,1181
2020-09-03,14686,14407,279,1.94,1181
2020-09-04,15143,15009,134,0.89,1181
2020-09-05,12256,11885,371,3.12,1181
2020-09-06,10299,9771,528,5.4,1181
2020-09-07,13978,14188,-210,-1.48,1181
2020-09-08,14686,14587,99,0.68,1181
2020-09-09,14686,14606,80,0.55,1181
2020-09-10,14686,14608,78,0.53,1181
2020-09-11,15143,15171,-28,-0.18,1181
2020-09-12,12256,12009,247,2.06,1181
2020-09-13,10299,9858,441,4.47,1181
2020-09-14,13978,14241,-263,-1.85,1181
2020-09-15,14686,14609,77,0.53,1181
2020-09-16,14686,14601,85,0.58,1181
2020-09-17,14686,14581,105,0.72,1181
2020-09-18,15143,15127,16,0.11,1181
2020-09-19,12256,11952,304,2.54,1181
2020-09-20,10299,9794,505,5.16,1181
2020-09-21,13978,14175,-197,-1.39,1181
2020-09-22,14686,14546,140,0.96,1181
2020-09-23,14686,14545,141,0.97,1181
2020-09-24,14686,14536,150,1.03,1181
2020-09-25,15143,15097,46,0.3,1181
2020-09-26,12256,11941,315,2.64,1181
2020-09-27,10299,9802,497,5.07,1181
2020-09-28,13978,14205,-227,-1.6,1181
2020-09-29,14686,14597,89,0.61,1181
2020-09-30,14686,14617,69,0.47,1181
2020-10-01,14455,14628,-173,-1.18,1181
2020-10-02,14888,15207,-319,-2.1,1181
2020-10-03,11914,12065,-151,-1.25,1181
2020-10-04,9809,9939,-130,-1.31,1181
2020-10-05,13961,14349,-388,-2.7,1181
2020-10-06,14455,14745,-290,-1.97,1181
2020-10-07,14455,14766,-311,-2.11,1181
2020-10-08,14455,14773,-318,-2.15,1181
2020-10-09,14888,15343,-455,-2.97,1181
2020-10-10,11914,12189,-275,-2.26,1181
2020-10-11,9809,10047,-238,-2.37,1181
2020-10-12,13961,14438,-477,-3.3,1181
2020-10-13,14455,14813,-358,-2.42,1181
2020-10-14,14455,14811,-356,-2.4,1181
2020-10-15,14455,14793,-338,-2.28,1181
2020-10-16,14888,15339,-451,-2.94,1181
2020-10-17,11914,12160,-246,-2.02,1181
2020-10-18,9809,9995,-186,-1.86,1181
2020-10-19,13961,14365,-404,-2.81,1181
2020-10-20,14455,14721,-266,-1.81,1181
2020-10-21,14455,14702,-247,-1.68,1181
2020-10-22,14455,14672,-217,-1.48,1181
2020-10-23,14888,15209,-321,-2.11,1181
2020-10-24,11914,12027,-113,-0.94,1181
2020-10-25,9809,9861,-52,-0.53,1181
2020-10-26,13961,14235,-274,-1.92,1181
2020-10-27,14455,14599,-144,-0.99,1181
2020-10-28,14455,14592,-137,-0.94,1181
2020-10-29,14455,14577,-122,-0.84,1181
2020-10-30,14888,15132,-244,-1.61,1181
2020-10-31,11914,11969,-55,-0.46,1181
2020-11-01,7880,9824,-1944,-19.79,1181
2020-11-02,12153,14221,-2068,-14.54,1181
2020-11-03,11712,14606,-2894,-19.81,1181
2020-11-04,11712,14620,-2908,-19.89,1181
2020-11-05,11712,14625,-2913,-19.92,1181
2020-11-06,12607,15196,-2589,-17.04,1181
2020-11-07,9730,12047,-2317,-19.23,1181
2020-11-08,7880,9912,-2032,-20.5,1181
2020-11-09,12153,14314,-2161,-15.1,1181
2020-11-10,11712,14701,-2989,-20.33,1181
2020-11-11,11712,14711,-2999,-20.39,1181
2020-11-12,11712,14706,-2994,-20.36,1181
2020-11-13,12607,15264,-2657,-17.41,1181
2020-11-14,9730,12097,-2367,-19.57,1181
2020-11-15,7880,9939,-2059,-20.72,1181
2020-11-16,12153,14315,-2162,-15.1,1181
2020-11-17,11712,14672,-2960,-20.17,1181
2020-11-18,11712,14650,-2938,-20.05,1181
2020-11-19,11712,14612,-2900,-19.85,1181
2020-11-20,12607,15135,-2528,-16.7,1181
2020-11-21,9730,11933,-2203,-18.46,1181
2020-11-22,7880,9741,-1861,-19.1,1181
2020-11-23,12153,14084,-1931,-13.71,1181
2020-11-24,11712,14411,-2699,-18.73,1181
2020-11-25,11712,14362,-2650,-18.45,1181
2020-11-26,11712,14300,-2588,-18.1,1181
2020-11-27,12607,14804,-2197,-14.84,1181
2020-11-28,9730,11588,-1858,-16.03,1181
2020-11-29,7880,9388,-1508,-16.06,1181
2020-11-30,12153,13727,-1574,-11.47,1181
2020-12-01,11840,14056,-2216,-15.77,1181
2020-12-02,11840,14013,-2173,-15.51,1181
2020-12-03,11840,13964,-2124,-15.21,1181
2020-12-04,13127,14484,-1357,-9.37,1181
2020-12-05,9830,11288,-1458,-12.92,1181
2020-12-06,7494,9111,-1617,-17.75,1181
2020-12-07,11909,13476,-1567,-11.63,1181
2020-12-08,11840,13832,-1992,-14.4,1181
2020-12-09,11840,13817,-1977,-14.31,1181
2020-12-10,11840,13796,-1956,-14.18,1181
2020-12-11,13127,14343,-1216,-8.48,1181
2020-12-12,9830,11172,-1342,-12.01,1181
2020-12-13,7494,9017,-1523,-16.89,1181
2020-12-14,11909,13401,-1492,-11.13,1181
2020-12-15,11840,13771,-1931,-14.02,1181
2020-12-16,11840,13768,-1928,-14.0,1181
2020-12-17,11840,13751,-1911,-13.9,1181
2020-12-18,13127,14299,-1172,-8.2,1181
2020-12-19,9830,11122,-1292,-11.62,1181
2020-12-20,7494,8958,-1464,-16.34,1181
2020-12-21,11909,13327,-1418,-10.64,1181
2020-12-22,11840,13679,-1839,-13.44,1181
2020-12-23,11840,13652,-1812,-13.27,1181
2020-12-24,11840,13609,-1769,-13.0,1181
2020-12-25,13127,14128,-1001,-7.09,1181
2020-12-26,9830,10921,-1091,-9.99,1181
2020-12-27,7494,8726,-1232,-14.12,1181
2020-12-28,11909,13064,-1155,-8.84,1181
2020-12-29,11840,13386,-1546,-11.55,1181
2020-12-30,11840,13332,-1492,-11.19,1181
2020-12-31,11840,13264,-1424,-10.74,1181
2021-01-01,11540,13762,-2222,-16.15,1181
2021-01-02,8397,10539,-2142,-20.32,1181
2021-01-03,6829,8332,-1503,-18.04,1181
2021-01-04,10497,12664,-2167,-17.11,1181
2021-01-05,11019,12986,-1967,-15.15,1181
2021-01-06,11019,12937,-1918,-14.83,1181
2021-01-07,11019,12882,-1863,-14.46,1181
2021-01-08,11540,13397,-1857,-13.86,1181
2021-01-09,8397,10197,-1800,-17.65,1181
2021-01-10,6829,8017,-1188,-14.82,1181
2021-01-11,10497,12382,-1885,-15.22,1181
2021-01-12,11019,12740,-1721,-13.51,1181
2021-01-13,11019,12730,-1711,-13.44,1181
2021-01-14,11019,12715,-1696,-13.34,1181
2021-01-15,11540,13272,-1732,-13.05,1181
2021-01-16,8397,10114,-1717,-16.98,1181
2021-01-17,6829,7976,-1147,-14.38,1181
2021-01-18,10497,12380,-1883,-15.21,1181
2021-01-19,11019,12775,-1756,-13.75,1181
2021-01-20,11019,12799,-1780,-13.91,1181
2021-01-21,11019,12814,-1795,-14.01,1181
2021-01-22,11540,13396,-1856,-13.85,1181
2021-01-23,8397,10259,-1862,-18.15,1181
2021-01-24,6829,8136,-1307,-16.06,1181
2021-01-25,10497,12550,-2053,-16.36,1181
2021-01-26,11019,12950,-1931,-14.91,1181
2021-01-27,11019,12973,-1954,-15.06,1181
2021-01-28,11019,12983,-1964,-15.13,1181
2021-01-29,11540,13556,-2016,-14.87,1181
2021-01-30,8397,10406,-2009,-19.31,1181
2021-01-31,6829,8267,-1438,-17.39,1181
2021-02-01,12097,12663,-566,-4.47,1181
2021-02-02,12485,13043,-558,-4.28,1181
2021-02-03,12485,13046,-561,-4.3,1181
2021-02-04,12485,13036,-551,-4.23,1181
2021-02-05,13204,13591,-387,-2.85,1181
2021-02-06,9919,10423,-504,-4.84,1181
2021-02-07,8108,8270,-162,-1.96,1181
2021-02-08,12097,12655,-558,-4.41,1181
2021-02-09,12485,13029,-544,-4.18,1181
2021-02-10,12485,13029,-544,-4.18,1181
2021-02-11,12485,13022,-537,-4.12,1181
2021-02-12,13204,13583,-379,-2.79,1181
2021-02-13,9919,10427,-508,-4.87,1181
2021-02-14,8108,8290,-182,-2.2,1181
2021-02-15,12097,12695,-598,-4.71,1181
2021-02-16,12485,13093,-608,-4.64,1181
2021-02-17,12485,13121,-636,-4.85,1181
2021-02-18,12485,13143,-658,-5.01,1181
2021-02-19,13204,13735,-531,-3.87,1181
2021-02-20,9919,10612,-693,-6.53,1181
2021-02-21,8108,8508,-400,-4.7,1181
2021-02-22,12097,12946,-849,-6.56,1181
2021-02-23,12485,13374,-889,-6.65,1181
2021-02-24,12485,13431,-946,-7.04,1181
2021-02-25,12485,13479,-994,-7.37,1181
2021-02-26,13204,14094,-890,-6.31,1181
2021-02-27,9919,10989,-1070,-9.74,1181
2021-02-28,8108,8898,-790,-8.88,1181
2021-03-01,13151,13344,-193,-1.45,1181
2021-03-02,13763,13776,-13,-0.09,1181
2021-03-03,13763,13831,-68,-0.49,1181
2021-03-04,13763,13871,-108,-0.78,1181
2021-03-05,13999,14475,-476,-3.29,1181
2021-03-06,11185,11354,-169,-1.49,1181
2021-03-07,8466,9243,-777,-8.41,1181
2021-03-08,13151,13666,-515,-3.77,1181
2021-03-09,13763,14071,-308,-2.19,1181
2021-03-10,13763,14098,-335,-2.38,1181
2021-03-11,13763,14110,-347,-2.46,1181
2021-03-12,13999,14684,-685,-4.66,1181
2021-03-13,11185,11534,-349,-3.03,1181
2021-03-14,8466,9396,-930,-9.9,1181
2021-03-15,13151,13794,-643,-4.66,1181
2021-03-16,13763,14177,-414,-2.92,1181
2021-03-17,13763,14185,-422,-2.97,1181
2021-03-18,13763,14181,-418,-2.95,1181
2021-03-19,13999,14744,-745,-5.05,1181
2021-03-20,11185,11588,-403,-3.48,1181
2021-03-21,8466,9447,-981,-10.38,1181
2021-03-22,13151,13847,-696,-5.03,1181
2021-03-23,13763,14237,-474,-3.33,1181
2021-03-24,13763,14255,-492,-3.45,1181
2021-03-25,13763,14265,-502,-3.52,1181
2021-03-26,13999,14845,-846,-5.7,1181
2021-03-27,11185,11708,-523,-4.47,1181
2021-03-28,8466,9589,-1123,-11.71,1181
2021-03-29,13151,14010,-859,-6.13,1181
2021-03-30,13763,14422,-659,-4.57,1181
2021-03-31,13763,14462,-699,-4.83,1181
2021-04-01,12803,14493,-1690,-11.66,1181
2021-04-02,13708,15092,-1384,-9.17,1181
2021-04-03,10628,11971,-1343,-11.22,1181
2021-04-04,9027,9865,-838,-8.49,1181
2021-04-05,12884,14296,-1412,-9.88,1181
2021-04-06,12803,14714,-1911,-12.99,1181
2021-04-07,12803,14755,-1952,-13.23,1181
2021-04-08,12803,14784,-1981,-13.4,1181
2021-04-09,13708,15376,-1668,-10.85,1181
2021-04-10,10628,12244,-1616,-13.2,1181
2021-04-11,9027,10123,-1096,-10.83,1181
2021-04-12,12884,14536,-1652,-11.36,1181
2021-04-13,12803,14933,-2130,-14.26,1181
2021-04-14,12803,14951,-2148,-14.37,1181
2021-04-15,12803,14954,-2151,-14.38,1181
2021-04-16,13708,15520,-1812,-11.68,1181
2021-04-17,10628,12361,-1733,-14.02,1181
2021-04-18,9027,10214,-1187,-11.62,1181
2021-04-19,12884,14601,-1717,-11.76,1181
2021-04-20,12803,14973,-2170,-14.49,1181
2021-04-21,12803,14970,-2167,-14.48,1181
2021-04-22,12803,14954,-2151,-14.38,1181
2021-04-23,13708,15503,-1795,-11.58,1181
2021-04-24,10628,12331,-1703,-13.81,1181
2021-04-25,9027,10174,-1147,-11.27,1181
2021-04-26,12884,14556,-1672,-11.49,1181
2021-04-27,12803,14926,-2123,-14.22,1181
2021-04-28,12803,14924,-2121,-14.21,1181
2021-04-29,12803,14912,-2109,-14.14,1181
2021-04-30,13708,15469,-1761,-11.38,1181
2021-05-01,12217,12308,-91,-0.74,1181
2021-05-02,9438,10163,-725,-7.13,1181
2021-05-03,14403,14559,-156,-1.07,1181
2021-05-04,14936,14943,-7,-0.05,1181
2021-05-05,14936,14956,-20,-0.13,1181
2021-05-06,14936,14959,-23,-0.15,1181
2021-05-07,15502,15530,-28,-0.18,1181
2021-05-08,12217,12380,-163,-1.32,1181
2021-05-09,9438,10246,-808,-7.89,1181
2021-05-10,14403,14650,-247,-1.69,1181
2021-05-11,14936,15041,-105,-0.7,1181
2021-05-12,14936,15056,-120,-0.8,1181
2021-05-13,14936,15059,-123,-0.82,1181
2021-05-14,15502,15627,-125,-0.8,1181
2021-05-15,12217,12472,-255,-2.04,1181
2021-05-16,9438,10330,-892,-8.64,1181
2021-05-17,14403,14723,-320,-2.17,1181
2021-05-18,14936,15101,-165,-1.09,1181
2021-05-19,14936,15103,-167,-1.11,1181
2021-05-20,14936,15092,-156,-1.03,1181
2021-05-21,15502,15644,-142,-0.91,1181
2021-05-22,12217,12474,-257,-2.06,1181
2021-05-23,9438,10318,-880,-8.53,1181
2021-05-24,14403,14699,-296,-2.01,1181
2021-05-25,14936,15066,-130,-0.86,1181
2021-05-26,14936,15059,-123,-0.82,1181
2021-05-27,14936,15042,-106,-0.7,1181
2021-05-28,15502,15591,-89,-0.57,1181
2021-05-29,12217,12421,-204,-1.64,1181
2021-05-30,9438,10268,-830,-8.08,1181
2021-05-31,14403,14655,-252,-1.72,1181
2021-06-01,15498,15031,467,3.11,1181
2021-06-02,15498,15036,462,3.07,1181
2021-06-03,15498,15032,466,3.1,1181
2021-06-04,15518,15597,-79,-0.51,1181
2021-06-05,12813,12444,369,2.97,1181
2021-06-06,10860,10308,552,5.36,1181
2021-06-07,15030,14711,319,2.17,1181
2021-06-08,15498,15103,395,2.62,1181
2021-06-09,15498,15122,376,2.49,1181
2021-06-10,15498,15130,368,2.43,1181
2021-06-11,15518,15703,-185,-1.18,1181
2021-06-12,12813,12555,258,2.05,1181
2021-06-13,10860,10419,441,4.23,1181
2021-06-14,15030,14818,212,1.43,1181
2021-06-15,15498,15201,297,1.95,1181
2021-06-16,15498,15205,293,1.93,1181
2021-06-17,15498,15192,306,2.01,1181
2021-06-18,15518,15741,-223,-1.42,1181
2021-06-19,12813,12562,251,2.0,1181
2021-06-20,10860,10392,468,4.5,1181
2021-06-21,15030,14752,278,1.88,1181
2021-06-22,15498,15093,405,2.68,1181
2021-06-23,15498,15053,445,2.96,1181
2021-06-24,15498,14995,503,3.35,1181
2021-06-25,15518,15496,22,0.14,1181
2021-06-26,12813,12272,541,4.41,1181
2021-06-27,10860,10057,803,7.98,1181
2021-06-28,15030,14375,655,4.56,1181
2021-06-29,15498,14677,821,5.59,1181
2021-06-30,15498,14603,895,6.13,1181
2021-07-01,14450,14516,-66,-0.45,1181
2021-07-02,14652,14994,-342,-2.28,1181
2021-07-03,11620,11753,-133,-1.13,1181
2021-07-04,9558,9529,29,0.3,1181
2021-07-05,13940,13845,95,0.69,1181
2021-07-06,14450,14152,298,2.11,1181
2021-07-07,14450,14090,360,2.56,1181
2021-07-08,14450,14022,428,3.05,1181
2021-07-09,14652,14527,125,0.86,1181
2021-07-10,11620,11318,302,2.67,1181
2021-07-11,9558,9132,426,4.66,1181
2021-07-12,13940,13490,450,3.34,1181
2021-07-13,14450,13843,607,4.38,1181
2021-07-14,14450,13829,621,4.49,1181
2021-07-15,14450,13810,640,4.63,1181
2021-07-16,14652,14365,287,2.0,1181
2021-07-17,11620,11204,416,3.71,1181
2021-07-18,9558,9063,495,5.46,1181
2021-07-19,13940,13465,475,3.53,1181
2021-07-20,14450,13857,593,4.28,1181
2021-07-21,14450,13876,574,4.14,1181
2021-07-22,14450,13886,564,4.06,1181
2021-07-23,14652,14462,190,1.31,1181
2021-07-24,11620,11317,303,2.68,1181
2021-07-25,9558,9185,373,4.06,1181
2021-07-26,13940,13588,352,2.59,1181
2021-07-27,14450,13974,476,3.41,1181
2021-07-28,14450,13983,467,3.34,1181
2021-07-29,14450,13976,474,3.39,1181
2021-07-30,14652,14530,122,0.84,1181
2021-07-31,11620,11358,262,2.31,1181
2021-08-01,9150,9197,-47,-0.51,1181
2021-08-02,13192,13568,-376,-2.77,1181
2021-08-03,13597,13922,-325,-2.33,1181
2021-08-04,13597,13897,-300,-2.16,1181
2021-08-05,13597,13859,-262,-1.89,1181
2021-08-06,13792,14383,-591,-4.11,1181
2021-08-07,11601,11186,415,3.71,1181
2021-08-08,9150,9002,148,1.64,1181
2021-08-09,13192,13357,-165,-1.24,1181
2021-08-10,13597,13700,-103,-0.75,1181
2021-08-11,13597,13670,-73,-0.53,1181
2021-08-12,13597,13634,-37,-0.27,1181
2021-08-13,13792,14167,-375,-2.65,1181
2021-08-14,11601,10985,616,5.61,1181
2021-08-15,9150,8823,327,3.71,1181
2021-08-16,13192,13206,-14,-0.11,1181
2021-08-17,13597,13582,15,0.11,1181
2021-08-18,13597,13592,5,0.04,1181
2021-08-19,13597,13598,-1,-0.01,1181
2021-08-20,13792,14177,-385,-2.72,1181
2021-08-21,11601,11042,559,5.06,1181
2021-08-22,9150,8929,221,2.48,1181
2021-08-23,13192,13361,-169,-1.26,1181
2021-08-24,13597,13784,-187,-1.36,1181
2021-08-25,13597,13838,-241,-1.74,1181
2021-08-26,13597,13885,-288,-2.07,1181
2021-08-27,13792,14501,-709,-4.89,1181
2021-08-28,11601,11398,203,1.78,1181
2021-08-29,9150,9311,-161,-1.73,1181
2021-08-30,13192,13762,-570,-4.14,1181
2021-08-31,13597,14198,-601,-4.23,1181
2021-09-01,14741,14258,483,3.39,1181
2021-09-02,14741,14303,438,3.06,1181
2021-09-03,15245,14911,334,2.24,1181
2021-09-04,12650,11794,856,7.26,1181
2021-09-05,10944,9686,1258,12.99,1181
2021-09-06,14062,14111,-49,-0.35,1181
2021-09-07,14741,14517,224,1.54,1181
2021-09-08,14741,14543,198,1.36,1181
2021-09-09,14741,14552,189,1.3,1181
2021-09-10,15245,15122,123,0.81,1181
2021-09-11,12650,11966,684,5.72,1181
2021-09-12,10944,9819,1125,11.46,1181
2021-09-13,14062,14207,-145,-1.02,1181
2021-09-14,14741,14578,163,1.12,1181
2021-09-15,14741,14572,169,1.16,1181
2021-09-16,14741,14554,187,1.28,1181
2021-09-17,15245,15100,145,0.96,1181
2021-09-18,12650,11925,725,6.08,1181
2021-09-19,10944,9765,1179,12.07,1181
2021-09-20,14062,14144,-82,-0.58,1181
2021-09-21,14741,14512,229,1.58,1181
2021-09-22,14741,14508,233,1.61,1181
2021-09-23,14741,14496,245,1.69,1181
2021-09-24,15245,15052,193,1.28,1181
2021-09-25,12650,11892,758,6.37,1181
2021-09-26,10944,9749,1195,12.26,1181
2021-09-27,14062,14148,-86,-0.61,1181
2021-09-28,14741,14536,205,1.41,1181
2021-09-29,14741,14554,187,1.28,1181
2021-09-30,14741,14562,179,1.23,1181
2021-10-01,15324,15139,185,1.22,1181
2021-10-02,12400,11997,403,3.36,1181
2021-10-03,10266,9870,396,4.01,1181
2021-10-04,14068,14281,-213,-1.49,1181
2021-10-05,14666,14679,-13,-0.09,1181
2021-10-06,14666,14702,-36,-0.24,1181
2021-10-07,14666,14712,-46,-0.31,1181
2021-10-08,15324,15285,39,0.26,1181
2021-10-09,12400,12136,264,2.18,1181
2021-10-10,10266,9997,269,2.69,1181
2021-10-11,14068,14394,-326,-2.26,1181
2021-10-12,14666,14773,-107,-0.72,1181
2021-10-13,14666,14775,-109,-0.74,1181
2021-10-14,14666,14762,-96,-0.65,1181
2021-10-15,15324,15312,12,0.08,1181
2021-10-16,12400,12137,263,2.17,1181
2021-10-17,10266,9975,291,2.92,1181
2021-10-18,14068,14347,-279,-1.94,1181
2021-10-19,14666,14705,-39,-0.27,1181
2021-10-20,14666,14687,-21,-0.14,1181
2021-10-21,14666,14657,9,0.06,1181
2021-10-22,15324,15194,130,0.86,1181
2021-10-23,12400,12010,390,3.25,1181
2021-10-24,10266,9842,424,4.31,1181
2021-10-25,14068,14213,-145,-1.02,1181
2021-10-26,14666,14574,92,0.63,1181
2021-10-27,14666,14563,103,0.71,1181
2021-10-28,14666,14544,122,0.84,1181
2021-10-29,15324,15094,230,1.52,1181
2021-10-30,12400,11928,472,3.96,1181
2021-10-31,10266,9779,487,4.98,1181
2021-11-01,12666,14171,-1505,-10.62,1181
2021-11-02,13721,14554,-833,-5.72,1181
2021-11-03,13721,14565,-844,-5.79,1181
2021-11-04,13721,14567,-846,-5.81,1181
2021-11-05,14210,15137,-927,-6.12,1181
2021-11-06,11514,11988,-474,-3.95,1181
2021-11-07,9297,9854,-557,-5.65,1181
2021-11-08,12666,14257,-1591,-11.16,1181
2021-11-09,13721,14646,-925,-6.32,1181
2021-11-10,13721,14659,-938,-6.4,1181
2021-11-11,13721,14659,-938,-6.4,1181
2021-11-12,14210,15222,-1012,-6.65,1181
2021-11-13,11514,12060,-546,-4.53,1181
2021-11-14,9297,9908,-611,-6.17,1181
2021-11-15,12666,14290,-1624,-11.36,1181
2021-11-16,13721,14654,-933,-6.37,1181
2021-11-17,13721,14639,-918,-6.27,1181
2021-11-18,13721,14607,-886,-6.07,1181
2021-11-19,14210,15136,-926,-6.12,1181
2021-11-20,11514,11939,-425,-3.56,1181
2021-11-21,9297,9753,-456,-4.68,1181
2021-11-22,12666,14100,-1434,-10.17,1181
2021-11-23,13721,14431,-710,-4.92,1181
2021-11-24,13721,14384,-663,-4.61,1181
2021-11-25,13721,14325,-604,-4.22,1181
2021-11-26,14210,14830,-620,-4.18,1181
2021-11-27,11514,11613,-99,-0.85,1181
2021-11-28,9297,9411,-114,-1.21,1181
2021-11-29,12666,13749,-1083,-7.88,1181
2021-11-30,13721,14074,-353,-2.51,1181
2021-12-01,12730,14028,-1298,-9.25,1181
2021-12-02,12730,13974,-1244,-8.9,1181
2021-12-03,12338,14490,-2152,-14.85,1181
2021-12-04,10329,11288,-959,-8.5,1181
2021-12-05,8183,9106,-923,-10.14,1181
2021-12-06,12538,13466,-928,-6.89,1181
2021-12-07,12730,13816,-1086,-7.86,1181
2021-12-08,12730,13797,-1067,-7.73,1181
2021-12-09,12730,13771,-1041,-7.56,1181
2021-12-10,12338,14315,-1977,-13.81,1181
2021-12-11,10329,11141,-812,-7.29,1181
2021-12-12,8183,8984,-801,-8.92,1181
2021-12-13,12538,13366,-828,-6.19,1181
2021-12-14,12730,13737,-1007,-7.33,1181
2021-12-15,12730,13734,-1004,-7.31,1181
2021-12-16,12730,13719,-989,-7.21,1181
2021-12-17,12338,14269,-1931,-13.53,1181
2021-12-18,10329,11097,-768,-6.92,1181
2021-12-19,8183,8936,-753,-8.43,1181
2021-12-20,12538,13310,-772,-5.8,1181
2021-12-21,12730,13667,-937,-6.86,1181
2021-12-22,12730,13646,-916,-6.71,1181
2021-12-23,12730,13609,-879,-6.46,1181
2021-12-24,12338,14134,-1796,-12.71,1181
2021-12-25,10329,10933,-604,-5.52,1181
2021-12-26,8183,8743,-560,-6.41,1181
2021-12-27,12538,13086,-548,-4.19,1181
2021-12-28,12730,13412,-682,-5.08,1181
2021-12-29,12730,13361,-631,-4.72,1181
2021-12-30,12730,13296,-566,-4.26,1181
2021-12-31,12338,13795,-1457,-10.56,1181
2022-01-01,9806,10573,-767,-7.25,1181
2022-01-02,7521,8364,-843,-10.08,1181
2022-01-03,11652,12695,-1043,-8.22,1181
2022-01-04,12454,13014,-560,-4.3,1181
2022-01-05,12454,12961,-507,-3.91,1181
2022-01-06,12454,12900,-446,-3.46,1181
2022-01-07,12685,13409,-724,-5.4,1181
2022-01-08,9806,10202,-396,-3.88,1181
2022-01-09,7521,8016,-495,-6.18,1181
2022-01-10,11652,12373,-721,-5.83,1181
2022-01-11,12454,12723,-269,-2.11,1181
2022-01-12,12454,12705,-251,-1.98,1181
2022-01-13,12454,12682,-228,-1.8,1181
2022-01-14,12685,13232,-547,-4.13,1181
2022-01-15,9806,10067,-261,-2.59,1181
2022-01-16,7521,7923,-402,-5.07,1181
2022-01-17,11652,12321,-669,-5.43,1181
2022-01-18,12454,12711,-257,-2.02,1181
2022-01-19,12454,12731,-277,-2.18,1181
2022-01-20,12454,12743,-289,-2.27,1181
2022-01-21,12685,13324,-639,-4.8,1181
2022-01-22,9806,10185,-379,-3.72,1181
2022-01-23,7521,8063,-542,-6.72,1181
2022-01-24,11652,12478,-826,-6.62,1181
2022-01-25,12454,12879,-425,-3.3,1181
2022-01-26,12454,12905,-451,-3.49,1181
2022-01-27,12454,12918,-464,-3.59,1181
2022-01-28,12685,13495,-810,-6.0,1181
2022-01-29,9806,10348,-542,-5.24,1181
2022-01-30,7521,8213,-692,-8.43,1181
2020-02-01,18416,16722,1694,10.13,1187
2020-02-02,10412,8367,2045,24.44,1187
2020-02-03,20509,20227,282,1.39,1187
2020-02-04,20651,20511,140,0.68,1187
2020-02-05,20651,20536,115,0.56,1187
2020-02-06,20651,20571,80,0.39,1187
2020-02-07,21414,21102,312,1.48,1187
2020-02-08,18416,16923,1493,8.82,1187
2020-02-09,10412,8538,1874,21.95,1187
2020-02-10,20509,20373,136,0.67,1187
2020-02-11,20651,20635,16,0.08,1187
2020-02-12,20651,20645,6,0.03,1187
2020-02-13,20651,20671,-20,-0.1,1187
2020-02-14,21414,21200,214,1.01,1187
2020-02-15,18416,17024,1392,8.18,1187
2020-02-16,10412,8648,1764,20.4,1187
2020-02-17,20509,20497,12,0.06,1187
2020-02-18,20651,20779,-128,-0.62,1187
2020-02-19,20651,20812,-161,-0.77,1187
2020-02-20,20651,20864,-213,-1.02,1187
2020-02-21,21414,21421,-7,-0.03,1187
2020-02-22,18416,17274,1142,6.61,1187
2020-02-23,10412,8928,1484,16.62,1187
2020-02-24,20509,20805,-296,-1.42,1187
2020-02-25,20651,21113,-462,-2.19,1187
2020-02-26,20651,21170,-519,-2.45,1187
2020-02-27,20651,21241,-590,-2.78,1187
2020-02-28,21414,21813,-399,-1.83,1187
2020-02-29,18416,17676,740,4.19,1187
2020-03-01,6943,9334,-2391,-25.62,1187
2020-03-02,14838,21210,-6372,-30.04,1187
2020-03-03,14881,21511,-6630,-30.82,1187
2020-03-04,14881,21556,-6675,-30.97,1187
2020-03-05,14881,21610,-6729,-31.14,1187
2020-03-06,16046,22161,-6115,-27.59,1187
2020-03-07,11500,17999,-6499,-36.11,1187
2020-03-08,6943,9629,-2686,-27.89,1187
2020-03-09,14838,21475,-6637,-30.91,1187
2020-03-10,14881,21745,-6864,-31.57,1187
2020-03-11,14881,21758,-6877,-31.61,1187
2020-03-12,14881,21782,-6901,-31.68,1187
2020-03-13,16046,22304,-6258,-28.06,1187
2020-03-14,11500,18115,-6615,-36.52,1187
2020-03-15,6943,9723,-2780,-28.59,1187
2020-03-16,14838,21551,-6713,-31.15,1187
2020-03-17,14881,21808,-6927,-31.76,1187
2020-03-18,14881,21813,-6932,-31.78,1187
2020-03-19,14881,21834,-6953,-31.84,1187
2020-03-20,16046,22359,-6313,-28.23,1187
2020-03-21,11500,18180,-6680,-36.74,1187
2020-03-22,6943,9802,-2859,-29.17,1187
2020-03-23,14838,21649,-6811,-31.46,1187
2020-03-24,14881,21929,-7048,-32.14,1187
2020-03-25,14881,21961,-7080,-32.24,1187
2020-03-26,14881,22012,-7131,-32.4,1187
2020-03-27,16046,22568,-6522,-28.9,1187
2020-03-28,11500,18421,-6921,-37.57,1187
2020-03-29,6943,10075,-3132,-31.09,1187
2020-03-30,14838,21953,-7115,-32.41,1187
2020-03-31,14881,22262,-7381,-33.16,1187
2020-04-01,14040,22320,-8280,-37.1,1187
2020-04-02,14040,22393,-8353,-37.3,1187
2020-04-03,13025,22967,-9942,-43.29,1187
2020-04-04,9327,18832,-9505,-50.47,1187
2020-04-05,5085,10492,-5407,-51.53,1187
2020-04-06,14233,22370,-8137,-36.37,1187
2020-04-07,14040,22673,-8633,-38.08,1187
2020-04-08,14040,22719,-8679,-38.2,1187
2020-04-09,14040,22773,-8733,-38.35,1187
2020-04-10,13025,23323,-10298,-44.15,1187
2020-04-11,9327,19159,-9832,-51.32,1187
2020-04-12,5085,10787,-5702,-52.86,1187
2020-04-13,14233,22628,-8395,-37.1,1187
2020-04-14,14040,22892,-8852,-38.67,1187
2020-04-15,14040,22897,-8857,-38.68,1187
2020-04-16,14040,22910,-8870,-38.72,1187
2020-04-17,13025,23419,-10394,-44.38,1187
2020-04-18,9327,19215,-9888,-51.46,1187
2020-04-19,5085,10805,-5720,-52.94,1187
2020-04-20,14233,22612,-8379,-37.06,1187
2020-04-21,14040,22845,-8805,-38.54,1187
2020-04-22,14040,22823,-8783,-38.48,1187
2020-04-23,14040,22815,-8775,-38.46,1187
2020-04-24,13025,23308,-10283,-44.12,1187
2020-04-25,9327,19093,-9766,-51.15,1187
2020-04-26,5085,10677,-5592,-52.37,1187
2020-04-27,14233,22484,-8251,-36.7,1187
2020-04-28,14040,22722,-8682,-38.21,1187
2020-04-29,14040,22709,-8669,-38.17,1187
2020-04-30,14040,22714,-8674,-38.19,1187
2020-05-01,21731,23224,-1493,-6.43,1187
2020-05-02,17833,19028,-1195,-6.28,1187
2020-05-03,8142,10633,-2491,-23.43,1187
2020-05-04,21106,22461,-1355,-6.03,1187
2020-05-05,20944,22720,-1776,-7.82,1187
2020-05-06,20944,22728,-1784,-7.85,1187
2020-05-07,20944,22752,-1808,-7.95,1187
2020-05-08,21731,23278,-1547,-6.65,1187
2020-05-09,17833,19096,-1263,-6.61,1187
2020-05-10,8142,10710,-2568,-23.98,1187
2020-05-11,21106,22545,-1439,-6.38,1187
2020-05-12,20944,22807,-1863,-8.17,1187
2020-05-13,20944,22813,-1869,-8.19,1187
2020-05-14,20944,22831,-1887,-8.27,1187
2020-05-15,21731,23348,-1617,-6.93,1187
2020-05-16,17833,19153,-1320,-6.89,1187
2020-05-17,8142,10753,-2611,-24.28,1187
2020-05-18,21106,22569,-1463,-6.48,1187
2020-05-19,20944,22812,-1868,-8.19,1187
2020-05-20,20944,22798,-1854,-8.13,1187
2020-05-21,20944,22797,-1853,-8.13,1187
2020-05-22,21731,23294,-1563,-6.71,1187
2020-05-23,17833,19081,-1248,-6.54,1187
2020-05-24,8142,10665,-2523,-23.66,1187
2020-05-25,21106,22469,-1363,-6.07,1187
2020-05-26,20944,22702,-1758,-7.74,1187
2020-05-27,20944,22683,-1739,-7.67,1187
2020-05-28,20944,22680,-1736,-7.65,1187
2020-05-29,21731,23180,-1449,-6.25,1187
2020-05-30,17833,18974,-1141,-6.01,1187
2020-05-31,8142,10569,-2427,-22.96,1187
2020-06-01,21671,22387,-716,-3.2,1187
2020-06-02,21655,22638,-983,-4.34,1187
2020-06-03,21655,22639,-984,-4.35,1187
2020-06-04,21655,22658,-1003,-4.43,1187
2020-06-05,21884,23181,-1297,-5.6,1187
2020-06-06,17507,18998,-1491,-7.85,1187
2020-06-07,9291,10615,-1324,-12.47,1187
2020-06-08,21671,22453,-782,-3.48,1187
2020-06-09,21655,22721,-1066,-4.69,1187
2020-06-10,21655,22736,-1081,-4.75,1187
2020-06-11,21655,22763,-1108,-4.87,1187
2020-06-12,21884,23289,-1405,-6.03,1187
2020-06-13,17507,19104,-1597,-8.36,1187
2020-06-14,9291,10712,-1421,-13.27,1187
2020-06-15,21671,22535,-864,-3.83,1187
2020-06-16,21655,22781,-1126,-4.94,1187
2020-06-17,21655,22767,-1112,-4.88,1187
2020-06-18,21655,22760,-1105,-4.86,1187
2020-06-19,21884,23245,-1361,-5.86,1187
2020-06-20,17507,19014,-1507,-7.93,1187
2020-06-21,9291,10572,-1281,-12.12,1187
2020-06-22,21671,22343,-672,-3.01,1187
2020-06-23,21655,22533,-878,-3.9,1187
2020-06-24,21655,22463,-808,-3.6,1187
2020-06-25,21655,22400,-745,-3.33,1187
2020-06-26,21884,22832,-948,-4.15,1187
2020-06-27,17507,18551,-1044,-5.63,1187
2020-06-28,9291,10063,-772,-7.67,1187
2020-06-29,21671,21792,-121,-0.56,1187
2020-06-30,21655,21948,-293,-1.33,1187
2020-07-01,21642,21851,-209,-0.96,1187
2020-07-02,21642,21769,-127,-0.58,1187
2020-07-03,21728,22191,-463,-2.09,1187
2020-07-04,17708,17908,-200,-1.12,1187
2020-07-05,10310,9426,884,9.38,1187
2020-07-06,21578,21172,406,1.92,1187
2020-07-07,21642,21352,290,1.36,1187
2020-07-08,21642,21287,355,1.67,1187
2020-07-09,21642,21243,399,1.88,1187
2020-07-10,21728,21709,19,0.09,1187
2020-07-11,17708,17475,233,1.33,1187
2020-07-12,10310,9045,1265,13.99,1187
2020-07-13,21578,20844,734,3.52,1187
2020-07-14,21642,21078,564,2.68,1187
2020-07-15,21642,21065,577,2.74,1187
2020-07-16,21642,21072,570,2.71,1187
2020-07-17,21728,21583,145,0.67,1187
2020-07-18,17708,17388,320,1.84,1187
2020-07-19,10310,8992,1318,14.66,1187
2020-07-20,21578,20817,761,3.66,1187
2020-07-21,21642,21068,574,2.72,1187
2020-07-22,21642,21064,578,2.74,1187
2020-07-23,21642,21070,572,2.71,1187
2020-07-24,21728,21571,157,0.73,1187
2020-07-25,17708,17358,350,2.02,1187
2020-07-26,10310,8934,1376,15.4,1187
2020-07-27,21578,20724,854,4.12,1187
2020-07-28,21642,20934,708,3.38,1187
2020-07-29,21642,20883,759,3.63,1187
2020-07-30,21642,20838,804,3.86,1187
2020-07-31,21728,21286,442,2.08,1187
2020-08-01,16536,17018,-482,-2.83,1187
2020-08-02,9956,8542,1414,16.55,1187
2020-08-03,21547,20282,1265,6.24,1187
2020-08-04,20965,20446,519,2.54,1187
2020-08-05,20965,20355,610,3.0,1187
2020-08-06,20965,20277,688,3.39,1187
2020-08-07,21047,20702,345,1.67,1187
2020-08-08,16536,16421,115,0.7,1187
2020-08-09,9956,7942,2014,25.36,1187
2020-08-10,21547,19690,1857,9.43,1187
2020-08-11,20965,19875,1090,5.48,1187
2020-08-12,20965,19817,1148,5.79,1187
2020-08-13,20965,19784,1181,5.97,1187
2020-08-14,21047,20264,783,3.86,1187
2020-08-15,16536,16050,486,3.03,1187
2020-08-16,9956,7646,2310,30.21,1187
2020-08-17,21547,19478,2069,10.62,1187
2020-08-18,20965,19753,1212,6.14,1187
2020-08-19,20965,19790,1175,5.94,1187
2020-08-20,20965,19855,1110,5.59,1187
2020-08-21,21047,20435,612,2.99,1187
2020-08-22,16536,16319,217,1.33,1187
2020-08-23,9956,8012,1944,24.26,1187
2020-08-24,21547,19935,1612,8.09,1187
2020-08-25,20965,20295,670,3.3,1187
2020-08-26,20965,20409,556,2.72,1187
2020-08-27,20965,20542,423,2.06,1187
2020-08-28,21047,21179,-132,-0.62,1187
2020-08-29,16536,17109,-573,-3.35,1187
2020-08-30,9956,8836,1120,12.68,1187
2020-08-31,21547,20781,766,3.69,1187
2020-09-01,21412,21150,262,1.24,1187
2020-09-02,21412,21261,151,0.71,1187
2020-09-03,21412,21378,34,0.16,1187
2020-09-04,21831,21988,-157,-0.71,1187
2020-09-05,18536,17881,655,3.66,1187
2020-09-06,10482,9562,920,9.62,1187
2020-09-07,21108,21453,-345,-1.61,1187
2020-09-08,21412,21762,-350,-1.61,1187
2020-09-09,21412,21807,-395,-1.81,1187
2020-09-10,21412,21857,-445,-2.04,1187
2020-09-11,21831,22398,-567,-2.53,1187
2020-09-12,18536,18222,314,1.72,1187
2020-09-13,10482,9836,646,6.57,1187
2020-09-14,21108,21663,-555,-2.56,1187
2020-09-15,21412,21913,-501,-2.29,1187
2020-09-16,21412,21905,-493,-2.25,1187
2020-09-17,21412,21908,-496,-2.26,1187
2020-09-18,21831,22410,-579,-2.58,1187
2020-09-19,18536,18203,333,1.83,1187
2020-09-20,10482,9794,688,7.02,1187
2020-09-21,21108,21606,-498,-2.3,1187
2020-09-22,21412,21849,-437,-2.0,1187
2020-09-23,21412,21842,-430,-1.97,1187
2020-09-24,21412,21852,-440,-2.01,1187
2020-09-25,21831,22368,-537,-2.4,1187
2020-09-26,18536,18179,357,1.96,1187
2020-09-27,10482,9792,690,7.05,1187
2020-09-28,21108,21629,-521,-2.41,1187
2020-09-29,21412,21899,-487,-2.22,1187
2020-09-30,21412,21920,-508,-2.32,1187
2020-10-01,21381,21957,-576,-2.62,1187
2020-10-02,22181,22497,-316,-1.4,1187
2020-10-03,18393,18331,62,0.34,1187
2020-10-04,9616,9963,-347,-3.48,1187
2020-10-05,21042,21815,-773,-3.54,1187
2020-10-06,21381,22095,-714,-3.23,1187
2020-10-07,21381,22120,-739,-3.34,1187
2020-10-08,21381,22157,-776,-3.5,1187
2020-10-09,22181,22692,-511,-2.25,1187
2020-10-10,18393,18515,-122,-0.66,1187
2020-10-11,9616,10131,-515,-5.08,1187
2020-10-12,21042,21964,-922,-4.2,1187
2020-10-13,21381,22221,-840,-3.78,1187
2020-10-14,21381,22221,-840,-3.78,1187
2020-10-15,21381,22230,-849,-3.82,1187
2020-10-16,22181,22736,-555,-2.44,1187
2020-10-17,18393,18531,-138,-0.74,1187
2020-10-18,9616,10120,-504,-4.98,1187
2020-10-19,21042,21927,-885,-4.04,1187
2020-10-20,21381,22161,-780,-3.52,1187
2020-10-21,21381,22140,-759,-3.43,1187
2020-10-22,21381,22133,-752,-3.4,1187
2020-10-23,22181,22627,-446,-1.97,1187
2020-10-24,18393,18414,-21,-0.11,1187
2020-10-25,9616,10000,-384,-3.84,1187
2020-10-26,21042,21809,-767,-3.52,1187
2020-10-27,21381,22048,-667,-3.03,1187
2020-10-28,21381,22038,-657,-2.98,1187
2020-10-29,21381,22044,-663,-3.01,1187
2020-10-30,22181,22555,-374,-1.66,1187
2020-10-31,18393,18361,32,0.17,1187
2020-11-01,7271,9967,-2696,-27.05,1187
2020-11-02,19262,21797,-2535,-11.63,1187
2020-11-03,17006,22057,-5051,-22.9,1187
2020-11-04,17006,22066,-5060,-22.93,1187
2020-11-05,17006,22091,-5085,-23.02,1187
2020-11-06,17721,22617,-4896,-21.65,1187
2020-11-07,13790,18435,-4645,-25.2,1187
2020-11-08,7271,10049,-2778,-27.64,1187
2020-11-09,19262,21883,-2621,-11.98,1187
2020-11-10,17006,22143,-5137,-23.2,1187
2020-11-11,17006,22148,-5142,-23.22,1187
2020-11-12,17006,22164,-5158,-23.27,1187
2020-11-13,17721,22677,-4956,-21.85,1187
2020-11-14,13790,18479,-4689,-25.37,1187
2020-11-15,7271,10074,-2803,-27.82,1187
2020-11-16,19262,21886,-2624,-11.99,1187
2020-11-17,17006,22122,-5116,-23.13,1187
2020-11-18,17006,22102,-5096,-23.06,1187
2020-11-19,17006,22093,-5087,-23.03,1187
2020-11-20,17721,22582,-4861,-21.53,1187
2020-11-21,13790,18362,-4572,-24.9,1187
2020-11-22,7271,9937,-2666,-26.83,1187
2020-11-23,19262,21733,-2471,-11.37,1187
2020-11-24,17006,21958,-4952,-22.55,1187
2020-11-25,17006,21931,-4925,-22.46,1187
2020-11-26,17006,21920,-4914,-22.42,1187
2020-11-27,17721,22413,-4692,-20.93,1187
2020-11-28,13790,18201,-4411,-24.23,1187
2020-11-29,7271,9791,-2520,-25.74,1187
2020-11-30,19262,21606,-2344,-10.85,1187
2020-12-01,17494,21855,-4361,-19.95,1187
2020-12-02,17494,21855,-4361,-19.95,1187
2020-12-03,17494,21875,-4381,-20.03,1187
2020-12-04,19629,22400,-2771,-12.37,1187
2020-12-05,15170,18222,-3052,-16.75,1187
2020-12-06,7384,9844,-2460,-24.99,1187
2020-12-07,19304,21690,-2386,-11.0,1187
2020-12-08,17494,21967,-4473,-20.36,1187
2020-12-09,17494,21992,-4498,-20.45,1187
2020-12-10,17494,22030,-4536,-20.59,1187
2020-12-11,19629,22568,-2939,-13.02,1187
2020-12-12,15170,18394,-3224,-17.53,1187
2020-12-13,7384,10014,-2630,-26.26,1187
2020-12-14,19304,21848,-2544,-11.64,1187
2020-12-15,17494,22103,-4609,-20.85,1187
2020-12-16,17494,22097,-4603,-20.83,1187
2020-12-17,17494,22096,-4602,-20.83,1187
2020-12-18,19629,22585,-2956,-13.09,1187
2020-12-19,15170,18354,-3184,-17.35,1187
2020-12-20,7384,9909,-2525,-25.48,1187
2020-12-21,19304,21672,-2368,-10.93,1187
2020-12-22,17494,21851,-4357,-19.94,1187
2020-12-23,17494,21765,-4271,-19.62,1187
2020-12-24,17494,21680,-4186,-19.31,1187
2020-12-25,19629,22086,-2457,-11.12,1187
2020-12-26,15170,17774,-2604,-14.65,1187
2020-12-27,7384,9249,-1865,-20.16,1187
2020-12-28,19304,20938,-1634,-7.8,1187
2020-12-29,17494,21049,-3555,-16.89,1187
2020-12-30,17494,20903,-3409,-16.31,1187
2020-12-31,17494,20769,-3275,-15.77,1187
2021-01-01,15135,21134,-5999,-28.39,1187
2021-01-02,9931,16794,-6863,-40.87,1187
2021-01-03,5974,8254,-2280,-27.62,1187
2021-01-04,14907,19940,-5033,-25.24,1187
2021-01-05,15127,20061,-4934,-24.59,1187
2021-01-06,15127,19939,-4812,-24.13,1187
2021-01-07,15127,19841,-4714,-23.76,1187
2021-01-08,15135,20255,-5120,-25.28,1187
2021-01-09,9931,15974,-6043,-37.83,1187
2021-01-10,5974,7505,-1531,-20.4,1187
2021-01-11,14907,19270,-4363,-22.64,1187
2021-01-12,15127,19478,-4351,-22.34,1187
2021-01-13,15127,19447,-4320,-22.21,1187
2021-01-14,15127,19445,-4318,-22.21,1187
2021-01-15,15135,19958,-4823,-24.17,1187
2021-01-16,9931,15776,-5845,-37.05,1187
2021-01-17,5974,7403,-1429,-19.3,1187
2021-01-18,14907,19261,-4354,-22.61,1187
2021-01-19,15127,19558,-4431,-22.66,1187
2021-01-20,15127,19610,-4483,-22.86,1187
2021-01-21,15127,19682,-4555,-23.14,1187
2021-01-22,15135,20261,-5126,-25.3,1187
2021-01-23,9931,16135,-6204,-38.45,1187
2021-01-24,5974,7807,-1833,-23.48,1187
2021-01-25,14907,19701,-4794,-24.33,1187
2021-01-26,15127,20023,-4896,-24.45,1187
2021-01-27,15127,20089,-4962,-24.7,1187
2021-01-28,15127,20166,-5039,-24.99,1187
2021-01-29,15135,20740,-5605,-27.03,1187
2021-01-30,9931,16600,-6669,-40.17,1187
2021-01-31,5974,8253,-2279,-27.61,1187
2021-02-01,19209,20120,-911,-4.53,1187
2021-02-02,18686,20411,-1725,-8.45,1187
2021-02-03,18686,20442,-1756,-8.59,1187
2021-02-04,18686,20483,-1797,-8.77,1187
2021-02-05,19246,21019,-1773,-8.44,1187
2021-02-06,15156,16844,-1688,-10.02,1187
2021-02-07,7477,8462,-985,-11.64,1187
2021-02-08,19209,20298,-1089,-5.37,1187
2021-02-09,18686,20562,-1876,-9.12,1187
2021-02-10,18686,20571,-1885,-9.16,1187
2021-02-11,18686,20595,-1909,-9.27,1187
2021-02-12,19246,21121,-1875,-8.88,1187
2021-02-13,15156,16941,-1785,-10.54,1187
2021-02-14,7477,8562,-1085,-12.67,1187
2021-02-15,19209,20406,-1197,-5.87,1187
2021-02-16,18686,20682,-1996,-9.65,1187
2021-02-17,18686,20710,-2024,-9.77,1187
2021-02-18,18686,20756,-2070,-9.97,1187
2021-02-19,19246,21308,-2062,-9.68,1187
2021-02-20,15156,17156,-2000,-11.66,1187
2021-02-21,7477,8805,-1328,-15.08,1187
2021-02-22,19209,20678,-1469,-7.1,1187
2021-02-23,18686,20983,-2297,-10.95,1187
2021-02-24,18686,21038,-2352,-11.18,1187
2021-02-25,18686,21108,-2422,-11.47,1187
2021-02-26,19246,21680,-2434,-11.23,1187
2021-02-27,15156,17544,-2388,-13.61,1187
2021-02-28,7477,9204,-1727,-18.76,1187
2021-03-01,19893,21084,-1191,-5.65,1187
2021-03-02,19830,21389,-1559,-7.29,1187
2021-03-03,19830,21438,-1608,-7.5,1187
2021-03-04,19830,21498,-1668,-7.76,1187
2021-03-05,20057,22054,-1997,-9.06,1187
2021-03-06,16762,17898,-1136,-6.35,1187
2021-03-07,7775,9534,-1759,-18.45,1187
2021-03-08,19893,21386,-1493,-6.98,1187
2021-03-09,19830,21662,-1832,-8.46,1187
2021-03-10,19830,21680,-1850,-8.53,1187
2021-03-11,19830,21708,-1878,-8.65,1187
2021-03-12,20057,22233,-2176,-9.79,1187
2021-03-13,16762,18048,-1286,-7.13,1187
2021-03-14,7775,9657,-1882,-19.49,1187
2021-03-15,19893,21485,-1592,-7.41,1187
2021-03-16,19830,21742,-1912,-8.79,1187
2021-03-17,19830,21745,-1915,-8.81,1187
2021-03-18,19830,21764,-1934,-8.89,1187
2021-03-19,20057,22286,-2229,-10.0,1187
2021-03-20,16762,18102,-1340,-7.4,1187
2021-03-21,7775,9719,-1944,-20.0,1187
2021-03-22,19893,21560,-1667,-7.73,1187
2021-03-23,19830,21834,-2004,-9.18,1187
2021-03-24,19830,21860,-2030,-9.29,1187
2021-03-25,19830,21905,-2075,-9.47,1187
2021-03-26,20057,22455,-2398,-10.68,1187
2021-03-27,16762,18303,-1541,-8.42,1187
2021-03-28,7775,9952,-2177,-21.88,1187
2021-03-29,19893,21826,-1933,-8.86,1187
2021-03-30,19830,22131,-2301,-10.4,1187
2021-03-31,19830,22187,-2357,-10.62,1187
2021-04-01,16549,22258,-5709,-25.65,1187
2021-04-02,16728,22832,-6104,-26.73,1187
2021-04-03,11286,18698,-7412,-39.64,1187
2021-04-04,7296,10360,-3064,-29.58,1187
2021-04-05,16823,22241,-5418,-24.36,1187
2021-04-06,16549,22549,-6000,-26.61,1187
2021-04-07,16549,22599,-6050,-26.77,1187
2021-04-08,16549,22660,-6111,-26.97,1187
2021-04-09,16728,23217,-6489,-27.95,1187
2021-04-10,11286,19060,-7774,-40.79,1187
2021-04-11,7296,10695,-3399,-31.78,1187
2021-04-12,16823,22544,-5721,-25.38,1187
2021-04-13,16549,22816,-6267,-27.47,1187
2021-04-14,16549,22828,-6279,-27.51,1187
2021-04-15,16549,22849,-6300,-27.57,1187
2021-04-16,16728,23364,-6636,-28.4,1187
2021-04-17,11286,19166,-7880,-41.11,1187
2021-04-18,7296,10761,-3465,-32.2,1187
2021-04-19,16823,22572,-5749,-25.47,1187
2021-04-20,16549,22808,-6259,-27.44,1187
2021-04-21,16549,22788,-6239,-27.38,1187
2021-04-22,16549,22781,-6232,-27.36,1187
2021-04-23,16728,23274,-6546,-28.13,1187
2021-04-24,11286,19058,-7772,-40.78,1187
2021-04-25,7296,10641,-3345,-31.44,1187
2021-04-26,16823,22445,-5622,-25.05,1187
2021-04-27,16549,22680,-6131,-27.03,1187
2021-04-28,16549,22664,-6115,-26.98,1187
2021-04-29,16549,22665,-6116,-26.98,1187
2021-04-30,16728,23170,-6442,-27.8,1187
2021-05-01,18179,18970,-791,-4.17,1187
2021-05-02,8717,10571,-1854,-17.54,1187
2021-05-03,21418,22395,-977,-4.36,1187
2021-05-04,21385,22651,-1266,-5.59,1187
2021-05-05,21385,22657,-1272,-5.61,1187
2021-05-06,21385,22679,-1294,-5.71,1187
2021-05-07,22029,23203,-1174,-5.06,1187
2021-05-08,18179,19020,-841,-4.42,1187
2021-05-09,8717,10635,-1918,-18.03,1187
2021-05-10,21418,22471,-1053,-4.69,1187
2021-05-11,21385,22734,-1349,-5.93,1187
2021-05-12,21385,22743,-1358,-5.97,1187
2021-05-13,21385,22764,-1379,-6.06,1187
2021-05-14,22029,23284,-1255,-5.39,1187
2021-05-15,18179,19093,-914,-4.79,1187
2021-05-16,8717,10696,-1979,-18.5,1187
2021-05-17,21418,22517,-1099,-4.88,1187
2021-05-18,21385,22763,-1378,-6.05,1187
2021-05-19,21385,22753,-1368,-6.01,1187
2021-05-20,21385,22755,-1370,-6.02,1187
2021-05-21,22029,23254,-1225,-5.27,1187
2021-05-22,18179,19044,-865,-4.54,1187
2021-05-23,8717,10629,-1912,-17.99,1187
2021-05-24,21418,22433,-1015,-4.52,1187
2021-05-25,21385,22666,-1281,-5.65,1187
2021-05-26,21385,22646,-1261,-5.57,1187
2021-05-27,21385,22640,-1255,-5.54,1187
2021-05-28,22029,23137,-1108,-4.79,1187
2021-05-29,18179,18929,-750,-3.96,1187
2021-05-30,8717,10519,-1802,-17.13,1187
2021-05-31,21418,22334,-916,-4.1,1187
2021-06-01,21868,22580,-712,-3.15,1187
2021-06-02,21868,22577,-709,-3.14,1187
2021-06-03,21868,22591,-723,-3.2,1187
2021-06-04,21628,23110,-1482,-6.41,1187
2021-06-05,17287,18924,-1637,-8.65,1187
2021-06-06,10426,10538,-112,-1.06,1187
2021-06-07,21624,22374,-750,-3.35,1187
2021-06-08,21868,22641,-773,-3.41,1187
2021-06-09,21868,22656,-788,-3.48,1187
2021-06-10,21868,22685,-817,-3.6,1187
2021-06-11,21628,23213,-1585,-6.83,1187
2021-06-12,17287,19032,-1745,-9.17,1187
2021-06-13,10426,10645,-219,-2.06,1187
2021-06-14,21624,22475,-851,-3.79,1187
2021-06-15,21868,22728,-860,-3.78,1187
2021-06-16,21868,22722,-854,-3.76,1187
2021-06-17,21868,22724,-856,-3.77,1187
2021-06-18,21628,23219,-1591,-6.85,1187
2021-06-19,17287,18998,-1711,-9.01,1187
2021-06-20,10426,10567,-141,-1.33,1187
2021-06-21,21624,22348,-724,-3.24,1187
2021-06-22,21868,22548,-680,-3.02,1187
2021-06-23,21868,22488,-620,-2.76,1187
2021-06-24,21868,22434,-566,-2.52,1187
2021-06-25,21628,22874,-1246,-5.45,1187
2021-06-26,17287,18599,-1312,-7.05,1187
2021-06-27,10426,10116,310,3.06,1187
2021-06-28,21624,21849,-225,-1.03,1187
2021-06-29,21868,22007,-139,-0.63,1187
2021-06-30,21868,21911,-43,-0.2,1187
2021-07-01,21081,21828,-747,-3.42,1187
2021-07-02,21533,22246,-713,-3.21,1187
2021-07-03,16728,17959,-1231,-6.85,1187
2021-07-04,9697,9472,225,2.38,1187
2021-07-05,20996,21210,-214,-1.01,1187
2021-07-06,21081,21382,-301,-1.41,1187
2021-07-07,21081,21308,-227,-1.07,1187
2021-07-08,21081,21255,-174,-0.82,1187
2021-07-09,21533,21710,-177,-0.82,1187
2021-07-10,16728,17466,-738,-4.23,1187
2021-07-11,9697,9027,670,7.42,1187
2021-07-12,20996,20816,180,0.86,1187
2021-07-13,21081,21041,40,0.19,1187
2021-07-14,21081,21021,60,0.29,1187
2021-07-15,21081,21021,60,0.29,1187
2021-07-16,21533,21527,6,0.03,1187
2021-07-17,16728,17329,-601,-3.47,1187
2021-07-18,9697,8931,766,8.58,1187
2021-07-19,20996,20755,241,1.16,1187
2021-07-20,21081,21009,72,0.34,1187
2021-07-21,21081,21008,73,0.35,1187
2021-07-22,21081,21018,63,0.3,1187
2021-07-23,21533,21526,7,0.03,1187
2021-07-24,16728,17320,-592,-3.42,1187
2021-07-25,9697,8906,791,8.88,1187
2021-07-26,20996,20705,291,1.41,1187
2021-07-27,21081,20925,156,0.75,1187
2021-07-28,21081,20884,197,0.94,1187
2021-07-29,21081,20849,232,1.11,1187
2021-07-30,21533,21307,226,1.06,1187
2021-07-31,16728,17048,-320,-1.88,1187
2021-08-01,9404,8580,824,9.6,1187
2021-08-02,19469,20326,-857,-4.22,1187
2021-08-03,19437,20495,-1058,-5.16,1187
2021-08-04,19437,20407,-970,-4.75,1187
2021-08-05,19437,20330,-893,-4.39,1187
2021-08-06,19517,20753,-1236,-5.96,1187
2021-08-07,15664,16469,-805,-4.89,1187
2021-08-08,9404,7985,1419,17.77,1187
2021-08-09,19469,19725,-256,-1.3,1187
2021-08-10,19437,19900,-463,-2.33,1187
2021-08-11,19437,19830,-393,-1.98,1187
2021-08-12,19437,19783,-346,-1.75,1187
2021-08-13,19517,20248,-731,-3.61,1187
2021-08-14,15664,16017,-353,-2.2,1187
2021-08-15,9404,7596,1808,23.8,1187
2021-08-16,19469,19410,59,0.3,1187
2021-08-17,19437,19667,-230,-1.17,1187
2021-08-18,19437,19685,-248,-1.26,1187
2021-08-19,19437,19732,-295,-1.5,1187
2021-08-20,19517,20295,-778,-3.83,1187
2021-08-21,15664,16163,-499,-3.09,1187
2021-08-22,9404,7841,1563,19.93,1187
2021-08-23,19469,19751,-282,-1.43,1187
2021-08-24,19437,20101,-664,-3.3,1187
2021-08-25,19437,20206,-769,-3.81,1187
2021-08-26,19437,20333,-896,-4.41,1187
2021-08-27,19517,20965,-1448,-6.91,1187
2021-08-28,15664,16894,-1230,-7.28,1187
2021-08-29,9404,8621,783,9.08,1187
2021-08-30,19469,20569,-1100,-5.35,1187
2021-08-31,19437,20943,-1506,-7.19,1187
2021-09-01,20578,21060,-482,-2.29,1187
2021-09-02,20578,21186,-608,-2.87,1187
2021-09-03,20961,21806,-845,-3.88,1187
2021-09-04,17920,17711,209,1.18,1187
2021-09-05,11172,9403,1769,18.81,1187
2021-09-06,20512,21307,-795,-3.73,1187
2021-09-07,20578,21629,-1051,-4.86,1187
2021-09-08,20578,21687,-1109,-5.11,1187
2021-09-09,20578,21749,-1171,-5.38,1187
2021-09-10,20961,22302,-1341,-6.01,1187
2021-09-11,17920,18138,-218,-1.2,1187
2021-09-12,11172,9761,1411,14.46,1187
2021-09-13,20512,21597,-1085,-5.02,1187
2021-09-14,20578,21854,-1276,-5.84,1187
2021-09-15,20578,21853,-1275,-5.83,1187
2021-09-16,20578,21860,-1282,-5.86,1187
2021-09-17,20961,22365,-1404,-6.28,1187
2021-09-18,17920,18159,-239,-1.32,1187
2021-09-19,11172,9749,1423,14.6,1187
2021-09-20,20512,21560,-1048,-4.86,1187
2021-09-21,20578,21800,-1222,-5.61,1187
2021-09-22,20578,21790,-1212,-5.56,1187
2021-09-23,20578,21796,-1218,-5.59,1187
2021-09-24,20961,22306,-1345,-6.03,1187
2021-09-25,17920,18112,-192,-1.06,1187
2021-09-26,11172,9720,1452,14.94,1187
2021-09-27,20512,21552,-1040,-4.83,1187
2021-09-28,20578,21817,-1239,-5.68,1187
2021-09-29,20578,21833,-1255,-5.75,1187
2021-09-30,20578,21867,-1289,-5.89,1187
2021-10-01,21958,22404,-446,-1.99,1187
2021-10-02,18737,18236,501,2.75,1187
2021-10-03,10534,9867,667,6.76,1187
2021-10-04,20523,21719,-1196,-5.51,1187
2021-10-05,20804,22000,-1196,-5.44,1187
2021-10-06,20804,22027,-1223,-5.55,1187
2021-10-07,20804,22066,-1262,-5.72,1187
2021-10-08,21958,22605,-647,-2.86,1187
2021-10-09,18737,18432,305,1.65,1187
2021-10-10,10534,10054,480,4.77,1187
2021-10-11,20523,21892,-1369,-6.25,1187
2021-10-12,20804,22154,-1350,-6.09,1187
2021-10-13,20804,22159,-1355,-6.11,1187
2021-10-14,20804,22174,-1370,-6.18,1187
2021-10-15,21958,22685,-727,-3.2,1187
2021-10-16,18737,18484,253,1.37,1187
2021-10-17,10534,10077,457,4.54,1187
2021-10-18,20523,21887,-1364,-6.23,1187
2021-10-19,20804,22123,-1319,-5.96,1187
2021-10-20,20804,22104,-1300,-5.88,1187
2021-10-21,20804,22098,-1294,-5.86,1187
2021-10-22,21958,22592,-634,-2.81,1187
2021-10-23,18737,18378,359,1.95,1187
2021-10-24,10534,9962,572,5.74,1187
2021-10-25,20523,21768,-1245,-5.72,1187
2021-10-26,20804,22004,-1200,-5.45,1187
2021-10-27,20804,21990,-1186,-5.39,1187
2021-10-28,20804,21993,-1189,-5.41,1187
2021-10-29,21958,22499,-541,-2.4,1187
2021-10-30,18737,18301,436,2.38,1187
2021-10-31,10534,9903,631,6.37,1187
2021-11-01,17881,21729,-3848,-17.71,1187
2021-11-02,18953,21987,-3034,-13.8,1187
2021-11-03,18953,21993,-3040,-13.82,1187
2021-11-04,18953,22016,-3063,-13.91,1187
2021-11-05,19998,22541,-2543,-11.28,1187
2021-11-06,16537,18359,-1822,-9.92,1187
2021-11-07,9184,9974,-790,-7.92,1187
2021-11-08,17881,21810,-3929,-18.01,1187
2021-11-09,18953,22072,-3119,-14.13,1187
2021-11-10,18953,22080,-3127,-14.16,1187
2021-11-11,18953,22100,-3147,-14.24,1187
2021-11-12,19998,22617,-2619,-11.58,1187
2021-11-13,16537,18423,-1886,-10.24,1187
2021-11-14,9184,10023,-839,-8.37,1187
2021-11-15,17881,21840,-3959,-18.13,1187
2021-11-16,18953,22081,-3128,-14.17,1187
2021-11-17,18953,22065,-3112,-14.1,1187
2021-11-18,18953,22060,-3107,-14.08,1187
2021-11-19,19998,22552,-2554,-11.32,1187
2021-11-20,16537,18334,-1797,-9.8,1187
2021-11-21,9184,9911,-727,-7.34,1187
2021-11-22,17881,21708,-3827,-17.63,1187
2021-11-23,18953,21932,-2979,-13.58,1187
2021-11-24,18953,21903,-2950,-13.47,1187
2021-11-25,18953,21890,-2937,-13.42,1187
2021-11-26,19998,22379,-2381,-10.64,1187
2021-11-27,16537,18163,-1626,-8.95,1187
2021-11-28,9184,9748,-564,-5.79,1187
2021-11-29,17881,21557,-3676,-17.05,1187
2021-11-30,18953,21800,-2847,-13.06,1187
2021-12-01,18285,21794,-3509,-16.1,1187
2021-12-02,18285,21807,-3522,-16.15,1187
2021-12-03,16043,22326,-6283,-28.14,1187
2021-12-04,13715,18142,-4427,-24.4,1187
2021-12-05,8486,9760,-1274,-13.05,1187
2021-12-06,19189,21602,-2413,-11.17,1187
2021-12-07,18285,21876,-3591,-16.42,1187
2021-12-08,18285,21900,-3615,-16.51,1187
2021-12-09,18285,21938,-3653,-16.65,1187
2021-12-10,16043,22478,-6435,-28.63,1187
2021-12-11,13715,18308,-4593,-25.09,1187
2021-12-12,8486,9932,-1446,-14.56,1187
2021-12-13,19189,21774,-2585,-11.87,1187
2021-12-14,18285,22038,-3753,-17.03,1187
2021-12-15,18285,22042,-3757,-17.04,1187
2021-12-16,18285,22052,-3767,-17.08,1187
2021-12-17,16043,22554,-6511,-28.87,1187
2021-12-18,13715,18338,-4623,-25.21,1187
2021-12-19,8486,9907,-1421,-14.34,1187
2021-12-20,19189,21685,-2496,-11.51,1187
2021-12-21,18285,21880,-3595,-16.43,1187
2021-12-22,18285,21809,-3524,-16.16,1187
2021-12-23,18285,21740,-3455,-15.89,1187
2021-12-24,16043,22159,-6116,-27.6,1187
2021-12-25,13715,17860,-4145,-23.21,1187
2021-12-26,8486,9347,-861,-9.21,1187
2021-12-27,19189,21045,-1856,-8.82,1187
2021-12-28,18285,21164,-2879,-13.6,1187
2021-12-29,18285,21024,-2739,-13.03,1187
2021-12-30,18285,20892,-2607,-12.48,1187
2021-12-31,16043,21259,-5216,-24.54,1187
2022-01-01,15214,16917,-1703,-10.07,1187
2022-01-02,7587,8373,-786,-9.39,1187
2022-01-03,17780,20052,-2272,-11.33,1187
2022-01-04,17669,20165,-2496,-12.38,1187
2022-01-05,17669,20032,-2363,-11.8,1187
2022-01-06,17669,19921,-2252,-11.3,1187
2022-01-07,18156,20321,-2165,-10.65,1187
2022-01-08,15214,16024,-810,-5.05,1187
2022-01-09,7587,7538,49,0.65,1187
2022-01-10,17780,19285,-1505,-7.8,1187
2022-01-11,17669,19475,-1806,-9.27,1187
2022-01-12,17669,19426,-1757,-9.04,1187
2022-01-13,17669,19406,-1737,-8.95,1187
2022-01-14,18156,19901,-1745,-8.77,1187
2022-01-15,15214,15703,-489,-3.11,1187
2022-01-16,7587,7314,273,3.73,1187
2022-01-17,17780,19159,-1379,-7.2,1187
2022-01-18,17669,19443,-1774,-9.12,1187
2022-01-19,17669,19485,-1816,-9.32,1187
2022-01-20,17669,19549,-1880,-9.62,1187
2022-01-21,18156,20121,-1965,-9.77,1187
2022-01-22,15214,15990,-776,-4.85,1187
2022-01-23,7587,7660,-73,-0.95,1187
2022-01-24,17780,19553,-1773,-9.07,1187
2022-01-25,17669,19876,-2207,-11.1,1187
2022-01-26,17669,19944,-2275,-11.41,1187
2022-01-27,17669,20025,-2356,-11.77,1187
2022-01-28,18156,20604,-2448,-11.88,1187
2022-01-29,15214,16471,-1257,-7.63,1187
2022-01-30,7587,8130,-543,-6.68,1187
2020-02-01,17529,16559,970,5.86,1188
2020-02-02,9346,8589,757,8.81,1188
2020-02-03,20886,21234,-348,-1.64,1188
2020-02-04,21010,21241,-231,-1.09,1188
2020-02-05,21010,21251,-241,-1.13,1188
2020-02-06,21010,21276,-266,-1.25,1188
2020-02-07,21645,21568,77,0.36,1188
2020-02-08,17529,16674,855,5.13,1188
2020-02-09,9346,8687,659,7.59,1188
2020-02-10,20886,21319,-433,-2.03,1188
2020-02-11,21010,21318,-308,-1.44,1188
2020-02-12,21010,21326,-316,-1.48,1188
2020-02-13,21010,21353,-343,-1.61,1188
2020-02-14,21645,21653,-8,-0.04,1188
2020-02-15,17529,16772,757,4.51,1188
2020-02-16,9346,8802,544,6.18,1188
2020-02-17,20886,21455,-569,-2.65,1188
2020-02-18,21010,21479,-469,-2.18,1188
2020-02-19,21010,21513,-503,-2.34,1188
2020-02-20,21010,21569,-559,-2.59,1188
2020-02-21,21645,21898,-253,-1.16,1188
2020-02-22,17529,17045,484,2.84,1188
2020-02-23,9346,9101,245,2.69,1188
2020-02-24,20886,21779,-893,-4.1,1188
2020-02-25,21010,21824,-814,-3.73,1188
2020-02-26,21010,21876,-866,-3.96,1188
2020-02-27,21010,21944,-934,-4.26,1188
2020-02-28,21645,22281,-636,-2.85,1188
2020-02-29,17529,17430,99,0.57,1188
2020-03-01,6405,9484,-3079,-32.47,1188
2020-03-02,15417,22154,-6737,-30.41,1188
2020-03-03,15514,22185,-6671,-30.07,1188
2020-03-04,15514,22219,-6705,-30.18,1188
2020-03-05,15514,22265,-6751,-30.32,1188
2020-03-06,16921,22577,-5656,-25.05,1188
2020-03-07,11744,17698,-5954,-33.64,1188
2020-03-08,6405,9722,-3317,-34.12,1188
2020-03-09,15417,22361,-6944,-31.05,1188
2020-03-10,15514,22363,-6849,-30.63,1188
2020-03-11,15514,22367,-6853,-30.64,1188
2020-03-12,15514,22386,-6872,-30.7,1188
2020-03-13,16921,22674,-5753,-25.37,1188
2020-03-14,11744,17775,-6031,-33.93,1188
2020-03-15,6405,9783,-3378,-34.53,1188
2020-03-16,15417,22412,-6995,-31.21,1188
2020-03-17,15514,22408,-6894,-30.77,1188
2020-03-18,15514,22413,-6899,-30.78,1188
2020-03-19,15514,22439,-6925,-30.86,1188
2020-03-20,16921,22738,-5817,-25.58,1188
2020-03-21,11744,17857,-6113,-34.23,1188
2020-03-22,6405,9888,-3483,-35.22,1188
2020-03-23,15417,22543,-7126,-31.61,1188
2020-03-24,15514,22570,-7056,-31.26,1188
2020-03-25,15514,22608,-7094,-31.38,1188
2020-03-26,15514,22669,-7155,-31.56,1188
2020-03-27,16921,23003,-6082,-26.44,1188
2020-03-28,11744,18157,-6413,-35.32,1188
2020-03-29,6405,10221,-3816,-37.33,1188
2020-03-30,15417,22908,-7491,-32.7,1188
2020-03-31,15514,22962,-7448,-32.44,1188
2020-04-01,14339,23024,-8685,-37.72,1188
2020-04-02,14339,23103,-8764,-37.93,1188
2020-04-03,13874,23450,-9576,-40.84,1188
2020-04-04,9945,18610,-8665,-46.56,1188
2020-04-05,4859,10675,-5816,-54.48,1188
2020-04-06,14449,23355,-8906,-38.13,1188
2020-04-07,14339,23396,-9057,-38.71,1188
2020-04-08,14339,23439,-9100,-38.82,1188
2020-04-09,14339,23493,-9154,-38.96,1188
2020-04-10,13874,23810,-9936,-41.73,1188
2020-04-11,9945,18937,-8992,-47.48,1188
2020-04-12,4859,10963,-6104,-55.68,1188
2020-04-13,14449,23603,-9154,-38.78,1188
2020-04-14,14339,23602,-9263,-39.25,1188
2020-04-15,14339,23603,-9264,-39.25,1188
2020-04-16,14339,23615,-9276,-39.28,1188
2020-04-17,13874,23892,-10018,-41.93,1188
2020-04-18,9945,18981,-9036,-47.61,1188
2020-04-19,4859,10974,-6115,-55.72,1188
2020-04-20,14449,23584,-9135,-38.73,1188
2020-04-21,14339,23559,-9220,-39.14,1188
2020-04-22,14339,23540,-9201,-39.09,1188
2020-04-23,14339,23538,-9199,-39.08,1188
2020-04-24,13874,23808,-9934,-41.73,1188
2020-04-25,9945,18895,-8950,-47.37,1188
2020-04-26,4859,10892,-6033,-55.39,1188
2020-04-27,14449,23511,-9062,-38.54,1188
2020-04-28,14339,23500,-9161,-38.98,1188
2020-04-29,14339,23498,-9159,-38.98,1188
2020-04-30,14339,23518,-9179,-39.03,1188
2020-05-01,21629,23811,-2182,-9.16,1188
2020-05-02,17404,18923,-1519,-8.03,1188
2020-05-03,7884,10944,-3060,-27.96,1188
2020-05-04,20924,23587,-2663,-11.29,1188
2020-05-05,20853,23598,-2745,-11.63,1188
2020-05-06,20853,23616,-2763,-11.7,1188
2020-05-07,20853,23652,-2799,-11.83,1188
2020-05-08,21629,23958,-2329,-9.72,1188
2020-05-09,17404,19077,-1673,-8.77,1188
2020-05-10,7884,11100,-3216,-28.97,1188
2020-05-11,20924,23741,-2817,-11.87,1188
2020-05-12,20853,23744,-2891,-12.18,1188
2020-05-13,20853,23749,-2896,-12.19,1188
2020-05-14,20853,23767,-2914,-12.26,1188
2020-05-15,21629,24050,-2421,-10.07,1188
2020-05-16,17404,19143,-1739,-9.08,1188
2020-05-17,7884,11138,-3254,-29.22,1188
2020-05-18,20924,23747,-2823,-11.89,1188
2020-05-19,20853,23718,-2865,-12.08,1188
2020-05-20,20853,23691,-2838,-11.98,1188
2020-05-21,20853,23678,-2825,-11.93,1188
2020-05-22,21629,23932,-2303,-9.62,1188
2020-05-23,17404,18999,-1595,-8.4,1188
2020-05-24,7884,10971,-3087,-28.14,1188
2020-05-25,20924,23563,-2639,-11.2,1188
2020-05-26,20853,23521,-2668,-11.34,1188
2020-05-27,20853,23488,-2635,-11.22,1188
2020-05-28,20853,23474,-2621,-11.17,1188
2020-05-29,21629,23732,-2103,-8.86,1188
2020-05-30,17404,18810,-1406,-7.47,1188
2020-05-31,7884,10799,-2915,-26.99,1188
2020-06-01,22397,23412,-1015,-4.34,1188
2020-06-02,22413,23396,-983,-4.2,1188
2020-06-03,22413,23391,-978,-4.18,1188
2020-06-04,22413,23408,-995,-4.25,1188
2020-06-05,22562,23699,-1137,-4.8,1188
2020-06-06,17271,18808,-1537,-8.17,1188
2020-06-07,9304,10827,-1523,-14.07,1188
2020-06-08,22397,23468,-1071,-4.56,1188
2020-06-09,22413,23475,-1062,-4.52,1188
2020-06-10,22413,23487,-1074,-4.57,1188
2020-06-11,22413,23516,-1103,-4.69,1188
2020-06-12,22562,23810,-1248,-5.24,1188
2020-06-13,17271,18915,-1644,-8.69,1188
2020-06-14,9304,10921,-1617,-14.81,1188
2020-06-15,22397,23539,-1142,-4.85,1188
2020-06-16,22413,23514,-1101,-4.68,1188
2020-06-17,22413,23486,-1073,-4.57,1188
2020-06-18,22413,23465,-1052,-4.48,1188
2020-06-19,22562,23702,-1140,-4.81,1188
2020-06-20,17271,18742,-1471,-7.85,1188
2020-06-21,9304,10676,-1372,-12.85,1188
2020-06-22,22397,23218,-821,-3.54,1188
2020-06-23,22413,23115,-702,-3.04,1188
2020-06-24,22413,23006,-593,-2.58,1188
2020-06-25,22413,22904,-491,-2.14,1188
2020-06-26,22562,23062,-500,-2.17,1188
2020-06-27,17271,18027,-756,-4.19,1188
2020-06-28,9304,9893,-589,-5.95,1188
2020-06-29,22397,22372,25,0.11,1188
2020-06-30,22413,22215,198,0.89,1188
2020-07-01,22518,22062,456,2.07,1188
2020-07-02,22518,21928,590,2.69,1188
2020-07-03,22885,22065,820,3.72,1188
2020-07-04,17338,17022,316,1.86,1188
2020-07-05,9916,8892,1024,11.52,1188
2020-07-06,22531,21389,1142,5.34,1188
2020-07-07,22518,21262,1256,5.91,1188
2020-07-08,22518,21151,1367,6.46,1188
2020-07-09,22518,21069,1449,6.88,1188
2020-07-10,22885,21270,1615,7.59,1188
2020-07-11,17338,16298,1040,6.38,1188
2020-07-12,9916,8246,1670,20.25,1188
2020-07-13,22531,20826,1705,8.19,1188
2020-07-14,22518,20785,1733,8.34,1188
2020-07-15,22518,20762,1756,8.46,1188
2020-07-16,22518,20767,1751,8.43,1188
2020-07-17,22885,21052,1833,8.71,1188
2020-07-18,17338,16160,1178,7.29,1188
2020-07-19,9916,8181,1735,21.21,1188
2020-07-20,22531,20828,1703,8.18,1188
2020-07-21,22518,20843,1675,8.04,1188
2020-07-22,22518,20867,1651,7.91,1188
2020-07-23,22518,20907,1611,7.71,1188
2020-07-24,22885,21216,1669,7.87,1188
2020-07-25,17338,16336,1002,6.13,1188
2020-07-26,9916,8357,1559,18.66,1188
2020-07-27,22531,20993,1538,7.33,1188
2020-07-28,22518,20987,1531,7.29,1188
2020-07-29,22518,20980,1538,7.33,1188
2020-07-30,22518,20982,1536,7.32,1188
2020-07-31,22885,21245,1640,7.72,1188
2020-08-01,16544,16314,230,1.41,1188
2020-08-02,9628,8283,1345,16.24,1188
2020-08-03,21824,20863,961,4.61,1188
2020-08-04,21395,20803,592,2.85,1188
2020-08-05,21395,20744,651,3.14,1188
2020-08-06,21395,20699,696,3.36,1188
2020-08-07,21507,20921,586,2.8,1188
2020-08-08,16544,15957,587,3.68,1188
2020-08-09,9628,7901,1727,21.86,1188
2020-08-10,21824,20467,1357,6.63,1188
2020-08-11,21395,20404,991,4.86,1188
2020-08-12,21395,20354,1041,5.11,1188
2020-08-13,21395,20328,1067,5.25,1188
2020-08-14,21507,20582,925,4.49,1188
2020-08-15,16544,15661,883,5.64,1188
2020-08-16,9628,7659,1969,25.71,1188
2020-08-17,21824,20288,1536,7.57,1188
2020-08-18,21395,20297,1098,5.41,1188
2020-08-19,21395,20325,1070,5.26,1188
2020-08-20,21395,20383,1012,4.96,1188
2020-08-21,21507,20724,783,3.78,1188
2020-08-22,16544,15892,652,4.1,1188
2020-08-23,9628,7978,1650,20.68,1188
2020-08-24,21824,20695,1129,5.46,1188
2020-08-25,21395,20786,609,2.93,1188
2020-08-26,21395,20891,504,2.41,1188
2020-08-27,21395,21019,376,1.79,1188
2020-08-28,21507,21421,86,0.4,1188
2020-08-29,16544,16640,-96,-0.58,1188
2020-08-30,9628,8766,862,9.83,1188
2020-08-31,21824,21511,313,1.46,1188
2020-09-01,22307,21619,688,3.18,1188
2020-09-02,22307,21729,578,2.66,1188
2020-09-03,22307,21849,458,2.1,1188
2020-09-04,22778,22233,545,2.45,1188
2020-09-05,18199,17423,776,4.45,1188
2020-09-06,10393,9510,883,9.28,1188
2020-09-07,22457,22208,249,1.12,1188
2020-09-08,22307,22261,46,0.21,1188
2020-09-09,22307,22310,-3,-0.01,1188
2020-09-10,22307,22367,-60,-0.27,1188
2020-09-11,22778,22683,95,0.42,1188
2020-09-12,18199,17805,394,2.21,1188
2020-09-13,10393,9826,567,5.77,1188
2020-09-14,22457,22459,-2,-0.01,1188
2020-09-15,22307,22451,-144,-0.64,1188
2020-09-16,22307,22444,-137,-0.61,1188
2020-09-17,22307,22450,-143,-0.64,1188
2020-09-18,22778,22723,55,0.24,1188
2020-09-19,18199,17809,390,2.19,1188
2020-09-20,10393,9801,592,6.04,1188
2020-09-21,22457,22414,43,0.19,1188
2020-09-22,22307,22394,-87,-0.39,1188
2020-09-23,22307,22383,-76,-0.34,1188
2020-09-24,22307,22392,-85,-0.38,1188
2020-09-25,22778,22674,104,0.46,1188
2020-09-26,18199,17775,424,2.39,1188
2020-09-27,10393,9787,606,6.19,1188
2020-09-28,22457,22424,33,0.15,1188
2020-09-29,22307,22429,-122,-0.54,1188
2020-09-30,22307,22445,-138,-0.61,1188
2020-10-01,22156,22482,-326,-1.45,1188
2020-10-02,23104,22791,313,1.37,1188
2020-10-03,18256,17917,339,1.89,1188
2020-10-04,9495,9950,-455,-4.57,1188
2020-10-05,22173,22604,-431,-1.91,1188
2020-10-06,22156,22624,-468,-2.07,1188
2020-10-07,22156,22649,-493,-2.18,1188
2020-10-08,22156,22689,-533,-2.35,1188
2020-10-09,23104,22996,108,0.47,1188
2020-10-10,18256,18116,140,0.77,1188
2020-10-11,9495,10138,-643,-6.34,1188
2020-10-12,22173,22776,-603,-2.65,1188
2020-10-13,22156,22776,-620,-2.72,1188
2020-10-14,22156,22778,-622,-2.73,1188
2020-10-15,22156,22792,-636,-2.79,1188
2020-10-16,23104,23073,31,0.13,1188
2020-10-17,18256,18164,92,0.51,1188
2020-10-18,9495,10159,-664,-6.54,1188
2020-10-19,22173,22771,-598,-2.63,1188
2020-10-20,22156,22746,-590,-2.59,1188
2020-10-21,22156,22726,-570,-2.51,1188
2020-10-22,22156,22723,-567,-2.5,1188
2020-10-23,23104,22989,115,0.5,1188
2020-10-24,18256,18070,186,1.03,1188
2020-10-25,9495,10059,-564,-5.61,1188
2020-10-26,22173,22670,-497,-2.19,1188
2020-10-27,22156,22648,-492,-2.17,1188
2020-10-28,22156,22636,-480,-2.12,1188
2020-10-29,22156,22644,-488,-2.16,1188
2020-10-30,23104,22925,179,0.78,1188
2020-10-31,18256,18024,232,1.29,1188
2020-11-01,7335,10033,-2698,-26.89,1188
2020-11-02,20015,22665,-2650,-11.69,1188
2020-11-03,17768,22665,-4897,-21.61,1188
2020-11-04,17768,22674,-4906,-21.64,1188
2020-11-05,17768,22703,-4935,-21.74,1188
2020-11-06,19094,23002,-3908,-16.99,1188
2020-11-07,14390,18116,-3726,-20.57,1188
2020-11-08,7335,10138,-2803,-27.65,1188
2020-11-09,20015,22778,-2763,-12.13,1188
2020-11-10,17768,22783,-5015,-22.01,1188
2020-11-11,17768,22792,-5024,-22.04,1188
2020-11-12,17768,22816,-5048,-22.12,1188
2020-11-13,19094,23107,-4013,-17.37,1188
2020-11-14,14390,18209,-3819,-20.97,1188
2020-11-15,7335,10214,-2879,-28.19,1188
2020-11-16,20015,22835,-2820,-12.35,1188
2020-11-17,17768,22817,-5049,-22.13,1188
2020-11-18,17768,22802,-5034,-22.08,1188
2020-11-19,17768,22801,-5033,-22.07,1188
2020-11-20,19094,23066,-3972,-17.22,1188
2020-11-21,14390,18143,-3753,-20.69,1188
2020-11-22,7335,10125,-2790,-27.56,1188
2020-11-23,20015,22724,-2709,-11.92,1188
2020-11-24,17768,22689,-4921,-21.69,1188
2020-11-25,17768,22660,-4892,-21.59,1188
2020-11-26,17768,22648,-4880,-21.55,1188
2020-11-27,19094,22908,-3814,-16.65,1188
2020-11-28,14390,17984,-3594,-19.98,1188
2020-11-29,7335,9970,-2635,-26.43,1188
2020-11-30,20015,22579,-2564,-11.36,1188
2020-12-01,18566,22557,-3991,-17.69,1188
2020-12-02,18566,22545,-3979,-17.65,1188
2020-12-03,18566,22555,-3989,-17.69,1188
2020-12-04,20787,22839,-2052,-8.98,1188
2020-12-05,15833,17941,-2108,-11.75,1188
2020-12-06,7383,9954,-2571,-25.83,1188
2020-12-07,19953,22590,-2637,-11.67,1188
2020-12-08,18566,22594,-4028,-17.83,1188
2020-12-09,18566,22606,-4040,-17.87,1188
2020-12-10,18566,22636,-4070,-17.98,1188
2020-12-11,20787,22936,-2149,-9.37,1188
2020-12-12,15833,18050,-2217,-12.28,1188
2020-12-13,7383,10068,-2685,-26.67,1188
2020-12-14,19953,22703,-2750,-12.11,1188
2020-12-15,18566,22700,-4134,-18.21,1188
2020-12-16,18566,22697,-4131,-18.2,1188
2020-12-17,18566,22705,-4139,-18.23,1188
2020-12-18,20787,22976,-2189,-9.53,1188
2020-12-19,15833,18054,-2221,-12.3,1188
2020-12-20,7383,10030,-2647,-26.39,1188
2020-12-21,19953,22617,-2664,-11.78,1188
2020-12-22,18566,22561,-3995,-17.71,1188
2020-12-23,18566,22502,-3936,-17.49,1188
2020-12-24,18566,22452,-3886,-17.31,1188
2020-12-25,20787,22664,-1877,-8.28,1188
2020-12-26,15833,17683,-1850,-10.46,1188
2020-12-27,7383,9602,-2219,-23.11,1188
2020-12-28,19953,22135,-2182,-9.86,1188
2020-12-29,18566,22030,-3464,-15.72,1188
2020-12-30,18566,21927,-3361,-15.33,1188
2020-12-31,18566,21840,-3274,-14.99,1188
2021-01-01,16478,22022,-5544,-25.17,1188
2021-01-02,10803,17021,-6218,-36.53,1188
2021-01-03,6036,8929,-2893,-32.4,1188
2021-01-04,15856,21460,-5604,-26.11,1188
2021-01-05,16088,21362,-5274,-24.69,1188
2021-01-06,16088,21278,-5190,-24.39,1188
2021-01-07,16088,21219,-5131,-24.18,1188
2021-01-08,16478,21437,-4959,-23.13,1188
2021-01-09,10803,16481,-5678,-34.45,1188
2021-01-10,6036,8441,-2405,-28.49,1188
2021-01-11,15856,21031,-5175,-24.61,1188
2021-01-12,16088,20998,-4910,-23.38,1188
2021-01-13,16088,20981,-4893,-23.32,1188
2021-01-14,16088,20992,-4904,-23.36,1188
2021-01-15,16478,21282,-4804,-22.57,1188
2021-01-16,10803,16397,-5594,-34.12,1188
2021-01-17,6036,8426,-2390,-28.36,1188
2021-01-18,15856,21082,-5226,-24.79,1188
2021-01-19,16088,21110,-5022,-23.79,1188
2021-01-20,16088,21150,-5062,-23.93,1188
2021-01-21,16088,21211,-5123,-24.15,1188
2021-01-22,16478,21543,-5065,-23.51,1188
2021-01-23,10803,16693,-5890,-35.28,1188
2021-01-24,6036,8749,-2713,-31.01,1188
2021-01-25,15856,21424,-5568,-25.99,1188
2021-01-26,16088,21463,-5375,-25.04,1188
2021-01-27,16088,21505,-5417,-25.19,1188
2021-01-28,16088,21562,-5474,-25.39,1188
2021-01-29,16478,21884,-5406,-24.7,1188
2021-01-30,10803,17017,-6214,-36.52,1188
2021-01-31,6036,9052,-3016,-33.32,1188
2021-02-01,19906,21703,-1797,-8.28,1188
2021-02-02,19574,21715,-2141,-9.86,1188
2021-02-03,19574,21729,-2155,-9.92,1188
2021-02-04,19574,21757,-2183,-10.03,1188
2021-02-05,20361,22052,-1691,-7.67,1188
2021-02-06,15621,17160,-1539,-8.97,1188
2021-02-07,7668,9173,-1505,-16.41,1188
2021-02-08,19906,21805,-1899,-8.71,1188
2021-02-09,19574,21802,-2228,-10.22,1188
2021-02-10,19574,21808,-2234,-10.24,1188
2021-02-11,19574,21832,-2258,-10.34,1188
2021-02-12,20361,22128,-1767,-7.99,1188
2021-02-13,15621,17242,-1621,-9.4,1188
2021-02-14,7668,9267,-1599,-17.25,1188
2021-02-15,19906,21915,-2009,-9.17,1188
2021-02-16,19574,21933,-2359,-10.76,1188
2021-02-17,19574,21962,-2388,-10.87,1188
2021-02-18,19574,22012,-2438,-11.08,1188
2021-02-19,20361,22337,-1976,-8.85,1188
2021-02-20,15621,17480,-1859,-10.64,1188
2021-02-21,7668,9533,-1865,-19.56,1188
2021-02-22,19906,22208,-2302,-10.37,1188
2021-02-23,19574,22251,-2677,-12.03,1188
2021-02-24,19574,22302,-2728,-12.23,1188
2021-02-25,19574,22371,-2797,-12.5,1188
2021-02-26,20361,22709,-2348,-10.34,1188
2021-02-27,15621,17861,-2240,-12.54,1188
2021-02-28,7668,9918,-2250,-22.69,1188
2021-03-01,20912,22592,-1680,-7.44,1188
2021-03-02,20940,22628,-1688,-7.46,1188
2021-03-03,20940,22667,-1727,-7.62,1188
2021-03-04,20940,22719,-1779,-7.83,1188
2021-03-05,21412,23036,-1624,-7.05,1188
2021-03-06,17134,18164,-1030,-5.67,1188
2021-03-07,7833,10193,-2360,-23.15,1188
2021-03-08,20912,22838,-1926,-8.43,1188
2021-03-09,20940,22844,-1904,-8.33,1188
2021-03-10,20940,22852,-1912,-8.37,1188
2021-03-11,20940,22874,-1934,-8.46,1188
2021-03-12,21412,23164,-1752,-7.56,1188
2021-03-13,17134,18266,-1132,-6.2,1188
2021-03-14,7833,10274,-2441,-23.76,1188
2021-03-15,20912,22902,-1990,-8.69,1188
2021-03-16,20940,22896,-1956,-8.54,1188
2021-03-17,20940,22898,-1958,-8.55,1188
2021-03-18,20940,22920,-1980,-8.64,1188
2021-03-19,21412,23214,-1802,-7.76,1188
2021-03-20,17134,18327,-1193,-6.51,1188
2021-03-21,7833,10352,-2519,-24.33,1188
2021-03-22,20912,23001,-2089,-9.08,1188
2021-03-23,20940,23021,-2081,-9.04,1188
2021-03-24,20940,23052,-2112,-9.16,1188
2021-03-25,20940,23106,-2166,-9.37,1188
2021-03-26,21412,23435,-2023,-8.63,1188
2021-03-27,17134,18584,-1450,-7.8,1188
2021-03-28,7833,10643,-2810,-26.4,1188
2021-03-29,20912,23326,-2414,-10.35,1188
2021-03-30,20940,23378,-2438,-10.43,1188
2021-03-31,20940,23438,-2498,-10.66,1188
2021-04-01,17972,23517,-5545,-23.58,1188
2021-04-02,18540,23865,-5325,-22.31,1188
2021-04-03,12776,19028,-6252,-32.86,1188
2021-04-04,7657,11095,-3438,-30.99,1188
2021-04-05,18379,23780,-5401,-22.71,1188
2021-04-06,17972,23827,-5855,-24.57,1188
2021-04-07,17972,23876,-5904,-24.73,1188
2021-04-08,17972,23937,-5965,-24.92,1188
2021-04-09,18540,24262,-5722,-23.58,1188
2021-04-10,12776,19396,-6620,-34.13,1188
2021-04-11,7657,11430,-3773,-33.01,1188
2021-04-12,18379,24078,-5699,-23.67,1188
2021-04-13,17972,24085,-6113,-25.38,1188
2021-04-14,17972,24092,-6120,-25.4,1188
2021-04-15,17972,24111,-6139,-25.46,1188
2021-04-16,18540,24394,-5854,-24.0,1188
2021-04-17,12776,19488,-6712,-34.44,1188
2021-04-18,7657,11484,-3827,-33.32,1188
2021-04-19,18379,24097,-5718,-23.73,1188
2021-04-20,17972,24073,-6101,-25.34,1188
2021-04-21,17972,24054,-6082,-25.28,1188
2021-04-22,17972,24053,-6081,-25.28,1188
2021-04-23,18540,24321,-5781,-23.77,1188
2021-04-24,12776,19405,-6629,-34.16,1188
2021-04-25,7657,11398,-3741,-32.82,1188
2021-04-26,18379,24013,-5634,-23.46,1188
2021-04-27,17972,23998,-6026,-25.11,1188
2021-04-28,17972,23992,-6020,-25.09,1188
2021-04-29,17972,24007,-6035,-25.14,1188
2021-04-30,18540,24295,-5755,-23.69,1188
2021-05-01,18479,19402,-923,-4.76,1188
2021-05-02,8998,11419,-2421,-21.2,1188
2021-05-03,22844,24059,-1215,-5.05,1188
2021-05-04,22800,24068,-1268,-5.27,1188
2021-05-05,22800,24085,-1285,-5.34,1188
2021-05-06,22800,24120,-1320,-5.47,1188
2021-05-07,23059,24425,-1366,-5.59,1188
2021-05-08,18479,19546,-1067,-5.46,1188
2021-05-09,8998,11572,-2574,-22.24,1188
2021-05-10,22844,24216,-1372,-5.67,1188
2021-05-11,22800,24223,-1423,-5.87,1188
2021-05-12,22800,24233,-1433,-5.91,1188
2021-05-13,22800,24256,-1456,-6.0,1188
2021-05-14,23059,24545,-1486,-6.05,1188
2021-05-15,18479,19644,-1165,-5.93,1188
2021-05-16,8998,11645,-2647,-22.73,1188
2021-05-17,22844,24261,-1417,-5.84,1188
2021-05-18,22800,24237,-1437,-5.93,1188
2021-05-19,22800,24215,-1415,-5.84,1188
2021-05-20,22800,24207,-1407,-5.81,1188
2021-05-21,23059,24464,-1405,-5.74,1188
2021-05-22,18479,19533,-1054,-5.4,1188
2021-05-23,8998,11507,-2509,-21.8,1188
2021-05-24,22844,24099,-1255,-5.21,1188
2021-05-25,22800,24057,-1257,-5.23,1188
2021-05-26,22800,24021,-1221,-5.08,1188
2021-05-27,22800,24004,-1204,-5.02,1188
2021-05-28,23059,24259,-1200,-4.95,1188
2021-05-29,18479,19332,-853,-4.41,1188
2021-05-30,8998,11315,-2317,-20.48,1188
2021-05-31,22844,23922,-1078,-4.51,1188
2021-06-01,22681,23900,-1219,-5.1,1188
2021-06-02,22681,23889,-1208,-5.06,1188
2021-06-03,22681,23900,-1219,-5.1,1188
2021-06-04,22736,24185,-1449,-5.99,1188
2021-06-05,17797,19290,-1493,-7.74,1188
2021-06-06,10629,11305,-676,-5.98,1188
2021-06-07,22665,23943,-1278,-5.34,1188
2021-06-08,22681,23949,-1268,-5.29,1188
2021-06-09,22681,23962,-1281,-5.35,1188
2021-06-10,22681,23993,-1312,-5.47,1188
2021-06-11,22736,24291,-1555,-6.4,1188
2021-06-12,17797,19401,-1604,-8.27,1188
2021-06-13,10629,11414,-785,-6.88,1188
2021-06-14,22665,24041,-1376,-5.72,1188
2021-06-15,22681,24027,-1346,-5.6,1188
2021-06-16,22681,24011,-1330,-5.54,1188
2021-06-17,22681,24002,-1321,-5.5,1188
2021-06-18,22736,24253,-1517,-6.25,1188
2021-06-19,17797,19308,-1511,-7.83,1188
2021-06-20,10629,11257,-628,-5.58,1188
2021-06-21,22665,23815,-1150,-4.83,1188
2021-06-22,22681,23726,-1045,-4.4,1188
2021-06-23,22681,23631,-950,-4.02,1188
2021-06-24,22681,23542,-861,-3.66,1188
2021-06-25,22736,23712,-976,-4.12,1188
2021-06-26,17797,18688,-891,-4.77,1188
2021-06-27,10629,10562,67,0.63,1188
2021-06-28,22665,23048,-383,-1.66,1188
2021-06-29,22681,22895,-214,-0.93,1188
2021-06-30,22681,22744,-63,-0.28,1188
2021-07-01,19913,22609,-2696,-11.92,1188
2021-07-02,20429,22743,-2314,-10.17,1188
2021-07-03,15943,17695,-1752,-9.9,1188
2021-07-04,9288,9557,-269,-2.81,1188
2021-07-05,19760,22045,-2285,-10.37,1188
2021-07-06,19913,21906,-1993,-9.1,1188
2021-07-07,19913,21782,-1869,-8.58,1188
2021-07-08,19913,21686,-1773,-8.18,1188
2021-07-09,20429,21871,-1442,-6.59,1188
2021-07-10,15943,16883,-940,-5.57,1188
2021-07-11,9288,8814,474,5.38,1188
2021-07-12,19760,21379,-1619,-7.57,1188
2021-07-13,19913,21322,-1409,-6.61,1188
2021-07-14,19913,21284,-1371,-6.44,1188
2021-07-15,19913,21275,-1362,-6.4,1188
2021-07-16,20429,21547,-1118,-5.19,1188
2021-07-17,15943,16644,-701,-4.21,1188
2021-07-18,9288,8657,631,7.29,1188
2021-07-19,19760,21297,-1537,-7.22,1188
2021-07-20,19913,21308,-1395,-6.55,1188
2021-07-21,19913,21329,-1416,-6.64,1188
2021-07-22,19913,21369,-1456,-6.81,1188
2021-07-23,20429,21679,-1250,-5.77,1188
2021-07-24,15943,16803,-860,-5.12,1188
2021-07-25,9288,8831,457,5.17,1188
2021-07-26,19760,21474,-1714,-7.98,1188
2021-07-27,19913,21476,-1563,-7.28,1188
2021-07-28,19913,21479,-1566,-7.29,1188
2021-07-29,19913,21491,-1578,-7.34,1188
2021-07-30,20429,21764,-1335,-6.13,1188
2021-07-31,15943,16844,-901,-5.35,1188
2021-08-01,8786,8822,-36,-0.41,1188
2021-08-02,18921,21412,-2491,-11.63,1188
2021-08-03,18831,21360,-2529,-11.84,1188
2021-08-04,18831,21308,-2477,-11.62,1188
2021-08-05,18831,21268,-2437,-11.46,1188
2021-08-06,18984,21493,-2509,-11.67,1188
2021-08-07,14745,16530,-1785,-10.8,1188
2021-08-08,8786,8473,313,3.69,1188
2021-08-09,18921,21036,-2115,-10.05,1188
2021-08-10,18831,20967,-2136,-10.19,1188
2021-08-11,18831,20909,-2078,-9.94,1188
2021-08-12,18831,20874,-2043,-9.79,1188
2021-08-13,18984,21116,-2132,-10.1,1188
2021-08-14,14745,16182,-1437,-8.88,1188
2021-08-15,8786,8165,621,7.61,1188
2021-08-16,18921,20779,-1858,-8.94,1188
2021-08-17,18831,20771,-1940,-9.34,1188
2021-08-18,18831,20783,-1952,-9.39,1188
2021-08-19,18831,20824,-1993,-9.57,1188
2021-08-20,18984,21149,-2165,-10.24,1188
2021-08-21,14745,16302,-1557,-9.55,1188
2021-08-22,8786,8374,412,4.92,1188
2021-08-23,18921,21077,-2156,-10.23,1188
2021-08-24,18831,21156,-2325,-10.99,1188
2021-08-25,18831,21252,-2421,-11.39,1188
2021-08-26,18831,21372,-2541,-11.89,1188
2021-08-27,18984,21768,-2784,-12.79,1188
2021-08-28,14745,16984,-2239,-13.18,1188
2021-08-29,8786,9110,-324,-3.56,1188
2021-08-30,18921,21856,-2935,-13.43,1188
2021-08-31,18831,21967,-3136,-14.28,1188
2021-09-01,21231,22082,-851,-3.85,1188
2021-09-02,21231,22210,-979,-4.41,1188
2021-09-03,21537,22602,-1065,-4.71,1188
2021-09-04,17588,17802,-214,-1.2,1188
2021-09-05,11028,9901,1127,11.38,1188
2021-09-06,21320,22610,-1290,-5.71,1188
2021-09-07,21231,22676,-1445,-6.37,1188
2021-09-08,21231,22738,-1507,-6.63,1188
2021-09-09,21231,22807,-1576,-6.91,1188
2021-09-10,21537,23136,-1599,-6.91,1188
2021-09-11,17588,18269,-681,-3.73,1188
2021-09-12,11028,10300,728,7.07,1188
2021-09-13,21320,22943,-1623,-7.07,1188
2021-09-14,21231,22943,-1712,-7.46,1188
2021-09-15,21231,22943,-1712,-7.46,1188
2021-09-16,21231,22954,-1723,-7.51,1188
2021-09-17,21537,23231,-1694,-7.29,1188
2021-09-18,17588,18319,-731,-3.99,1188
2021-09-19,11028,10312,716,6.94,1188
2021-09-20,21320,22924,-1604,-7.0,1188
2021-09-21,21231,22902,-1671,-7.3,1188
2021-09-22,21231,22888,-1657,-7.24,1188
2021-09-23,21231,22893,-1662,-7.26,1188
2021-09-24,21537,23171,-1634,-7.05,1188
2021-09-25,17588,18267,-679,-3.72,1188
2021-09-26,11028,10274,754,7.34,1188
2021-09-27,21320,22905,-1585,-6.92,1188
2021-09-28,21231,22906,-1675,-7.31,1188
2021-09-29,21231,22917,-1686,-7.36,1188
2021-09-30,21231,22949,-1718,-7.49,1188
2021-10-01,22351,23255,-904,-3.89,1188
2021-10-02,18344,18378,-34,-0.19,1188
2021-10-03,10224,10410,-186,-1.79,1188
2021-10-04,21763,23063,-1300,-5.64,1188
2021-10-05,21945,23083,-1138,-4.93,1188
2021-10-06,21945,23109,-1164,-5.04,1188
2021-10-07,21945,23151,-1206,-5.21,1188
2021-10-08,22351,23461,-1110,-4.73,1188
2021-10-09,18344,18584,-240,-1.29,1188
2021-10-10,10224,10611,-387,-3.65,1188
2021-10-11,21763,23254,-1491,-6.41,1188
2021-10-12,21945,23259,-1314,-5.65,1188
2021-10-13,21945,23266,-1321,-5.68,1188
2021-10-14,21945,23286,-1341,-5.76,1188
2021-10-15,22351,23571,-1220,-5.18,1188
2021-10-16,18344,18667,-323,-1.73,1188
2021-10-17,10224,10667,-443,-4.15,1188
2021-10-18,21763,23282,-1519,-6.52,1188
2021-10-19,21945,23260,-1315,-5.65,1188
2021-10-20,21945,23242,-1297,-5.58,1188
2021-10-21,21945,23240,-1295,-5.57,1188
2021-10-22,22351,23506,-1155,-4.91,1188
2021-10-23,18344,18586,-242,-1.3,1188
2021-10-24,10224,10574,-350,-3.31,1188
2021-10-25,21763,23183,-1420,-6.13,1188
2021-10-26,21945,23159,-1214,-5.24,1188
2021-10-27,21945,23143,-1198,-5.18,1188
2021-10-28,21945,23147,-1202,-5.19,1188
2021-10-29,22351,23424,-1073,-4.58,1188
2021-10-30,18344,18519,-175,-0.94,1188
2021-10-31,10224,10524,-300,-2.85,1188
2021-11-01,19542,23152,-3610,-15.59,1188
2021-11-02,20377,23148,-2771,-11.97,1188
2021-11-03,20377,23154,-2777,-11.99,1188
2021-11-04,20377,23180,-2803,-12.09,1188
2021-11-05,21425,23477,-2052,-8.74,1188
2021-11-06,16944,18591,-1647,-8.86,1188
2021-11-07,9349,10613,-1264,-11.91,1188
2021-11-08,19542,23254,-3712,-15.96,1188
2021-11-09,20377,23260,-2883,-12.39,1188
2021-11-10,20377,23272,-2895,-12.44,1188
2021-11-11,20377,23299,-2922,-12.54,1188
2021-11-12,21425,23593,-2168,-9.19,1188
2021-11-13,16944,18699,-1755,-9.39,1188
2021-11-14,9349,10708,-1359,-12.69,1188
2021-11-15,19542,23334,-3792,-16.25,1188
2021-11-16,20377,23321,-2944,-12.62,1188
2021-11-17,20377,23311,-2934,-12.59,1188
2021-11-18,20377,23314,-2937,-12.6,1188
2021-11-19,21425,23584,-2159,-9.15,1188
2021-11-20,16944,18664,-1720,-9.22,1188
2021-11-21,9349,10649,-1300,-12.21,1188
2021-11-22,19542,23251,-3709,-15.95,1188
2021-11-23,20377,23216,-2839,-12.23,1188
2021-11-24,20377,23187,-2810,-12.12,1188
2021-11-25,20377,23175,-2798,-12.07,1188
2021-11-26,21425,23433,-2008,-8.57,1188
2021-11-27,16944,18507,-1563,-8.45,1188
2021-11-28,9349,10490,-1141,-10.88,1188
2021-11-29,19542,23094,-3552,-15.38,1188
2021-11-30,20377,23068,-2691,-11.67,1188
2021-12-01,19300,23052,-3752,-16.28,1188
2021-12-02,19300,23056,-3756,-16.29,1188
2021-12-03,17304,23334,-6030,-25.84,1188
2021-12-04,14809,18432,-3623,-19.66,1188
2021-12-05,8633,10440,-1807,-17.31,1188
2021-12-06,20348,23072,-2724,-11.81,1188
2021-12-07,19300,23072,-3772,-16.35,1188
2021-12-08,19300,23082,-3782,-16.39,1188
2021-12-09,19300,23111,-3811,-16.49,1188
2021-12-10,17304,23411,-6107,-26.09,1188
2021-12-11,14809,18526,-3717,-20.06,1188
2021-12-12,8633,10547,-1914,-18.15,1188
2021-12-13,20348,23185,-2837,-12.24,1188
2021-12-14,19300,23187,-3887,-16.76,1188
2021-12-15,19300,23190,-3890,-16.77,1188
2021-12-16,19300,23206,-3906,-16.83,1188
2021-12-17,17304,23486,-6182,-26.32,1188
2021-12-18,14809,18573,-3764,-20.27,1188
2021-12-19,8633,10560,-1927,-18.25,1188
2021-12-20,20348,23158,-2810,-12.13,1188
2021-12-21,19300,23113,-3813,-16.5,1188
2021-12-22,19300,23065,-3765,-16.32,1188
2021-12-23,19300,23026,-3726,-16.18,1188
2021-12-24,17304,23248,-5944,-25.57,1188
2021-12-25,14809,18276,-3467,-18.97,1188
2021-12-26,8633,10204,-1571,-15.4,1188
2021-12-27,20348,22744,-2396,-10.53,1188
2021-12-28,19300,22644,-3344,-14.77,1188
2021-12-29,19300,22546,-3246,-14.4,1188
2021-12-30,19300,22461,-3161,-14.07,1188
2021-12-31,17304,22644,-5340,-23.58,1188
2022-01-01,15854,17641,-1787,-10.13,1188
2022-01-02,7791,9546,-1755,-18.38,1188
2022-01-03,18993,22072,-3079,-13.95,1188
2022-01-04,18729,21968,-3239,-14.74,1188
2022-01-05,18729,21876,-3147,-14.39,1188
2022-01-06,18729,21807,-3078,-14.11,1188
2022-01-07,19460,22015,-2555,-11.61,1188
2022-01-08,15854,17046,-1192,-6.99,1188
2022-01-09,7791,8994,-1203,-13.38,1188
2022-01-10,18993,21571,-2578,-11.95,1188
2022-01-11,18729,21524,-2795,-12.99,1188
2022-01-12,18729,21495,-2766,-12.87,1188
2022-01-13,18729,21493,-2764,-12.86,1188
2022-01-14,19460,21771,-2311,-10.62,1188
2022-01-15,15854,16873,-1019,-6.04,1188
2022-01-16,7791,8892,-1101,-12.38,1188
2022-01-17,18993,21539,-2546,-11.82,1188
2022-01-18,18729,21559,-2830,-13.13,1188
2022-01-19,18729,21592,-2863,-13.26,1188
2022-01-20,18729,21648,-2919,-13.48,1188
2022-01-21,19460,21977,-2517,-11.45,1188
2022-01-22,15854,17124,-1270,-7.42,1188
2022-01-23,7791,9180,-1389,-15.13,1188
2022-01-24,18993,21856,-2863,-13.1,1188
2022-01-25,18729,21897,-3168,-14.47,1188
2022-01-26,18729,21942,-3213,-14.64,1188
2022-01-27,18729,22003,-3274,-14.88,1188
2022-01-28,19460,22330,-2870,-12.85,1188
2022-01-29,15854,17468,-1614,-9.24,1188
2022-01-30,7791,9509,-1718,-18.07,1188
2020-02-01,7490,6839,651,9.52,1200
2020-02-02,4802,4263,539,12.64,1200
2020-02-03,16042,15838,204,1.29,1200
2020-02-04,16377,16226,151,0.93,1200
2020-02-05,16377,16246,131,0.81,1200
2020-02-06,16377,16259,118,0.73,1200
2020-02-07,15482,15233,249,1.63,1200
2020-02-08,7490,6952,538,7.74,1200
2020-02-09,4802,4358,444,10.19,1200
2020-02-10,16042,15918,124,0.78,1200
2020-02-11,16377,16294,83,0.51,1200
2020-02-12,16377,16304,73,0.45,1200
2020-02-13,16377,16311,66,0.4,1200
2020-02-14,15482,15283,199,1.3,1200
2020-02-15,7490,7003,487,6.95,1200
2020-02-16,4802,4414,388,8.79,1200
2020-02-17,16042,15983,59,0.37,1200
2020-02-18,16377,16370,7,0.04,1200
2020-02-19,16377,16394,-17,-0.1,1200
2020-02-20,16377,16418,-41,-0.25,1200
2020-02-21,15482,15409,73,0.47,1200
2020-02-22,7490,7149,341,4.77,1200
2020-02-23,4802,4580,222,4.85,1200
2020-02-24,16042,16168,-126,-0.78,1200
2020-02-25,16377,16574,-197,-1.19,1200
2020-02-26,16377,16616,-239,-1.44,1200
2020-02-27,16377,16656,-279,-1.68,1200
2020-02-28,15482,15659,-177,-1.13,1200
2020-02-29,7490,7409,81,1.09,1200
2020-03-01,3600,4847,-1247,-25.73,1200
2020-03-02,12171,16438,-4267,-25.96,1200
2020-03-03,12329,16843,-4514,-26.8,1200
2020-03-04,12329,16881,-4552,-26.97,1200
2020-03-05,12329,16912,-4583,-27.1,1200
2020-03-06,11995,15905,-3910,-24.58,1200
2020-03-07,5327,7640,-2313,-30.27,1200
2020-03-08,3600,5061,-1461,-28.87,1200
2020-03-09,12171,16633,-4462,-26.83,1200
2020-03-10,12329,17018,-4689,-27.55,1200
2020-03-11,12329,17034,-4705,-27.62,1200
2020-03-12,12329,17044,-4715,-27.66,1200
2020-03-13,11995,16015,-4020,-25.1,1200
2020-03-14,5327,7730,-2403,-31.09,1200
2020-03-15,3600,5133,-1533,-29.87,1200
2020-03-16,12171,16688,-4517,-27.07,1200
2020-03-17,12329,17059,-4730,-27.73,1200
2020-03-18,12329,17065,-4736,-27.75,1200
2020-03-19,12329,17067,-4738,-27.76,1200
2020-03-20,11995,16034,-4039,-25.19,1200
2020-03-21,5327,7749,-2422,-31.26,1200
2020-03-22,3600,5155,-1555,-30.16,1200
2020-03-23,12171,16717,-4546,-27.19,1200
2020-03-24,12329,17098,-4769,-27.89,1200
2020-03-25,12329,17116,-4787,-27.97,1200
2020-03-26,12329,17133,-4804,-28.04,1200
2020-03-27,11995,16117,-4122,-25.58,1200
2020-03-28,5327,7850,-2523,-32.14,1200
2020-03-29,3600,5274,-1674,-31.74,1200
2020-03-30,12171,16855,-4684,-27.79,1200
2020-03-31,12329,17255,-4926,-28.55,1200
2020-04-01,10950,17290,-6340,-36.67,1200
2020-04-02,10950,17323,-6373,-36.79,1200
2020-04-03,9503,16319,-6816,-41.77,1200
2020-04-04,4443,8062,-3619,-44.89,1200
2020-04-05,2470,5494,-3024,-55.04,1200
2020-04-06,10862,17079,-6217,-36.4,1200
2020-04-07,10950,17478,-6528,-37.35,1200
2020-04-08,10950,17510,-6560,-37.46,1200
2020-04-09,10950,17536,-6586,-37.56,1200
2020-04-10,9503,16522,-7019,-42.48,1200
2020-04-11,4443,8251,-3808,-46.15,1200
2020-04-12,2470,5667,-3197,-56.41,1200
2020-04-13,10862,17232,-6370,-36.97,1200
2020-04-14,10950,17611,-6661,-37.82,1200
2020-04-15,10950,17621,-6671,-37.86,1200
2020-04-16,10950,17624,-6674,-37.87,1200
2020-04-17,9503,16587,-7084,-42.71,1200
2020-04-18,4443,8294,-3851,-46.43,1200
2020-04-19,2470,5688,-3218,-56.58,1200
2020-04-20,10862,17235,-6373,-36.98,1200
2020-04-21,10950,17596,-6646,-37.77,1200
2020-04-22,10950,17591,-6641,-37.75,1200
2020-04-23,10950,17583,-6633,-37.72,1200
2020-04-24,9503,16538,-7035,-42.54,1200
2020-04-25,4443,8240,-3797,-46.08,1200
2020-04-26,2470,5632,-3162,-56.14,1200
2020-04-27,10862,17180,-6318,-36.78,1200
2020-04-28,10950,17546,-6596,-37.59,1200
2020-04-29,10950,17549,-6599,-37.6,1200
2020-04-30,10950,17550,-6600,-37.61,1200
2020-05-01,13746,16518,-2772,-16.78,1200
2020-05-02,7085,8234,-1149,-13.95,1200
2020-05-03,4011,5641,-1630,-28.9,1200
2020-05-04,14787,17204,-2417,-14.05,1200
2020-05-05,15103,17585,-2482,-14.11,1200
2020-05-06,15103,17602,-2499,-14.2,1200
2020-05-07,15103,17617,-2514,-14.27,1200
2020-05-08,13746,16595,-2849,-17.17,1200
2020-05-09,7085,8320,-1235,-14.84,1200
2020-05-10,4011,5733,-1722,-30.04,1200
2020-05-11,14787,17299,-2512,-14.52,1200
2020-05-12,15103,17681,-2578,-14.58,1200
2020-05-13,15103,17694,-2591,-14.64,1200
2020-05-14,15103,17702,-2599,-14.68,1200
2020-05-15,13746,16671,-2925,-17.55,1200
2020-05-16,7085,8383,-1298,-15.48,1200
2020-05-17,4011,5781,-1770,-30.62,1200
2020-05-18,14787,17330,-2543,-14.67,1200
2020-05-19,15103,17692,-2589,-14.63,1200
2020-05-20,15103,17686,-2583,-14.6,1200
2020-05-21,15103,17673,-2570,-14.54,1200
2020-05-22,13746,16621,-2875,-17.3,1200
2020-05-23,7085,8314,-1229,-14.78,1200
2020-05-24,4011,5693,-1682,-29.55,1200
2020-05-25,14787,17226,-2439,-14.16,1200
2020-05-26,15103,17574,-2471,-14.06,1200
2020-05-27,15103,17556,-2453,-13.97,1200
2020-05-28,15103,17535,-2432,-13.87,1200
2020-05-29,13746,16478,-2732,-16.58,1200
2020-05-30,7085,8169,-1084,-13.27,1200
2020-05-31,4011,5550,-1539,-27.73,1200
2020-06-01,15906,17088,-1182,-6.92,1200
2020-06-02,16258,17444,-1186,-6.8,1200
2020-06-03,16258,17438,-1180,-6.77,1200
2020-06-04,16258,17430,-1172,-6.72,1200
2020-06-05,14620,16388,-1768,-10.79,1200
2020-06-06,7194,8096,-902,-11.14,1200
2020-06-07,4670,5494,-824,-15.0,1200
2020-06-08,15906,17049,-1143,-6.7,1200
2020-06-09,16258,17422,-1164,-6.68,1200
2020-06-10,16258,17431,-1173,-6.73,1200
2020-06-11,16258,17436,-1178,-6.76,1200
2020-06-12,14620,16404,-1784,-10.88,1200
2020-06-13,7194,8118,-924,-11.38,1200
2020-06-14,4670,5520,-850,-15.4,1200
2020-06-15,15906,17074,-1168,-6.84,1200
2020-06-16,16258,17441,-1183,-6.78,1200
2020-06-17,16258,17440,-1182,-6.78,1200
2020-06-18,16258,17431,-1173,-6.73,1200
2020-06-19,14620,16381,-1761,-10.75,1200
2020-06-20,7194,8073,-879,-10.89,1200
2020-06-21,4670,5449,-779,-14.3,1200
2020-06-22,15906,16974,-1068,-6.29,1200
2020-06-23,16258,17310,-1052,-6.08,1200
2020-06-24,16258,17276,-1018,-5.89,1200
2020-06-25,16258,17234,-976,-5.66,1200
2020-06-26,14620,16151,-1531,-9.48,1200
2020-06-27,7194,7811,-617,-7.9,1200
2020-06-28,4670,5156,-486,-9.43,1200
2020-06-29,15906,16654,-748,-4.49,1200
2020-06-30,16258,16966,-708,-4.17,1200
2020-07-01,15948,16912,-964,-5.7,1200
2020-07-02,15948,16854,-906,-5.38,1200
2020-07-03,14777,15761,-984,-6.24,1200
2020-07-04,7272,7416,-144,-1.94,1200
2020-07-05,5004,4762,242,5.08,1200
2020-07-06,15658,16266,-608,-3.74,1200
2020-07-07,15948,16591,-643,-3.88,1200
2020-07-08,15948,16554,-606,-3.66,1200
2020-07-09,15948,16518,-570,-3.45,1200
2020-07-10,14777,15451,-674,-4.36,1200
2020-07-11,7272,7136,136,1.91,1200
2020-07-12,5004,4515,489,10.83,1200
2020-07-13,15658,16053,-395,-2.46,1200
2020-07-14,15948,16412,-464,-2.83,1200
2020-07-15,15948,16410,-462,-2.82,1200
2020-07-16,15948,16408,-460,-2.8,1200
2020-07-17,14777,15373,-596,-3.88,1200
2020-07-18,7272,7086,186,2.62,1200
2020-07-19,5004,4489,515,11.47,1200
2020-07-20,15658,16047,-389,-2.42,1200
2020-07-21,15948,16420,-472,-2.87,1200
2020-07-22,15948,16427,-479,-2.92,1200
2020-07-23,15948,16427,-479,-2.92,1200
2020-07-24,14777,15388,-611,-3.97,1200
2020-07-25,7272,7091,181,2.55,1200
2020-07-26,5004,4479,525,11.72,1200
2020-07-27,15658,16016,-358,-2.24,1200
2020-07-28,15948,16364,-416,-2.54,1200
2020-07-29,15948,16340,-392,-2.4,1200
2020-07-30,15948,16308,-360,-2.21,1200
2020-07-31,14777,15233,-456,-2.99,1200
2020-08-01,7097,6900,197,2.86,1200
2020-08-02,4931,4251,680,16.0,1200
2020-08-03,15372,15753,-381,-2.42,1200
2020-08-04,15367,16068,-701,-4.36,1200
2020-08-05,15367,16016,-649,-4.05,1200
2020-08-06,15367,15959,-592,-3.71,1200
2020-08-07,14320,14865,-545,-3.67,1200
2020-08-08,7097,6520,577,8.85,1200
2020-08-09,4931,3866,1065,27.55,1200
2020-08-10,15372,15371,1,0.01,1200
2020-08-11,15367,15696,-329,-2.1,1200
2020-08-12,15367,15663,-296,-1.89,1200
2020-08-13,15367,15633,-266,-1.7,1200
2020-08-14,14320,14575,-255,-1.75,1200
2020-08-15,7097,6273,824,13.14,1200
2020-08-16,4931,3668,1263,34.43,1200
2020-08-17,15372,15228,144,0.95,1200
2020-08-18,15367,15614,-247,-1.58,1200
2020-08-19,15367,15645,-278,-1.78,1200
2020-08-20,15367,15682,-315,-2.01,1200
2020-08-21,14320,14692,-372,-2.53,1200
2020-08-22,7097,6457,640,9.91,1200
2020-08-23,4931,3920,1011,25.79,1200
2020-08-24,15372,15543,-171,-1.1,1200
2020-08-25,15367,15989,-622,-3.89,1200
2020-08-26,15367,16075,-708,-4.4,1200
2020-08-27,15367,16160,-793,-4.91,1200
2020-08-28,14320,15211,-891,-5.86,1200
2020-08-29,7097,7010,87,1.24,1200
2020-08-30,4931,4497,434,9.65,1200
2020-08-31,15372,16137,-765,-4.74,1200
2020-09-01,15992,16590,-598,-3.6,1200
2020-09-02,15992,16674,-682,-4.09,1200
2020-09-03,15992,16749,-757,-4.52,1200
2020-09-04,14867,15782,-915,-5.8,1200
2020-09-05,7510,7555,-45,-0.6,1200
2020-09-06,4952,5010,-58,-1.16,1200
2020-09-07,15620,16612,-992,-5.97,1200
2020-09-08,15992,17023,-1031,-6.06,1200
2020-09-09,15992,17062,-1070,-6.27,1200
2020-09-10,15992,17089,-1097,-6.42,1200
2020-09-11,14867,16074,-1207,-7.51,1200
2020-09-12,7510,7799,-289,-3.71,1200
2020-09-13,4952,5207,-255,-4.9,1200
2020-09-14,15620,16766,-1146,-6.84,1200
2020-09-15,15992,17136,-1144,-6.68,1200
2020-09-16,15992,17139,-1147,-6.69,1200
2020-09-17,15992,17136,-1144,-6.68,1200
2020-09-18,14867,16096,-1229,-7.64,1200
2020-09-19,7510,7802,-292,-3.74,1200
2020-09-20,4952,5198,-246,-4.73,1200
2020-09-21,15620,16749,-1129,-6.74,1200
2020-09-22,15992,17120,-1128,-6.59,1200
2020-09-23,15992,17128,-1136,-6.63,1200
2020-09-24,15992,17135,-1143,-6.67,1200
2020-09-25,14867,16109,-1242,-7.71,1200
2020-09-26,7510,7834,-324,-4.14,1200
2020-09-27,4952,5251,-299,-5.69,1200
2020-09-28,15620,16825,-1205,-7.16,1200
2020-09-29,15992,17220,-1228,-7.13,1200
2020-09-30,15992,17251,-1259,-7.3,1200
2020-10-01,16308,17281,-973,-5.63,1200
2020-10-02,15514,16277,-763,-4.69,1200
2020-10-03,7717,8019,-302,-3.77,1200
2020-10-04,4685,5451,-766,-14.05,1200
2020-10-05,16098,17037,-939,-5.51,1200
2020-10-06,16308,17437,-1129,-6.47,1200
2020-10-07,16308,17471,-1163,-6.66,1200
2020-10-08,16308,17498,-1190,-6.8,1200
2020-10-09,15514,16485,-971,-5.89,1200
2020-10-10,7717,8215,-498,-6.06,1200
2020-10-11,4685,5630,-945,-16.79,1200
2020-10-12,16098,17196,-1098,-6.39,1200
2020-10-13,16308,17573,-1265,-7.2,1200
2020-10-14,16308,17581,-1273,-7.24,1200
2020-10-15,16308,17581,-1273,-7.24,1200
2020-10-16,15514,16540,-1026,-6.2,1200
2020-10-17,7717,8243,-526,-6.38,1200
2020-10-18,4685,5632,-947,-16.81,1200
2020-10-19,16098,17172,-1074,-6.25,1200
2020-10-20,16308,17528,-1220,-6.96,1200
2020-10-21,16308,17517,-1209,-6.9,1200
2020-10-22,16308,17503,-1195,-6.83,1200
2020-10-23,15514,16453,-939,-5.71,1200
2020-10-24,7717,8150,-433,-5.31,1200
2020-10-25,4685,5539,-854,-15.42,1200
2020-10-26,16098,17085,-987,-5.78,1200
2020-10-27,16308,17450,-1142,-6.54,1200
2020-10-28,16308,17454,-1146,-6.57,1200
2020-10-29,16308,17457,-1149,-6.58,1200
2020-10-30,15514,16429,-915,-5.57,1200
2020-10-31,7717,8151,-434,-5.32,1200
2020-11-01,3890,5566,-1676,-30.11,1200
2020-11-02,15076,17139,-2063,-12.04,1200
2020-11-03,14308,17532,-3224,-18.39,1200
2020-11-04,14308,17561,-3253,-18.52,1200
2020-11-05,14308,17589,-3281,-18.65,1200
2020-11-06,13628,16582,-2954,-17.81,1200
2020-11-07,6207,8322,-2115,-25.41,1200
2020-11-08,3890,5750,-1860,-32.35,1200
2020-11-09,15076,17330,-2254,-13.01,1200
2020-11-10,14308,17724,-3416,-19.27,1200
2020-11-11,14308,17750,-3442,-19.39,1200
2020-11-12,14308,17767,-3459,-19.47,1200
2020-11-13,13628,16742,-3114,-18.6,1200
2020-11-14,6207,8457,-2250,-26.61,1200
2020-11-15,3890,5855,-1965,-33.56,1200
2020-11-16,15076,17400,-2324,-13.36,1200
2020-11-17,14308,17754,-3446,-19.41,1200
2020-11-18,14308,17734,-3426,-19.32,1200
2020-11-19,14308,17703,-3395,-19.18,1200
2020-11-20,13628,16627,-2999,-18.04,1200
2020-11-21,6207,8291,-2084,-25.14,1200
2020-11-22,3890,5637,-1747,-30.99,1200
2020-11-23,15076,17131,-2055,-12.0,1200
2020-11-24,14308,17435,-3127,-17.94,1200
2020-11-25,14308,17370,-3062,-17.63,1200
2020-11-26,14308,17298,-2990,-17.29,1200
2020-11-27,13628,16186,-2558,-15.8,1200
2020-11-28,6207,7819,-1612,-20.62,1200
2020-11-29,3890,5141,-1251,-24.33,1200
2020-11-30,15076,16618,-1542,-9.28,1200
2020-12-01,13300,16913,-3613,-21.36,1200
2020-12-02,13300,16846,-3546,-21.05,1200
2020-12-03,13300,16778,-3478,-20.73,1200
2020-12-04,14552,15678,-1126,-7.18,1200
2020-12-05,7106,7330,-224,-3.06,1200
2020-12-06,3785,4676,-891,-19.05,1200
2020-12-07,13964,16182,-2218,-13.71,1200
2020-12-08,13300,16511,-3211,-19.45,1200
2020-12-09,13300,16480,-3180,-19.3,1200
2020-12-10,13300,16451,-3151,-19.15,1200
2020-12-11,14552,15391,-839,-5.45,1200
2020-12-12,7106,7083,23,0.32,1200
2020-12-13,3785,4469,-684,-15.31,1200
2020-12-14,13964,16012,-2048,-12.79,1200
2020-12-15,13300,16375,-3075,-18.78,1200
2020-12-16,13300,16374,-3074,-18.77,1200
2020-12-17,13300,16371,-3071,-18.76,1200
2020-12-18,14552,15332,-780,-5.09,1200
2020-12-19,7106,7039,67,0.95,1200
2020-12-20,3785,4434,-649,-14.64,1200
2020-12-21,13964,15980,-2016,-12.62,1200
2020-12-22,13300,16340,-3040,-18.6,1200
2020-12-23,13300,16331,-3031,-18.56,1200
2020-12-24,13300,16315,-3015,-18.48,1200
2020-12-25,14552,15258,-706,-4.63,1200
2020-12-26,7106,6942,164,2.36,1200
2020-12-27,3785,4312,-527,-12.22,1200
2020-12-28,13964,15831,-1867,-11.79,1200
2020-12-29,13300,16163,-2863,-17.71,1200
2020-12-30,13300,16126,-2826,-17.52,1200
2020-12-31,13300,16081,-2781,-17.29,1200
2021-01-01,12356,14998,-2642,-17.62,1200
2021-01-02,5109,6660,-1551,-23.29,1200
2021-01-03,3289,4010,-721,-17.98,1200
2021-01-04,12752,15514,-2762,-17.8,1200
2021-01-05,13174,15835,-2661,-16.8,1200
2021-01-06,13174,15792,-2618,-16.58,1200
2021-01-07,13174,15749,-2575,-16.35,1200
2021-01-08,12356,14672,-2316,-15.79,1200
2021-01-09,5109,6346,-1237,-19.49,1200
2021-01-10,3289,3714,-425,-11.44,1200
2021-01-11,12752,15241,-2489,-16.33,1200
2021-01-12,13174,15591,-2417,-15.5,1200
2021-01-13,13174,15581,-2407,-15.45,1200
2021-01-14,13174,15574,-2400,-15.41,1200
2021-01-15,12356,14536,-2180,-15.0,1200
2021-01-16,5109,6251,-1142,-18.27,1200
2021-01-17,3289,3661,-372,-10.16,1200
2021-01-18,12752,15231,-2479,-16.28,1200
2021-01-19,13174,15622,-2448,-15.67,1200
2021-01-20,13174,15652,-2478,-15.83,1200
2021-01-21,13174,15682,-2508,-15.99,1200
2021-01-22,12356,14679,-2323,-15.83,1200
2021-01-23,5109,6424,-1315,-20.47,1200
2021-01-24,3289,3860,-571,-14.79,1200
2021-01-25,12752,15451,-2699,-17.47,1200
2021-01-26,13174,15858,-2684,-16.93,1200
2021-01-27,13174,15899,-2725,-17.14,1200
2021-01-28,13174,15935,-2761,-17.33,1200
2021-01-29,12356,14932,-2576,-17.25,1200
2021-01-30,5109,6673,-1564,-23.44,1200
2021-01-31,3289,4101,-812,-19.8,1200
2021-02-01,14583,15679,-1096,-6.99,1200
2021-02-02,14671,16071,-1400,-8.71,1200
2021-02-03,14671,16095,-1424,-8.85,1200
2021-02-04,14671,16111,-1440,-8.94,1200
2021-02-05,13842,15089,-1247,-8.26,1200
2021-02-06,6651,6810,-159,-2.33,1200
2021-02-07,3960,4218,-258,-6.12,1200
2021-02-08,14583,15779,-1196,-7.58,1200
2021-02-09,14671,16155,-1484,-9.19,1200
2021-02-10,14671,16165,-1494,-9.24,1200
2021-02-11,14671,16171,-1500,-9.28,1200
2021-02-12,13842,15142,-1300,-8.59,1200
2021-02-13,6651,6860,-209,-3.05,1200
2021-02-14,3960,4268,-308,-7.22,1200
2021-02-15,14583,15833,-1250,-7.89,1200
2021-02-16,14671,16217,-1546,-9.53,1200
2021-02-17,14671,16238,-1567,-9.65,1200
2021-02-18,14671,16258,-1587,-9.76,1200
2021-02-19,13842,15245,-1403,-9.2,1200
2021-02-20,6651,6981,-330,-4.73,1200
2021-02-21,3960,4409,-449,-10.18,1200
2021-02-22,14583,15994,-1411,-8.82,1200
2021-02-23,14671,16397,-1726,-10.53,1200
2021-02-24,14671,16438,-1767,-10.75,1200
2021-02-25,14671,16476,-1805,-10.96,1200
2021-02-26,13842,15478,-1636,-10.57,1200
2021-02-27,6651,7228,-577,-7.98,1200
2021-02-28,3960,4667,-707,-15.15,1200
2021-03-01,15346,16259,-913,-5.62,1200
2021-03-02,15476,16667,-1191,-7.15,1200
2021-03-03,15476,16707,-1231,-7.37,1200
2021-03-04,15476,16742,-1266,-7.56,1200
2021-03-05,14551,15737,-1186,-7.54,1200
2021-03-06,7172,7477,-305,-4.08,1200
2021-03-07,4022,4902,-880,-17.95,1200
2021-03-08,15346,16478,-1132,-6.87,1200
2021-03-09,15476,16867,-1391,-8.25,1200
2021-03-10,15476,16887,-1411,-8.36,1200
2021-03-11,15476,16901,-1425,-8.43,1200
2021-03-12,14551,15875,-1324,-8.34,1200
2021-03-13,7172,7592,-420,-5.53,1200
2021-03-14,4022,4997,-975,-19.51,1200
2021-03-15,15346,16554,-1208,-7.3,1200
2021-03-16,15476,16926,-1450,-8.57,1200
2021-03-17,15476,16932,-1456,-8.6,1200
2021-03-18,15476,16934,-1458,-8.61,1200
2021-03-19,14551,15899,-1348,-8.48,1200
2021-03-20,7172,7612,-440,-5.78,1200
2021-03-21,4022,5015,-993,-19.8,1200
2021-03-22,15346,16575,-1229,-7.41,1200
2021-03-23,15476,16953,-1477,-8.71,1200
2021-03-24,15476,16967,-1491,-8.79,1200
2021-03-25,15476,16981,-1505,-8.86,1200
2021-03-26,14551,15961,-1410,-8.83,1200
2021-03-27,7172,7691,-519,-6.75,1200
2021-03-28,4022,5112,-1090,-21.32,1200
2021-03-29,15346,16690,-1344,-8.05,1200
2021-03-30,15476,17086,-1610,-9.42,1200
2021-03-31,15476,17120,-1644,-9.6,1200
2021-04-01,14725,17151,-2426,-14.14,1200
2021-04-02,13627,16147,-2520,-15.61,1200
2021-04-03,6248,7890,-1642,-20.81,1200
2021-04-04,3846,5322,-1476,-27.73,1200
2021-04-05,14673,16908,-2235,-13.22,1200
2021-04-06,14725,17309,-2584,-14.93,1200
2021-04-07,14725,17344,-2619,-15.1,1200
2021-04-08,14725,17372,-2647,-15.24,1200
2021-04-09,13627,16362,-2735,-16.72,1200
2021-04-10,6248,8095,-1847,-22.82,1200
2021-04-11,3846,5515,-1669,-30.26,1200
2021-04-12,14673,17085,-2412,-14.12,1200
2021-04-13,14725,17468,-2743,-15.7,1200
2021-04-14,14725,17482,-2757,-15.77,1200
2021-04-15,14725,17489,-2764,-15.8,1200
2021-04-16,13627,16456,-2829,-17.19,1200
2021-04-17,6248,8166,-1918,-23.49,1200
2021-04-18,3846,5563,-1717,-30.86,1200
2021-04-19,14673,17112,-2439,-14.25,1200
2021-04-20,14725,17475,-2750,-15.74,1200
2021-04-21,14725,17471,-2746,-15.72,1200
2021-04-22,14725,17463,-2738,-15.68,1200
2021-04-23,13627,16417,-2790,-16.99,1200
2021-04-24,6248,8119,-1871,-23.04,1200
2021-04-25,3846,5509,-1663,-30.19,1200
2021-04-26,14673,17055,-2382,-13.97,1200
2021-04-27,14725,17419,-2694,-15.47,1200
2021-04-28,14725,17420,-2695,-15.47,1200
2021-04-29,14725,17418,-2693,-15.46,1200
2021-04-30,13627,16382,-2755,-16.82,1200
2021-05-01,7896,8095,-199,-2.46,1200
2021-05-02,4462,5500,-1038,-18.87,1200
2021-05-03,16087,17060,-973,-5.7,1200
2021-05-04,16537,17440,-903,-5.18,1200
2021-05-05,16537,17455,-918,-5.26,1200
2021-05-06,16537,17468,-931,-5.33,1200
2021-05-07,15523,16446,-923,-5.61,1200
2021-05-08,7896,8170,-274,-3.35,1200
2021-05-09,4462,5584,-1122,-20.09,1200
2021-05-10,16087,17151,-1064,-6.2,1200
2021-05-11,16537,17534,-997,-5.69,1200
2021-05-12,16537,17551,-1014,-5.78,1200
2021-05-13,16537,17561,-1024,-5.83,1200
2021-05-14,15523,16533,-1010,-6.11,1200
2021-05-15,7896,8249,-353,-4.28,1200
2021-05-16,4462,5650,-1188,-21.03,1200
2021-05-17,16087,17203,-1116,-6.49,1200
2021-05-18,16537,17570,-1033,-5.88,1200
2021-05-19,16537,17567,-1030,-5.86,1200
2021-05-20,16537,17558,-1021,-5.82,1200
2021-05-21,15523,16509,-986,-5.97,1200
2021-05-22,7896,8204,-308,-3.75,1200
2021-05-23,4462,5586,-1124,-20.12,1200
2021-05-24,16087,17120,-1033,-6.03,1200
2021-05-25,16537,17469,-932,-5.34,1200
2021-05-26,16537,17452,-915,-5.24,1200
2021-05-27,16537,17430,-893,-5.12,1200
2021-05-28,15523,16373,-850,-5.19,1200
2021-05-29,7896,8062,-166,-2.06,1200
2021-05-30,4462,5441,-979,-17.99,1200
2021-05-31,16087,16976,-889,-5.24,1200
2021-06-01,16620,17330,-710,-4.1,1200
2021-06-02,16620,17320,-700,-4.04,1200
2021-06-03,16620,17309,-689,-3.98,1200
2021-06-04,15074,16264,-1190,-7.32,1200
2021-06-05,7835,7968,-133,-1.67,1200
2021-06-06,5385,5364,21,0.39,1200
2021-06-07,16212,16916,-704,-4.16,1200
2021-06-08,16620,17287,-667,-3.86,1200
2021-06-09,16620,17294,-674,-3.9,1200
2021-06-10,16620,17298,-678,-3.92,1200
2021-06-11,15074,16267,-1193,-7.33,1200
2021-06-12,7835,7982,-147,-1.84,1200
2021-06-13,5385,5385,0,0.0,1200
2021-06-14,16212,16942,-730,-4.31,1200
2021-06-15,16620,17312,-692,-4.0,1200
2021-06-16,16620,17315,-695,-4.01,1200
2021-06-17,16620,17311,-691,-3.99,1200
2021-06-18,15074,16266,-1192,-7.33,1200
2021-06-19,7835,7964,-129,-1.62,1200
2021-06-20,5385,5346,39,0.73,1200
2021-06-21,16212,16877,-665,-3.94,1200
2021-06-22,16620,17220,-600,-3.48,1200
2021-06-23,16620,17192,-572,-3.33,1200
2021-06-24,16620,17155,-535,-3.12,1200
2021-06-25,15074,16077,-1003,-6.24,1200
2021-06-26,7835,7742,93,1.2,1200
2021-06-27,5385,5091,294,5.77,1200
2021-06-28,16212,16592,-380,-2.29,1200
2021-06-29,16620,16906,-286,-1.69,1200
2021-06-30,16620,16853,-233,-1.38,1200
2021-07-01,15579,16795,-1216,-7.24,1200
2021-07-02,14749,15701,-952,-6.06,1200
2021-07-03,7330,7354,-24,-0.33,1200
2021-07-04,4954,4697,257,5.47,1200
2021-07-05,15230,16197,-967,-5.97,1200
2021-07-06,15579,16517,-938,-5.68,1200
2021-07-07,15579,16474,-895,-5.43,1200
2021-07-08,15579,16433,-854,-5.2,1200
2021-07-09,14749,15359,-610,-3.97,1200
2021-07-10,7330,7037,293,4.16,1200
2021-07-11,4954,4410,544,12.34,1200
2021-07-12,15230,15941,-711,-4.46,1200
2021-07-13,15579,16295,-716,-4.39,1200
2021-07-14,15579,16287,-708,-4.35,1200
2021-07-15,15579,16280,-701,-4.31,1200
2021-07-16,14749,15241,-492,-3.23,1200
2021-07-17,7330,6951,379,5.45,1200
2021-07-18,4954,4353,601,13.81,1200
2021-07-19,15230,15910,-680,-4.27,1200
2021-07-20,15579,16284,-705,-4.33,1200
2021-07-21,15579,16292,-713,-4.38,1200
2021-07-22,15579,16295,-716,-4.39,1200
2021-07-23,14749,15260,-511,-3.35,1200
2021-07-24,7330,6968,362,5.2,1200
2021-07-25,4954,4361,593,13.6,1200
2021-07-26,15230,15904,-674,-4.24,1200
2021-07-27,15579,16259,-680,-4.18,1200
2021-07-28,15579,16242,-663,-4.08,1200
2021-07-29,15579,16217,-638,-3.93,1200
2021-07-30,14749,15149,-400,-2.64,1200
2021-07-31,7330,6822,508,7.45,1200
2021-08-01,4825,4179,646,15.46,1200
2021-08-02,14648,15686,-1038,-6.62,1200
2021-08-03,14829,16004,-1175,-7.34,1200
2021-08-04,14829,15955,-1126,-7.06,1200
2021-08-05,14829,15899,-1070,-6.73,1200
2021-08-06,13745,14805,-1060,-7.16,1200
2021-08-07,6891,6458,433,6.7,1200
2021-08-08,4825,3801,1024,26.94,1200
2021-08-09,14648,15301,-653,-4.27,1200
2021-08-10,14829,15621,-792,-5.07,1200
2021-08-11,14829,15580,-751,-4.82,1200
2021-08-12,14829,15541,-712,-4.58,1200
2021-08-13,13745,14473,-728,-5.03,1200
2021-08-14,6891,6159,732,11.89,1200
2021-08-15,4825,3543,1282,36.18,1200
2021-08-16,14648,15090,-442,-2.93,1200
2021-08-17,14829,15464,-635,-4.11,1200
2021-08-18,14829,15482,-653,-4.22,1200
2021-08-19,14829,15507,-678,-4.37,1200
2021-08-20,13745,14505,-760,-5.24,1200
2021-08-21,6891,6259,632,10.1,1200
2021-08-22,4825,3711,1114,30.02,1200
2021-08-23,14648,15325,-677,-4.42,1200
2021-08-24,14829,15763,-934,-5.93,1200
2021-08-25,14829,15843,-1014,-6.4,1200
2021-08-26,14829,15923,-1094,-6.87,1200
2021-08-27,13745,14971,-1226,-8.19,1200
2021-08-28,6891,6768,123,1.82,1200
2021-08-29,4825,4255,570,13.4,1200
2021-08-30,14648,15897,-1249,-7.86,1200
2021-08-31,14829,16353,-1524,-9.32,1200
2021-09-01,16385,16442,-57,-0.35,1200
2021-09-02,16385,16523,-138,-0.84,1200
2021-09-03,15111,15563,-452,-2.9,1200
2021-09-04,7724,7344,380,5.17,1200
2021-09-05,5360,4807,553,11.5,1200
2021-09-06,15909,16418,-509,-3.1,1200
2021-09-07,16385,16839,-454,-2.7,1200
2021-09-08,16385,16886,-501,-2.97,1200
2021-09-09,16385,16923,-538,-3.18,1200
2021-09-10,15111,15915,-804,-5.05,1200
2021-09-11,7724,7648,76,0.99,1200
2021-09-12,5360,5063,297,5.87,1200
2021-09-13,15909,16627,-718,-4.32,1200
2021-09-14,16385,17003,-618,-3.63,1200
2021-09-15,16385,17009,-624,-3.67,1200
2021-09-16,16385,17009,-624,-3.67,1200
2021-09-17,15111,15970,-859,-5.38,1200
2021-09-18,7724,7676,48,0.63,1200
2021-09-19,5360,5071,289,5.7,1200
2021-09-20,15909,16620,-711,-4.28,1200
2021-09-21,16385,16988,-603,-3.55,1200
2021-09-22,16385,16992,-607,-3.57,1200
2021-09-23,16385,16995,-610,-3.59,1200
2021-09-24,15111,15965,-854,-5.35,1200
2021-09-25,7724,7685,39,0.51,1200
2021-09-26,5360,5098,262,5.14,1200
2021-09-27,15909,16668,-759,-4.55,1200
2021-09-28,16385,17058,-673,-3.95,1200
2021-09-29,16385,17086,-701,-4.1,1200
2021-09-30,16385,17113,-728,-4.25,1200
2021-10-01,16160,16106,54,0.34,1200
2021-10-02,8378,7847,531,6.77,1200
2021-10-03,5237,5279,-42,-0.8,1200
2021-10-04,16080,16865,-785,-4.65,1200
2021-10-05,16901,17267,-366,-2.12,1200
2021-10-06,16901,17303,-402,-2.32,1200
2021-10-07,16901,17332,-431,-2.49,1200
2021-10-08,16160,16324,-164,-1.0,1200
2021-10-09,8378,8058,320,3.97,1200
2021-10-10,5237,5478,-241,-4.4,1200
2021-10-11,16080,17049,-969,-5.68,1200
2021-10-12,16901,17431,-530,-3.04,1200
2021-10-13,16901,17444,-543,-3.11,1200
2021-10-14,16901,17449,-548,-3.14,1200
2021-10-15,16160,16414,-254,-1.55,1200
2021-10-16,8378,8120,258,3.18,1200
2021-10-17,5237,5513,-276,-5.01,1200
2021-10-18,16080,17056,-976,-5.72,1200
2021-10-19,16901,17414,-513,-2.95,1200
2021-10-20,16901,17404,-503,-2.89,1200
2021-10-21,16901,17390,-489,-2.81,1200
2021-10-22,16160,16339,-179,-1.1,1200
2021-10-23,8378,8035,343,4.27,1200
2021-10-24,5237,5421,-184,-3.39,1200
2021-10-25,16080,16963,-883,-5.21,1200
2021-10-26,16901,17324,-423,-2.44,1200
2021-10-27,16901,17323,-422,-2.44,1200
2021-10-28,16901,17322,-421,-2.43,1200
2021-10-29,16160,16288,-128,-0.79,1200
2021-10-30,8378,8005,373,4.66,1200
2021-10-31,5237,5415,-178,-3.29,1200
2021-11-01,15413,16984,-1571,-9.25,1200
2021-11-02,16096,17372,-1276,-7.35,1200
2021-11-03,16096,17398,-1302,-7.48,1200
2021-11-04,16096,17424,-1328,-7.62,1200
2021-11-05,15298,16415,-1117,-6.8,1200
2021-11-06,7746,8154,-408,-5.0,1200
2021-11-07,4712,5582,-870,-15.59,1200
2021-11-08,15413,17165,-1752,-10.21,1200
2021-11-09,16096,17562,-1466,-8.35,1200
2021-11-10,16096,17591,-1495,-8.5,1200
2021-11-11,16096,17614,-1518,-8.62,1200
2021-11-12,15298,16595,-1297,-7.82,1200
2021-11-13,7746,8318,-572,-6.88,1200
2021-11-14,4712,5725,-1013,-17.69,1200
2021-11-15,15413,17278,-1865,-10.79,1200
2021-11-16,16096,17641,-1545,-8.76,1200
2021-11-17,16096,17631,-1535,-8.71,1200
2021-11-18,16096,17609,-1513,-8.59,1200
2021-11-19,15298,16544,-1246,-7.53,1200
2021-11-20,7746,8216,-470,-5.72,1200
2021-11-21,4712,5571,-859,-15.42,1200
2021-11-22,15413,17073,-1660,-9.72,1200
2021-11-23,16096,17384,-1288,-7.41,1200
2021-11-24,16096,17325,-1229,-7.09,1200
2021-11-25,16096,17257,-1161,-6.73,1200
2021-11-26,15298,16149,-851,-5.27,1200
2021-11-27,7746,7784,-38,-0.49,1200
2021-11-28,4712,5106,-394,-7.72,1200
2021-11-29,15413,16583,-1170,-7.06,1200
2021-11-30,16096,16875,-779,-4.62,1200
2021-12-01,14175,16805,-2630,-15.65,1200
2021-12-02,14175,16732,-2557,-15.28,1200
2021-12-03,11639,15627,-3988,-25.52,1200
2021-12-04,6889,7272,-383,-5.27,1200
2021-12-05,4166,4612,-446,-9.67,1200
2021-12-06,14803,16110,-1307,-8.11,1200
2021-12-07,14175,16431,-2256,-13.73,1200
2021-12-08,14175,16393,-2218,-13.53,1200
2021-12-09,14175,16357,-2182,-13.34,1200
2021-12-10,11639,15290,-3651,-23.88,1200
2021-12-11,6889,6976,-87,-1.25,1200
2021-12-12,4166,4355,-189,-4.34,1200
2021-12-13,14803,15894,-1091,-6.86,1200
2021-12-14,14175,16253,-2078,-12.79,1200
2021-12-15,14175,16249,-2074,-12.76,1200
2021-12-16,14175,16244,-2069,-12.74,1200
2021-12-17,11639,15205,-3566,-23.45,1200
2021-12-18,6889,6912,-23,-0.33,1200
2021-12-19,4166,4308,-142,-3.3,1200
2021-12-20,14803,15857,-1054,-6.65,1200
2021-12-21,14175,16220,-2045,-12.61,1200
2021-12-22,14175,16216,-2041,-12.59,1200
2021-12-23,14175,16204,-2029,-12.52,1200
2021-12-24,11639,15152,-3513,-23.19,1200
2021-12-25,6889,6842,47,0.69,1200
2021-12-26,4166,4217,-51,-1.21,1200
2021-12-27,14803,15742,-939,-5.96,1200
2021-12-28,14175,16078,-1903,-11.84,1200
2021-12-29,14175,16046,-1871,-11.66,1200
2021-12-30,14175,16005,-1830,-11.43,1200
2021-12-31,11639,14925,-3286,-22.02,1200
2022-01-01,6556,6589,-33,-0.5,1200
2022-01-02,3837,3940,-103,-2.61,1200
2022-01-03,13995,15444,-1449,-9.38,1200
2022-01-04,14331,15764,-1433,-9.09,1200
2022-01-05,14331,15720,-1389,-8.84,1200
2022-01-06,14331,15673,-1342,-8.56,1200
2022-01-07,13030,14592,-1562,-10.7,1200
2022-01-08,6556,6261,295,4.71,1200
2022-01-09,3837,3622,215,5.94,1200
2022-01-10,13995,15143,-1148,-7.58,1200
2022-01-11,14331,15485,-1154,-7.45,1200
2022-01-12,14331,15468,-1137,-7.35,1200
2022-01-13,14331,15453,-1122,-7.26,1200
2022-01-14,13030,14407,-1377,-9.56,1200
2022-01-15,6556,6115,441,7.21,1200
2022-01-16,3837,3517,320,9.1,1200
2022-01-17,13995,15080,-1085,-7.19,1200
2022-01-18,14331,15465,-1134,-7.33,1200
2022-01-19,14331,15489,-1158,-7.48,1200
2022-01-20,14331,15514,-1183,-7.63,1200
2022-01-21,13030,14507,-1477,-10.18,1200
2022-01-22,6556,6249,307,4.91,1200
2022-01-23,3837,3683,154,4.18,1200
2022-01-24,13995,15273,-1278,-8.37,1200
2022-01-25,14331,15680,-1349,-8.6,1200
2022-01-26,14331,15722,-1391,-8.85,1200
2022-01-27,14331,15759,-1428,-9.06,1200
2022-01-28,13030,14758,-1728,-11.71,1200
2022-01-29,6556,6502,54,0.83,1200
2022-01-30,3837,3933,-96,-2.44,1200
2020-02-01,3817,3369,448,13.3,1201
2020-02-02,1963,1461,502,34.36,1201
2020-02-03,8268,8062,206,2.56,1201
2020-02-04,8511,8293,218,2.63,1201
2020-02-05,8511,8304,207,2.49,1201
2020-02-06,8511,8316,195,2.34,1201
2020-02-07,8040,8044,-4,-0.05,1201
2020-02-08,3817,3439,378,10.99,1201
2020-02-09,1963,1520,443,29.14,1201
2020-02-10,8268,8112,156,1.92,1201
2020-02-11,8511,8336,175,2.1,1201
2020-02-12,8511,8343,168,2.01,1201
2020-02-13,8511,8352,159,1.9,1201
2020-02-14,8040,8082,-42,-0.52,1201
2020-02-15,3817,3478,339,9.75,1201
2020-02-16,1963,1565,398,25.43,1201
2020-02-17,8268,8163,105,1.29,1201
2020-02-18,8511,8396,115,1.37,1201
2020-02-19,8511,8412,99,1.18,1201
2020-02-20,8511,8432,79,0.94,1201
2020-02-21,8040,8173,-133,-1.63,1201
2020-02-22,3817,3581,236,6.59,1201
2020-02-23,1963,1678,285,16.98,1201
2020-02-24,8268,8287,-19,-0.23,1201
2020-02-25,8511,8530,-19,-0.22,1201
2020-02-26,8511,8554,-43,-0.5,1201
2020-02-27,8511,8581,-70,-0.82,1201
2020-02-28,8040,8326,-286,-3.44,1201
2020-02-29,3817,3737,80,2.14,1201
2020-03-01,1716,1834,-118,-6.43,1201
2020-03-02,6794,8442,-1648,-19.52,1201
2020-03-03,6741,8680,-1939,-22.34,1201
2020-03-04,6741,8698,-1957,-22.5,1201
2020-03-05,6741,8717,-1976,-22.67,1201
2020-03-06,6693,8453,-1760,-20.82,1201
2020-03-07,3042,3853,-811,-21.05,1201
2020-03-08,1716,1939,-223,-11.5,1201
2020-03-09,6794,8534,-1740,-20.39,1201
2020-03-10,6741,8759,-2018,-23.04,1201
2020-03-11,6741,8766,-2025,-23.1,1201
2020-03-12,6741,8773,-2032,-23.16,1201
2020-03-13,6693,8498,-1805,-21.24,1201
2020-03-14,3042,3889,-847,-21.78,1201
2020-03-15,1716,1967,-251,-12.76,1201
2020-03-16,6794,8556,-1762,-20.59,1201
2020-03-17,6741,8778,-2037,-23.21,1201
2020-03-18,6741,8783,-2042,-23.25,1201
2020-03-19,6741,8791,-2050,-23.32,1201
2020-03-20,6693,8519,-1826,-21.43,1201
2020-03-21,3042,3914,-872,-22.28,1201
2020-03-22,1716,2000,-284,-14.2,1201
2020-03-23,6794,8598,-1804,-20.98,1201
2020-03-24,6741,8831,-2090,-23.67,1201
2020-03-25,6741,8847,-2106,-23.8,1201
2020-03-26,6741,8868,-2127,-23.99,1201
2020-03-27,6693,8609,-1916,-22.26,1201
2020-03-28,3042,4018,-976,-24.29,1201
2020-03-29,1716,2116,-400,-18.9,1201
2020-03-30,6794,8727,-1933,-22.15,1201
2020-03-31,6741,8970,-2229,-24.85,1201
2020-04-01,6356,8996,-2640,-29.35,1201
2020-04-02,6356,9024,-2668,-29.57,1201
2020-04-03,5702,8771,-3069,-34.99,1201
2020-04-04,2887,4184,-1297,-31.0,1201
2020-04-05,1200,2283,-1083,-47.44,1201
2020-04-06,6377,8892,-2515,-28.28,1201
2020-04-07,6356,9132,-2776,-30.4,1201
2020-04-08,6356,9152,-2796,-30.55,1201
2020-04-09,6356,9172,-2816,-30.7,1201
2020-04-10,5702,8909,-3207,-36.0,1201
2020-04-11,2887,4310,-1423,-33.02,1201
2020-04-12,1200,2397,-1197,-49.94,1201
2020-04-13,6377,8992,-2615,-29.08,1201
2020-04-14,6356,9217,-2861,-31.04,1201
2020-04-15,6356,9222,-2866,-31.08,1201
2020-04-16,6356,9228,-2872,-31.12,1201
2020-04-17,5702,8951,-3249,-36.3,1201
2020-04-18,2887,4340,-1453,-33.48,1201
2020-04-19,1200,2415,-1215,-50.31,1201
2020-04-20,6377,9000,-2623,-29.14,1201
2020-04-21,6356,9218,-2862,-31.05,1201
2020-04-22,6356,9217,-2861,-31.04,1201
2020-04-23,6356,9220,-2864,-31.06,1201
2020-04-24,5702,8941,-3239,-36.23,1201
2020-04-25,2887,4331,-1444,-33.34,1201
2020-04-26,1200,2409,-1209,-50.19,1201
2020-04-27,6377,8999,-2622,-29.14,1201
2020-04-28,6356,9223,-2867,-31.09,1201
2020-04-29,6356,9230,-2874,-31.14,1201
2020-04-30,6356,9242,-2886,-31.23,1201
2020-05-01,7673,8973,-1300,-14.49,1201
2020-05-02,4025,4372,-347,-7.94,1201
2020-05-03,1732,2461,-729,-29.62,1201
2020-05-04,8059,9060,-1001,-11.05,1201
2020-05-05,8138,9293,-1155,-12.43,1201
2020-05-06,8138,9308,-1170,-12.57,1201
2020-05-07,8138,9325,-1187,-12.73,1201
2020-05-08,7673,9060,-1387,-15.31,1201
2020-05-09,4025,4461,-436,-9.77,1201
2020-05-10,1732,2549,-817,-32.05,1201
2020-05-11,8059,9146,-1087,-11.88,1201
2020-05-12,8138,9374,-1236,-13.19,1201
2020-05-13,8138,9382,-1244,-13.26,1201
2020-05-14,8138,9390,-1252,-13.33,1201
2020-05-15,7673,9114,-1441,-15.81,1201
2020-05-16,4025,4502,-477,-10.6,1201
2020-05-17,1732,2576,-844,-32.76,1201
2020-05-18,8059,9158,-1099,-12.0,1201
2020-05-19,8138,9370,-1232,-13.15,1201
2020-05-20,8138,9362,-1224,-13.07,1201
2020-05-21,8138,9355,-1217,-13.01,1201
2020-05-22,7673,9064,-1391,-15.35,1201
2020-05-23,4025,4439,-414,-9.33,1201
2020-05-24,1732,2501,-769,-30.75,1201
2020-05-25,8059,9072,-1013,-11.17,1201
2020-05-26,8138,9277,-1139,-12.28,1201
2020-05-27,8138,9263,-1125,-12.15,1201
2020-05-28,8138,9252,-1114,-12.04,1201
2020-05-29,7673,8961,-1288,-14.37,1201
2020-05-30,4025,4338,-313,-7.22,1201
2020-05-31,1732,2404,-672,-27.95,1201
2020-06-01,8422,8982,-560,-6.23,1201
2020-06-02,8570,9194,-624,-6.79,1201
2020-06-03,8570,9191,-621,-6.76,1201
2020-06-04,8570,9191,-621,-6.76,1201
2020-06-05,7906,8912,-1006,-11.29,1201
2020-06-06,3748,4301,-553,-12.86,1201
2020-06-07,2003,2379,-376,-15.8,1201
2020-06-08,8422,8969,-547,-6.1,1201
2020-06-09,8570,9192,-622,-6.77,1201
2020-06-10,8570,9197,-627,-6.82,1201
2020-06-11,8570,9205,-635,-6.9,1201
2020-06-12,7906,8930,-1024,-11.47,1201
2020-06-13,3748,4320,-572,-13.24,1201
2020-06-14,2003,2397,-394,-16.44,1201
2020-06-15,8422,8983,-561,-6.25,1201
2020-06-16,8570,9198,-628,-6.83,1201
2020-06-17,8570,9192,-622,-6.77,1201
2020-06-18,8570,9186,-616,-6.71,1201
2020-06-19,7906,8894,-988,-11.11,1201
2020-06-20,3748,4265,-517,-12.12,1201
2020-06-21,2003,2321,-318,-13.7,1201
2020-06-22,8422,8883,-461,-5.19,1201
2020-06-23,8570,9074,-504,-5.55,1201
2020-06-24,8570,9043,-473,-5.23,1201
2020-06-25,8570,9012,-442,-4.9,1201
2020-06-26,7906,8695,-789,-9.07,1201
2020-06-27,3748,4043,-295,-7.3,1201
2020-06-28,2003,2077,-74,-3.56,1201
2020-06-29,8422,8620,-198,-2.3,1201
2020-06-30,8570,8794,-224,-2.55,1201
2020-07-01,9518,8750,768,8.78,1201
2020-07-02,9518,8708,810,9.3,1201
2020-07-03,8906,8386,520,6.2,1201
2020-07-04,4272,3732,540,14.47,1201
2020-07-05,2542,1767,775,43.86,1201
2020-07-06,9638,8316,1322,15.9,1201
2020-07-07,9518,8500,1018,11.98,1201
2020-07-08,9518,8469,1049,12.39,1201
2020-07-09,9518,8445,1073,12.71,1201
2020-07-10,8906,8142,764,9.38,1201
2020-07-11,4272,3510,762,21.71,1201
2020-07-12,2542,1570,972,61.91,1201
2020-07-13,9638,8144,1494,18.34,1201
2020-07-14,9518,8353,1165,13.95,1201
2020-07-15,9518,8348,1170,14.02,1201
2020-07-16,9518,8348,1170,14.02,1201
2020-07-17,8906,8069,837,10.37,1201
2020-07-18,4272,3458,814,23.54,1201
2020-07-19,2542,1537,1005,65.39,1201
2020-07-20,9638,8126,1512,18.61,1201
2020-07-21,9518,8348,1170,14.02,1201
2020-07-22,9518,8352,1166,13.96,1201
2020-07-23,9518,8357,1161,13.89,1201
2020-07-24,8906,8079,827,10.24,1201
2020-07-25,4272,3465,807,23.29,1201
2020-07-26,2542,1537,1005,65.39,1201
2020-07-27,9638,8116,1522,18.75,1201
2020-07-28,9518,8325,1193,14.33,1201
2020-07-29,9518,8313,1205,14.5,1201
2020-07-30,9518,8300,1218,14.67,1201
2020-07-31,8906,8003,903,11.28,1201
2020-08-01,4214,3369,845,25.08,1201
2020-08-02,2572,1420,1152,81.13,1201
2020-08-03,9305,7980,1325,16.6,1201
2020-08-04,9452,8170,1282,15.69,1201
2020-08-05,9452,8141,1311,16.1,1201
2020-08-06,9452,8114,1338,16.49,1201
2020-08-07,8611,7806,805,10.31,1201
2020-08-08,4214,3164,1050,33.19,1201
2020-08-09,2572,1212,1360,112.21,1201
2020-08-10,9305,7772,1533,19.72,1201
2020-08-11,9452,7967,1485,18.64,1201
2020-08-12,9452,7947,1505,18.94,1201
2020-08-13,9452,7933,1519,19.15,1201
2020-08-14,8611,7641,970,12.69,1201
2020-08-15,4214,3021,1193,39.49,1201
2020-08-16,2572,1093,1479,135.32,1201
2020-08-17,9305,7680,1625,21.16,1201
2020-08-18,9452,7905,1547,19.57,1201
2020-08-19,9452,7917,1535,19.39,1201
2020-08-20,9452,7936,1516,19.1,1201
2020-08-21,8611,7677,934,12.17,1201
2020-08-22,4214,3090,1124,36.38,1201
2020-08-23,2572,1193,1379,115.59,1201
2020-08-24,9305,7811,1494,19.13,1201
2020-08-25,9452,8064,1388,17.21,1201
2020-08-26,9452,8100,1352,16.69,1201
2020-08-27,9452,8141,1311,16.1,1201
2020-08-28,8611,7900,711,9.0,1201
2020-08-29,4214,3326,888,26.7,1201
2020-08-30,2572,1439,1133,78.74,1201
2020-08-31,9305,8062,1243,15.42,1201
2020-09-01,8635,8315,320,3.85,1201
2020-09-02,8635,8348,287,3.44,1201
2020-09-03,8635,8381,254,3.03,1201
2020-09-04,8321,8129,192,2.36,1201
2020-09-05,3846,3541,305,8.61,1201
2020-09-06,2238,1637,601,36.71,1201
2020-09-07,8299,8240,59,0.72,1201
2020-09-08,8635,8472,163,1.92,1201
2020-09-09,8635,8483,152,1.79,1201
2020-09-10,8635,8493,142,1.67,1201
2020-09-11,8321,8219,102,1.24,1201
2020-09-12,3846,3610,236,6.54,1201
2020-09-13,2238,1686,552,32.74,1201
2020-09-14,8299,8271,28,0.34,1201
2020-09-15,8635,8487,148,1.74,1201
2020-09-16,8635,8485,150,1.77,1201
2020-09-17,8635,8486,149,1.76,1201
2020-09-18,8321,8205,116,1.41,1201
2020-09-19,3846,3591,255,7.1,1201
2020-09-20,2238,1667,571,34.25,1201
2020-09-21,8299,8254,45,0.55,1201
2020-09-22,8635,8476,159,1.88,1201
2020-09-23,8635,8482,153,1.8,1201
2020-09-24,8635,8492,143,1.68,1201
2020-09-25,8321,8223,98,1.19,1201
2020-09-26,3846,3622,224,6.18,1201
2020-09-27,2238,1711,527,30.8,1201
2020-09-28,8299,8313,-14,-0.17,1201
2020-09-29,8635,8548,87,1.02,1201
2020-09-30,8635,8566,69,0.81,1201
2020-10-01,8770,8588,182,2.12,1201
2020-10-02,8527,8329,198,2.38,1201
2020-10-03,4021,3736,285,7.63,1201
2020-10-04,1995,1831,164,8.96,1201
2020-10-05,8768,8435,333,3.95,1201
2020-10-06,8770,8671,99,1.14,1201
2020-10-07,8770,8687,83,0.96,1201
2020-10-08,8770,8704,66,0.76,1201
2020-10-09,8527,8438,89,1.05,1201
2020-10-10,4021,3835,186,4.85,1201
2020-10-11,1995,1918,77,4.01,1201
2020-10-12,8768,8510,258,3.03,1201
2020-10-13,8770,8731,39,0.45,1201
2020-10-14,8770,8732,38,0.44,1201
2020-10-15,8770,8733,37,0.42,1201
2020-10-16,8527,8450,77,0.91,1201
2020-10-17,4021,3832,189,4.93,1201
2020-10-18,1995,1901,94,4.94,1201
2020-10-19,8768,8479,289,3.41,1201
2020-10-20,8770,8689,81,0.93,1201
2020-10-21,8770,8680,90,1.04,1201
2020-10-22,8770,8674,96,1.11,1201
2020-10-23,8527,8387,140,1.67,1201
2020-10-24,4021,3767,254,6.74,1201
2020-10-25,1995,1836,159,8.66,1201
2020-10-26,8768,8417,351,4.17,1201
2020-10-27,8770,8631,139,1.61,1201
2020-10-28,8770,8630,140,1.62,1201
2020-10-29,8770,8632,138,1.6,1201
2020-10-30,8527,8355,172,2.06,1201
2020-10-31,4021,3747,274,7.31,1201
2020-11-01,1637,1827,-190,-10.4,1201
2020-11-02,8223,8420,-197,-2.34,1201
2020-11-03,7690,8647,-957,-11.07,1201
2020-11-04,7690,8656,-966,-11.16,1201
2020-11-05,7690,8669,-979,-11.29,1201
2020-11-06,7580,8400,-820,-9.76,1201
2020-11-07,3453,3798,-345,-9.08,1201
2020-11-08,1637,1884,-247,-13.11,1201
2020-11-09,8223,8479,-256,-3.02,1201
2020-11-10,7690,8705,-1015,-11.66,1201
2020-11-11,7690,8712,-1022,-11.73,1201
2020-11-12,7690,8720,-1030,-11.81,1201
2020-11-13,7580,8444,-864,-10.23,1201
2020-11-14,3453,3832,-379,-9.89,1201
2020-11-15,1637,1906,-269,-14.11,1201
2020-11-16,8223,8489,-266,-3.13,1201
2020-11-17,7690,8701,-1011,-11.62,1201
2020-11-18,7690,8693,-1003,-11.54,1201
2020-11-19,7690,8686,-996,-11.47,1201
2020-11-20,7580,8395,-815,-9.71,1201
2020-11-21,3453,3769,-316,-8.38,1201
2020-11-22,1637,1829,-192,-10.5,1201
2020-11-23,8223,8400,-177,-2.11,1201
2020-11-24,7690,8602,-912,-10.6,1201
2020-11-25,7690,8586,-896,-10.44,1201
2020-11-26,7690,8574,-884,-10.31,1201
2020-11-27,7580,8280,-700,-8.45,1201
2020-11-28,3453,3654,-201,-5.5,1201
2020-11-29,1637,1717,-80,-4.66,1201
2020-11-30,8223,8293,-70,-0.84,1201
2020-12-01,7427,8503,-1076,-12.65,1201
2020-12-02,7427,8497,-1070,-12.59,1201
2020-12-03,7427,8496,-1069,-12.58,1201
2020-12-04,8097,8216,-119,-1.45,1201
2020-12-05,3973,3604,369,10.24,1201
2020-12-06,1637,1682,-45,-2.68,1201
2020-12-07,7811,8272,-461,-5.57,1201
2020-12-08,7427,8496,-1069,-12.58,1201
2020-12-09,7427,8504,-1077,-12.66,1201
2020-12-10,7427,8514,-1087,-12.77,1201
2020-12-11,8097,8242,-145,-1.76,1201
2020-12-12,3973,3637,336,9.24,1201
2020-12-13,1637,1718,-81,-4.71,1201
2020-12-14,7811,8308,-497,-5.98,1201
2020-12-15,7427,8528,-1101,-12.91,1201
2020-12-16,7427,8528,-1101,-12.91,1201
2020-12-17,7427,8527,-1100,-12.9,1201
2020-12-18,8097,8241,-144,-1.75,1201
2020-12-19,3973,3617,356,9.84,1201
2020-12-20,1637,1676,-39,-2.33,1201
2020-12-21,7811,8242,-431,-5.23,1201
2020-12-22,7427,8436,-1009,-11.96,1201
2020-12-23,7427,8407,-980,-11.66,1201
2020-12-24,7427,8376,-949,-11.33,1201
2020-12-25,8097,8059,38,0.47,1201
2020-12-26,3973,3404,569,16.72,1201
2020-12-27,1637,1435,202,14.08,1201
2020-12-28,7811,7972,-161,-2.02,1201
2020-12-29,7427,8140,-713,-8.76,1201
2020-12-30,7427,8088,-661,-8.17,1201
2020-12-31,7427,8037,-610,-7.59,1201
2021-01-01,6715,7705,-990,-12.85,1201
2021-01-02,2813,3039,-226,-7.44,1201
2021-01-03,1439,1062,377,35.5,1201
2021-01-04,6910,7598,-688,-9.06,1201
2021-01-05,7050,7769,-719,-9.25,1201
2021-01-06,7050,7725,-675,-8.74,1201
2021-01-07,7050,7688,-638,-8.3,1201
2021-01-08,6715,7373,-658,-8.92,1201
2021-01-09,2813,2730,83,3.04,1201
2021-01-10,1439,779,660,84.72,1201
2021-01-11,6910,7345,-435,-5.92,1201
2021-01-12,7050,7548,-498,-6.6,1201
2021-01-13,7050,7539,-489,-6.49,1201
2021-01-14,7050,7538,-488,-6.47,1201
2021-01-15,6715,7260,-545,-7.51,1201
2021-01-16,2813,2654,159,5.99,1201
2021-01-17,1439,740,699,94.46,1201
2021-01-18,6910,7341,-431,-5.87,1201
2021-01-19,7050,7577,-527,-6.96,1201
2021-01-20,7050,7599,-549,-7.22,1201
2021-01-21,7050,7625,-575,-7.54,1201
2021-01-22,6715,7372,-657,-8.91,1201
2021-01-23,2813,2786,27,0.97,1201
2021-01-24,1439,889,550,61.87,1201
2021-01-25,6910,7503,-593,-7.9,1201
2021-01-26,7050,7748,-698,-9.01,1201
2021-01-27,7050,7774,-724,-9.31,1201
2021-01-28,7050,7802,-752,-9.64,1201
2021-01-29,6715,7546,-831,-11.01,1201
2021-01-30,2813,2955,-142,-4.81,1201
2021-01-31,1439,1050,389,37.05,1201
2021-02-01,7852,7653,199,2.6,1201
2021-02-02,7723,7886,-163,-2.07,1201
2021-02-03,7723,7900,-177,-2.24,1201
2021-02-04,7723,7914,-191,-2.41,1201
2021-02-05,7543,7644,-101,-1.32,1201
2021-02-06,3447,3040,407,13.39,1201
2021-02-07,1632,1122,510,45.45,1201
2021-02-08,7852,7714,138,1.79,1201
2021-02-09,7723,7938,-215,-2.71,1201
2021-02-10,7723,7945,-222,-2.79,1201
2021-02-11,7723,7953,-230,-2.89,1201
2021-02-12,7543,7681,-138,-1.8,1201
2021-02-13,3447,3077,370,12.02,1201
2021-02-14,1632,1161,471,40.57,1201
2021-02-15,7852,7757,95,1.22,1201
2021-02-16,7723,7988,-265,-3.32,1201
2021-02-17,7723,8002,-279,-3.49,1201
2021-02-18,7723,8020,-297,-3.7,1201
2021-02-19,7543,7758,-215,-2.77,1201
2021-02-20,3447,3165,282,8.91,1201
2021-02-21,1632,1261,371,29.42,1201
2021-02-22,7852,7868,-16,-0.2,1201
2021-02-23,7723,8110,-387,-4.77,1201
2021-02-24,7723,8133,-410,-5.04,1201
2021-02-25,7723,8160,-437,-5.36,1201
2021-02-26,7543,7905,-362,-4.58,1201
2021-02-27,3447,3317,130,3.92,1201
2021-02-28,1632,1416,216,15.25,1201
2021-03-01,8127,8024,103,1.28,1201
2021-03-02,8257,8264,-7,-0.08,1201
2021-03-03,8257,8285,-28,-0.34,1201
2021-03-04,8257,8306,-49,-0.59,1201
2021-03-05,7896,8044,-148,-1.84,1201
2021-03-06,3857,3446,411,11.93,1201
2021-03-07,1608,1535,73,4.76,1201
2021-03-08,8127,8132,-5,-0.06,1201
2021-03-09,8257,8360,-103,-1.23,1201
2021-03-10,8257,8368,-111,-1.33,1201
2021-03-11,8257,8377,-120,-1.43,1201
2021-03-12,7896,8103,-207,-2.55,1201
2021-03-13,3857,3494,363,10.39,1201
2021-03-14,1608,1573,35,2.23,1201
2021-03-15,8127,8162,-35,-0.43,1201
2021-03-16,8257,8383,-126,-1.5,1201
2021-03-17,8257,8387,-130,-1.55,1201
2021-03-18,8257,8394,-137,-1.63,1201
2021-03-19,7896,8120,-224,-2.76,1201
2021-03-20,3857,3514,343,9.76,1201
2021-03-21,1608,1597,11,0.69,1201
2021-03-22,8127,8193,-66,-0.81,1201
2021-03-23,8257,8423,-166,-1.97,1201
2021-03-24,8257,8437,-180,-2.13,1201
2021-03-25,8257,8455,-198,-2.34,1201
2021-03-26,7896,8194,-298,-3.64,1201
2021-03-27,3857,3601,256,7.11,1201
2021-03-28,1608,1697,-89,-5.24,1201
2021-03-29,8127,8306,-179,-2.16,1201
2021-03-30,8257,8548,-291,-3.4,1201
2021-03-31,8257,8573,-316,-3.69,1201
2021-04-01,7776,8602,-826,-9.6,1201
2021-04-02,7547,8349,-802,-9.61,1201
2021-04-03,3346,3762,-416,-11.06,1201
2021-04-04,1608,1862,-254,-13.64,1201
2021-04-05,7814,8473,-659,-7.78,1201
2021-04-06,7776,8714,-938,-10.76,1201
2021-04-07,7776,8737,-961,-11.0,1201
2021-04-08,7776,8759,-983,-11.22,1201
2021-04-09,7547,8499,-952,-11.2,1201
2021-04-10,3346,3902,-556,-14.25,1201
2021-04-11,1608,1992,-384,-19.28,1201
2021-04-12,7814,8590,-776,-9.03,1201
2021-04-13,7776,8817,-1041,-11.81,1201
2021-04-14,7776,8825,-1049,-11.89,1201
2021-04-15,7776,8834,-1058,-11.98,1201
2021-04-16,7547,8558,-1011,-11.81,1201
2021-04-17,3346,3948,-602,-15.25,1201
2021-04-18,1608,2025,-417,-20.59,1201
2021-04-19,7814,8611,-797,-9.26,1201
2021-04-20,7776,8828,-1052,-11.92,1201
2021-04-21,7776,8828,-1052,-11.92,1201
2021-04-22,7776,8830,-1054,-11.94,1201
2021-04-23,7547,8550,-1003,-11.73,1201
2021-04-24,3346,3938,-592,-15.03,1201
2021-04-25,1608,2015,-407,-20.2,1201
2021-04-26,7814,8603,-789,-9.17,1201
2021-04-27,7776,8826,-1050,-11.9,1201
2021-04-28,7776,8831,-1055,-11.95,1201
2021-04-29,7776,8841,-1065,-12.05,1201
2021-04-30,7547,8570,-1023,-11.94,1201
2021-05-01,4390,3968,422,10.64,1201
2021-05-02,1873,2054,-181,-8.81,1201
2021-05-03,8942,8653,289,3.34,1201
2021-05-04,9097,8885,212,2.39,1201
2021-05-05,9097,8899,198,2.22,1201
2021-05-06,9097,8916,181,2.03,1201
2021-05-07,8645,8652,-7,-0.08,1201
2021-05-08,4390,4054,336,8.29,1201
2021-05-09,1873,2143,-270,-12.6,1201
2021-05-10,8942,8742,200,2.29,1201
2021-05-11,9097,8971,126,1.4,1201
2021-05-12,9097,8982,115,1.28,1201
2021-05-13,9097,8992,105,1.17,1201
2021-05-14,8645,8719,-74,-0.85,1201
2021-05-15,4390,4110,280,6.81,1201
2021-05-16,1873,2187,-314,-14.36,1201
2021-05-17,8942,8772,170,1.94,1201
2021-05-18,9097,8987,110,1.22,1201
2021-05-19,9097,8981,116,1.29,1201
2021-05-20,9097,8976,121,1.35,1201
2021-05-21,8645,8688,-43,-0.49,1201
2021-05-22,4390,4064,326,8.02,1201
2021-05-23,1873,2127,-254,-11.94,1201
2021-05-24,8942,8700,242,2.78,1201
2021-05-25,9097,8904,193,2.17,1201
2021-05-26,9097,8890,207,2.33,1201
2021-05-27,9097,8879,218,2.46,1201
2021-05-28,8645,8586,59,0.69,1201
2021-05-29,4390,3961,429,10.83,1201
2021-05-30,1873,2025,-152,-7.51,1201
2021-05-31,8942,8601,341,3.96,1201
2021-06-01,9168,8812,356,4.04,1201
2021-06-02,9168,8806,362,4.11,1201
2021-06-03,9168,8804,364,4.13,1201
2021-06-04,8444,8522,-78,-0.92,1201
2021-06-05,4061,3909,152,3.89,1201
2021-06-06,2243,1986,257,12.94,1201
2021-06-07,8798,8574,224,2.61,1201
2021-06-08,9168,8796,372,4.23,1201
2021-06-09,9168,8801,367,4.17,1201
2021-06-10,9168,8808,360,4.09,1201
2021-06-11,8444,8534,-90,-1.05,1201
2021-06-12,4061,3926,135,3.44,1201
2021-06-13,2243,2005,238,11.87,1201
2021-06-14,8798,8593,205,2.39,1201
2021-06-15,9168,8811,357,4.05,1201
2021-06-16,9168,8809,359,4.08,1201
2021-06-17,9168,8806,362,4.11,1201
2021-06-18,8444,8519,-75,-0.88,1201
2021-06-19,4061,3895,166,4.26,1201
2021-06-20,2243,1955,288,14.73,1201
2021-06-21,8798,8522,276,3.24,1201
2021-06-22,9168,8717,451,5.17,1201
2021-06-23,9168,8691,477,5.49,1201
2021-06-24,9168,8663,505,5.83,1201
2021-06-25,8444,8351,93,1.11,1201
2021-06-26,4061,3702,359,9.7,1201
2021-06-27,2243,1738,505,29.06,1201
2021-06-28,8798,8283,515,6.22,1201
2021-06-29,9168,8458,710,8.39,1201
2021-06-30,9168,8415,753,8.95,1201
2021-07-01,8531,8373,158,1.89,1201
2021-07-02,8339,8050,289,3.59,1201
2021-07-03,3697,3394,303,8.93,1201
2021-07-04,1874,1427,447,31.32,1201
2021-07-05,8177,7972,205,2.57,1201
2021-07-06,8531,8153,378,4.64,1201
2021-07-07,8531,8118,413,5.09,1201
2021-07-08,8531,8089,442,5.46,1201
2021-07-09,8339,7782,557,7.16,1201
2021-07-10,3697,3145,552,17.55,1201
2021-07-11,1874,1200,674,56.17,1201
2021-07-12,8177,7769,408,5.25,1201
2021-07-13,8531,7974,557,6.99,1201
2021-07-14,8531,7965,566,7.11,1201
2021-07-15,8531,7962,569,7.15,1201
2021-07-16,8339,7679,660,8.59,1201
2021-07-17,3697,3066,631,20.58,1201
2021-07-18,1874,1143,731,63.95,1201
2021-07-19,8177,7731,446,5.77,1201
2021-07-20,8531,7953,578,7.27,1201
2021-07-21,8531,7957,574,7.21,1201
2021-07-22,8531,7963,568,7.13,1201
2021-07-23,8339,7687,652,8.48,1201
2021-07-24,3697,3076,621,20.19,1201
2021-07-25,1874,1150,724,62.96,1201
2021-07-26,8177,7733,444,5.74,1201
2021-07-27,8531,7946,585,7.36,1201
2021-07-28,8531,7938,593,7.47,1201
2021-07-29,8531,7929,602,7.59,1201
2021-07-30,8339,7635,704,9.22,1201
2021-07-31,3697,3005,692,23.03,1201
2021-08-01,1954,1059,895,84.51,1201
2021-08-02,7837,7622,215,2.82,1201
2021-08-03,7800,7815,-15,-0.19,1201
2021-08-04,7800,7787,13,0.17,1201
2021-08-05,7800,7761,39,0.5,1201
2021-08-06,7404,7453,-49,-0.66,1201
2021-08-07,3484,2810,674,23.99,1201
2021-08-08,1954,856,1098,128.27,1201
2021-08-09,7837,7414,423,5.71,1201
2021-08-10,7800,7606,194,2.55,1201
2021-08-11,7800,7582,218,2.88,1201
2021-08-12,7800,7564,236,3.12,1201
2021-08-13,7404,7267,137,1.89,1201
2021-08-14,3484,2641,843,31.92,1201
2021-08-15,1954,707,1247,176.38,1201
2021-08-16,7837,7289,548,7.52,1201
2021-08-17,7800,7507,293,3.9,1201
2021-08-18,7800,7513,287,3.82,1201
2021-08-19,7800,7526,274,3.64,1201
2021-08-20,7404,7262,142,1.96,1201
2021-08-21,3484,2669,815,30.54,1201
2021-08-22,1954,768,1186,154.43,1201
2021-08-23,7837,7381,456,6.18,1201
2021-08-24,7800,7631,169,2.21,1201
2021-08-25,7800,7665,135,1.76,1201
2021-08-26,7800,7703,97,1.26,1201
2021-08-27,7404,7462,-58,-0.78,1201
2021-08-28,3484,2888,596,20.64,1201
2021-08-29,1954,1001,953,95.2,1201
2021-08-30,7837,7625,212,2.78,1201
2021-08-31,7800,7881,-81,-1.03,1201
2021-09-01,8761,7917,844,10.66,1201
2021-09-02,8761,7953,808,10.16,1201
2021-09-03,8131,7704,427,5.54,1201
2021-09-04,3943,3120,823,26.38,1201
2021-09-05,2312,1220,1092,89.51,1201
2021-09-06,8377,7827,550,7.03,1201
2021-09-07,8761,8064,697,8.64,1201
2021-09-08,8761,8079,682,8.44,1201
2021-09-09,8761,8093,668,8.25,1201
2021-09-10,8131,7822,309,3.95,1201
2021-09-11,3943,3216,727,22.61,1201
2021-09-12,2312,1294,1018,78.67,1201
2021-09-13,8377,7881,496,6.29,1201
2021-09-14,8761,8099,662,8.17,1201
2021-09-15,8761,8098,663,8.19,1201
2021-09-16,8761,8098,663,8.19,1201
2021-09-17,8131,7817,314,4.02,1201
2021-09-18,3943,3202,741,23.14,1201
2021-09-19,2312,1277,1035,81.05,1201
2021-09-20,8377,7862,515,6.55,1201
2021-09-21,8761,8082,679,8.4,1201
2021-09-22,8761,8085,676,8.36,1201
2021-09-23,8761,8093,668,8.25,1201
2021-09-24,8131,7821,310,3.96,1201
2021-09-25,3943,3217,726,22.57,1201
2021-09-26,2312,1304,1008,77.3,1201
2021-09-27,8377,7903,474,6.0,1201
2021-09-28,8761,8136,625,7.68,1201
2021-09-29,8761,8153,608,7.46,1201
2021-09-30,8761,8174,587,7.18,1201
2021-10-01,9245,7914,1331,16.82,1201
2021-10-02,4366,3321,1045,31.47,1201
2021-10-03,2289,1416,873,61.65,1201
2021-10-04,8785,8021,764,9.52,1201
2021-10-05,9102,8259,843,10.21,1201
2021-10-06,9102,8277,825,9.97,1201
2021-10-07,9102,8296,806,9.72,1201
2021-10-08,9245,8032,1213,15.1,1201
2021-10-09,4366,3432,934,27.21,1201
2021-10-10,2289,1518,771,50.79,1201
2021-10-11,8785,8112,673,8.3,1201
2021-10-12,9102,8336,766,9.19,1201
2021-10-13,9102,8340,762,9.14,1201
2021-10-14,9102,8344,758,9.08,1201
2021-10-15,9245,8064,1181,14.65,1201
2021-10-16,4366,3448,918,26.62,1201
2021-10-17,2289,1519,770,50.69,1201
2021-10-18,8785,8098,687,8.48,1201
2021-10-19,9102,8309,793,9.54,1201
2021-10-20,9102,8301,801,9.65,1201
2021-10-21,9102,8295,807,9.73,1201
2021-10-22,9245,8007,1238,15.46,1201
2021-10-23,4366,3386,980,28.94,1201
2021-10-24,2289,1454,835,57.43,1201
2021-10-25,8785,8033,752,9.36,1201
2021-10-26,9102,8246,856,10.38,1201
2021-10-27,9102,8242,860,10.43,1201
2021-10-28,9102,8242,860,10.43,1201
2021-10-29,9245,7963,1282,16.1,1201
2021-10-30,4366,3352,1014,30.25,1201
2021-10-31,2289,1431,858,59.96,1201
2021-11-01,8392,8021,371,4.63,1201
2021-11-02,8671,8246,425,5.15,1201
2021-11-03,8671,8255,416,5.04,1201
2021-11-04,8671,8266,405,4.9,1201
2021-11-05,8540,7997,543,6.79,1201
2021-11-06,4020,3395,625,18.41,1201
2021-11-07,2109,1481,628,42.4,1201
2021-11-08,8392,8077,315,3.9,1201
2021-11-09,8671,8305,366,4.41,1201
2021-11-10,8671,8313,358,4.31,1201
2021-11-11,8671,8323,348,4.18,1201
2021-11-12,8540,8050,490,6.09,1201
2021-11-13,4020,3441,579,16.83,1201
2021-11-14,2109,1517,592,39.02,1201
2021-11-15,8392,8102,290,3.58,1201
2021-11-16,8671,8318,353,4.24,1201
2021-11-17,8671,8313,358,4.31,1201
2021-11-18,8671,8308,363,4.37,1201
2021-11-19,8540,8019,521,6.5,1201
2021-11-20,4020,3395,625,18.41,1201
2021-11-21,2109,1457,652,44.75,1201
2021-11-22,8392,8029,363,4.52,1201
2021-11-23,8671,8232,439,5.33,1201
2021-11-24,8671,8216,455,5.54,1201
2021-11-25,8671,8203,468,5.71,1201
2021-11-26,8540,7908,632,7.99,1201
2021-11-27,4020,3281,739,22.52,1201
2021-11-28,2109,1342,767,57.15,1201
2021-11-29,8392,7916,476,6.01,1201
2021-11-30,8671,8123,548,6.75,1201
2021-12-01,7874,8115,-241,-2.97,1201
2021-12-02,7874,8111,-237,-2.92,1201
2021-12-03,6531,7828,-1297,-16.57,1201
2021-12-04,3814,3213,601,18.71,1201
2021-12-05,1668,1289,379,29.4,1201
2021-12-06,8037,7877,160,2.03,1201
2021-12-07,7874,8099,-225,-2.78,1201
2021-12-08,7874,8105,-231,-2.85,1201
2021-12-09,7874,8114,-240,-2.96,1201
2021-12-10,6531,7842,-1311,-16.72,1201
2021-12-11,3814,3237,577,17.83,1201
2021-12-12,1668,1320,348,26.36,1201
2021-12-13,8037,7912,125,1.58,1201
2021-12-14,7874,8135,-261,-3.21,1201
2021-12-15,7874,8138,-264,-3.24,1201
2021-12-16,7874,8141,-267,-3.28,1201
2021-12-17,6531,7859,-1328,-16.9,1201
2021-12-18,3814,3240,574,17.72,1201
2021-12-19,1668,1305,363,27.82,1201
2021-12-20,8037,7876,161,2.04,1201
2021-12-21,7874,8075,-201,-2.49,1201
2021-12-22,7874,8052,-178,-2.21,1201
2021-12-23,7874,8027,-153,-1.91,1201
2021-12-24,6531,7715,-1184,-15.35,1201
2021-12-25,3814,3066,748,24.4,1201
2021-12-26,1668,1100,568,51.64,1201
2021-12-27,8037,7642,395,5.17,1201
2021-12-28,7874,7812,62,0.79,1201
2021-12-29,7874,7763,111,1.43,1201
2021-12-30,7874,7713,161,2.09,1201
2021-12-31,6531,7381,-850,-11.52,1201
2022-01-01,3231,2715,516,19.01,1201
2022-01-02,1565,737,828,112.35,1201
2022-01-03,7548,7271,277,3.81,1201
2022-01-04,7513,7438,75,1.01,1201
2022-01-05,7513,7391,122,1.65,1201
2022-01-06,7513,7348,165,2.25,1201
2022-01-07,7107,7028,79,1.12,1201
2022-01-08,3231,2379,852,35.81,1201
2022-01-09,1565,422,1143,270.85,1201
2022-01-10,7548,6981,567,8.12,1201
2022-01-11,7513,7177,336,4.68,1201
2022-01-12,7513,7161,352,4.92,1201
2022-01-13,7513,7153,360,5.03,1201
2022-01-14,7107,6869,238,3.46,1201
2022-01-15,3231,2257,974,43.15,1201
2022-01-16,1565,337,1228,364.39,1201
2022-01-17,7548,6932,616,8.89,1201
2022-01-18,7513,7164,349,4.87,1201
2022-01-19,7513,7182,331,4.61,1201
2022-01-20,7513,7206,307,4.26,1201
2022-01-21,7107,6950,157,2.26,1201
2022-01-22,3231,2363,868,36.73,1201
2022-01-23,1565,465,1100,236.56,1201
2022-01-24,7548,7078,470,6.64,1201
2022-01-25,7513,7324,189,2.58,1201
2022-01-26,7513,7351,162,2.2,1201
2022-01-27,7513,7380,133,1.8,1201
2022-01-28,7107,7127,-20,-0.28,1201
2022-01-29,3231,2538,693,27.3,1201
2022-01-30,1565,635,930,146.46,1201
2020-02-01,9467,8641,826,9.56,1202
2020-02-02,5140,4046,1094,27.04,1202
2020-02-03,14227,14254,-27,-0.19,1202
2020-02-04,14449,14399,50,0.35,1202
2020-02-05,14449,14404,45,0.31,1202
2020-02-06,14449,14411,38,0.26,1202
2020-02-07,14602,14598,4,0.03,1202
2020-02-08,9467,8689,778,8.95,1202
2020-02-09,5140,4078,1062,26.04,1202
2020-02-10,14227,14274,-47,-0.33,1202
2020-02-11,14449,14411,38,0.26,1202
2020-02-12,14449,14414,35,0.24,1202
2020-02-13,14449,14422,27,0.19,1202
2020-02-14,14602,14616,-14,-0.1,1202
2020-02-15,9467,8717,750,8.6,1202
2020-02-16,5140,4121,1019,24.73,1202
2020-02-17,14227,14337,-110,-0.77,1202
2020-02-18,14449,14496,-47,-0.32,1202
2020-02-19,14449,14523,-74,-0.51,1202
2020-02-20,14449,14557,-108,-0.74,1202
2020-02-21,14602,14779,-177,-1.2,1202
2020-02-22,9467,8907,560,6.29,1202
2020-02-23,5140,4338,802,18.49,1202
2020-02-24,14227,14578,-351,-2.41,1202
2020-02-25,14449,14760,-311,-2.11,1202
2020-02-26,14449,14807,-358,-2.42,1202
2020-02-27,14449,14858,-409,-2.75,1202
2020-02-28,14602,15091,-489,-3.24,1202
2020-02-29,9467,9227,240,2.6,1202
2020-03-01,3467,4662,-1195,-25.63,1202
2020-03-02,10584,14900,-4316,-28.97,1202
2020-03-03,10647,15076,-4429,-29.38,1202
2020-03-04,10647,15112,-4465,-29.55,1202
2020-03-05,10647,15149,-4502,-29.72,1202
2020-03-06,11379,15364,-3985,-25.94,1202
2020-03-07,6272,9479,-3207,-33.83,1202
2020-03-08,3467,4890,-1423,-29.1,1202
2020-03-09,10584,15103,-4519,-29.92,1202
2020-03-10,10647,15253,-4606,-30.2,1202
2020-03-11,10647,15264,-4617,-30.25,1202
2020-03-12,10647,15275,-4628,-30.3,1202
2020-03-13,11379,15467,-4088,-26.43,1202
2020-03-14,6272,9561,-3289,-34.4,1202
2020-03-15,3467,4954,-1487,-30.02,1202
2020-03-16,10584,15153,-4569,-30.15,1202
2020-03-17,10647,15292,-4645,-30.38,1202
2020-03-18,10647,15296,-4649,-30.39,1202
2020-03-19,10647,15305,-4658,-30.43,1202
2020-03-20,11379,15500,-4121,-26.59,1202
2020-03-21,6272,9601,-3329,-34.67,1202
2020-03-22,3467,5005,-1538,-30.73,1202
2020-03-23,10584,15219,-4635,-30.46,1202
2020-03-24,10647,15377,-4730,-30.76,1202
2020-03-25,10647,15403,-4756,-30.88,1202
2020-03-26,10647,15436,-4789,-31.02,1202
2020-03-27,11379,15656,-4277,-27.32,1202
2020-03-28,6272,9784,-3512,-35.9,1202
2020-03-29,3467,5214,-1747,-33.51,1202
2020-03-30,10584,15453,-4869,-31.51,1202
2020-03-31,10647,15634,-4987,-31.9,1202
2020-04-01,9333,15681,-6348,-40.48,1202
2020-04-02,9333,15732,-6399,-40.68,1202
2020-04-03,8713,15967,-7254,-45.43,1202
2020-04-04,5412,10104,-4692,-46.44,1202
2020-04-05,2316,5540,-3224,-58.19,1202
2020-04-06,9095,15780,-6685,-42.36,1202
2020-04-07,9333,15958,-6625,-41.52,1202
2020-04-08,9333,15996,-6663,-41.65,1202
2020-04-09,9333,16034,-6701,-41.79,1202
2020-04-10,8713,16251,-7538,-46.38,1202
2020-04-11,5412,10366,-4954,-47.79,1202
2020-04-12,2316,5777,-3461,-59.91,1202
2020-04-13,9095,15989,-6894,-43.12,1202
2020-04-14,9333,16137,-6804,-42.16,1202
2020-04-15,9333,16144,-6811,-42.19,1202
2020-04-16,9333,16149,-6816,-42.21,1202
2020-04-17,8713,16333,-7620,-46.65,1202
2020-04-18,5412,10418,-5006,-48.05,1202
2020-04-19,2316,5798,-3482,-60.06,1202
2020-04-20,9095,15983,-6888,-43.1,1202
2020-04-21,9333,16105,-6772,-42.05,1202
2020-04-22,9333,16090,-6757,-42.0,1202
2020-04-23,9333,16077,-6744,-41.95,1202
2020-04-24,8713,16247,-7534,-46.37,1202
2020-04-25,5412,10321,-4909,-47.56,1202
2020-04-26,2316,5696,-3380,-59.34,1202
2020-04-27,9095,15878,-6783,-42.72,1202
2020-04-28,9333,16002,-6669,-41.68,1202
2020-04-29,9333,15991,-6658,-41.64,1202
2020-04-30,9333,15986,-6653,-41.62,1202
2020-05-01,13452,16167,-2715,-16.79,1202
2020-05-02,8998,10253,-1255,-12.24,1202
2020-05-03,3850,5642,-1792,-31.76,1202
2020-05-04,13064,15839,-2775,-17.52,1202
2020-05-05,13336,15978,-2642,-16.54,1202
2020-05-06,13336,15982,-2646,-16.56,1202
2020-05-07,13336,15991,-2655,-16.6,1202
2020-05-08,13452,16185,-2733,-16.89,1202
2020-05-09,8998,10282,-1284,-12.49,1202
2020-05-10,3850,5679,-1829,-32.21,1202
2020-05-11,13064,15883,-2819,-17.75,1202
2020-05-12,13336,16026,-2690,-16.79,1202
2020-05-13,13336,16032,-2696,-16.82,1202
2020-05-14,13336,16040,-2704,-16.86,1202
2020-05-15,13452,16230,-2778,-17.12,1202
2020-05-16,8998,10322,-1324,-12.83,1202
2020-05-17,3850,5711,-1861,-32.59,1202
2020-05-18,13064,15906,-2842,-17.87,1202
2020-05-19,13336,16040,-2704,-16.86,1202
2020-05-20,13336,16035,-2699,-16.83,1202
2020-05-21,13336,16033,-2697,-16.82,1202
2020-05-22,13452,16214,-2762,-17.03,1202
2020-05-23,8998,10297,-1299,-12.62,1202
2020-05-24,3850,5680,-1830,-32.22,1202
2020-05-25,13064,15870,-2806,-17.68,1202
2020-05-26,13336,16001,-2665,-16.66,1202
2020-05-27,13336,15997,-2661,-16.63,1202
2020-05-28,13336,15998,-2662,-16.64,1202
2020-05-29,13452,16183,-2731,-16.88,1202
2020-05-30,8998,10275,-1277,-12.43,1202
2020-05-31,3850,5668,-1818,-32.07,1202
2020-06-01,14425,15871,-1446,-9.11,1202
2020-06-02,14698,16016,-1318,-8.23,1202
2020-06-03,14698,16027,-1329,-8.29,1202
2020-06-04,14698,16044,-1346,-8.39,1202
2020-06-05,14376,16245,-1869,-11.51,1202
2020-06-06,9114,10352,-1238,-11.96,1202
2020-06-07,4784,5759,-975,-16.93,1202
2020-06-08,14425,15974,-1549,-9.7,1202
2020-06-09,14698,16128,-1430,-8.87,1202
2020-06-10,14698,16145,-1447,-8.96,1202
2020-06-11,14698,16163,-1465,-9.06,1202
2020-06-12,14376,16363,-1987,-12.14,1202
2020-06-13,9114,10462,-1348,-12.88,1202
2020-06-14,4784,5857,-1073,-18.32,1202
2020-06-15,14425,16054,-1629,-10.15,1202
2020-06-16,14698,16186,-1488,-9.19,1202
2020-06-17,14698,16175,-1477,-9.13,1202
2020-06-18,14698,16162,-1464,-9.06,1202
2020-06-19,14376,16325,-1949,-11.94,1202
2020-06-20,9114,10384,-1270,-12.23,1202
2020-06-21,4784,5737,-953,-16.61,1202
2020-06-22,14425,15889,-1464,-9.21,1202
2020-06-23,14698,15975,-1277,-7.99,1202
2020-06-24,14698,15919,-1221,-7.67,1202
2020-06-25,14698,15860,-1162,-7.33,1202
2020-06-26,14376,15980,-1604,-10.04,1202
2020-06-27,9114,9999,-885,-8.85,1202
2020-06-28,4784,5315,-531,-9.99,1202
2020-06-29,14425,15436,-1011,-6.55,1202
2020-06-30,14698,15495,-797,-5.14,1202
2020-07-01,17049,15418,1631,10.58,1202
2020-07-02,17049,15346,1703,11.1,1202
2020-07-03,16773,15458,1315,8.51,1202
2020-07-04,10430,9478,952,10.04,1202
2020-07-05,6305,4801,1504,31.33,1202
2020-07-06,17534,14935,2599,17.4,1202
2020-07-07,17049,15015,2034,13.55,1202
2020-07-08,17049,14965,2084,13.93,1202
2020-07-09,17049,14925,2124,14.23,1202
2020-07-10,16773,15074,1699,11.27,1202
2020-07-11,10430,9134,1296,14.19,1202
2020-07-12,6305,4500,1805,40.11,1202
2020-07-13,17534,14679,2855,19.45,1202
2020-07-14,17049,14804,2245,15.16,1202
2020-07-15,17049,14798,2251,15.21,1202
2020-07-16,17049,14799,2250,15.2,1202
2020-07-17,16773,14988,1785,11.91,1202
2020-07-18,10430,9083,1347,14.83,1202
2020-07-19,6305,4479,1826,40.77,1202
2020-07-20,17534,14683,2851,19.42,1202
2020-07-21,17049,14826,2223,14.99,1202
2020-07-22,17049,14832,2217,14.95,1202
2020-07-23,17049,14838,2211,14.9,1202
2020-07-24,16773,15025,1748,11.63,1202
2020-07-25,10430,9112,1318,14.46,1202
2020-07-26,6305,4493,1812,40.33,1202
2020-07-27,17534,14676,2858,19.47,1202
2020-07-28,17049,14793,2256,15.25,1202
2020-07-29,17049,14769,2280,15.44,1202
2020-07-30,17049,14743,2306,15.64,1202
2020-07-31,16773,14894,1879,12.62,1202
2020-08-01,10526,8944,1582,17.69,1202
2020-08-02,6665,4289,2376,55.4,1202
2020-08-03,16824,14437,2387,16.53,1202
2020-08-04,17192,14522,2670,18.39,1202
2020-08-05,17192,14470,2722,18.81,1202
2020-08-06,17192,14419,2773,19.23,1202
2020-08-07,16913,14552,2361,16.22,1202
2020-08-08,10526,8591,1935,22.52,1202
2020-08-09,6665,3931,2734,69.55,1202
2020-08-10,16824,14082,2742,19.47,1202
2020-08-11,17192,14178,3014,21.26,1202
2020-08-12,17192,14143,3049,21.56,1202
2020-08-13,17192,14119,3073,21.76,1202
2020-08-14,16913,14285,2628,18.4,1202
2020-08-15,10526,8364,2162,25.85,1202
2020-08-16,6665,3750,2915,77.73,1202
2020-08-17,16824,13952,2872,20.58,1202
2020-08-18,17192,14103,3089,21.9,1202
2020-08-19,17192,14126,3066,21.7,1202
2020-08-20,17192,14162,3030,21.4,1202
2020-08-21,16913,14388,2525,17.55,1202
2020-08-22,10526,8526,2000,23.46,1202
2020-08-23,6665,3969,2696,67.93,1202
2020-08-24,16824,14226,2598,18.26,1202
2020-08-25,17192,14426,2766,19.17,1202
2020-08-26,17192,14494,2698,18.61,1202
2020-08-27,17192,14568,2624,18.01,1202
2020-08-28,16913,14826,2087,14.08,1202
2020-08-29,10526,8987,1539,17.12,1202
2020-08-30,6665,4447,2218,49.88,1202
2020-08-31,16824,14712,2112,14.36,1202
2020-09-01,15111,14913,198,1.33,1202
2020-09-02,15111,14974,137,0.91,1202
2020-09-03,15111,15034,77,0.51,1202
2020-09-04,15032,15271,-239,-1.57,1202
2020-09-05,9766,9406,360,3.83,1202
2020-09-06,5323,4835,488,10.09,1202
2020-09-07,14830,15064,-234,-1.55,1202
2020-09-08,15111,15227,-116,-0.76,1202
2020-09-09,15111,15249,-138,-0.9,1202
2020-09-10,15111,15268,-157,-1.03,1202
2020-09-11,15032,15465,-433,-2.8,1202
2020-09-12,9766,9562,204,2.13,1202
2020-09-13,5323,4955,368,7.43,1202
2020-09-14,14830,15152,-322,-2.13,1202
2020-09-15,15111,15287,-176,-1.15,1202
2020-09-16,15111,15284,-173,-1.13,1202
2020-09-17,15111,15285,-174,-1.14,1202
2020-09-18,15032,15470,-438,-2.83,1202
2020-09-19,9766,9559,207,2.17,1202
2020-09-20,5323,4950,373,7.54,1202
2020-09-21,14830,15150,-320,-2.11,1202
2020-09-22,15111,15293,-182,-1.19,1202
2020-09-23,15111,15304,-193,-1.26,1202
2020-09-24,15111,15321,-210,-1.37,1202
2020-09-25,15032,15525,-493,-3.18,1202
2020-09-26,9766,9636,130,1.35,1202
2020-09-27,5323,5050,273,5.41,1202
2020-09-28,14830,15273,-443,-2.9,1202
2020-09-29,15111,15439,-328,-2.12,1202
2020-09-30,15111,15472,-361,-2.33,1202
2020-10-01,15371,15508,-137,-0.88,1202
2020-10-02,15523,15729,-206,-1.31,1202
2020-10-03,9894,9853,41,0.42,1202
2020-10-04,4840,5277,-437,-8.28,1202
2020-10-05,15076,15505,-429,-2.77,1202
2020-10-06,15371,15672,-301,-1.92,1202
2020-10-07,15371,15700,-329,-2.1,1202
2020-10-08,15371,15728,-357,-2.27,1202
2020-10-09,15523,15936,-413,-2.59,1202
2020-10-10,9894,10044,-150,-1.49,1202
2020-10-11,4840,5448,-608,-11.16,1202
2020-10-12,15076,15654,-578,-3.69,1202
2020-10-13,15371,15796,-425,-2.69,1202
2020-10-14,15371,15798,-427,-2.7,1202
2020-10-15,15371,15799,-428,-2.71,1202
2020-10-16,15523,15981,-458,-2.87,1202
2020-10-17,9894,10063,-169,-1.68,1202
2020-10-18,4840,5443,-603,-11.08,1202
2020-10-19,15076,15628,-552,-3.53,1202
2020-10-20,15371,15752,-381,-2.42,1202
2020-10-21,15371,15739,-368,-2.34,1202
2020-10-22,15371,15731,-360,-2.29,1202
2020-10-23,15523,15906,-383,-2.41,1202
2020-10-24,9894,9986,-92,-0.92,1202
2020-10-25,4840,5368,-528,-9.84,1202
2020-10-26,15076,15560,-484,-3.11,1202
2020-10-27,15371,15694,-323,-2.06,1202
2020-10-28,15371,15695,-324,-2.06,1202
2020-10-29,15371,15702,-331,-2.11,1202
2020-10-30,15523,15897,-374,-2.35,1202
2020-10-31,9894,9997,-103,-1.03,1202
2020-11-01,3786,5401,-1615,-29.9,1202
2020-11-02,13604,15613,-2009,-12.87,1202
2020-11-03,12318,15768,-3450,-21.88,1202
2020-11-04,12318,15788,-3470,-21.98,1202
2020-11-05,12318,15812,-3494,-22.1,1202
2020-11-06,12858,16019,-3161,-19.73,1202
2020-11-07,7790,10130,-2340,-23.1,1202
2020-11-08,3786,5539,-1753,-31.65,1202
2020-11-09,13604,15753,-2149,-13.64,1202
2020-11-10,12318,15904,-3586,-22.55,1202
2020-11-11,12318,15916,-3598,-22.61,1202
2020-11-12,12318,15928,-3610,-22.66,1202
2020-11-13,12858,16118,-3260,-20.23,1202
2020-11-14,7790,10208,-2418,-23.69,1202
2020-11-15,3786,5593,-1807,-32.31,1202
2020-11-16,13604,15780,-2176,-13.79,1202
2020-11-17,12318,15902,-3584,-22.54,1202
2020-11-18,12318,15883,-3565,-22.45,1202
2020-11-19,12318,15864,-3546,-22.35,1202
2020-11-20,12858,16024,-3166,-19.76,1202
2020-11-21,7790,10084,-2294,-22.75,1202
2020-11-22,3786,5441,-1655,-30.42,1202
2020-11-23,13604,15603,-1999,-12.81,1202
2020-11-24,12318,15703,-3385,-21.56,1202
2020-11-25,12318,15667,-3349,-21.38,1202
2020-11-26,12318,15635,-3317,-21.22,1202
2020-11-27,12858,15787,-2929,-18.55,1202
2020-11-28,7790,9844,-2054,-20.87,1202
2020-11-29,3786,5203,-1417,-27.23,1202
2020-11-30,13604,15372,-1768,-11.5,1202
2020-12-01,12458,15485,-3027,-19.55,1202
2020-12-02,12458,15465,-3007,-19.44,1202
2020-12-03,12458,15453,-2995,-19.38,1202
2020-12-04,14108,15627,-1519,-9.72,1202
2020-12-05,8886,9710,-824,-8.49,1202
2020-12-06,3884,5096,-1212,-23.78,1202
2020-12-07,13338,15291,-1953,-12.77,1202
2020-12-08,12458,15430,-2972,-19.26,1202
2020-12-09,12458,15435,-2977,-19.29,1202
2020-12-10,12458,15444,-2986,-19.33,1202
2020-12-11,14108,15637,-1529,-9.78,1202
2020-12-12,8886,9734,-848,-8.71,1202
2020-12-13,3884,5128,-1244,-24.26,1202
2020-12-14,13338,15328,-1990,-12.98,1202
2020-12-15,12458,15463,-3005,-19.43,1202
2020-12-16,12458,15459,-3001,-19.41,1202
2020-12-17,12458,15453,-2995,-19.38,1202
2020-12-18,14108,15624,-1516,-9.7,1202
2020-12-19,8886,9693,-807,-8.33,1202
2020-12-20,3884,5054,-1170,-23.15,1202
2020-12-21,13338,15214,-1876,-12.33,1202
2020-12-22,12458,15307,-2849,-18.61,1202
2020-12-23,12458,15257,-2799,-18.35,1202
2020-12-24,12458,15202,-2744,-18.05,1202
2020-12-25,14108,15324,-1216,-7.94,1202
2020-12-26,8886,9342,-456,-4.88,1202
2020-12-27,3884,4655,-771,-16.56,1202
2020-12-28,13338,14769,-1431,-9.69,1202
2020-12-29,12458,14819,-2361,-15.93,1202
2020-12-30,12458,14731,-2273,-15.43,1202
2020-12-31,12458,14644,-2186,-14.93,1202
2021-01-01,11207,14739,-3532,-23.96,1202
2021-01-02,6135,8739,-2604,-29.8,1202
2021-01-03,3155,4041,-886,-21.93,1202
2021-01-04,10863,14152,-3289,-23.24,1202
2021-01-05,11119,14208,-3089,-21.74,1202
2021-01-06,11119,14134,-3015,-21.33,1202
2021-01-07,11119,14069,-2950,-20.97,1202
2021-01-08,11207,14194,-2987,-21.04,1202
2021-01-09,6135,8231,-2096,-25.46,1202
2021-01-10,3155,3576,-421,-11.77,1202
2021-01-11,10863,13737,-2874,-20.92,1202
2021-01-12,11119,13846,-2727,-19.7,1202
2021-01-13,11119,13828,-2709,-19.59,1202
2021-01-14,11119,13823,-2704,-19.56,1202
2021-01-15,11207,14008,-2801,-20.0,1202
2021-01-16,6135,8105,-1970,-24.31,1202
2021-01-17,3155,3509,-354,-10.09,1202
2021-01-18,10863,13726,-2863,-20.86,1202
2021-01-19,11119,13888,-2769,-19.94,1202
2021-01-20,11119,13918,-2799,-20.11,1202
2021-01-21,11119,13955,-2836,-20.32,1202
2021-01-22,11207,14178,-2971,-20.96,1202
2021-01-23,6135,8305,-2170,-26.13,1202
2021-01-24,3155,3733,-578,-15.48,1202
2021-01-25,10863,13966,-3103,-22.22,1202
2021-01-26,11119,14138,-3019,-21.35,1202
2021-01-27,11119,14172,-3053,-21.54,1202
2021-01-28,11119,14206,-3087,-21.73,1202
2021-01-29,11207,14420,-3213,-22.28,1202
2021-01-30,6135,8534,-2399,-28.11,1202
2021-01-31,3155,3944,-789,-20.01,1202
2021-02-01,12914,14156,-1242,-8.77,1202
2021-02-02,12754,14305,-1551,-10.84,1202
2021-02-03,12754,14315,-1561,-10.9,1202
2021-02-04,12754,14324,-1570,-10.96,1202
2021-02-05,13128,14514,-1386,-9.55,1202
2021-02-06,8052,8606,-554,-6.44,1202
2021-02-07,3890,3996,-106,-2.65,1202
2021-02-08,12914,14192,-1278,-9.01,1202
2021-02-09,12754,14328,-1574,-10.99,1202
2021-02-10,12754,14328,-1574,-10.99,1202
2021-02-11,12754,14334,-1580,-11.02,1202
2021-02-12,13128,14524,-1396,-9.61,1202
2021-02-13,8052,8621,-569,-6.6,1202
2021-02-14,3890,4021,-131,-3.26,1202
2021-02-15,12914,14231,-1317,-9.25,1202
2021-02-16,12754,14385,-1631,-11.34,1202
2021-02-17,12754,14407,-1653,-11.47,1202
2021-02-18,12754,14437,-1683,-11.66,1202
2021-02-19,13128,14653,-1525,-10.41,1202
2021-02-20,8052,8777,-725,-8.26,1202
2021-02-21,3890,4204,-314,-7.47,1202
2021-02-22,12914,14441,-1527,-10.57,1202
2021-02-23,12754,14621,-1867,-12.77,1202
2021-02-24,12754,14666,-1912,-13.04,1202
2021-02-25,12754,14716,-1962,-13.33,1202
2021-02-26,13128,14950,-1822,-12.19,1202
2021-02-27,8052,9087,-1035,-11.39,1202
2021-02-28,3890,4523,-633,-14.0,1202
2021-03-01,13711,14765,-1054,-7.14,1202
2021-03-02,13905,14944,-1039,-6.95,1202
2021-03-03,13905,14984,-1079,-7.2,1202
2021-03-04,13905,15025,-1120,-7.45,1202
2021-03-05,13884,15245,-1361,-8.93,1202
2021-03-06,8892,9365,-473,-5.05,1202
2021-03-07,4026,4780,-754,-15.77,1202
2021-03-08,13711,14999,-1288,-8.59,1202
2021-03-09,13905,15153,-1248,-8.24,1202
2021-03-10,13905,15168,-1263,-8.33,1202
2021-03-11,13905,15183,-1278,-8.42,1202
2021-03-12,13884,15378,-1494,-9.72,1202
2021-03-13,8892,9474,-582,-6.14,1202
2021-03-14,4026,4867,-841,-17.28,1202
2021-03-15,13711,15067,-1356,-9.0,1202
2021-03-16,13905,15206,-1301,-8.56,1202
2021-03-17,13905,15209,-1304,-8.57,1202
2021-03-18,13905,15216,-1311,-8.62,1202
2021-03-19,13884,15408,-1524,-9.89,1202
2021-03-20,8892,9505,-613,-6.45,1202
2021-03-21,4026,4905,-879,-17.92,1202
2021-03-22,13711,15115,-1404,-9.29,1202
2021-03-23,13905,15268,-1363,-8.93,1202
2021-03-24,13905,15289,-1384,-9.05,1202
2021-03-25,13905,15317,-1412,-9.22,1202
2021-03-26,13884,15533,-1649,-10.62,1202
2021-03-27,8892,9655,-763,-7.9,1202
2021-03-28,4026,5081,-1055,-20.76,1202
2021-03-29,13711,15317,-1606,-10.49,1202
2021-03-30,13905,15496,-1591,-10.27,1202
2021-03-31,13905,15541,-1636,-10.53,1202
2021-04-01,12506,15590,-3084,-19.78,1202
2021-04-02,12722,15824,-3102,-19.6,1202
2021-04-03,7155,9962,-2807,-28.18,1202
2021-04-04,3871,5400,-1529,-28.31,1202
2021-04-05,12725,15642,-2917,-18.65,1202
2021-04-06,12506,15823,-3317,-20.96,1202
2021-04-07,12506,15865,-3359,-21.17,1202
2021-04-08,12506,15908,-3402,-21.39,1202
2021-04-09,12722,16130,-3408,-21.13,1202
2021-04-10,7155,10251,-3096,-30.2,1202
2021-04-11,3871,5667,-1796,-31.69,1202
2021-04-12,12725,15886,-3161,-19.9,1202
2021-04-13,12506,16039,-3533,-22.03,1202
2021-04-14,12506,16052,-3546,-22.09,1202
2021-04-15,12506,16063,-3557,-22.14,1202
2021-04-16,12722,16253,-3531,-21.73,1202
2021-04-17,7155,10342,-3187,-30.82,1202
2021-04-18,3871,5727,-1856,-32.41,1202
2021-04-19,12725,15915,-3190,-20.04,1202
2021-04-20,12506,16040,-3534,-22.03,1202
2021-04-21,12506,16027,-3521,-21.97,1202
2021-04-22,12506,16015,-3509,-21.91,1202
2021-04-23,12722,16186,-3464,-21.4,1202
2021-04-24,7155,10259,-3104,-30.26,1202
2021-04-25,3871,5632,-1761,-31.27,1202
2021-04-26,12725,15813,-3088,-19.53,1202
2021-04-27,12506,15935,-3429,-21.52,1202
2021-04-28,12506,15922,-3416,-21.45,1202
2021-04-29,12506,15914,-3408,-21.42,1202
2021-04-30,12722,16092,-3370,-20.94,1202
2021-05-01,9971,10176,-205,-2.01,1202
2021-05-02,4453,5561,-1108,-19.92,1202
2021-05-03,15171,15756,-585,-3.71,1202
2021-05-04,15503,15892,-389,-2.45,1202
2021-05-05,15503,15895,-392,-2.47,1202
2021-05-06,15503,15902,-399,-2.51,1202
2021-05-07,15883,16094,-211,-1.31,1202
2021-05-08,9971,10191,-220,-2.16,1202
2021-05-09,4453,5588,-1135,-20.31,1202
2021-05-10,15171,15791,-620,-3.93,1202
2021-05-11,15503,15935,-432,-2.71,1202
2021-05-12,15503,15942,-439,-2.75,1202
2021-05-13,15503,15951,-448,-2.81,1202
2021-05-14,15883,16143,-260,-1.61,1202
2021-05-15,9971,10237,-266,-2.6,1202
2021-05-16,4453,5629,-1176,-20.89,1202
2021-05-17,15171,15825,-654,-4.13,1202
2021-05-18,15503,15961,-458,-2.87,1202
2021-05-19,15503,15958,-455,-2.85,1202
2021-05-20,15503,15957,-454,-2.85,1202
2021-05-21,15883,16139,-256,-1.59,1202
2021-05-22,9971,10223,-252,-2.47,1202
2021-05-23,4453,5606,-1153,-20.57,1202
2021-05-24,15171,15796,-625,-3.96,1202
2021-05-25,15503,15926,-423,-2.66,1202
2021-05-26,15503,15920,-417,-2.62,1202
2021-05-27,15503,15919,-416,-2.61,1202
2021-05-28,15883,16102,-219,-1.36,1202
2021-05-29,9971,10191,-220,-2.16,1202
2021-05-30,4453,5581,-1128,-20.21,1202
2021-05-31,15171,15781,-610,-3.87,1202
2021-06-01,15793,15923,-130,-0.82,1202
2021-06-02,15793,15931,-138,-0.87,1202
2021-06-03,15793,15945,-152,-0.95,1202
2021-06-04,15310,16144,-834,-5.17,1202
2021-06-05,9636,10249,-613,-5.98,1202
2021-06-06,5334,5655,-321,-5.68,1202
2021-06-07,15394,15869,-475,-2.99,1202
2021-06-08,15793,16023,-230,-1.44,1202
2021-06-09,15793,16041,-248,-1.55,1202
2021-06-10,15793,16062,-269,-1.67,1202
2021-06-11,15310,16264,-954,-5.87,1202
2021-06-12,9636,10367,-731,-7.05,1202
2021-06-13,5334,5767,-433,-7.51,1202
2021-06-14,15394,15970,-576,-3.61,1202
2021-06-15,15793,16108,-315,-1.96,1202
2021-06-16,15793,16105,-312,-1.94,1202
2021-06-17,15793,16099,-306,-1.9,1202
2021-06-18,15310,16271,-961,-5.91,1202
2021-06-19,9636,10339,-703,-6.8,1202
2021-06-20,5334,5700,-366,-6.42,1202
2021-06-21,15394,15861,-467,-2.94,1202
2021-06-22,15793,15955,-162,-1.02,1202
2021-06-23,15793,15906,-113,-0.71,1202
2021-06-24,15793,15854,-61,-0.38,1202
2021-06-25,15310,15980,-670,-4.19,1202
2021-06-26,9636,10005,-369,-3.69,1202
2021-06-27,5334,5324,10,0.19,1202
2021-06-28,15394,15448,-54,-0.35,1202
2021-06-29,15793,15508,285,1.84,1202
2021-06-30,15793,15432,361,2.34,1202
2021-07-01,14531,15358,-827,-5.38,1202
2021-07-02,14574,15468,-894,-5.78,1202
2021-07-03,9214,9484,-270,-2.85,1202
2021-07-04,5034,4802,232,4.83,1202
2021-07-05,14396,14931,-535,-3.58,1202
2021-07-06,14531,15004,-473,-3.15,1202
2021-07-07,14531,14946,-415,-2.78,1202
2021-07-08,14531,14898,-367,-2.46,1202
2021-07-09,14574,15039,-465,-3.09,1202
2021-07-10,9214,9090,124,1.36,1202
2021-07-11,5034,4448,586,13.17,1202
2021-07-12,14396,14619,-223,-1.53,1202
2021-07-13,14531,14736,-205,-1.39,1202
2021-07-14,14531,14724,-193,-1.31,1202
2021-07-15,14531,14720,-189,-1.28,1202
2021-07-16,14574,14903,-329,-2.21,1202
2021-07-17,9214,8995,219,2.43,1202
2021-07-18,5034,4388,646,14.72,1202
2021-07-19,14396,14591,-195,-1.34,1202
2021-07-20,14531,14734,-203,-1.38,1202
2021-07-21,14531,14742,-211,-1.43,1202
2021-07-22,14531,14751,-220,-1.49,1202
2021-07-23,14574,14942,-368,-2.46,1202
2021-07-24,9214,9033,181,2.0,1202
2021-07-25,5034,4420,614,13.89,1202
2021-07-26,14396,14609,-213,-1.46,1202
2021-07-27,14531,14733,-202,-1.37,1202
2021-07-28,14531,14716,-185,-1.26,1202
2021-07-29,14531,14697,-166,-1.13,1202
2021-07-30,14574,14855,-281,-1.89,1202
2021-07-31,9214,8911,303,3.4,1202
2021-08-01,4956,4262,694,16.28,1202
2021-08-02,13653,14414,-761,-5.28,1202
2021-08-03,13682,14503,-821,-5.66,1202
2021-08-04,13682,14453,-771,-5.33,1202
2021-08-05,13682,14404,-722,-5.01,1202
2021-08-06,13880,14537,-657,-4.52,1202
2021-08-07,8634,8573,61,0.71,1202
2021-08-08,4956,3911,1045,26.72,1202
2021-08-09,13653,14057,-404,-2.87,1202
2021-08-10,13682,14147,-465,-3.29,1202
2021-08-11,13682,14105,-423,-3.0,1202
2021-08-12,13682,14072,-390,-2.77,1202
2021-08-13,13880,14229,-349,-2.45,1202
2021-08-14,8634,8297,337,4.06,1202
2021-08-15,4956,3673,1283,34.93,1202
2021-08-16,13653,13864,-211,-1.52,1202
2021-08-17,13682,14003,-321,-2.29,1202
2021-08-18,13682,14016,-334,-2.38,1202
2021-08-19,13682,14040,-358,-2.55,1202
2021-08-20,13880,14257,-377,-2.64,1202
2021-08-21,8634,8385,249,2.97,1202
2021-08-22,4956,3820,1136,29.74,1202
2021-08-23,13653,14069,-416,-2.96,1202
2021-08-24,13682,14264,-582,-4.08,1202
2021-08-25,13682,14327,-645,-4.5,1202
2021-08-26,13682,14398,-716,-4.97,1202
2021-08-27,13880,14654,-774,-5.28,1202
2021-08-28,8634,8816,-182,-2.06,1202
2021-08-29,4956,4277,679,15.88,1202
2021-08-30,13653,14544,-891,-6.13,1202
2021-08-31,13682,14749,-1067,-7.23,1202
2021-09-01,15095,14815,280,1.89,1202
2021-09-02,15095,14880,215,1.44,1202
2021-09-03,14974,15124,-150,-0.99,1202
2021-09-04,9823,9266,557,6.01,1202
2021-09-05,5719,4703,1016,21.6,1202
2021-09-06,14889,14940,-51,-0.34,1202
2021-09-07,15095,15110,-15,-0.1,1202
2021-09-08,15095,15139,-44,-0.29,1202
2021-09-09,15095,15165,-70,-0.46,1202
2021-09-10,14974,15369,-395,-2.57,1202
2021-09-11,9823,9471,352,3.72,1202
2021-09-12,5719,4868,851,17.48,1202
2021-09-13,14889,15068,-179,-1.19,1202
2021-09-14,15095,15206,-111,-0.73,1202
2021-09-15,15095,15205,-110,-0.72,1202
2021-09-16,15095,15206,-111,-0.73,1202
2021-09-17,14974,15390,-416,-2.7,1202
2021-09-18,9823,9478,345,3.64,1202
2021-09-19,5719,4866,853,17.53,1202
2021-09-20,14889,15063,-174,-1.16,1202
2021-09-21,15095,15203,-108,-0.71,1202
2021-09-22,15095,15209,-114,-0.75,1202
2021-09-23,15095,15222,-127,-0.83,1202
2021-09-24,14974,15421,-447,-2.9,1202
2021-09-25,9823,9528,295,3.1,1202
2021-09-26,5719,4937,782,15.84,1202
2021-09-27,14889,15157,-268,-1.77,1202
2021-09-28,15095,15320,-225,-1.47,1202
2021-09-29,15095,15349,-254,-1.65,1202
2021-09-30,15095,15384,-289,-1.88,1202
2021-10-01,15956,15604,352,2.26,1202
2021-10-02,10621,9728,893,9.18,1202
2021-10-03,5521,5152,369,7.16,1202
2021-10-04,15201,15382,-181,-1.18,1202
2021-10-05,15580,15551,29,0.19,1202
2021-10-06,15580,15582,-2,-0.01,1202
2021-10-07,15580,15614,-34,-0.22,1202
2021-10-08,15956,15826,130,0.82,1202
2021-10-09,10621,9939,682,6.86,1202
2021-10-10,5521,5347,174,3.25,1202
2021-10-11,15201,15558,-357,-2.29,1202
2021-10-12,15580,15705,-125,-0.8,1202
2021-10-13,15580,15712,-132,-0.84,1202
2021-10-14,15580,15718,-138,-0.88,1202
2021-10-15,15956,15904,52,0.33,1202
2021-10-16,10621,9990,631,6.32,1202
2021-10-17,5521,5373,148,2.75,1202
2021-10-18,15201,15560,-359,-2.31,1202
2021-10-19,15580,15685,-105,-0.67,1202
2021-10-20,15580,15673,-93,-0.59,1202
2021-10-21,15580,15663,-83,-0.53,1202
2021-10-22,15956,15838,118,0.75,1202
2021-10-23,10621,9916,705,7.11,1202
2021-10-24,5521,5296,225,4.25,1202
2021-10-25,15201,15484,-283,-1.83,1202
2021-10-26,15580,15614,-34,-0.22,1202
2021-10-27,15580,15612,-32,-0.2,1202
2021-10-28,15580,15615,-35,-0.22,1202
2021-10-29,15956,15805,151,0.96,1202
2021-10-30,10621,9902,719,7.26,1202
2021-10-31,5521,5302,219,4.13,1202
2021-11-01,13879,15511,-1632,-10.52,1202
2021-11-02,14556,15663,-1107,-7.07,1202
2021-11-03,14556,15681,-1125,-7.17,1202
2021-11-04,14556,15703,-1147,-7.3,1202
2021-11-05,14664,15910,-1246,-7.83,1202
2021-11-06,9609,10021,-412,-4.11,1202
2021-11-07,4933,5432,-499,-9.19,1202
2021-11-08,13879,15648,-1769,-11.3,1202
2021-11-09,14556,15802,-1246,-7.89,1202
2021-11-10,14556,15818,-1262,-7.98,1202
2021-11-11,14556,15834,-1278,-8.07,1202
2021-11-12,14664,16030,-1366,-8.52,1202
2021-11-13,9609,10125,-516,-5.1,1202
2021-11-14,4933,5516,-583,-10.57,1202
2021-11-15,13879,15709,-1830,-11.65,1202
2021-11-16,14556,15836,-1280,-8.08,1202
2021-11-17,14556,15824,-1268,-8.01,1202
2021-11-18,14556,15809,-1253,-7.93,1202
2021-11-19,14664,15974,-1310,-8.2,1202
2021-11-20,9609,10038,-429,-4.27,1202
2021-11-21,4933,5399,-466,-8.63,1202
2021-11-22,13879,15563,-1684,-10.82,1202
2021-11-23,14556,15665,-1109,-7.08,1202
2021-11-24,14556,15630,-1074,-6.87,1202
2021-11-25,14556,15597,-1041,-6.67,1202
2021-11-26,14664,15748,-1084,-6.88,1202
2021-11-27,9609,9803,-194,-1.98,1202
2021-11-28,4933,5159,-226,-4.38,1202
2021-11-29,13879,15324,-1445,-9.43,1202
2021-11-30,14556,15433,-877,-5.68,1202
2021-12-01,13503,15408,-1905,-12.36,1202
2021-12-02,13503,15390,-1887,-12.26,1202
2021-12-03,11657,15560,-3903,-25.08,1202
2021-12-04,8575,9637,-1062,-11.02,1202
2021-12-05,4474,5018,-544,-10.84,1202
2021-12-06,14159,15210,-1051,-6.91,1202
2021-12-07,13503,15345,-1842,-12.0,1202
2021-12-08,13503,15347,-1844,-12.02,1202
2021-12-09,13503,15354,-1851,-12.06,1202
2021-12-10,11657,15547,-3890,-25.02,1202
2021-12-11,8575,9643,-1068,-11.08,1202
2021-12-12,4474,5039,-565,-11.21,1202
2021-12-13,14159,15241,-1082,-7.1,1202
2021-12-14,13503,15381,-1878,-12.21,1202
2021-12-15,13503,15381,-1878,-12.21,1202
2021-12-16,13503,15381,-1878,-12.21,1202
2021-12-17,11657,15560,-3903,-25.08,1202
2021-12-18,8575,9636,-1061,-11.01,1202
2021-12-19,4474,5006,-532,-10.63,1202
2021-12-20,14159,15175,-1016,-6.7,1202
2021-12-21,13503,15278,-1775,-11.62,1202
2021-12-22,13503,15236,-1733,-11.37,1202
2021-12-23,13503,15191,-1688,-11.11,1202
2021-12-24,11657,15321,-3664,-23.91,1202
2021-12-25,8575,9348,-773,-8.27,1202
2021-12-26,4474,4668,-194,-4.16,1202
2021-12-27,14159,14788,-629,-4.25,1202
2021-12-28,13503,14844,-1341,-9.03,1202
2021-12-29,13503,14759,-1256,-8.51,1202
2021-12-30,13503,14674,-1171,-7.98,1202
2021-12-31,11657,14770,-3113,-21.08,1202
2022-01-01,8403,8770,-367,-4.18,1202
2022-01-02,4109,4069,40,0.98,1202
2022-01-03,12708,14177,-1469,-10.36,1202
2022-01-04,12767,14227,-1460,-10.26,1202
2022-01-05,12767,14146,-1379,-9.75,1202
2022-01-06,12767,14073,-1306,-9.28,1202
2022-01-07,12731,14189,-1458,-10.28,1202
2022-01-08,8403,8216,187,2.28,1202
2022-01-09,4109,3551,558,15.71,1202
2022-01-10,12708,13700,-992,-7.24,1202
2022-01-11,12767,13799,-1032,-7.48,1202
2022-01-12,12767,13770,-1003,-7.28,1202
2022-01-13,12767,13753,-986,-7.17,1202
2022-01-14,12731,13928,-1197,-8.59,1202
2022-01-15,8403,8015,388,4.84,1202
2022-01-16,4109,3410,699,20.5,1202
2022-01-17,12708,13619,-911,-6.69,1202
2022-01-18,12767,13774,-1007,-7.31,1202
2022-01-19,12767,13799,-1032,-7.48,1202
2022-01-20,12767,13831,-1064,-7.69,1202
2022-01-21,12731,14051,-1320,-9.39,1202
2022-01-22,8403,8176,227,2.78,1202
2022-01-23,4109,3603,506,14.04,1202
2022-01-24,12708,13837,-1129,-8.16,1202
2022-01-25,12767,14011,-1244,-8.88,1202
2022-01-26,12767,14047,-1280,-9.11,1202
2022-01-27,12767,14084,-1317,-9.35,1202
2022-01-28,12731,14302,-1571,-10.98,1202
2022-01-29,8403,8421,-18,-0.21,1202
2022-01-30,4109,3835,274,7.14,1202
2020-02-01,10174,9547,627,6.57,1211
2020-02-02,7108,6704,404,6.03,1211
2020-02-03,19177,19006,171,0.9,1211
2020-02-04,19523,19349,174,0.9,1211
2020-02-05,19523,19361,162,0.84,1211
2020-02-06,19523,19377,146,0.75,1211
2020-02-07,18940,18805,135,0.72,1211
2020-02-08,10174,9641,533,5.53,1211
2020-02-09,7108,6784,324,4.78,1211
2020-02-10,19177,19076,101,0.53,1211
2020-02-11,19523,19413,110,0.57,1211
2020-02-12,19523,19425,98,0.5,1211
2020-02-13,19523,19446,77,0.4,1211
2020-02-14,18940,18883,57,0.3,1211
2020-02-15,10174,9734,440,4.52,1211
2020-02-16,7108,6896,212,3.07,1211
2020-02-17,19177,19211,-34,-0.18,1211
2020-02-18,19523,19575,-52,-0.27,1211
2020-02-19,19523,19616,-93,-0.47,1211
2020-02-20,19523,19667,-144,-0.73,1211
2020-02-21,18940,19137,-197,-1.03,1211
2020-02-22,10174,10020,154,1.54,1211
2020-02-23,7108,7212,-104,-1.44,1211
2020-02-24,19177,19557,-380,-1.94,1211
2020-02-25,19523,19948,-425,-2.13,1211
2020-02-26,19523,20012,-489,-2.44,1211
2020-02-27,19523,20083,-560,-2.79,1211
2020-02-28,18940,19567,-627,-3.2,1211
2020-02-29,10174,10460,-286,-2.73,1211
2020-03-01,5526,7657,-2131,-27.83,1211
2020-03-02,15523,20000,-4477,-22.38,1211
2020-03-03,15507,20385,-4878,-23.93,1211
2020-03-04,15507,20438,-4931,-24.13,1211
2020-03-05,15507,20492,-4985,-24.33,1211
2020-03-06,15403,19956,-4553,-22.82,1211
2020-03-07,7658,10824,-3166,-29.25,1211
2020-03-08,5526,7994,-2468,-30.87,1211
2020-03-09,15523,20307,-4784,-23.56,1211
2020-03-10,15507,20661,-5154,-24.95,1211
2020-03-11,15507,20683,-5176,-25.03,1211
2020-03-12,15507,20707,-5200,-25.11,1211
2020-03-13,15403,20141,-4738,-23.52,1211
2020-03-14,7658,10983,-3325,-30.27,1211
2020-03-15,5526,8130,-2604,-32.03,1211
2020-03-16,15523,20424,-4901,-24.0,1211
2020-03-17,15507,20763,-5256,-25.31,1211
2020-03-18,15507,20775,-5268,-25.36,1211
2020-03-19,15507,20794,-5287,-25.43,1211
2020-03-20,15403,20229,-4826,-23.86,1211
2020-03-21,7658,11077,-3419,-30.87,1211
2020-03-22,5526,8235,-2709,-32.9,1211
2020-03-23,15523,20545,-5022,-24.44,1211
2020-03-24,15507,20905,-5398,-25.82,1211
2020-03-25,15507,20941,-5434,-25.95,1211
2020-03-26,15507,20987,-5480,-26.11,1211
2020-03-27,15403,20451,-5048,-24.68,1211
2020-03-28,7658,11330,-3672,-32.41,1211
2020-03-29,5526,8518,-2992,-35.13,1211
2020-03-30,15523,20859,-5336,-25.58,1211
2020-03-31,15507,21247,-5740,-27.02,1211
2020-04-01,14482,21309,-6827,-32.04,1211
2020-04-02,14482,21378,-6896,-32.26,1211
2020-04-03,13194,20862,-7668,-36.76,1211
2020-04-04,7259,11754,-4495,-38.24,1211
2020-04-05,4202,8951,-4749,-53.06,1211
2020-04-06,14625,21295,-6670,-31.32,1211
2020-04-07,14482,21681,-7199,-33.2,1211
2020-04-08,14482,21735,-7253,-33.37,1211
2020-04-09,14482,21790,-7308,-33.54,1211
2020-04-10,13194,21253,-8059,-37.92,1211
2020-04-11,7259,12121,-4862,-40.11,1211
2020-04-12,4202,9289,-5087,-54.76,1211
2020-04-13,14625,21600,-6975,-32.29,1211
2020-04-14,14482,21950,-7468,-34.02,1211
2020-04-15,14482,21965,-7483,-34.07,1211
2020-04-16,14482,21981,-7499,-34.12,1211
2020-04-17,13194,21404,-8210,-38.36,1211
2020-04-18,7259,12233,-4974,-40.66,1211
2020-04-19,4202,9363,-5161,-55.12,1211
2020-04-20,14625,21638,-7013,-32.41,1211
2020-04-21,14482,21954,-7472,-34.03,1211
2020-04-22,14482,21941,-7459,-34.0,1211
2020-04-23,14482,21931,-7449,-33.97,1211
2020-04-24,13194,21335,-8141,-38.16,1211
2020-04-25,7259,12148,-4889,-40.25,1211
2020-04-26,4202,9268,-5066,-54.66,1211
2020-04-27,14625,21538,-6913,-32.1,1211
2020-04-28,14482,21855,-7373,-33.74,1211
2020-04-29,14482,21846,-7364,-33.71,1211
2020-04-30,14482,21846,-7364,-33.71,1211
2020-05-01,18172,21262,-3090,-14.53,1211
2020-05-02,10605,12091,-1486,-12.29,1211
2020-05-03,6741,9229,-2488,-26.96,1211
2020-05-04,18625,21519,-2894,-13.45,1211
2020-05-05,18920,21857,-2937,-13.44,1211
2020-05-06,18920,21869,-2949,-13.48,1211
2020-05-07,18920,21888,-2968,-13.56,1211
2020-05-08,18172,21323,-3151,-14.78,1211
2020-05-09,10605,12169,-1564,-12.85,1211
2020-05-10,6741,9321,-2580,-27.68,1211
2020-05-11,18625,21621,-2996,-13.86,1211
2020-05-12,18920,21966,-3046,-13.87,1211
2020-05-13,18920,21981,-3061,-13.93,1211
2020-05-14,18920,22000,-3080,-14.0,1211
2020-05-15,18172,21431,-3259,-15.21,1211
2020-05-16,10605,12269,-1664,-13.56,1211
2020-05-17,6741,9410,-2669,-28.36,1211
2020-05-18,18625,21697,-3072,-14.16,1211
2020-05-19,18920,22025,-3105,-14.1,1211
2020-05-20,18920,22023,-3103,-14.09,1211
2020-05-21,18920,22023,-3103,-14.09,1211
2020-05-22,18172,21434,-3262,-15.22,1211
2020-05-23,10605,12253,-1648,-13.45,1211
2020-05-24,6741,9376,-2635,-28.1,1211
2020-05-25,18625,21646,-3021,-13.96,1211
2020-05-26,18920,21960,-3040,-13.84,1211
2020-05-27,18920,21945,-3025,-13.78,1211
2020-05-28,18920,21936,-3016,-13.75,1211
2020-05-29,18172,21342,-3170,-14.85,1211
2020-05-30,10605,12159,-1554,-12.78,1211
2020-05-31,6741,9283,-2542,-27.38,1211
2020-06-01,19779,21558,-1779,-8.25,1211
2020-06-02,20497,21880,-1383,-6.32,1211
2020-06-03,20497,21877,-1380,-6.31,1211
2020-06-04,20497,21882,-1385,-6.33,1211
2020-06-05,19200,21303,-2103,-9.87,1211
2020-06-06,11142,12136,-994,-8.19,1211
2020-06-07,8077,9277,-1200,-12.94,1211
2020-06-08,19779,21569,-1790,-8.3,1211
2020-06-09,20497,21906,-1409,-6.43,1211
2020-06-10,20497,21917,-1420,-6.48,1211
2020-06-11,20497,21933,-1436,-6.55,1211
2020-06-12,19200,21362,-2162,-10.12,1211
2020-06-13,11142,12199,-1057,-8.66,1211
2020-06-14,8077,9340,-1263,-13.52,1211
2020-06-15,19779,21626,-1847,-8.54,1211
2020-06-16,20497,21954,-1457,-6.64,1211
2020-06-17,20497,21949,-1452,-6.62,1211
2020-06-18,20497,21944,-1447,-6.59,1211
2020-06-19,19200,21348,-2148,-10.06,1211
2020-06-20,11142,12155,-1013,-8.33,1211
2020-06-21,8077,9263,-1186,-12.8,1211
2020-06-22,19779,21513,-1734,-8.06,1211
2020-06-23,20497,21801,-1304,-5.98,1211
2020-06-24,20497,21755,-1258,-5.78,1211
2020-06-25,20497,21709,-1212,-5.58,1211
2020-06-26,19200,21071,-1871,-8.88,1211
2020-06-27,11142,11839,-697,-5.89,1211
2020-06-28,8077,8909,-832,-9.34,1211
2020-06-29,19779,21124,-1345,-6.37,1211
2020-06-30,20497,21382,-885,-4.14,1211
2020-07-01,18125,21311,-3186,-14.95,1211
2020-07-02,18125,21246,-3121,-14.69,1211
2020-07-03,17290,20596,-3306,-16.05,1211
2020-07-04,9599,11357,-1758,-15.48,1211
2020-07-05,6996,8428,-1432,-16.99,1211
2020-07-06,17634,20651,-3017,-14.61,1211
2020-07-07,18125,20923,-2798,-13.37,1211
2020-07-08,18125,20873,-2748,-13.17,1211
2020-07-09,18125,20834,-2709,-13.0,1211
2020-07-10,17290,20216,-2926,-14.47,1211
2020-07-11,9599,11013,-1414,-12.84,1211
2020-07-12,6996,8123,-1127,-13.87,1211
2020-07-13,17634,20388,-2754,-13.51,1211
2020-07-14,18125,20704,-2579,-12.46,1211
2020-07-15,18125,20697,-2572,-12.43,1211
2020-07-16,18125,20700,-2575,-12.44,1211
2020-07-17,17290,20122,-2832,-14.07,1211
2020-07-18,9599,10955,-1356,-12.38,1211
2020-07-19,6996,8098,-1102,-13.61,1211
2020-07-20,17634,20389,-2755,-13.51,1211
2020-07-21,18125,20726,-2601,-12.55,1211
2020-07-22,18125,20733,-2608,-12.58,1211
2020-07-23,18125,20743,-2618,-12.62,1211
2020-07-24,17290,20165,-2875,-14.26,1211
2020-07-25,9599,10991,-1392,-12.66,1211
2020-07-26,6996,8119,-1123,-13.83,1211
2020-07-27,17634,20390,-2756,-13.52,1211
2020-07-28,18125,20700,-2575,-12.44,1211
2020-07-29,18125,20676,-2551,-12.34,1211
2020-07-30,18125,20650,-2525,-12.23,1211
2020-07-31,17290,20033,-2743,-13.69,1211
2020-08-01,9546,10819,-1273,-11.77,1211
2020-08-02,6985,7906,-921,-11.65,1211
2020-08-03,17345,20137,-2792,-13.87,1211
2020-08-04,17850,20408,-2558,-12.53,1211
2020-08-05,17850,20349,-2499,-12.28,1211
2020-08-06,17850,20294,-2444,-12.04,1211
2020-08-07,17215,19653,-2438,-12.41,1211
2020-08-08,9546,10422,-876,-8.41,1211
2020-08-09,6985,7499,-514,-6.85,1211
2020-08-10,17345,19729,-2384,-12.08,1211
2020-08-11,17850,20008,-2158,-10.79,1211
2020-08-12,17850,19966,-2116,-10.6,1211
2020-08-13,17850,19936,-2086,-10.46,1211
2020-08-14,17215,19329,-2114,-10.94,1211
2020-08-15,9546,10140,-594,-5.86,1211
2020-08-16,6985,7268,-283,-3.89,1211
2020-08-17,17345,19554,-2209,-11.3,1211
2020-08-18,17850,19896,-2046,-10.28,1211
2020-08-19,17850,19920,-2070,-10.39,1211
2020-08-20,17850,19960,-2110,-10.57,1211
2020-08-21,17215,19424,-2209,-11.37,1211
2020-08-22,9546,10307,-761,-7.38,1211
2020-08-23,6985,7505,-520,-6.93,1211
2020-08-24,17345,19859,-2514,-12.66,1211
2020-08-25,17850,20264,-2414,-11.91,1211
2020-08-26,17850,20346,-2496,-12.27,1211
2020-08-27,17850,20438,-2588,-12.66,1211
2020-08-28,17215,19946,-2731,-13.69,1211
2020-08-29,9546,10865,-1319,-12.14,1211
2020-08-30,6985,8089,-1104,-13.65,1211
2020-08-31,17345,20461,-3116,-15.23,1211
2020-09-01,20372,20874,-502,-2.4,1211
2020-09-02,20372,20955,-583,-2.78,1211
2020-09-03,20372,21036,-664,-3.16,1211
2020-09-04,19846,20525,-679,-3.31,1211
2020-09-05,11494,11417,77,0.67,1211
2020-09-06,8148,8607,-459,-5.33,1211
2020-09-07,20022,20938,-916,-4.37,1211
2020-09-08,20372,21306,-934,-4.38,1211
2020-09-09,20372,21339,-967,-4.53,1211
2020-09-10,20372,21369,-997,-4.67,1211
2020-09-11,19846,20806,-960,-4.61,1211
2020-09-12,11494,11646,-152,-1.31,1211
2020-09-13,8148,8786,-638,-7.26,1211
2020-09-14,20022,21070,-1048,-4.97,1211
2020-09-15,20372,21394,-1022,-4.78,1211
2020-09-16,20372,21387,-1015,-4.75,1211
2020-09-17,20372,21384,-1012,-4.73,1211
2020-09-18,19846,20794,-948,-4.56,1211
2020-09-19,11494,11612,-118,-1.02,1211
2020-09-20,8148,8738,-590,-6.75,1211
2020-09-21,20022,21014,-992,-4.72,1211
2020-09-22,20372,21337,-965,-4.52,1211
2020-09-23,20372,21335,-963,-4.51,1211
2020-09-24,20372,21341,-969,-4.54,1211
2020-09-25,19846,20766,-920,-4.43,1211
2020-09-26,11494,11603,-109,-0.94,1211
2020-09-27,8148,8751,-603,-6.89,1211
2020-09-28,20022,21051,-1029,-4.89,1211
2020-09-29,20372,21399,-1027,-4.8,1211
2020-09-30,20372,21421,-1049,-4.9,1211
2020-10-01,20635,21452,-817,-3.81,1211
2020-10-02,20034,20898,-864,-4.13,1211
2020-10-03,11057,11755,-698,-5.94,1211
2020-10-04,7320,8918,-1598,-17.92,1211
2020-10-05,20423,21230,-807,-3.8,1211
2020-10-06,20635,21584,-949,-4.4,1211
2020-10-07,20635,21609,-974,-4.51,1211
2020-10-08,20635,21637,-1002,-4.63,1211
2020-10-09,20034,21075,-1041,-4.94,1211
2020-10-10,11057,11918,-861,-7.22,1211
2020-10-11,7320,9064,-1744,-19.24,1211
2020-10-12,20423,21354,-931,-4.36,1211
2020-10-13,20635,21683,-1048,-4.83,1211
2020-10-14,20635,21680,-1045,-4.82,1211
2020-10-15,20635,21678,-1043,-4.81,1211
2020-10-16,20034,21085,-1051,-4.98,1211
2020-10-17,11057,11898,-841,-7.07,1211
2020-10-18,7320,9013,-1693,-18.78,1211
2020-10-19,20423,21274,-851,-4.0,1211
2020-10-20,20635,21577,-942,-4.37,1211
2020-10-21,20635,21551,-916,-4.25,1211
2020-10-22,20635,21529,-894,-4.15,1211
2020-10-23,20034,20922,-888,-4.24,1211
2020-10-24,11057,11724,-667,-5.69,1211
2020-10-25,7320,8834,-1514,-17.14,1211
2020-10-26,20423,21094,-671,-3.18,1211
2020-10-27,20635,21402,-767,-3.58,1211
2020-10-28,20635,21384,-749,-3.5,1211
2020-10-29,20635,21376,-741,-3.47,1211
2020-10-30,20034,20784,-750,-3.61,1211
2020-10-31,11057,11606,-549,-4.73,1211
2020-11-01,6364,8738,-2374,-27.17,1211
2020-11-02,19397,21021,-1624,-7.73,1211
2020-11-03,18312,21352,-3040,-14.24,1211
2020-11-04,18312,21358,-3046,-14.26,1211
2020-11-05,18312,21372,-3060,-14.32,1211
2020-11-06,18120,20801,-2681,-12.89,1211
2020-11-07,9516,11640,-2124,-18.25,1211
2020-11-08,6364,8785,-2421,-27.56,1211
2020-11-09,19397,21079,-1682,-7.98,1211
2020-11-10,18312,21416,-3104,-14.49,1211
2020-11-11,18312,21422,-3110,-14.52,1211
2020-11-12,18312,21431,-3119,-14.55,1211
2020-11-13,18120,20851,-2731,-13.1,1211
2020-11-14,9516,11676,-2160,-18.5,1211
2020-11-15,6364,8803,-2439,-27.71,1211
2020-11-16,19397,21074,-1677,-7.96,1211
2020-11-17,18312,21385,-3073,-14.37,1211
2020-11-18,18312,21363,-3051,-14.28,1211
2020-11-19,18312,21341,-3029,-14.19,1211
2020-11-20,18120,20729,-2609,-12.59,1211
2020-11-21,9516,11522,-2006,-17.41,1211
2020-11-22,6364,8618,-2254,-26.15,1211
2020-11-23,19397,20859,-1462,-7.01,1211
2020-11-24,18312,21142,-2830,-13.39,1211
2020-11-25,18312,21095,-2783,-13.19,1211
2020-11-26,18312,21053,-2741,-13.02,1211
2020-11-27,18120,20425,-2305,-11.29,1211
2020-11-28,9516,11207,-1691,-15.09,1211
2020-11-29,6364,8297,-1933,-23.3,1211
2020-11-30,19397,20537,-1140,-5.55,1211
2020-12-01,17439,20825,-3386,-16.26,1211
2020-12-02,17439,20788,-3349,-16.11,1211
2020-12-03,17439,20761,-3322,-16.0,1211
2020-12-04,19456,20151,-695,-3.45,1211
2020-12-05,10696,10956,-260,-2.37,1211
2020-12-06,6192,8070,-1878,-23.27,1211
2020-12-07,17804,20338,-2534,-12.46,1211
2020-12-08,17439,20654,-3215,-15.57,1211
2020-12-09,17439,20646,-3207,-15.53,1211
2020-12-10,17439,20645,-3206,-15.53,1211
2020-12-11,19456,20062,-606,-3.02,1211
2020-12-12,10696,10889,-193,-1.77,1211
2020-12-13,6192,8022,-1830,-22.81,1211
2020-12-14,17804,20305,-2501,-12.32,1211
2020-12-15,17439,20630,-3191,-15.47,1211
2020-12-16,17439,20626,-3187,-15.45,1211
2020-12-17,17439,20624,-3185,-15.44,1211
2020-12-18,19456,20033,-577,-2.88,1211
2020-12-19,10696,10846,-150,-1.38,1211
2020-12-20,6192,7961,-1769,-22.22,1211
2020-12-21,17804,20218,-2414,-11.94,1211
2020-12-22,17439,20514,-3075,-14.99,1211
2020-12-23,17439,20476,-3037,-14.83,1211
2020-12-24,17439,20437,-2998,-14.67,1211
2020-12-25,19456,19806,-350,-1.77,1211
2020-12-26,10696,10579,117,1.11,1211
2020-12-27,6192,7652,-1460,-19.08,1211
2020-12-28,17804,19870,-2066,-10.4,1211
2020-12-29,17439,20128,-2689,-13.36,1211
2020-12-30,17439,20055,-2616,-13.04,1211
2020-12-31,17439,19986,-2547,-12.74,1211
2021-01-01,16348,19329,-2981,-15.42,1211
2021-01-02,8010,10082,-2072,-20.55,1211
2021-01-03,5600,7143,-1543,-21.6,1211
2021-01-04,16499,19354,-2855,-14.75,1211
2021-01-05,16898,19614,-2716,-13.85,1211
2021-01-06,16898,19550,-2652,-13.57,1211
2021-01-07,16898,19497,-2599,-13.33,1211
2021-01-08,16348,18865,-2517,-13.34,1211
2021-01-09,8010,9649,-1639,-16.99,1211
2021-01-10,5600,6747,-1147,-17.0,1211
2021-01-11,16499,19002,-2503,-13.17,1211
2021-01-12,16898,19309,-2411,-12.49,1211
2021-01-13,16898,19297,-2399,-12.43,1211
2021-01-14,16898,19299,-2401,-12.44,1211
2021-01-15,16348,18722,-2374,-12.68,1211
2021-01-16,8010,9562,-1552,-16.23,1211
2021-01-17,5600,6716,-1116,-16.62,1211
2021-01-18,16499,19024,-2525,-13.27,1211
2021-01-19,16898,19382,-2484,-12.82,1211
2021-01-20,16898,19416,-2518,-12.97,1211
2021-01-21,16898,19459,-2561,-13.16,1211
2021-01-22,16348,18919,-2571,-13.59,1211
2021-01-23,8010,9790,-1780,-18.18,1211
2021-01-24,5600,6967,-1367,-19.62,1211
2021-01-25,16499,19292,-2793,-14.48,1211
2021-01-26,16898,19661,-2763,-14.05,1211
2021-01-27,16898,19700,-2802,-14.22,1211
2021-01-28,16898,19742,-2844,-14.41,1211
2021-01-29,16348,19194,-2846,-14.83,1211
2021-01-30,8010,10053,-2043,-20.32,1211
2021-01-31,5600,7213,-1613,-22.36,1211
2021-02-01,18487,19520,-1033,-5.29,1211
2021-02-02,18457,19867,-1410,-7.1,1211
2021-02-03,18457,19883,-1426,-7.17,1211
2021-02-04,18457,19901,-1444,-7.26,1211
2021-02-05,18164,19331,-1167,-6.04,1211
2021-02-06,9726,10169,-443,-4.36,1211
2021-02-07,6323,7312,-989,-13.53,1211
2021-02-08,18487,19603,-1116,-5.69,1211
2021-02-09,18457,19939,-1482,-7.43,1211
2021-02-10,18457,19948,-1491,-7.47,1211
2021-02-11,18457,19965,-1508,-7.55,1211
2021-02-12,18164,19398,-1234,-6.36,1211
2021-02-13,9726,10244,-518,-5.06,1211
2021-02-14,6323,7400,-1077,-14.55,1211
2021-02-15,18487,19710,-1223,-6.2,1211
2021-02-16,18457,20068,-1611,-8.03,1211
2021-02-17,18457,20103,-1646,-8.19,1211
2021-02-18,18457,20148,-1691,-8.39,1211
2021-02-19,18164,19612,-1448,-7.38,1211
2021-02-20,9726,10490,-764,-7.28,1211
2021-02-21,6323,7678,-1355,-17.65,1211
2021-02-22,18487,20018,-1531,-7.65,1211
2021-02-23,18457,20407,-1950,-9.56,1211
2021-02-24,18457,20469,-2012,-9.83,1211
2021-02-25,18457,20539,-2082,-10.14,1211
2021-02-26,18164,20023,-1859,-9.28,1211
2021-02-27,9726,10917,-1191,-10.91,1211
2021-02-28,6323,8116,-1793,-22.09,1211
2021-03-01,19328,20463,-1135,-5.55,1211
2021-03-02,19670,20851,-1181,-5.66,1211
2021-03-03,19670,20908,-1238,-5.92,1211
2021-03-04,19670,20968,-1298,-6.19,1211
2021-03-05,19039,20437,-1398,-6.84,1211
2021-03-06,10832,11311,-479,-4.23,1211
2021-03-07,6629,8487,-1858,-21.89,1211
2021-03-08,19328,20806,-1478,-7.1,1211
2021-03-09,19670,21165,-1495,-7.06,1211
2021-03-10,19670,21192,-1522,-7.18,1211
2021-03-11,19670,21221,-1551,-7.31,1211
2021-03-12,19039,20659,-1620,-7.84,1211
2021-03-13,10832,11504,-672,-5.84,1211
2021-03-14,6629,8652,-2023,-23.38,1211
2021-03-15,19328,20948,-1620,-7.73,1211
2021-03-16,19670,21286,-1616,-7.59,1211
2021-03-17,19670,21297,-1627,-7.64,1211
2021-03-18,19670,21314,-1644,-7.71,1211
2021-03-19,19039,20747,-1708,-8.23,1211
2021-03-20,10832,11591,-759,-6.55,1211
2021-03-21,6629,8744,-2115,-24.19,1211
2021-03-22,19328,21049,-1721,-8.18,1211
2021-03-23,19670,21403,-1733,-8.1,1211
2021-03-24,19670,21433,-1763,-8.23,1211
2021-03-25,19670,21474,-1804,-8.4,1211
2021-03-26,19039,20933,-1894,-9.05,1211
2021-03-27,10832,11806,-974,-8.25,1211
2021-03-28,6629,8989,-2360,-26.25,1211
2021-03-29,19328,21325,-1997,-9.36,1211
2021-03-30,19670,21710,-2040,-9.4,1211
2021-03-31,19670,21769,-2099,-9.64,1211
2021-04-01,18961,21836,-2875,-13.17,1211
2021-04-02,18472,21319,-2847,-13.35,1211
2021-04-03,9874,12212,-2338,-19.15,1211
2021-04-04,6581,9410,-2829,-30.06,1211
2021-04-05,18921,21757,-2836,-13.03,1211
2021-04-06,18961,22146,-3185,-14.38,1211
2021-04-07,18961,22204,-3243,-14.61,1211
2021-04-08,18961,22264,-3303,-14.84,1211
2021-04-09,18472,21734,-3262,-15.01,1211
2021-04-10,9874,12609,-2735,-21.69,1211
2021-04-11,6581,9784,-3203,-32.74,1211
2021-04-12,18921,22102,-3181,-14.39,1211
2021-04-13,18961,22459,-3498,-15.58,1211
2021-04-14,18961,22482,-3521,-15.66,1211
2021-04-15,18961,22505,-3544,-15.75,1211
2021-04-16,18472,21935,-3463,-15.79,1211
2021-04-17,9874,12770,-2896,-22.68,1211
2021-04-18,6581,9905,-3324,-33.56,1211
2021-04-19,18921,22185,-3264,-14.71,1211
2021-04-20,18961,22505,-3544,-15.75,1211
2021-04-21,18961,22495,-3534,-15.71,1211
2021-04-22,18961,22487,-3526,-15.68,1211
2021-04-23,18472,21892,-3420,-15.62,1211
2021-04-24,9874,12705,-2831,-22.28,1211
2021-04-25,6581,9824,-3243,-33.01,1211
2021-04-26,18921,22092,-3171,-14.35,1211
2021-04-27,18961,22407,-3446,-15.38,1211
2021-04-28,18961,22395,-3434,-15.33,1211
2021-04-29,18961,22391,-3430,-15.32,1211
2021-04-30,18472,21803,-3331,-15.28,1211
2021-05-01,11969,12629,-660,-5.23,1211
2021-05-02,7716,9763,-2047,-20.97,1211
2021-05-03,20940,22049,-1109,-5.03,1211
2021-05-04,21408,22383,-975,-4.36,1211
2021-05-05,21408,22391,-983,-4.39,1211
2021-05-06,21408,22408,-1000,-4.46,1211
2021-05-07,20563,21841,-1278,-5.85,1211
2021-05-08,11969,12685,-716,-5.64,1211
2021-05-09,7716,9836,-2120,-21.55,1211
2021-05-10,20940,22137,-1197,-5.41,1211
2021-05-11,21408,22482,-1074,-4.78,1211
2021-05-12,21408,22499,-1091,-4.85,1211
2021-05-13,21408,22520,-1112,-4.94,1211
2021-05-14,20563,21954,-1391,-6.34,1211
2021-05-15,11969,12794,-825,-6.45,1211
2021-05-16,7716,9939,-2223,-22.37,1211
2021-05-17,20940,22229,-1289,-5.8,1211
2021-05-18,21408,22562,-1154,-5.11,1211
2021-05-19,21408,22563,-1155,-5.12,1211
2021-05-20,21408,22566,-1158,-5.13,1211
2021-05-21,20563,21981,-1418,-6.45,1211
2021-05-22,11969,12803,-834,-6.51,1211
2021-05-23,7716,9928,-2212,-22.28,1211
2021-05-24,20940,22200,-1260,-5.68,1211
2021-05-25,21408,22515,-1107,-4.92,1211
2021-05-26,21408,22501,-1093,-4.86,1211
2021-05-27,21408,22492,-1084,-4.82,1211
2021-05-28,20563,21896,-1333,-6.09,1211
2021-05-29,11969,12712,-743,-5.84,1211
2021-05-30,7716,9834,-2118,-21.54,1211
2021-05-31,20940,22106,-1166,-5.27,1211
2021-06-01,21258,22425,-1167,-5.2,1211
2021-06-02,21258,22419,-1161,-5.18,1211
2021-06-03,21258,22420,-1162,-5.18,1211
2021-06-04,20516,21838,-1322,-6.05,1211
2021-06-05,11886,12668,-782,-6.17,1211
2021-06-06,8961,9807,-846,-8.63,1211
2021-06-07,21412,22096,-684,-3.1,1211
2021-06-08,21258,22432,-1174,-5.23,1211
2021-06-09,21258,22441,-1183,-5.27,1211
2021-06-10,21258,22457,-1199,-5.34,1211
2021-06-11,20516,21887,-1371,-6.26,1211
2021-06-12,11886,12725,-839,-6.59,1211
2021-06-13,8961,9869,-908,-9.2,1211
2021-06-14,21412,22159,-747,-3.37,1211
2021-06-15,21258,22491,-1233,-5.48,1211
2021-06-16,21258,22491,-1233,-5.48,1211
2021-06-17,21258,22493,-1235,-5.49,1211
2021-06-18,20516,21904,-1388,-6.34,1211
2021-06-19,11886,12718,-832,-6.54,1211
2021-06-20,8961,9833,-872,-8.87,1211
2021-06-21,21412,22091,-679,-3.07,1211
2021-06-22,21258,22387,-1129,-5.04,1211
2021-06-23,21258,22348,-1090,-4.88,1211
2021-06-24,21258,22309,-1051,-4.71,1211
2021-06-25,20516,21679,-1163,-5.36,1211
2021-06-26,11886,12452,-566,-4.55,1211
2021-06-27,8961,9527,-566,-5.94,1211
2021-06-28,21412,21746,-334,-1.54,1211
2021-06-29,21258,22007,-749,-3.4,1211
2021-06-30,21258,21937,-679,-3.1,1211
2021-07-01,18782,21872,-3090,-14.13,1211
2021-07-02,18615,21220,-2605,-12.28,1211
2021-07-03,10745,11979,-1234,-10.3,1211
2021-07-04,7582,9046,-1464,-16.18,1211
2021-07-05,17626,21264,-3638,-17.11,1211
2021-07-06,18782,21531,-2749,-12.77,1211
2021-07-07,18782,21474,-2692,-12.54,1211
2021-07-08,18782,21428,-2646,-12.35,1211
2021-07-09,18615,20801,-2186,-10.51,1211
2021-07-10,10745,11591,-846,-7.3,1211
2021-07-11,7582,8692,-1110,-12.77,1211
2021-07-12,17626,20950,-3324,-15.87,1211
2021-07-13,18782,21257,-2475,-11.64,1211
2021-07-14,18782,21244,-2462,-11.59,1211
2021-07-15,18782,21241,-2459,-11.58,1211
2021-07-16,18615,20657,-2042,-9.89,1211
2021-07-17,10745,11487,-742,-6.46,1211
2021-07-18,7582,8626,-1044,-12.1,1211
2021-07-19,17626,20916,-3290,-15.73,1211
2021-07-20,18782,21252,-2470,-11.62,1211
2021-07-21,18782,21261,-2479,-11.66,1211
2021-07-22,18782,21274,-2492,-11.71,1211
2021-07-23,18615,20699,-2084,-10.07,1211
2021-07-24,10745,11531,-786,-6.82,1211
2021-07-25,7582,8664,-1082,-12.49,1211
2021-07-26,17626,20942,-3316,-15.83,1211
2021-07-27,18782,21259,-2477,-11.65,1211
2021-07-28,18782,21242,-2460,-11.58,1211
2021-07-29,18782,21225,-2443,-11.51,1211
2021-07-30,18615,20615,-2000,-9.7,1211
2021-07-31,10745,11409,-664,-5.82,1211
2021-08-01,7830,8502,-672,-7.9,1211
2021-08-02,16771,20739,-3968,-19.13,1211
2021-08-03,16954,21015,-4061,-19.32,1211
2021-08-04,16954,20960,-4006,-19.11,1211
2021-08-05,16954,20907,-3953,-18.91,1211
2021-08-06,16601,20266,-3665,-18.08,1211
2021-08-07,10340,11034,-694,-6.29,1211
2021-08-08,7830,8109,-279,-3.44,1211
2021-08-09,16771,20334,-3563,-17.52,1211
2021-08-10,16954,20607,-3653,-17.73,1211
2021-08-11,16954,20557,-3603,-17.53,1211
2021-08-12,16954,20519,-3565,-17.37,1211
2021-08-13,16601,19901,-3300,-16.58,1211
2021-08-14,10340,10701,-361,-3.37,1211
2021-08-15,7830,7816,14,0.18,1211
2021-08-16,16771,20089,-3318,-16.52,1211
2021-08-17,16954,20418,-3464,-16.97,1211
2021-08-18,16954,20429,-3475,-17.01,1211
2021-08-19,16954,20456,-3502,-17.12,1211
2021-08-20,16601,19907,-3306,-16.61,1211
2021-08-21,10340,10778,-438,-4.06,1211
2021-08-22,7830,7965,-135,-1.69,1211
2021-08-23,16771,20309,-3538,-17.42,1211
2021-08-24,16954,20706,-3752,-18.12,1211
2021-08-25,16954,20781,-3827,-18.42,1211
2021-08-26,16954,20868,-3914,-18.76,1211
2021-08-27,16601,20373,-3772,-18.51,1211
2021-08-28,10340,11290,-950,-8.41,1211
2021-08-29,7830,8514,-684,-8.03,1211
2021-08-30,16771,20888,-4117,-19.71,1211
2021-08-31,16954,21304,-4350,-20.42,1211
2021-09-01,18988,21390,-2402,-11.23,1211
2021-09-02,18988,21478,-2490,-11.59,1211
2021-09-03,18072,20974,-2902,-13.84,1211
2021-09-04,10707,11874,-1167,-9.83,1211
2021-09-05,8545,9074,-529,-5.83,1211
2021-09-06,18062,21415,-3353,-15.66,1211
2021-09-07,18988,21792,-2804,-12.87,1211
2021-09-08,18988,21834,-2846,-13.03,1211
2021-09-09,18988,21874,-2886,-13.19,1211
2021-09-10,18072,21320,-3248,-15.23,1211
2021-09-11,10707,12168,-1461,-12.01,1211
2021-09-12,8545,9316,-771,-8.28,1211
2021-09-13,18062,21606,-3544,-16.4,1211
2021-09-14,18988,21935,-2947,-13.44,1211
2021-09-15,18988,21933,-2945,-13.43,1211
2021-09-16,18988,21932,-2944,-13.42,1211
2021-09-17,18072,21343,-3271,-15.33,1211
2021-09-18,10707,12162,-1455,-11.96,1211
2021-09-19,8545,9287,-742,-7.99,1211
2021-09-20,18062,21561,-3499,-16.23,1211
2021-09-21,18988,21881,-2893,-13.22,1211
2021-09-22,18988,21875,-2887,-13.2,1211
2021-09-23,18988,21878,-2890,-13.21,1211
2021-09-24,18072,21297,-3225,-15.14,1211
2021-09-25,10707,12130,-1423,-11.73,1211
2021-09-26,8545,9273,-728,-7.85,1211
2021-09-27,18062,21568,-3506,-16.26,1211
2021-09-28,18988,21912,-2924,-13.34,1211
2021-09-29,18988,21931,-2943,-13.42,1211
2021-09-30,18988,21958,-2970,-13.53,1211
2021-10-01,19347,21402,-2055,-9.6,1211
2021-10-02,10999,12257,-1258,-10.26,1211
2021-10-03,8074,9420,-1346,-14.29,1211
2021-10-04,18348,21732,-3384,-15.57,1211
2021-10-05,19658,22088,-2430,-11.0,1211
2021-10-06,19658,22115,-2457,-11.11,1211
2021-10-07,19658,22146,-2488,-11.23,1211
2021-10-08,19347,21588,-2241,-10.38,1211
2021-10-09,10999,12436,-1437,-11.56,1211
2021-10-10,8074,9587,-1513,-15.78,1211
2021-10-11,18348,21882,-3534,-16.15,1211
2021-10-12,19658,22218,-2560,-11.52,1211
2021-10-13,19658,22220,-2562,-11.53,1211
2021-10-14,19658,22224,-2566,-11.55,1211
2021-10-15,19347,21636,-2289,-10.58,1211
2021-10-16,10999,12454,-1455,-11.68,1211
2021-10-17,8074,9574,-1500,-15.67,1211
2021-10-18,18348,21839,-3491,-15.99,1211
2021-10-19,19658,22145,-2487,-11.23,1211
2021-10-20,19658,22121,-2463,-11.13,1211
2021-10-21,19658,22100,-2442,-11.05,1211
2021-10-22,19347,21493,-2146,-9.98,1211
2021-10-23,10999,12294,-1295,-10.53,1211
2021-10-24,8074,9403,-1329,-14.13,1211
2021-10-25,18348,21661,-3313,-15.29,1211
2021-10-26,19658,21965,-2307,-10.5,1211
2021-10-27,19658,21944,-2286,-10.42,1211
2021-10-28,19658,21931,-2273,-10.36,1211
2021-10-29,19347,21335,-1988,-9.32,1211
2021-10-30,10999,12153,-1154,-9.5,1211
2021-10-31,8074,9280,-1206,-13.0,1211
2021-11-01,17255,21559,-4304,-19.96,1211
2021-11-02,18516,21886,-3370,-15.4,1211
2021-11-03,18516,21889,-3373,-15.41,1211
2021-11-04,18516,21899,-3383,-15.45,1211
2021-11-05,17543,21326,-3783,-17.74,1211
2021-11-06,9836,12164,-2328,-19.14,1211
2021-11-07,6989,9309,-2320,-24.92,1211
2021-11-08,17255,21604,-4349,-20.13,1211
2021-11-09,18516,21942,-3426,-15.61,1211
2021-11-10,18516,21951,-3435,-15.65,1211
2021-11-11,18516,21964,-3448,-15.7,1211
2021-11-12,17543,21387,-3844,-17.97,1211
2021-11-13,9836,12217,-2381,-19.49,1211
2021-11-14,6989,9350,-2361,-25.25,1211
2021-11-15,17255,21627,-4372,-20.22,1211
2021-11-16,18516,21943,-3427,-15.62,1211
2021-11-17,18516,21927,-3411,-15.56,1211
2021-11-18,18516,21912,-3396,-15.5,1211
2021-11-19,17543,21305,-3762,-17.66,1211
2021-11-20,9836,12103,-2267,-18.73,1211
2021-11-21,6989,9204,-2215,-24.07,1211
2021-11-22,17255,21449,-4194,-19.55,1211
2021-11-23,18516,21735,-3219,-14.81,1211
2021-11-24,18516,21691,-3175,-14.64,1211
2021-11-25,18516,21650,-3134,-14.48,1211
2021-11-26,17543,21022,-3479,-16.55,1211
2021-11-27,9836,11803,-1967,-16.67,1211
2021-11-28,6989,8891,-1902,-21.39,1211
2021-11-29,17255,21129,-3874,-18.33,1211
2021-11-30,18516,21413,-2897,-13.53,1211
2021-12-01,16498,21372,-4874,-22.81,1211
2021-12-02,16498,21340,-4842,-22.69,1211
2021-12-03,13730,20725,-6995,-33.75,1211
2021-12-04,9166,11524,-2358,-20.46,1211
2021-12-05,6296,8633,-2337,-27.07,1211
2021-12-06,16101,20896,-4795,-22.95,1211
2021-12-07,16498,21207,-4709,-22.2,1211
2021-12-08,16498,21194,-4696,-22.16,1211
2021-12-09,16498,21190,-4692,-22.14,1211
2021-12-10,13730,20603,-6873,-33.36,1211
2021-12-11,9166,11428,-2262,-19.79,1211
2021-12-12,6296,8561,-2265,-26.46,1211
2021-12-13,16101,20843,-4742,-22.75,1211
2021-12-14,16498,21170,-4672,-22.07,1211
2021-12-15,16498,21168,-4670,-22.06,1211
2021-12-16,16498,21170,-4672,-22.07,1211
2021-12-17,13730,20583,-6853,-33.29,1211
2021-12-18,9166,11402,-2236,-19.61,1211
2021-12-19,6296,8522,-2226,-26.12,1211
2021-12-20,16101,20787,-4686,-22.54,1211
2021-12-21,16498,21090,-4592,-21.77,1211
2021-12-22,16498,21060,-4562,-21.66,1211
2021-12-23,16498,21029,-4531,-21.55,1211
2021-12-24,13730,20406,-6676,-32.72,1211
2021-12-25,9166,11185,-2019,-18.05,1211
2021-12-26,6296,8266,-1970,-23.83,1211
2021-12-27,16101,20489,-4388,-21.42,1211
2021-12-28,16498,20752,-4254,-20.5,1211
2021-12-29,16498,20683,-4185,-20.23,1211
2021-12-30,16498,20616,-4118,-19.97,1211
2021-12-31,13730,19961,-6231,-31.22,1211
2022-01-01,8488,10714,-2226,-20.78,1211
2022-01-02,5692,7773,-2081,-26.77,1211
2022-01-03,14850,19982,-5132,-25.68,1211
2022-01-04,15863,20237,-4374,-21.61,1211
2022-01-05,15863,20168,-4305,-21.35,1211
2022-01-06,15863,20108,-4245,-21.11,1211
2022-01-07,14907,19468,-4561,-23.43,1211
2022-01-08,8488,10243,-1755,-17.13,1211
2022-01-09,5692,7332,-1640,-22.37,1211
2022-01-10,14850,19576,-4726,-24.14,1211
2022-01-11,15863,19873,-4010,-20.18,1211
2022-01-12,15863,19851,-3988,-20.09,1211
2022-01-13,15863,19842,-3979,-20.05,1211
2022-01-14,14907,19255,-4348,-22.58,1211
2022-01-15,8488,10086,-1598,-15.84,1211
2022-01-16,5692,7231,-1539,-21.28,1211
2022-01-17,14850,19531,-4681,-23.97,1211
2022-01-18,15863,19882,-4019,-20.21,1211
2022-01-19,15863,19911,-4048,-20.33,1211
2022-01-20,15863,19950,-4087,-20.49,1211
2022-01-21,14907,19406,-4499,-23.18,1211
2022-01-22,8488,10275,-1787,-17.39,1211
2022-01-23,5692,7451,-1759,-23.61,1211
2022-01-24,14850,19777,-4927,-24.91,1211
2022-01-25,15863,20147,-4284,-21.26,1211
2022-01-26,15863,20188,-4325,-21.42,1211
2022-01-27,15863,20233,-4370,-21.6,1211
2022-01-28,14907,19689,-4782,-24.29,1211
2022-01-29,8488,10552,-2064,-19.56,1211
2022-01-30,5692,7717,-2025,-26.24,1211
2020-02-01,6214,5837,377,6.46,1216
2020-02-02,5080,4516,564,12.49,1216
2020-02-03,7773,7655,118,1.54,1216
2020-02-04,7922,7894,28,0.35,1216
2020-02-05,7922,7887,35,0.44,1216
2020-02-06,7922,7873,49,0.62,1216
2020-02-07,8240,8086,154,1.9,1216
2020-02-08,6214,5783,431,7.45,1216
2020-02-09,5080,4458,622,13.95,1216
2020-02-10,7773,7596,177,2.33,1216
2020-02-11,7922,7838,84,1.07,1216
2020-02-12,7922,7836,86,1.1,1216
2020-02-13,7922,7830,92,1.17,1216
2020-02-14,8240,8054,186,2.31,1216
2020-02-15,6214,5763,451,7.83,1216
2020-02-16,5080,4454,626,14.05,1216
2020-02-17,7773,7609,164,2.16,1216
2020-02-18,7922,7868,54,0.69,1216
2020-02-19,7922,7885,37,0.47,1216
2020-02-20,7922,7897,25,0.32,1216
2020-02-21,8240,8140,100,1.23,1216
2020-02-22,6214,5868,346,5.9,1216
2020-02-23,5080,4575,505,11.04,1216
2020-02-24,7773,7745,28,0.36,1216
2020-02-25,7922,8017,-95,-1.18,1216
2020-02-26,7922,8044,-122,-1.52,1216
2020-02-27,7922,8065,-143,-1.77,1216
2020-02-28,8240,8313,-73,-0.88,1216
2020-02-29,6214,6042,172,2.85,1216
2020-03-01,3571,4748,-1177,-24.79,1216
2020-03-02,5251,7915,-2664,-33.66,1216
2020-03-03,5491,8180,-2689,-32.87,1216
2020-03-04,5491,8198,-2707,-33.02,1216
2020-03-05,5491,8207,-2716,-33.09,1216
2020-03-06,6003,8442,-2439,-28.89,1216
2020-03-07,4182,6156,-1974,-32.07,1216
2020-03-08,3571,4847,-1276,-26.33,1216
2020-03-09,5251,7997,-2746,-34.34,1216
2020-03-10,5491,8247,-2756,-33.42,1216
2020-03-11,5491,8250,-2759,-33.44,1216
2020-03-12,5491,8245,-2754,-33.4,1216
2020-03-13,6003,8467,-2464,-29.1,1216
2020-03-14,4182,6171,-1989,-32.23,1216
2020-03-15,3571,4854,-1283,-26.43,1216
2020-03-16,5251,7999,-2748,-34.35,1216
2020-03-17,5491,8246,-2755,-33.41,1216
2020-03-18,5491,8250,-2759,-33.44,1216
2020-03-19,5491,8249,-2758,-33.43,1216
2020-03-20,6003,8478,-2475,-29.19,1216
2020-03-21,4182,6192,-2010,-32.46,1216
2020-03-22,3571,4887,-1316,-26.93,1216
2020-03-23,5251,8047,-2796,-34.75,1216
2020-03-24,5491,8311,-2820,-33.93,1216
2020-03-25,5491,8333,-2842,-34.11,1216
2020-03-26,5491,8351,-2860,-34.25,1216
2020-03-27,6003,8600,-2597,-30.2,1216
2020-03-28,4182,6334,-2152,-33.98,1216
2020-03-29,3571,5048,-1477,-29.26,1216
2020-03-30,5251,8226,-2975,-36.17,1216
2020-03-31,5491,8506,-3015,-35.45,1216
2020-04-01,4532,8542,-4010,-46.94,1216
2020-04-02,4532,8571,-4039,-47.12,1216
2020-04-03,4642,8828,-4186,-47.42,1216
2020-04-04,3662,6567,-2905,-44.24,1216
2020-04-05,2704,5283,-2579,-48.82,1216
2020-04-06,4468,8458,-3990,-47.17,1216
2020-04-07,4532,8733,-4201,-48.1,1216
2020-04-08,4532,8760,-4228,-48.26,1216
2020-04-09,4532,8778,-4246,-48.37,1216
2020-04-10,4642,9019,-4377,-48.53,1216
2020-04-11,3662,6741,-3079,-45.68,1216
2020-04-12,2704,5437,-2733,-50.27,1216
2020-04-13,4468,8591,-4123,-47.99,1216
2020-04-14,4532,8843,-4311,-48.75,1216
2020-04-15,4532,8847,-4315,-48.77,1216
2020-04-16,4532,8841,-4309,-48.74,1216
2020-04-17,4642,9060,-4418,-48.76,1216
2020-04-18,3662,6760,-3098,-45.83,1216
2020-04-19,2704,5436,-2732,-50.26,1216
2020-04-20,4468,8572,-4104,-47.88,1216
2020-04-21,4532,8808,-4276,-48.55,1216
2020-04-22,4532,8799,-4267,-48.49,1216
2020-04-23,4532,8782,-4250,-48.39,1216
2020-04-24,4642,8994,-4352,-48.39,1216
2020-04-25,3662,6690,-3028,-45.26,1216
2020-04-26,2704,5364,-2660,-49.59,1216
2020-04-27,4468,8502,-4034,-47.45,1216
2020-04-28,4532,8743,-4211,-48.16,1216
2020-04-29,4532,8740,-4208,-48.15,1216
2020-04-30,4532,8733,-4201,-48.1,1216
2020-05-01,6977,8955,-1978,-22.09,1216
2020-05-02,5333,6662,-1329,-19.95,1216
2020-05-03,4068,5349,-1281,-23.95,1216
2020-05-04,6370,8499,-2129,-25.05,1216
2020-05-05,6669,8753,-2084,-23.81,1216
2020-05-06,6669,8762,-2093,-23.89,1216
2020-05-07,6669,8765,-2096,-23.91,1216
2020-05-08,6977,8996,-2019,-22.44,1216
2020-05-09,5333,6710,-1377,-20.52,1216
2020-05-10,4068,5403,-1335,-24.71,1216
2020-05-11,6370,8556,-2186,-25.55,1216
2020-05-12,6669,8810,-2141,-24.3,1216
2020-05-13,6669,8816,-2147,-24.35,1216
2020-05-14,6669,8815,-2146,-24.34,1216
2020-05-15,6977,9040,-2063,-22.82,1216
2020-05-16,5333,6746,-1413,-20.95,1216
2020-05-17,4068,5428,-1360,-25.06,1216
2020-05-18,6370,8570,-2200,-25.67,1216
2020-05-19,6669,8811,-2142,-24.31,1216
2020-05-20,6669,8805,-2136,-24.26,1216
2020-05-21,6669,8791,-2122,-24.14,1216
2020-05-22,6977,9004,-2027,-22.51,1216
2020-05-23,5333,6698,-1365,-20.38,1216
2020-05-24,4068,5370,-1302,-24.25,1216
2020-05-25,6370,8503,-2133,-25.09,1216
2020-05-26,6669,8738,-2069,-23.68,1216
2020-05-27,6669,8727,-2058,-23.58,1216
2020-05-28,6669,8711,-2042,-23.44,1216
2020-05-29,6977,8924,-1947,-21.82,1216
2020-05-30,5333,6621,-1288,-19.45,1216
2020-05-31,4068,5298,-1230,-23.22,1216
2020-06-01,7439,8439,-1000,-11.85,1216
2020-06-02,7867,8683,-816,-9.4,1216
2020-06-03,7867,8683,-816,-9.4,1216
2020-06-04,7867,8679,-812,-9.36,1216
2020-06-05,8005,8905,-900,-10.11,1216
2020-06-06,5897,6615,-718,-10.85,1216
2020-06-07,4743,5305,-562,-10.59,1216
2020-06-08,7439,8457,-1018,-12.04,1216
2020-06-09,7867,8712,-845,-9.7,1216
2020-06-10,7867,8721,-854,-9.79,1216
2020-06-11,7867,8723,-856,-9.81,1216
2020-06-12,8005,8952,-947,-10.58,1216
2020-06-13,5897,6662,-765,-11.48,1216
2020-06-14,4743,5349,-606,-11.33,1216
2020-06-15,7439,8494,-1055,-12.42,1216
2020-06-16,7867,8738,-871,-9.97,1216
2020-06-17,7867,8733,-866,-9.92,1216
2020-06-18,7867,8717,-850,-9.75,1216
2020-06-19,8005,8924,-919,-10.3,1216
2020-06-20,5897,6610,-713,-10.79,1216
2020-06-21,4743,5270,-527,-10.0,1216
2020-06-22,7439,8386,-947,-11.29,1216
2020-06-23,7867,8600,-733,-8.52,1216
2020-06-24,7867,8563,-696,-8.13,1216
2020-06-25,7867,8516,-649,-7.62,1216
2020-06-26,8005,8693,-688,-7.91,1216
2020-06-27,5897,6350,-453,-7.13,1216
2020-06-28,4743,4983,-240,-4.82,1216
2020-06-29,7439,8075,-636,-7.88,1216
2020-06-30,7867,8268,-401,-4.85,1216
2020-07-01,7509,8214,-705,-8.58,1216
2020-07-02,7509,8155,-646,-7.92,1216
2020-07-03,7791,8324,-533,-6.4,1216
2020-07-04,5536,5979,-443,-7.41,1216
2020-07-05,4635,4614,21,0.46,1216
2020-07-06,7254,7713,-459,-5.95,1216
2020-07-07,7509,7919,-410,-5.18,1216
2020-07-08,7509,7883,-374,-4.74,1216
2020-07-09,7509,7845,-336,-4.28,1216
2020-07-10,7791,8040,-249,-3.1,1216
2020-07-11,5536,5722,-186,-3.25,1216
2020-07-12,4635,4388,247,5.63,1216
2020-07-13,7254,7521,-267,-3.55,1216
2020-07-14,7509,7760,-251,-3.23,1216
2020-07-15,7509,7757,-248,-3.2,1216
2020-07-16,7509,7752,-243,-3.13,1216
2020-07-17,7791,7979,-188,-2.36,1216
2020-07-18,5536,5690,-154,-2.71,1216
2020-07-19,4635,4383,252,5.75,1216
2020-07-20,7254,7538,-284,-3.77,1216
2020-07-21,7509,7795,-286,-3.67,1216
2020-07-22,7509,7807,-298,-3.82,1216
2020-07-23,7509,7811,-302,-3.87,1216
2020-07-24,7791,8041,-250,-3.11,1216
2020-07-25,5536,5753,-217,-3.77,1216
2020-07-26,4635,4439,196,4.42,1216
2020-07-27,7254,7584,-330,-4.35,1216
2020-07-28,7509,7827,-318,-4.06,1216
2020-07-29,7509,7821,-312,-3.99,1216
2020-07-30,7509,7804,-295,-3.78,1216
2020-07-31,7791,8011,-220,-2.75,1216
2020-08-01,5721,5697,24,0.42,1216
2020-08-02,4689,4358,331,7.6,1216
2020-08-03,7038,7477,-439,-5.87,1216
2020-08-04,7253,7696,-443,-5.76,1216
2020-08-05,7253,7666,-413,-5.39,1216
2020-08-06,7253,7629,-376,-4.93,1216
2020-08-07,7458,7820,-362,-4.63,1216
2020-08-08,5721,5493,228,4.15,1216
2020-08-09,4689,4146,543,13.1,1216
2020-08-10,7038,7262,-224,-3.08,1216
2020-08-11,7253,7483,-230,-3.07,1216
2020-08-12,7253,7462,-209,-2.8,1216
2020-08-13,7253,7438,-185,-2.49,1216
2020-08-14,7458,7647,-189,-2.47,1216
2020-08-15,5721,5345,376,7.03,1216
2020-08-16,4689,4026,663,16.47,1216
2020-08-17,7038,7175,-137,-1.91,1216
2020-08-18,7253,7432,-179,-2.41,1216
2020-08-19,7253,7450,-197,-2.64,1216
2020-08-20,7253,7467,-214,-2.87,1216
2020-08-21,7458,7719,-261,-3.38,1216
2020-08-22,5721,5458,263,4.82,1216
2020-08-23,4689,4182,507,12.12,1216
2020-08-24,7038,7371,-333,-4.52,1216
2020-08-25,7253,7666,-413,-5.39,1216
2020-08-26,7253,7718,-465,-6.02,1216
2020-08-27,7253,7766,-513,-6.61,1216
2020-08-28,7458,8044,-586,-7.28,1216
2020-08-29,5721,5805,-84,-1.45,1216
2020-08-30,4689,4544,145,3.19,1216
2020-08-31,7038,7743,-705,-9.1,1216
2020-09-01,7973,8042,-69,-0.86,1216
2020-09-02,7973,8093,-120,-1.48,1216
2020-09-03,7973,8135,-162,-1.99,1216
2020-09-04,8194,8400,-206,-2.45,1216
2020-09-05,6065,6144,-79,-1.29,1216
2020-09-06,4992,4862,130,2.67,1216
2020-09-07,7672,8037,-365,-4.54,1216
2020-09-08,7973,8308,-335,-4.03,1216
2020-09-09,7973,8329,-356,-4.27,1216
2020-09-10,7973,8340,-367,-4.4,1216
2020-09-11,8194,8573,-379,-4.42,1216
2020-09-12,6065,6286,-221,-3.52,1216
2020-09-13,4992,4974,18,0.36,1216
2020-09-14,7672,8120,-448,-5.52,1216
2020-09-15,7973,8366,-393,-4.7,1216
2020-09-16,7973,8365,-392,-4.69,1216
2020-09-17,7973,8356,-383,-4.58,1216
2020-09-18,8194,8574,-380,-4.43,1216
2020-09-19,6065,6276,-211,-3.36,1216
2020-09-20,4992,4957,35,0.71,1216
2020-09-21,7672,8100,-428,-5.28,1216
2020-09-22,7973,8348,-375,-4.49,1216
2020-09-23,7973,8352,-379,-4.54,1216
2020-09-24,7973,8352,-379,-4.54,1216
2020-09-25,8194,8583,-389,-4.53,1216
2020-09-26,6065,6299,-234,-3.71,1216
2020-09-27,4992,4997,-5,-0.1,1216
2020-09-28,7672,8159,-487,-5.97,1216
2020-09-29,7973,8425,-452,-5.36,1216
2020-09-30,7973,8448,-475,-5.62,1216
2020-10-01,8008,8466,-458,-5.41,1216
2020-10-02,8128,8714,-586,-6.72,1216
2020-10-03,6181,6445,-264,-4.1,1216
2020-10-04,4871,5155,-284,-5.51,1216
2020-10-05,7773,8327,-554,-6.65,1216
2020-10-06,8008,8600,-592,-6.88,1216
2020-10-07,8008,8626,-618,-7.16,1216
2020-10-08,8008,8644,-636,-7.36,1216
2020-10-09,8128,8888,-760,-8.55,1216
2020-10-10,6181,6612,-431,-6.52,1216
2020-10-11,4871,5311,-440,-8.28,1216
2020-10-12,7773,8468,-695,-8.21,1216
2020-10-13,8008,8724,-716,-8.21,1216
2020-10-14,8008,8731,-723,-8.28,1216
2020-10-15,8008,8727,-719,-8.24,1216
2020-10-16,8128,8948,-820,-9.16,1216
2020-10-17,6181,6648,-467,-7.02,1216
2020-10-18,4871,5323,-452,-8.49,1216
2020-10-19,7773,8457,-684,-8.09,1216
2020-10-20,8008,8690,-682,-7.85,1216
2020-10-21,8008,8675,-667,-7.69,1216
2020-10-22,8008,8652,-644,-7.44,1216
2020-10-23,8128,8855,-727,-8.21,1216
2020-10-24,6181,6540,-359,-5.49,1216
2020-10-25,4871,5203,-332,-6.38,1216
2020-10-26,7773,8328,-555,-6.66,1216
2020-10-27,8008,8555,-547,-6.39,1216
2020-10-28,8008,8537,-529,-6.2,1216
2020-10-29,8008,8514,-506,-5.94,1216
2020-10-30,8128,8720,-592,-6.79,1216
2020-10-31,6181,6411,-230,-3.59,1216
2020-11-01,3917,5082,-1165,-22.92,1216
2020-11-02,6545,8216,-1671,-20.34,1216
2020-11-03,6134,8454,-2320,-27.44,1216
2020-11-04,6134,8449,-2315,-27.4,1216
2020-11-05,6134,8438,-2304,-27.31,1216
2020-11-06,6534,8657,-2123,-24.52,1216
2020-11-07,4962,6360,-1398,-21.98,1216
2020-11-08,3917,5043,-1126,-22.33,1216
2020-11-09,6545,8188,-1643,-20.07,1216
2020-11-10,6134,8435,-2301,-27.28,1216
2020-11-11,6134,8437,-2303,-27.3,1216
2020-11-12,6134,8432,-2298,-27.25,1216
2020-11-13,6534,8655,-2121,-24.51,1216
2020-11-14,4962,6359,-1397,-21.97,1216
2020-11-15,3917,5042,-1125,-22.31,1216
2020-11-16,6545,8184,-1639,-20.03,1216
2020-11-17,6134,8428,-2294,-27.22,1216
2020-11-18,6134,8424,-2290,-27.18,1216
2020-11-19,6134,8412,-2278,-27.08,1216
2020-11-20,6534,8627,-2093,-24.26,1216
2020-11-21,4962,6324,-1362,-21.54,1216
2020-11-22,3917,4998,-1081,-21.63,1216
2020-11-23,6545,8132,-1587,-19.52,1216
2020-11-24,6134,8368,-2234,-26.7,1216
2020-11-25,6134,8357,-2223,-26.6,1216
2020-11-26,6134,8340,-2206,-26.45,1216
2020-11-27,6534,8551,-2017,-23.59,1216
2020-11-28,4962,6245,-1283,-20.54,1216
2020-11-29,3917,4917,-1000,-20.34,1216
2020-11-30,6545,8053,-1508,-18.73,1216
2020-12-01,6474,8291,-1817,-21.92,1216
2020-12-02,6474,8285,-1811,-21.86,1216
2020-12-03,6474,8274,-1800,-21.75,1216
2020-12-04,6902,8492,-1590,-18.72,1216
2020-12-05,5258,6194,-936,-15.11,1216
2020-12-06,3752,4877,-1125,-23.07,1216
2020-12-07,6548,8022,-1474,-18.37,1216
2020-12-08,6474,8270,-1796,-21.72,1216
2020-12-09,6474,8273,-1799,-21.75,1216
2020-12-10,6474,8271,-1797,-21.73,1216
2020-12-11,6902,8496,-1594,-18.76,1216
2020-12-12,5258,6205,-947,-15.26,1216
2020-12-13,3752,4892,-1140,-23.3,1216
2020-12-14,6548,8039,-1491,-18.55,1216
2020-12-15,6474,8287,-1813,-21.88,1216
2020-12-16,6474,8288,-1814,-21.89,1216
2020-12-17,6474,8281,-1807,-21.82,1216
2020-12-18,6902,8499,-1597,-18.79,1216
2020-12-19,5258,6198,-940,-15.17,1216
2020-12-20,3752,4872,-1120,-22.99,1216
2020-12-21,6548,8005,-1457,-18.2,1216
2020-12-22,6474,8237,-1763,-21.4,1216
2020-12-23,6474,8220,-1746,-21.24,1216
2020-12-24,6474,8194,-1720,-20.99,1216
2020-12-25,6902,8393,-1491,-17.76,1216
2020-12-26,5258,6072,-814,-13.41,1216
2020-12-27,3752,4728,-976,-20.64,1216
2020-12-28,6548,7842,-1294,-16.5,1216
2020-12-29,6474,8058,-1584,-19.66,1216
2020-12-30,6474,8026,-1552,-19.34,1216
2020-12-31,6474,7988,-1514,-18.95,1216
2021-01-01,6262,8176,-1914,-23.41,1216
2021-01-02,4606,5849,-1243,-21.25,1216
2021-01-03,3575,4500,-925,-20.56,1216
2021-01-04,5754,7615,-1861,-24.44,1216
2021-01-05,6002,7833,-1831,-23.38,1216
2021-01-06,6002,7807,-1805,-23.12,1216
2021-01-07,6002,7778,-1776,-22.83,1216
2021-01-08,6262,7980,-1718,-21.53,1216
2021-01-09,4606,5667,-1061,-18.72,1216
2021-01-10,3575,4336,-761,-17.55,1216
2021-01-11,5754,7470,-1716,-22.97,1216
2021-01-12,6002,7710,-1708,-22.15,1216
2021-01-13,6002,7706,-1704,-22.11,1216
2021-01-14,6002,7700,-1698,-22.05,1216
2021-01-15,6262,7924,-1662,-20.97,1216
2021-01-16,4606,5633,-1027,-18.23,1216
2021-01-17,3575,4323,-748,-17.3,1216
2021-01-18,5754,7476,-1722,-23.03,1216
2021-01-19,6002,7733,-1731,-22.38,1216
2021-01-20,6002,7744,-1742,-22.49,1216
2021-01-21,6002,7750,-1748,-22.55,1216
2021-01-22,6262,7983,-1721,-21.56,1216
2021-01-23,4606,5699,-1093,-19.18,1216
2021-01-24,3575,4392,-817,-18.6,1216
2021-01-25,5754,7545,-1791,-23.74,1216
2021-01-26,6002,7799,-1797,-23.04,1216
2021-01-27,6002,7805,-1803,-23.1,1216
2021-01-28,6002,7803,-1801,-23.08,1216
2021-01-29,6262,8027,-1765,-21.99,1216
2021-01-30,4606,5732,-1126,-19.64,1216
2021-01-31,3575,4413,-838,-18.99,1216
2021-02-01,6572,7553,-981,-12.99,1216
2021-02-02,6764,7794,-1030,-13.22,1216
2021-02-03,6764,7788,-1024,-13.15,1216
2021-02-04,6764,7774,-1010,-12.99,1216
2021-02-05,6874,7988,-1114,-13.95,1216
2021-02-06,5047,5684,-637,-11.21,1216
2021-02-07,4095,4359,-264,-6.06,1216
2021-02-08,6572,7496,-924,-12.33,1216
2021-02-09,6764,7736,-972,-12.56,1216
2021-02-10,6764,7731,-967,-12.51,1216
2021-02-11,6764,7722,-958,-12.41,1216
2021-02-12,6874,7943,-1069,-13.46,1216
2021-02-13,5047,5649,-602,-10.66,1216
2021-02-14,4095,4336,-241,-5.56,1216
2021-02-15,6572,7488,-916,-12.23,1216
2021-02-16,6764,7744,-980,-12.65,1216
2021-02-17,6764,7757,-993,-12.8,1216
2021-02-18,6764,7766,-1002,-12.9,1216
2021-02-19,6874,8006,-1132,-14.14,1216
2021-02-20,5047,5731,-684,-11.94,1216
2021-02-21,4095,4436,-341,-7.69,1216
2021-02-22,6572,7605,-1033,-13.58,1216
2021-02-23,6764,7876,-1112,-14.12,1216
2021-02-24,6764,7903,-1139,-14.41,1216
2021-02-25,6764,7924,-1160,-14.64,1216
2021-02-26,6874,8172,-1298,-15.88,1216
2021-02-27,5047,5903,-856,-14.5,1216
2021-02-28,4095,4611,-516,-11.19,1216
2021-03-01,6792,7779,-987,-12.69,1216
2021-03-02,7128,8047,-919,-11.42,1216
2021-03-03,7128,8068,-940,-11.65,1216
2021-03-04,7128,8080,-952,-11.78,1216
2021-03-05,7154,8317,-1163,-13.98,1216
2021-03-06,5512,6035,-523,-8.67,1216
2021-03-07,4116,4729,-613,-12.96,1216
2021-03-08,6792,7881,-1089,-13.82,1216
2021-03-09,7128,8134,-1006,-12.37,1216
2021-03-10,7128,8138,-1010,-12.41,1216
2021-03-11,7128,8135,-1007,-12.38,1216
2021-03-12,7154,8358,-1204,-14.41,1216
2021-03-13,5512,6063,-551,-9.09,1216
2021-03-14,4116,4746,-630,-13.27,1216
2021-03-15,6792,7890,-1098,-13.92,1216
2021-03-16,7128,8136,-1008,-12.39,1216
2021-03-17,7128,8138,-1010,-12.41,1216
2021-03-18,7128,8134,-1006,-12.37,1216
2021-03-19,7154,8361,-1207,-14.44,1216
2021-03-20,5512,6072,-560,-9.22,1216
2021-03-21,4116,4764,-648,-13.6,1216
2021-03-22,6792,7920,-1128,-14.24,1216
2021-03-23,7128,8181,-1053,-12.87,1216
2021-03-24,7128,8198,-1070,-13.05,1216
2021-03-25,7128,8213,-1085,-13.21,1216
2021-03-26,7154,8458,-1304,-15.42,1216
2021-03-27,5512,6189,-677,-10.94,1216
2021-03-28,4116,4901,-785,-16.02,1216
2021-03-29,6792,8076,-1284,-15.9,1216
2021-03-30,7128,8355,-1227,-14.69,1216
2021-03-31,7128,8390,-1262,-15.04,1216
2021-04-01,6549,8419,-1870,-22.21,1216
2021-04-02,6907,8676,-1769,-20.39,1216
2021-04-03,5030,6416,-1386,-21.6,1216
2021-04-04,4089,5133,-1044,-20.34,1216
2021-04-05,6634,8311,-1677,-20.18,1216
2021-04-06,6549,8589,-2040,-23.75,1216
2021-04-07,6549,8618,-2069,-24.01,1216
2021-04-08,6549,8640,-2091,-24.2,1216
2021-04-09,6907,8885,-1978,-22.26,1216
2021-04-10,5030,6611,-1581,-23.91,1216
2021-04-11,4089,5311,-1222,-23.01,1216
2021-04-12,6634,8470,-1836,-21.68,1216
2021-04-13,6549,8727,-2178,-24.96,1216
2021-04-14,6549,8734,-2185,-25.02,1216
2021-04-15,6549,8732,-2183,-25.0,1216
2021-04-16,6907,8955,-2048,-22.87,1216
2021-04-17,5030,6657,-1627,-24.44,1216
2021-04-18,4089,5336,-1247,-23.37,1216
2021-04-19,6634,8474,-1840,-21.71,1216
2021-04-20,6549,8712,-2163,-24.83,1216
2021-04-21,6549,8703,-2154,-24.75,1216
2021-04-22,6549,8687,-2138,-24.61,1216
2021-04-23,6907,8898,-1991,-22.38,1216
2021-04-24,5030,6593,-1563,-23.71,1216
2021-04-25,4089,5266,-1177,-22.35,1216
2021-04-26,6634,8402,-1768,-21.04,1216
2021-04-27,6549,8641,-2092,-24.21,1216
2021-04-28,6549,8636,-2087,-24.17,1216
2021-04-29,6549,8626,-2077,-24.08,1216
2021-04-30,6907,8846,-1939,-21.92,1216
2021-05-01,5835,6551,-716,-10.93,1216
2021-05-02,4444,5236,-792,-15.13,1216
2021-05-03,7551,8384,-833,-9.94,1216
2021-05-04,7845,8636,-791,-9.16,1216
2021-05-05,7845,8643,-798,-9.23,1216
2021-05-06,7845,8645,-800,-9.25,1216
2021-05-07,7918,8876,-958,-10.79,1216
2021-05-08,5835,6590,-755,-11.46,1216
2021-05-09,4444,5282,-838,-15.87,1216
2021-05-10,7551,8436,-885,-10.49,1216
2021-05-11,7845,8691,-846,-9.73,1216
2021-05-12,7845,8700,-855,-9.83,1216
2021-05-13,7845,8701,-856,-9.84,1216
2021-05-14,7918,8928,-1010,-11.31,1216
2021-05-15,5835,6636,-801,-12.07,1216
2021-05-16,4444,5320,-876,-16.47,1216
2021-05-17,7551,8464,-913,-10.79,1216
2021-05-18,7845,8708,-863,-9.91,1216
2021-05-19,7845,8705,-860,-9.88,1216
2021-05-20,7845,8693,-848,-9.75,1216
2021-05-21,7918,8907,-989,-11.1,1216
2021-05-22,5835,6603,-768,-11.63,1216
2021-05-23,4444,5275,-831,-15.75,1216
2021-05-24,7551,8409,-858,-10.2,1216
2021-05-25,7845,8644,-799,-9.24,1216
2021-05-26,7845,8633,-788,-9.13,1216
2021-05-27,7845,8616,-771,-8.95,1216
2021-05-28,7918,8827,-909,-10.3,1216
2021-05-29,5835,6522,-687,-10.53,1216
2021-05-30,4444,5197,-753,-14.49,1216
2021-05-31,7551,8335,-784,-9.41,1216
2021-06-01,8138,8577,-439,-5.12,1216
2021-06-02,8138,8575,-437,-5.1,1216
2021-06-03,8138,8569,-431,-5.03,1216
2021-06-04,8044,8792,-748,-8.51,1216
2021-06-05,6133,6500,-367,-5.65,1216
2021-06-06,5065,5188,-123,-2.37,1216
2021-06-07,7599,8339,-740,-8.87,1216
2021-06-08,8138,8593,-455,-5.3,1216
2021-06-09,8138,8602,-464,-5.39,1216
2021-06-10,8138,8604,-466,-5.42,1216
2021-06-11,8044,8834,-790,-8.94,1216
2021-06-12,6133,6547,-414,-6.32,1216
2021-06-13,5065,5236,-171,-3.27,1216
2021-06-14,7599,8384,-785,-9.36,1216
2021-06-15,8138,8632,-494,-5.72,1216
2021-06-16,8138,8631,-493,-5.71,1216
2021-06-17,8138,8620,-482,-5.59,1216
2021-06-18,8044,8833,-789,-8.93,1216
2021-06-19,6133,6525,-392,-6.01,1216
2021-06-20,5065,5190,-125,-2.41,1216
2021-06-21,7599,8312,-713,-8.58,1216
2021-06-22,8138,8531,-393,-4.61,1216
2021-06-23,8138,8500,-362,-4.26,1216
2021-06-24,8138,8458,-320,-3.78,1216
2021-06-25,8044,8640,-596,-6.9,1216
2021-06-26,6133,6301,-168,-2.67,1216
2021-06-27,5065,4937,128,2.59,1216
2021-06-28,7599,8031,-432,-5.38,1216
2021-06-29,8138,8226,-88,-1.07,1216
2021-06-30,8138,8173,-35,-0.43,1216
2021-07-01,6655,8113,-1458,-17.97,1216
2021-07-02,6964,8282,-1318,-15.91,1216
2021-07-03,5156,5934,-778,-13.11,1216
2021-07-04,4411,4566,-155,-3.39,1216
2021-07-05,6237,7661,-1424,-18.59,1216
2021-07-06,6655,7862,-1207,-15.35,1216
2021-07-07,6655,7821,-1166,-14.91,1216
2021-07-08,6655,7777,-1122,-14.43,1216
2021-07-09,6964,7966,-1002,-12.58,1216
2021-07-10,5156,5642,-486,-8.61,1216
2021-07-11,4411,4302,109,2.53,1216
2021-07-12,6237,7428,-1191,-16.03,1216
2021-07-13,6655,7661,-1006,-13.13,1216
2021-07-14,6655,7653,-998,-13.04,1216
2021-07-15,6655,7643,-988,-12.93,1216
2021-07-16,6964,7865,-901,-11.46,1216
2021-07-17,5156,5573,-417,-7.48,1216
2021-07-18,4411,4263,148,3.47,1216
2021-07-19,6237,7416,-1179,-15.9,1216
2021-07-20,6655,7673,-1018,-13.27,1216
2021-07-21,6655,7684,-1029,-13.39,1216
2021-07-22,6655,7690,-1035,-13.46,1216
2021-07-23,6964,7922,-958,-12.09,1216
2021-07-24,5156,5636,-480,-8.52,1216
2021-07-25,4411,4326,85,1.96,1216
2021-07-26,6237,7474,-1237,-16.55,1216
2021-07-27,6655,7722,-1067,-13.82,1216
2021-07-28,6655,7720,-1065,-13.8,1216
2021-07-29,6655,7708,-1053,-13.66,1216
2021-07-30,6964,7920,-956,-12.07,1216
2021-07-31,5156,5611,-455,-8.11,1216
2021-08-01,4402,4276,126,2.95,1216
2021-08-02,6206,7399,-1193,-16.12,1216
2021-08-03,6423,7621,-1198,-15.72,1216
2021-08-04,6423,7595,-1172,-15.43,1216
2021-08-05,6423,7560,-1137,-15.04,1216
2021-08-06,6580,7751,-1171,-15.11,1216
2021-08-07,5147,5424,-277,-5.11,1216
2021-08-08,4402,4075,327,8.02,1216
2021-08-09,6206,7189,-983,-13.67,1216
2021-08-10,6423,7407,-984,-13.28,1216
2021-08-11,6423,7381,-958,-12.98,1216
2021-08-12,6423,7353,-930,-12.65,1216
2021-08-13,6580,7556,-976,-12.92,1216
2021-08-14,5147,5246,-99,-1.89,1216
2021-08-15,4402,3920,482,12.3,1216
2021-08-16,6206,7062,-856,-12.12,1216
2021-08-17,6423,7311,-888,-12.15,1216
2021-08-18,6423,7321,-898,-12.27,1216
2021-08-19,6423,7331,-908,-12.39,1216
2021-08-20,6580,7574,-994,-13.12,1216
2021-08-21,5147,5307,-160,-3.01,1216
2021-08-22,4402,4024,378,9.39,1216
2021-08-23,6206,7207,-1001,-13.89,1216
2021-08-24,6423,7497,-1074,-14.33,1216
2021-08-25,6423,7545,-1122,-14.87,1216
2021-08-26,6423,7591,-1168,-15.39,1216
2021-08-27,6580,7866,-1286,-16.35,1216
2021-08-28,5147,5626,-479,-8.51,1216
2021-08-29,4402,4365,37,0.85,1216
2021-08-30,6206,7566,-1360,-17.98,1216
2021-08-31,6423,7867,-1444,-18.36,1216
2021-09-01,7246,7921,-675,-8.52,1216
2021-09-02,7246,7967,-721,-9.05,1216
2021-09-03,7509,8237,-728,-8.84,1216
2021-09-04,6072,5986,86,1.44,1216
2021-09-05,5268,4709,559,11.87,1216
2021-09-06,6962,7890,-928,-11.76,1216
2021-09-07,7246,8167,-921,-11.28,1216
2021-09-08,7246,8194,-948,-11.57,1216
2021-09-09,7246,8210,-964,-11.74,1216
2021-09-10,7509,8449,-940,-11.13,1216
2021-09-11,6072,6167,-95,-1.54,1216
2021-09-12,5268,4859,409,8.42,1216
2021-09-13,6962,8009,-1047,-13.07,1216
2021-09-14,7246,8258,-1012,-12.25,1216
2021-09-15,7246,8258,-1012,-12.25,1216
2021-09-16,7246,8251,-1005,-12.18,1216
2021-09-17,7509,8470,-961,-11.35,1216
2021-09-18,6072,6171,-99,-1.6,1216
2021-09-19,5268,4851,417,8.6,1216
2021-09-20,6962,7993,-1031,-12.9,1216
2021-09-21,7246,8238,-992,-12.04,1216
2021-09-22,7246,8239,-993,-12.05,1216
2021-09-23,7246,8236,-990,-12.02,1216
2021-09-24,7509,8463,-954,-11.27,1216
2021-09-25,6072,6176,-104,-1.68,1216
2021-09-26,5268,4870,398,8.17,1216
2021-09-27,6962,8029,-1067,-13.29,1216
2021-09-28,7246,8292,-1046,-12.61,1216
2021-09-29,7246,8311,-1065,-12.81,1216
2021-09-30,7246,8327,-1081,-12.98,1216
2021-10-01,7794,8573,-779,-9.09,1216
2021-10-02,6035,6303,-268,-4.25,1216
2021-10-03,4975,5013,-38,-0.76,1216
2021-10-04,6913,8185,-1272,-15.54,1216
2021-10-05,7266,8458,-1192,-14.09,1216
2021-10-06,7266,8485,-1219,-14.37,1216
2021-10-07,7266,8506,-1240,-14.58,1216
2021-10-08,7794,8752,-958,-10.95,1216
2021-10-09,6035,6479,-444,-6.85,1216
2021-10-10,4975,5182,-207,-3.99,1216
2021-10-11,6913,8343,-1430,-17.14,1216
2021-10-12,7266,8603,-1337,-15.54,1216
2021-10-13,7266,8614,-1348,-15.65,1216
2021-10-14,7266,8615,-1349,-15.66,1216
2021-10-15,7794,8840,-1046,-11.83,1216
2021-10-16,6035,6545,-510,-7.79,1216
2021-10-17,4975,5224,-249,-4.77,1216
2021-10-18,6913,8361,-1448,-17.32,1216
2021-10-19,7266,8598,-1332,-15.49,1216
2021-10-20,7266,8585,-1319,-15.36,1216
2021-10-21,7266,8564,-1298,-15.16,1216
2021-10-22,7794,8769,-975,-11.12,1216
2021-10-23,6035,6456,-421,-6.52,1216
2021-10-24,4975,5119,-144,-2.81,1216
2021-10-25,6913,8244,-1331,-16.15,1216
2021-10-26,7266,8471,-1205,-14.23,1216
2021-10-27,7266,8452,-1186,-14.03,1216
2021-10-28,7266,8427,-1161,-13.78,1216
2021-10-29,7794,8631,-837,-9.7,1216
2021-10-30,6035,6320,-285,-4.51,1216
2021-10-31,4975,4989,-14,-0.28,1216
2021-11-01,6866,8121,-1255,-15.45,1216
2021-11-02,7375,8356,-981,-11.74,1216
2021-11-03,7375,8348,-973,-11.66,1216
2021-11-04,7375,8336,-961,-11.53,1216
2021-11-05,7805,8552,-747,-8.73,1216
2021-11-06,5946,6254,-308,-4.92,1216
2021-11-07,4700,4935,-235,-4.76,1216
2021-11-08,6866,8079,-1213,-15.01,1216
2021-11-09,7375,8325,-950,-11.41,1216
2021-11-10,7375,8327,-952,-11.43,1216
2021-11-11,7375,8322,-947,-11.38,1216
2021-11-12,7805,8545,-740,-8.66,1216
2021-11-13,5946,6251,-305,-4.88,1216
2021-11-14,4700,4934,-234,-4.74,1216
2021-11-15,6866,8078,-1212,-15.0,1216
2021-11-16,7375,8323,-948,-11.39,1216
2021-11-17,7375,8320,-945,-11.36,1216
2021-11-18,7375,8311,-936,-11.26,1216
2021-11-19,7805,8527,-722,-8.47,1216
2021-11-20,5946,6225,-279,-4.48,1216
2021-11-21,4700,4900,-200,-4.08,1216
2021-11-22,6866,8036,-1170,-14.56,1216
2021-11-23,7375,8272,-897,-10.84,1216
2021-11-24,7375,8262,-887,-10.74,1216
2021-11-25,7375,8245,-870,-10.55,1216
2021-11-26,7805,8456,-651,-7.7,1216
2021-11-27,5946,6150,-204,-3.32,1216
2021-11-28,4700,4822,-122,-2.53,1216
2021-11-29,6866,7956,-1090,-13.7,1216
2021-11-30,7375,8193,-818,-9.98,1216
2021-12-01,6889,8185,-1296,-15.83,1216
2021-12-02,6889,8172,-1283,-15.7,1216
2021-12-03,6733,8388,-1655,-19.73,1216
2021-12-04,5714,6089,-375,-6.16,1216
2021-12-05,4119,4769,-650,-13.63,1216
2021-12-06,6885,7913,-1028,-12.99,1216
2021-12-07,6889,8159,-1270,-15.57,1216
2021-12-08,6889,8161,-1272,-15.59,1216
2021-12-09,6889,8158,-1269,-15.56,1216
2021-12-10,6733,8383,-1650,-19.68,1216
2021-12-11,5714,6092,-378,-6.2,1216
2021-12-12,4119,4779,-660,-13.81,1216
2021-12-13,6885,7927,-1042,-13.14,1216
2021-12-14,6889,8176,-1287,-15.74,1216
2021-12-15,6889,8179,-1290,-15.77,1216
2021-12-16,6889,8174,-1285,-15.72,1216
2021-12-17,6733,8395,-1662,-19.8,1216
2021-12-18,5714,6096,-382,-6.27,1216
2021-12-19,4119,4774,-655,-13.72,1216
2021-12-20,6885,7910,-1025,-12.96,1216
2021-12-21,6889,8146,-1257,-15.43,1216
2021-12-22,6889,8133,-1244,-15.3,1216
2021-12-23,6889,8110,-1221,-15.06,1216
2021-12-24,6733,8313,-1580,-19.01,1216
2021-12-25,5714,5995,-281,-4.69,1216
2021-12-26,4119,4653,-534,-11.48,1216
2021-12-27,6885,7771,-886,-11.4,1216
2021-12-28,6889,7988,-1099,-13.76,1216
2021-12-29,6889,7957,-1068,-13.42,1216
2021-12-30,6889,7920,-1031,-13.02,1216
2021-12-31,6733,8109,-1376,-16.97,1216
2022-01-01,5413,5781,-368,-6.37,1216
2022-01-02,4019,4431,-412,-9.3,1216
2022-01-03,6450,7544,-1094,-14.5,1216
2022-01-04,6754,7760,-1006,-12.96,1216
2022-01-05,6754,7732,-978,-12.65,1216
2022-01-06,6754,7699,-945,-12.27,1216
2022-01-07,7135,7897,-762,-9.65,1216
2022-01-08,5413,5581,-168,-3.01,1216
2022-01-09,4019,4246,-227,-5.35,1216
2022-01-10,6450,7376,-926,-12.55,1216
2022-01-11,6754,7611,-857,-11.26,1216
2022-01-12,6754,7603,-849,-11.17,1216
2022-01-13,6754,7593,-839,-11.05,1216
2022-01-14,7135,7813,-678,-8.68,1216
2022-01-15,5413,5519,-106,-1.92,1216
2022-01-16,4019,4206,-187,-4.45,1216
2022-01-17,6450,7357,-907,-12.33,1216
2022-01-18,6754,7612,-858,-11.27,1216
2022-01-19,6754,7622,-868,-11.39,1216
2022-01-20,6754,7627,-873,-11.45,1216
2022-01-21,7135,7860,-725,-9.22,1216
2022-01-22,5413,5576,-163,-2.92,1216
2022-01-23,4019,4271,-252,-5.9,1216
2022-01-24,6450,7425,-975,-13.13,1216
2022-01-25,6754,7681,-927,-12.07,1216
2022-01-26,6754,7689,-935,-12.16,1216
2022-01-27,6754,7690,-936,-12.17,1216
2022-01-28,7135,7916,-781,-9.87,1216
2022-01-29,5413,5623,-210,-3.73,1216
2022-01-30,4019,4306,-287,-6.67,1216
2020-02-01,14480,13784,696,5.05,1619
2020-02-02,10900,10298,602,5.85,1619
2020-02-03,17654,17641,13,0.07,1619
2020-02-04,18023,17958,65,0.36,1619
2020-02-05,18023,17959,64,0.36,1619
2020-02-06,18023,17962,61,0.34,1619
2020-02-07,18756,18253,503,2.76,1619
2020-02-08,14480,13805,675,4.89,1619
2020-02-09,10900,10304,596,5.78,1619
2020-02-10,17654,17637,17,0.1,1619
2020-02-11,18023,17949,74,0.41,1619
2020-02-12,18023,17948,75,0.42,1619
2020-02-13,18023,17956,67,0.37,1619
2020-02-14,18756,18255,501,2.74,1619
2020-02-15,14480,13821,659,4.77,1619
2020-02-16,10900,10337,563,5.45,1619
2020-02-17,17654,17691,-37,-0.21,1619
2020-02-18,18023,18026,-3,-0.02,1619
2020-02-19,18023,18052,-29,-0.16,1619
2020-02-20,18023,18087,-64,-0.35,1619
2020-02-21,18756,18414,342,1.86,1619
2020-02-22,14480,14007,473,3.38,1619
2020-02-23,10900,10549,351,3.33,1619
2020-02-24,17654,17927,-273,-1.52,1619
2020-02-25,18023,18284,-261,-1.43,1619
2020-02-26,18023,18326,-303,-1.65,1619
2020-02-27,18023,18375,-352,-1.92,1619
2020-02-28,18756,18711,45,0.24,1619
2020-02-29,14480,14307,173,1.21,1619
2020-03-01,8340,10848,-2508,-23.12,1619
2020-03-02,13195,18220,-5025,-27.58,1619
2020-03-03,13549,18565,-5016,-27.02,1619
2020-03-04,13549,18592,-5043,-27.12,1619
2020-03-05,13549,18621,-5072,-27.24,1619
2020-03-06,14688,18934,-4246,-22.43,1619
2020-03-07,10686,14505,-3819,-26.33,1619
2020-03-08,8340,11019,-2679,-24.31,1619
2020-03-09,13195,18362,-5167,-28.14,1619
2020-03-10,13549,18680,-5131,-27.47,1619
2020-03-11,13549,18680,-5131,-27.47,1619
2020-03-12,13549,18683,-5134,-27.48,1619
2020-03-13,14688,18975,-4287,-22.59,1619
2020-03-14,10686,14527,-3841,-26.44,1619
2020-03-15,8340,11027,-2687,-24.37,1619
2020-03-16,13195,18360,-5165,-28.13,1619
2020-03-17,13549,18674,-5125,-27.44,1619
2020-03-18,13549,18676,-5127,-27.45,1619
2020-03-19,13549,18687,-5138,-27.5,1619
2020-03-20,14688,18991,-4303,-22.66,1619
2020-03-21,10686,14562,-3876,-26.62,1619
2020-03-22,8340,11085,-2745,-24.76,1619
2020-03-23,13195,18446,-5251,-28.47,1619
2020-03-24,13549,18792,-5243,-27.9,1619
2020-03-25,13549,18828,-5279,-28.04,1619
2020-03-26,13549,18875,-5326,-28.22,1619
2020-03-27,14688,19217,-4529,-23.57,1619
2020-03-28,10686,14825,-4139,-27.92,1619
2020-03-29,8340,11384,-3044,-26.74,1619
2020-03-30,13195,18780,-5585,-29.74,1619
2020-03-31,13549,19156,-5607,-29.27,1619
2020-04-01,12424,19219,-6795,-35.36,1619
2020-04-02,12424,19288,-6864,-35.59,1619
2020-04-03,12385,19646,-7261,-36.96,1619
2020-04-04,9928,15264,-5336,-34.96,1619
2020-04-05,7177,11828,-4651,-39.32,1619
2020-04-06,12270,19220,-6950,-36.16,1619
2020-04-07,12424,19587,-7163,-36.57,1619
2020-04-08,12424,19634,-7210,-36.72,1619
2020-04-09,12424,19681,-7257,-36.87,1619
2020-04-10,12385,20011,-7626,-38.11,1619
2020-04-11,9928,15597,-5669,-36.35,1619
2020-04-12,7177,12122,-4945,-40.79,1619
2020-04-13,12270,19475,-7205,-37.0,1619
2020-04-14,12424,19799,-7375,-37.25,1619
2020-04-15,12424,19802,-7378,-37.26,1619
2020-04-16,12424,19805,-7381,-37.27,1619
2020-04-17,12385,20091,-7706,-38.36,1619
2020-04-18,9928,15635,-5707,-36.5,1619
2020-04-19,7177,12123,-4946,-40.8,1619
2020-04-20,12270,19440,-7170,-36.88,1619
2020-04-21,12424,19733,-7309,-37.04,1619
2020-04-22,12424,19711,-7287,-36.97,1619
2020-04-23,12424,19693,-7269,-36.91,1619
2020-04-24,12385,19966,-7581,-37.97,1619
2020-04-25,9928,15502,-5574,-35.96,1619
2020-04-26,7177,11986,-4809,-40.12,1619
2020-04-27,12270,19307,-7037,-36.45,1619
2020-04-28,12424,19608,-7184,-36.64,1619
2020-04-29,12424,19599,-7175,-36.61,1619
2020-04-30,12424,19599,-7175,-36.61,1619
2020-05-01,17418,19891,-2473,-12.43,1619
2020-05-02,13859,15449,-1590,-10.29,1619
2020-05-03,9737,11958,-2221,-18.57,1619
2020-05-04,16668,19303,-2635,-13.65,1619
2020-05-05,16884,19628,-2744,-13.98,1619
2020-05-06,16884,19641,-2757,-14.04,1619
2020-05-07,16884,19661,-2777,-14.12,1619
2020-05-08,17418,19972,-2554,-12.79,1619
2020-05-09,13859,15544,-1685,-10.84,1619
2020-05-10,9737,12062,-2325,-19.28,1619
2020-05-11,16668,19412,-2744,-14.14,1619
2020-05-12,16884,19739,-2855,-14.46,1619
2020-05-13,16884,19748,-2864,-14.5,1619
2020-05-14,16884,19760,-2876,-14.55,1619
2020-05-15,17418,20057,-2639,-13.16,1619
2020-05-16,13859,15613,-1754,-11.23,1619
2020-05-17,9737,12112,-2375,-19.61,1619
2020-05-18,16668,19440,-2772,-14.26,1619
2020-05-19,16884,19743,-2859,-14.48,1619
2020-05-20,16884,19728,-2844,-14.42,1619
2020-05-21,16884,19715,-2831,-14.36,1619
2020-05-22,17418,19989,-2571,-12.86,1619
2020-05-23,13859,15524,-1665,-10.73,1619
2020-05-24,9737,12004,-2267,-18.89,1619
2020-05-25,16668,19317,-2649,-13.71,1619
2020-05-26,16884,19608,-2724,-13.89,1619
2020-05-27,16884,19586,-2702,-13.8,1619
2020-05-28,16884,19571,-2687,-13.73,1619
2020-05-29,17418,19848,-2430,-12.24,1619
2020-05-30,13859,15391,-1532,-9.95,1619
2020-05-31,9737,11883,-2146,-18.06,1619
2020-06-01,18256,19213,-957,-4.98,1619
2020-06-02,19007,19526,-519,-2.66,1619
2020-06-03,19007,19527,-520,-2.66,1619
2020-06-04,19007,19539,-532,-2.72,1619
2020-06-05,18284,19844,-1560,-7.86,1619
2020-06-06,14591,15414,-823,-5.34,1619
2020-06-07,10344,11933,-1589,-13.32,1619
2020-06-08,18256,19288,-1032,-5.35,1619
2020-06-09,19007,19622,-615,-3.13,1619
2020-06-10,19007,19642,-635,-3.23,1619
2020-06-11,19007,19666,-659,-3.35,1619
2020-06-12,18284,19977,-1693,-8.47,1619
2020-06-13,14591,15547,-956,-6.15,1619
2020-06-14,10344,12059,-1715,-14.22,1619
2020-06-15,18256,19399,-1143,-5.89,1619
2020-06-16,19007,19709,-702,-3.56,1619
2020-06-17,19007,19698,-691,-3.51,1619
2020-06-18,19007,19683,-676,-3.43,1619
2020-06-19,18284,19949,-1665,-8.35,1619
2020-06-20,14591,15467,-876,-5.66,1619
2020-06-21,10344,11922,-1578,-13.24,1619
2020-06-22,18256,19200,-944,-4.92,1619
2020-06-23,19007,19446,-439,-2.26,1619
2020-06-24,19007,19369,-362,-1.87,1619
2020-06-25,19007,19288,-281,-1.46,1619
2020-06-26,18284,19490,-1206,-6.19,1619
2020-06-27,14591,14946,-355,-2.38,1619
2020-06-28,10344,11344,-1000,-8.82,1619
2020-06-29,18256,18571,-315,-1.7,1619
2020-06-30,19007,18774,233,1.24,1619
2020-07-01,17710,18661,-951,-5.1,1619
2020-07-02,17710,18554,-844,-4.55,1619
2020-07-03,17863,18739,-876,-4.67,1619
2020-07-04,13670,14190,-520,-3.66,1619
2020-07-05,10824,10593,231,2.18,1619
2020-07-06,18104,17836,268,1.5,1619
2020-07-07,17710,18065,-355,-1.97,1619
2020-07-08,17710,17988,-278,-1.55,1619
2020-07-09,17710,17926,-216,-1.2,1619
2020-07-10,17863,18164,-301,-1.66,1619
2020-07-11,13670,13675,-5,-0.04,1619
2020-07-12,10824,10143,681,6.71,1619
2020-07-13,18104,17455,649,3.72,1619
2020-07-14,17710,17754,-44,-0.25,1619
2020-07-15,17710,17748,-38,-0.21,1619
2020-07-16,17710,17755,-45,-0.25,1619
2020-07-17,17863,18059,-196,-1.09,1619
2020-07-18,13670,13630,40,0.29,1619
2020-07-19,10824,10153,671,6.61,1619
2020-07-20,18104,17511,593,3.39,1619
2020-07-21,17710,17848,-138,-0.77,1619
2020-07-22,17710,17869,-159,-0.89,1619
2020-07-23,17710,17895,-185,-1.03,1619
2020-07-24,17863,18205,-342,-1.88,1619
2020-07-25,13670,13772,-102,-0.74,1619
2020-07-26,10824,10280,544,5.29,1619
2020-07-27,18104,17614,490,2.78,1619
2020-07-28,17710,17918,-208,-1.16,1619
2020-07-29,17710,17899,-189,-1.06,1619
2020-07-30,17710,17877,-167,-0.93,1619
2020-07-31,17863,18135,-272,-1.5,1619
2020-08-01,13043,13646,-603,-4.42,1619
2020-08-02,9792,10098,-306,-3.03,1619
2020-08-03,16305,17375,-1070,-6.16,1619
2020-08-04,16598,17625,-1027,-5.83,1619
2020-08-05,16598,17556,-958,-5.46,1619
2020-08-06,16598,17490,-892,-5.1,1619
2020-08-07,15777,17712,-1935,-10.92,1619
2020-08-08,13043,13197,-154,-1.17,1619
2020-08-09,9792,9632,160,1.66,1619
2020-08-10,16305,16904,-599,-3.54,1619
2020-08-11,16598,17161,-563,-3.28,1619
2020-08-12,16598,17112,-514,-3.0,1619
2020-08-13,16598,17078,-480,-2.81,1619
2020-08-14,15777,17345,-1568,-9.04,1619
2020-08-15,13043,12887,156,1.21,1619
2020-08-16,9792,9389,403,4.29,1619
2020-08-17,16305,16739,-434,-2.59,1619
2020-08-18,16598,17082,-484,-2.83,1619
2020-08-19,16598,17125,-527,-3.08,1619
2020-08-20,16598,17188,-590,-3.43,1619
2020-08-21,15777,17556,-1779,-10.13,1619
2020-08-22,13043,13198,-155,-1.17,1619
2020-08-23,9792,9801,-9,-0.09,1619
2020-08-24,16305,17248,-943,-5.47,1619
2020-08-25,16598,17683,-1085,-6.14,1619
2020-08-26,16598,17812,-1214,-6.82,1619
2020-08-27,16598,17952,-1354,-7.54,1619
2020-08-28,15777,18386,-2609,-14.19,1619
2020-08-29,13043,14084,-1041,-7.39,1619
2020-08-30,9792,10730,-938,-8.74,1619
2020-08-31,16305,18207,-1902,-10.45,1619
2020-09-01,18460,18659,-199,-1.07,1619
2020-09-02,18460,18791,-331,-1.76,1619
2020-09-03,18460,18922,-462,-2.44,1619
2020-09-04,18888,19334,-446,-2.31,1619
2020-09-05,14400,14998,-598,-3.99,1619
2020-09-06,10772,11599,-827,-7.13,1619
2020-09-07,18201,19023,-822,-4.32,1619
2020-09-08,18460,19413,-953,-4.91,1619
2020-09-09,18460,19477,-1017,-5.22,1619
2020-09-10,18460,19536,-1076,-5.51,1619
2020-09-11,18888,19873,-985,-4.96,1619
2020-09-12,14400,15462,-1062,-6.87,1619
2020-09-13,10772,11989,-1217,-10.15,1619
2020-09-14,18201,19341,-1140,-5.89,1619
2020-09-15,18460,19664,-1204,-6.12,1619
2020-09-16,18460,19667,-1207,-6.14,1619
2020-09-17,18460,19671,-1211,-6.16,1619
2020-09-18,18888,19962,-1074,-5.38,1619
2020-09-19,14400,15513,-1113,-7.17,1619
2020-09-20,10772,12012,-1240,-10.32,1619
2020-09-21,18201,19344,-1143,-5.91,1619
2020-09-22,18460,19658,-1198,-6.09,1619
2020-09-23,18460,19659,-1199,-6.1,1619
2020-09-24,18460,19671,-1211,-6.16,1619
2020-09-25,18888,19977,-1089,-5.45,1619
2020-09-26,14400,15549,-1149,-7.39,1619
2020-09-27,10772,12075,-1303,-10.79,1619
2020-09-28,18201,19438,-1237,-6.36,1619
2020-09-29,18460,19785,-1325,-6.7,1619
2020-09-30,18460,19822,-1362,-6.87,1619
2020-10-01,18444,19869,-1425,-7.17,1619
2020-10-02,19068,20209,-1141,-5.65,1619
2020-10-03,14649,15813,-1164,-7.36,1619
2020-10-04,10680,12366,-1686,-13.63,1619
2020-10-05,18253,19752,-1499,-7.59,1619
2020-10-06,18444,20116,-1672,-8.31,1619
2020-10-07,18444,20164,-1720,-8.53,1619
2020-10-08,18444,20215,-1771,-8.76,1619
2020-10-09,19068,20551,-1483,-7.22,1619
2020-10-10,14649,16145,-1496,-9.27,1619
2020-10-11,10680,12681,-2001,-15.78,1619
2020-10-12,18253,20044,-1791,-8.94,1619
2020-10-13,18444,20378,-1934,-9.49,1619
2020-10-14,18444,20392,-1948,-9.55,1619
2020-10-15,18444,20404,-1960,-9.61,1619
2020-10-16,19068,20699,-1631,-7.88,1619
2020-10-17,14649,16249,-1600,-9.85,1619
2020-10-18,10680,12741,-2061,-16.18,1619
2020-10-19,18253,20059,-1806,-9.0,1619
2020-10-20,18444,20352,-1908,-9.38,1619
2020-10-21,18444,20325,-1881,-9.25,1619
2020-10-22,18444,20301,-1857,-9.15,1619
2020-10-23,19068,20563,-1495,-7.27,1619
2020-10-24,14649,16086,-1437,-8.93,1619
2020-10-25,10680,12556,-1876,-14.94,1619
2020-10-26,18253,19859,-1606,-8.09,1619
2020-10-27,18444,20142,-1698,-8.43,1619
2020-10-28,18444,20112,-1668,-8.29,1619
2020-10-29,18444,20090,-1646,-8.19,1619
2020-10-30,19068,20361,-1293,-6.35,1619
2020-10-31,14649,15898,-1249,-7.86,1619
2020-11-01,9130,12385,-3255,-26.28,1619
2020-11-02,16346,19710,-3364,-17.07,1619
2020-11-03,15369,20017,-4648,-23.22,1619
2020-11-04,15369,20013,-4644,-23.2,1619
2020-11-05,15369,20018,-4649,-23.22,1619
2020-11-06,16446,20316,-3870,-19.05,1619
2020-11-07,12516,15878,-3362,-21.17,1619
2020-11-08,9130,12389,-3259,-26.31,1619
2020-11-09,16346,19735,-3389,-17.17,1619
2020-11-10,15369,20059,-4690,-23.38,1619
2020-11-11,15369,20068,-4699,-23.42,1619
2020-11-12,15369,20082,-4713,-23.47,1619
2020-11-13,16446,20384,-3938,-19.32,1619
2020-11-14,12516,15945,-3429,-21.51,1619
2020-11-15,9130,12451,-3321,-26.67,1619
2020-11-16,16346,19786,-3440,-17.39,1619
2020-11-17,15369,20095,-4726,-23.52,1619
2020-11-18,15369,20086,-4717,-23.48,1619
2020-11-19,15369,20079,-4710,-23.46,1619
2020-11-20,16446,20357,-3911,-19.21,1619
2020-11-21,12516,15894,-3378,-21.25,1619
2020-11-22,9130,12373,-3243,-26.21,1619
2020-11-23,16346,19683,-3337,-16.95,1619
2020-11-24,15369,19969,-4600,-23.04,1619
2020-11-25,15369,19937,-4568,-22.91,1619
2020-11-26,15369,19910,-4541,-22.81,1619
2020-11-27,16446,20172,-3726,-18.47,1619
2020-11-28,12516,15696,-3180,-20.26,1619
2020-11-29,9130,12168,-3038,-24.97,1619
2020-11-30,16346,19474,-3128,-16.06,1619
2020-12-01,16175,19760,-3585,-18.14,1619
2020-12-02,16175,19735,-3560,-18.04,1619
2020-12-03,16175,19718,-3543,-17.97,1619
2020-12-04,17644,19994,-2350,-11.75,1619
2020-12-05,13351,15535,-2184,-14.06,1619
2020-12-06,8919,12027,-3108,-25.84,1619
2020-12-07,16833,19355,-2522,-13.03,1619
2020-12-08,16175,19665,-3490,-17.75,1619
2020-12-09,16175,19663,-3488,-17.74,1619
2020-12-10,16175,19670,-3495,-17.77,1619
2020-12-11,17644,19967,-2323,-11.63,1619
2020-12-12,13351,15528,-2177,-14.02,1619
2020-12-13,8919,12036,-3117,-25.9,1619
2020-12-14,16833,19377,-2544,-13.13,1619
2020-12-15,16175,19694,-3519,-17.87,1619
2020-12-16,16175,19695,-3520,-17.87,1619
2020-12-17,16175,19698,-3523,-17.89,1619
2020-12-18,17644,19987,-2343,-11.72,1619
2020-12-19,13351,15533,-2182,-14.05,1619
2020-12-20,8919,12021,-3102,-25.8,1619
2020-12-21,16833,19336,-2503,-12.94,1619
2020-12-22,16175,19623,-3448,-17.57,1619
2020-12-23,16175,19590,-3415,-17.43,1619
2020-12-24,16175,19556,-3381,-17.29,1619
2020-12-25,17644,19805,-2161,-10.91,1619
2020-12-26,13351,15310,-1959,-12.8,1619
2020-12-27,8919,11756,-2837,-24.13,1619
2020-12-28,16833,19031,-2198,-11.55,1619
2020-12-29,16175,19280,-3105,-16.1,1619
2020-12-30,16175,19211,-3036,-15.8,1619
2020-12-31,16175,19145,-2970,-15.51,1619
2021-01-01,15729,19368,-3639,-18.79,1619
2021-01-02,11401,14852,-3451,-23.24,1619
2021-01-03,8150,11284,-3134,-27.77,1619
2021-01-04,14548,18551,-4003,-21.58,1619
2021-01-05,14992,18799,-3807,-20.25,1619
2021-01-06,14992,18737,-3745,-19.99,1619
2021-01-07,14992,18686,-3694,-19.77,1619
2021-01-08,15729,18929,-3200,-16.91,1619
2021-01-09,11401,14442,-3041,-21.06,1619
2021-01-10,8150,10908,-2758,-25.28,1619
2021-01-11,14548,18215,-3667,-20.13,1619
2021-01-12,14992,18507,-3515,-18.99,1619
2021-01-13,14992,18493,-3501,-18.93,1619
2021-01-14,14992,18492,-3500,-18.93,1619
2021-01-15,15729,18787,-3058,-16.28,1619
2021-01-16,11401,14351,-2950,-20.56,1619
2021-01-17,8150,10869,-2719,-25.02,1619
2021-01-18,14548,18225,-3677,-20.18,1619
2021-01-19,14992,18563,-3571,-19.24,1619
2021-01-20,14992,18591,-3599,-19.36,1619
2021-01-21,14992,18627,-3635,-19.51,1619
2021-01-22,15729,18954,-3225,-17.01,1619
2021-01-23,11401,14544,-3143,-21.61,1619
2021-01-24,8150,11081,-2931,-26.45,1619
2021-01-25,14548,18450,-3902,-21.15,1619
2021-01-26,14992,18795,-3803,-20.23,1619
2021-01-27,14992,18823,-3831,-20.35,1619
2021-01-28,14992,18854,-3862,-20.48,1619
2021-01-29,15729,19171,-3442,-17.95,1619
2021-01-30,11401,14746,-3345,-22.68,1619
2021-01-31,8150,11264,-3114,-27.65,1619
2021-02-01,16580,18611,-2031,-10.91,1619
2021-02-02,16589,18933,-2344,-12.38,1619
2021-02-03,16589,18937,-2348,-12.4,1619
2021-02-04,16589,18943,-2354,-12.43,1619
2021-02-05,17238,19237,-1999,-10.39,1619
2021-02-06,13107,14790,-1683,-11.38,1619
2021-02-07,9647,11289,-1642,-14.55,1619
2021-02-08,16580,18621,-2041,-10.96,1619
2021-02-09,16589,18932,-2343,-12.38,1619
2021-02-10,16589,18928,-2339,-12.36,1619
2021-02-11,16589,18933,-2344,-12.38,1619
2021-02-12,17238,19229,-1991,-10.35,1619
2021-02-13,13107,14789,-1682,-11.37,1619
2021-02-14,9647,11301,-1654,-14.64,1619
2021-02-15,16580,18649,-2069,-11.09,1619
2021-02-16,16589,18980,-2391,-12.6,1619
2021-02-17,16589,19000,-2411,-12.69,1619
2021-02-18,16589,19029,-2440,-12.82,1619
2021-02-19,17238,19353,-2115,-10.93,1619
2021-02-20,13107,14941,-1834,-12.27,1619
2021-02-21,9647,11480,-1833,-15.97,1619
2021-02-22,16580,18855,-2275,-12.07,1619
2021-02-23,16589,19210,-2621,-13.64,1619
2021-02-24,16589,19252,-2663,-13.83,1619
2021-02-25,16589,19300,-2711,-14.05,1619
2021-02-26,17238,19638,-2400,-12.22,1619
2021-02-27,13107,15236,-2129,-13.97,1619
2021-02-28,9647,11780,-2133,-18.11,1619
2021-03-01,16883,19155,-2272,-11.86,1619
2021-03-02,17231,19505,-2274,-11.66,1619
2021-03-03,17231,19537,-2306,-11.8,1619
2021-03-04,17231,19570,-2339,-11.95,1619
2021-03-05,17600,19889,-2289,-11.51,1619
2021-03-06,13756,15466,-1710,-11.06,1619
2021-03-07,9688,11985,-2297,-19.17,1619
2021-03-08,16883,19333,-2450,-12.67,1619
2021-03-09,17231,19655,-2424,-12.33,1619
2021-03-10,17231,19658,-2427,-12.35,1619
2021-03-11,17231,19665,-2434,-12.38,1619
2021-03-12,17600,19958,-2358,-11.81,1619
2021-03-13,13756,15511,-1755,-11.31,1619
2021-03-14,9688,12011,-2323,-19.34,1619
2021-03-15,16883,19343,-2460,-12.72,1619
2021-03-16,17231,19655,-2424,-12.33,1619
2021-03-17,17231,19653,-2422,-12.32,1619
2021-03-18,17231,19660,-2429,-12.36,1619
2021-03-19,17600,19959,-2359,-11.82,1619
2021-03-20,13756,15524,-1768,-11.39,1619
2021-03-21,9688,12040,-2352,-19.53,1619
2021-03-22,16883,19395,-2512,-12.95,1619
2021-03-23,17231,19733,-2502,-12.68,1619
2021-03-24,17231,19762,-2531,-12.81,1619
2021-03-25,17231,19803,-2572,-12.99,1619
2021-03-26,17600,20138,-2538,-12.6,1619
2021-03-27,13756,15740,-1984,-12.6,1619
2021-03-28,9688,12294,-2606,-21.2,1619
2021-03-29,16883,19685,-2802,-14.23,1619
2021-03-30,17231,20058,-2827,-14.09,1619
2021-03-31,17231,20119,-2888,-14.35,1619
2021-04-01,15942,20188,-4246,-21.03,1619
2021-04-02,16913,20546,-3633,-17.68,1619
2021-04-03,12725,16166,-3441,-21.29,1619
2021-04-04,9633,12732,-3099,-24.34,1619
2021-04-05,16218,20129,-3911,-19.43,1619
2021-04-06,15942,20500,-4558,-22.23,1619
2021-04-07,15942,20553,-4611,-22.43,1619
2021-04-08,15942,20607,-4665,-22.64,1619
2021-04-09,16913,20945,-4032,-19.25,1619
2021-04-10,12725,16538,-3813,-23.06,1619
2021-04-11,9633,13072,-3439,-26.31,1619
2021-04-12,16218,20433,-4215,-20.63,1619
2021-04-13,15942,20765,-4823,-23.23,1619
2021-04-14,15942,20776,-4834,-23.27,1619
2021-04-15,15942,20786,-4844,-23.3,1619
2021-04-16,16913,21079,-4166,-19.76,1619
2021-04-17,12725,16629,-3904,-23.48,1619
2021-04-18,9633,13121,-3488,-26.58,1619
2021-04-19,16218,20443,-4225,-20.67,1619
2021-04-20,15942,20739,-4797,-23.13,1619
2021-04-21,15942,20718,-4776,-23.05,1619
2021-04-22,15942,20701,-4759,-22.99,1619
2021-04-23,16913,20973,-4060,-19.36,1619
2021-04-24,12725,16507,-3782,-22.91,1619
2021-04-25,9633,12989,-3356,-25.84,1619
2021-04-26,16218,20306,-4088,-20.13,1619
2021-04-27,15942,20604,-4662,-22.63,1619
2021-04-28,15942,20590,-4648,-22.57,1619
2021-04-29,15942,20585,-4643,-22.56,1619
2021-04-30,16913,20873,-3960,-18.97,1619
2021-05-01,14044,16427,-2383,-14.51,1619
2021-05-02,10074,12931,-2857,-22.09,1619
2021-05-03,17858,20272,-2414,-11.91,1619
2021-05-04,18230,20594,-2364,-11.48,1619
2021-05-05,18230,20604,-2374,-11.52,1619
2021-05-06,18230,20622,-2392,-11.6,1619
2021-05-07,18327,20931,-2604,-12.44,1619
2021-05-08,14044,16503,-2459,-14.9,1619
2021-05-09,10074,13022,-2948,-22.64,1619
2021-05-10,17858,20374,-2516,-12.35,1619
2021-05-11,18230,20703,-2473,-11.95,1619
2021-05-12,18230,20715,-2485,-12.0,1619
2021-05-13,18230,20730,-2500,-12.06,1619
2021-05-14,18327,21032,-2705,-12.86,1619
2021-05-15,14044,16592,-2548,-15.36,1619
2021-05-16,10074,13096,-3022,-23.08,1619
2021-05-17,17858,20429,-2571,-12.59,1619
2021-05-18,18230,20736,-2506,-12.09,1619
2021-05-19,18230,20725,-2495,-12.04,1619
2021-05-20,18230,20716,-2486,-12.0,1619
2021-05-21,18327,20994,-2667,-12.7,1619
2021-05-22,14044,16530,-2486,-15.04,1619
2021-05-23,10074,13012,-2938,-22.58,1619
2021-05-24,17858,20325,-2467,-12.14,1619
2021-05-25,18230,20616,-2386,-11.57,1619
2021-05-26,18230,20593,-2363,-11.47,1619
2021-05-27,18230,20576,-2346,-11.4,1619
2021-05-28,18327,20850,-2523,-12.1,1619
2021-05-29,14044,16388,-2344,-14.3,1619
2021-05-30,10074,12876,-2802,-21.76,1619
2021-05-31,17858,20201,-2343,-11.6,1619
2021-06-01,18338,20508,-2170,-10.58,1619
2021-06-02,18338,20505,-2167,-10.57,1619
2021-06-03,18338,20511,-2173,-10.59,1619
2021-06-04,18353,20811,-2458,-11.81,1619
2021-06-05,13970,16376,-2406,-14.69,1619
2021-06-06,10799,12892,-2093,-16.23,1619
2021-06-07,17902,20245,-2343,-11.57,1619
2021-06-08,18338,20577,-2239,-10.88,1619
2021-06-09,18338,20596,-2258,-10.96,1619
2021-06-10,18338,20622,-2284,-11.08,1619
2021-06-11,18353,20935,-2582,-12.33,1619
2021-06-12,13970,16509,-2539,-15.38,1619
2021-06-13,10799,13027,-2228,-17.1,1619
2021-06-14,17902,20373,-2471,-12.13,1619
2021-06-15,18338,20692,-2354,-11.38,1619
2021-06-16,18338,20690,-2352,-11.37,1619
2021-06-17,18338,20686,-2348,-11.35,1619
2021-06-18,18353,20963,-2610,-12.45,1619
2021-06-19,13970,16493,-2523,-15.3,1619
2021-06-20,10799,12960,-2161,-16.67,1619
2021-06-21,17902,20250,-2348,-11.6,1619
2021-06-22,18338,20509,-2171,-10.59,1619
2021-06-23,18338,20443,-2105,-10.3,1619
2021-06-24,18338,20373,-2035,-9.99,1619
2021-06-25,18353,20584,-2231,-10.84,1619
2021-06-26,13970,16049,-2079,-12.95,1619
2021-06-27,10799,12454,-1655,-13.29,1619
2021-06-28,17902,19686,-1784,-9.06,1619
2021-06-29,18338,19892,-1554,-7.81,1619
2021-06-30,18338,19780,-1442,-7.29,1619
2021-07-01,16179,19673,-3494,-17.76,1619
2021-07-02,16640,19856,-3216,-16.2,1619
2021-07-03,12682,15302,-2620,-17.12,1619
2021-07-04,9609,11698,-2089,-17.86,1619
2021-07-05,15742,18933,-3191,-16.85,1619
2021-07-06,16179,19152,-2973,-15.52,1619
2021-07-07,16179,19064,-2885,-15.13,1619
2021-07-08,16179,18991,-2812,-14.81,1619
2021-07-09,16640,19216,-2576,-13.41,1619
2021-07-10,12682,14713,-2031,-13.8,1619
2021-07-11,9609,11168,-1559,-13.96,1619
2021-07-12,15742,18466,-2724,-14.75,1619
2021-07-13,16179,18753,-2574,-13.73,1619
2021-07-14,16179,18736,-2557,-13.65,1619
2021-07-15,16179,18733,-2554,-13.63,1619
2021-07-16,16640,19028,-2388,-12.55,1619
2021-07-17,12682,14592,-1910,-13.09,1619
2021-07-18,9609,11109,-1500,-13.5,1619
2021-07-19,15742,18463,-2721,-14.74,1619
2021-07-20,16179,18799,-2620,-13.94,1619
2021-07-21,16179,18821,-2642,-14.04,1619
2021-07-22,16179,18849,-2670,-14.17,1619
2021-07-23,16640,19164,-2524,-13.17,1619
2021-07-24,12682,14737,-2055,-13.94,1619
2021-07-25,9609,11253,-1644,-14.61,1619
2021-07-26,15742,18596,-2854,-15.35,1619
2021-07-27,16179,18909,-2730,-14.44,1619
2021-07-28,16179,18900,-2721,-14.4,1619
2021-07-29,16179,18889,-2710,-14.35,1619
2021-07-30,16640,19158,-2518,-13.14,1619
2021-07-31,12682,14680,-1998,-13.61,1619
2021-08-01,9889,11141,-1252,-11.24,1619
2021-08-02,16268,18427,-2159,-11.72,1619
2021-08-03,17163,18684,-1521,-8.14,1619
2021-08-04,17163,18620,-1457,-7.82,1619
2021-08-05,17163,18558,-1395,-7.52,1619
2021-08-06,16571,18782,-2211,-11.77,1619
2021-08-07,13236,14266,-1030,-7.22,1619
2021-08-08,9889,10697,-808,-7.55,1619
2021-08-09,16268,17964,-1696,-9.44,1619
2021-08-10,17163,18213,-1050,-5.77,1619
2021-08-11,17163,18154,-991,-5.46,1619
2021-08-12,17163,18108,-945,-5.22,1619
2021-08-13,16571,18361,-1790,-9.75,1619
2021-08-14,13236,13887,-651,-4.69,1619
2021-08-15,9889,10372,-483,-4.66,1619
2021-08-16,16268,17704,-1436,-8.11,1619
2021-08-17,17163,18028,-865,-4.8,1619
2021-08-18,17163,18052,-889,-4.92,1619
2021-08-19,17163,18097,-934,-5.16,1619
2021-08-20,16571,18446,-1875,-10.16,1619
2021-08-21,13236,14072,-836,-5.94,1619
2021-08-22,9889,10658,-769,-7.22,1619
2021-08-23,16268,18091,-1823,-10.08,1619
2021-08-24,17163,18513,-1350,-7.29,1619
2021-08-25,17163,18631,-1468,-7.88,1619
2021-08-26,17163,18763,-1600,-8.53,1619
2021-08-27,16571,19192,-2621,-13.66,1619
2021-08-28,13236,14886,-1650,-11.08,1619
2021-08-29,9889,11531,-1642,-14.24,1619
2021-08-30,16268,19010,-2742,-14.42,1619
2021-08-31,17163,19466,-2303,-11.83,1619
2021-09-01,17565,19604,-2039,-10.4,1619
2021-09-02,17565,19743,-2178,-11.03,1619
2021-09-03,17889,20165,-2276,-11.29,1619
2021-09-04,14064,15841,-1777,-11.22,1619
2021-09-05,10813,12455,-1642,-13.18,1619
2021-09-06,17402,19892,-2490,-12.52,1619
2021-09-07,17565,20296,-2731,-13.46,1619
2021-09-08,17565,20374,-2809,-13.79,1619
2021-09-09,17565,20447,-2882,-14.09,1619
2021-09-10,17889,20797,-2908,-13.98,1619
2021-09-11,14064,16399,-2335,-14.24,1619
2021-09-12,10813,12938,-2125,-16.42,1619
2021-09-13,17402,20300,-2898,-14.28,1619
2021-09-14,17565,20632,-3067,-14.87,1619
2021-09-15,17565,20641,-3076,-14.9,1619
2021-09-16,17565,20651,-3086,-14.94,1619
2021-09-17,17889,20946,-3057,-14.59,1619
2021-09-18,14064,16499,-2435,-14.76,1619
2021-09-19,10813,12997,-2184,-16.8,1619
2021-09-20,17402,20329,-2927,-14.4,1619
2021-09-21,17565,20639,-3074,-14.89,1619
2021-09-22,17565,20636,-3071,-14.88,1619
2021-09-23,17565,20643,-3078,-14.91,1619
2021-09-24,17889,20943,-3054,-14.58,1619
2021-09-25,14064,16509,-2445,-14.81,1619
2021-09-26,10813,13027,-2214,-17.0,1619
2021-09-27,17402,20384,-2982,-14.63,1619
2021-09-28,17565,20725,-3160,-15.25,1619
2021-09-29,17565,20756,-3191,-15.37,1619
2021-09-30,17565,20797,-3232,-15.54,1619
2021-10-01,18761,21132,-2371,-11.22,1619
2021-10-02,14441,16733,-2292,-13.7,1619
2021-10-03,10732,13284,-2552,-19.21,1619
2021-10-04,17469,20669,-3200,-15.48,1619
2021-10-05,17944,21033,-3089,-14.69,1619
2021-10-06,17944,21083,-3139,-14.89,1619
2021-10-07,17944,21137,-3193,-15.11,1619
2021-10-08,18761,21477,-2716,-12.65,1619
2021-10-09,14441,17077,-2636,-15.44,1619
2021-10-10,10732,13619,-2887,-21.2,1619
2021-10-11,17469,20989,-3520,-16.77,1619
2021-10-12,17944,21331,-3387,-15.88,1619
2021-10-13,17944,21353,-3409,-15.96,1619
2021-10-14,17944,21373,-3429,-16.04,1619
2021-10-15,18761,21677,-2916,-13.45,1619
2021-10-16,14441,17235,-2794,-16.21,1619
2021-10-17,10732,13734,-3002,-21.86,1619
2021-10-18,17469,21060,-3591,-17.05,1619
2021-10-19,17944,21358,-3414,-15.98,1619
2021-10-20,17944,21336,-3392,-15.9,1619
2021-10-21,17944,21316,-3372,-15.82,1619
2021-10-22,18761,21582,-2821,-13.07,1619
2021-10-23,14441,17107,-2666,-15.58,1619
2021-10-24,10732,13577,-2845,-20.95,1619
2021-10-25,17469,20880,-3411,-16.34,1619
2021-10-26,17944,21161,-3217,-15.2,1619
2021-10-27,17944,21129,-3185,-15.07,1619
2021-10-28,17944,21104,-3160,-14.97,1619
2021-10-29,18761,21371,-2610,-12.21,1619
2021-10-30,14441,16903,-2462,-14.57,1619
2021-10-31,10732,13385,-2653,-19.82,1619
2021-11-01,16598,20705,-4107,-19.84,1619
2021-11-02,17470,21006,-3536,-16.83,1619
2021-11-03,17470,20997,-3527,-16.8,1619
2021-11-04,17470,20998,-3528,-16.8,1619
2021-11-05,18225,21292,-3067,-14.4,1619
2021-11-06,14349,16851,-2502,-14.85,1619
2021-11-07,10327,13359,-3032,-22.7,1619
2021-11-08,16598,20703,-4105,-19.83,1619
2021-11-09,17470,21026,-3556,-16.91,1619
2021-11-10,17470,21036,-3566,-16.95,1619
2021-11-11,17470,21051,-3581,-17.01,1619
2021-11-12,18225,21354,-3129,-14.65,1619
2021-11-13,14349,16918,-2569,-15.19,1619
2021-11-14,10327,13427,-3100,-23.09,1619
2021-11-15,16598,20766,-4168,-20.07,1619
2021-11-16,17470,21080,-3610,-17.13,1619
2021-11-17,17470,21076,-3606,-17.11,1619
2021-11-18,17470,21074,-3604,-17.1,1619
2021-11-19,18225,21356,-3131,-14.66,1619
2021-11-20,14349,16897,-2548,-15.08,1619
2021-11-21,10327,13381,-3054,-22.82,1619
2021-11-22,16598,20695,-4097,-19.8,1619
2021-11-23,17470,20984,-3514,-16.75,1619
2021-11-24,17470,20955,-3485,-16.63,1619
2021-11-25,17470,20930,-3460,-16.53,1619
2021-11-26,18225,21192,-2967,-14.0,1619
2021-11-27,14349,16716,-2367,-14.16,1619
2021-11-28,10327,13187,-2860,-21.69,1619
2021-11-29,16598,20491,-3893,-19.0,1619
2021-11-30,17470,20775,-3305,-15.91,1619
2021-12-01,16505,20746,-4241,-20.44,1619
2021-12-02,16505,20725,-4220,-20.36,1619
2021-12-03,16076,20997,-4921,-23.44,1619
2021-12-04,13591,16534,-2943,-17.8,1619
2021-12-05,9342,13021,-3679,-28.25,1619
2021-12-06,16842,20345,-3503,-17.22,1619
2021-12-07,16505,20651,-4146,-20.08,1619
2021-12-08,16505,20645,-4140,-20.05,1619
2021-12-09,16505,20648,-4143,-20.06,1619
2021-12-10,16076,20943,-4867,-23.24,1619
2021-12-11,13591,16502,-2911,-17.64,1619
2021-12-12,9342,13009,-3667,-28.19,1619
2021-12-13,16842,20350,-3508,-17.24,1619
2021-12-14,16505,20669,-4164,-20.15,1619
2021-12-15,16505,20672,-4167,-20.16,1619
2021-12-16,16505,20679,-4174,-20.18,1619
2021-12-17,16076,20973,-4897,-23.35,1619
2021-12-18,13591,16524,-2933,-17.75,1619
2021-12-19,9342,13018,-3676,-28.24,1619
2021-12-20,16842,20341,-3499,-17.2,1619
2021-12-21,16505,20635,-4130,-20.01,1619
2021-12-22,16505,20610,-4105,-19.92,1619
2021-12-23,16505,20583,-4078,-19.81,1619
2021-12-24,16076,20840,-4764,-22.86,1619
2021-12-25,13591,16352,-2761,-16.88,1619
2021-12-26,9342,12806,-3464,-27.05,1619
2021-12-27,16842,20087,-3245,-16.15,1619
2021-12-28,16505,20341,-3836,-18.86,1619
2021-12-29,16505,20276,-3771,-18.6,1619
2021-12-30,16505,20213,-3708,-18.34,1619
2021-12-31,16076,20437,-4361,-21.34,1619
2022-01-01,12885,15921,-3036,-19.07,1619
2022-01-02,8886,12352,-3466,-28.06,1619
2022-01-03,16015,19617,-3602,-18.36,1619
2022-01-04,16338,19862,-3524,-17.74,1619
2022-01-05,16338,19794,-3456,-17.46,1619
2022-01-06,16338,19737,-3399,-17.22,1619
2022-01-07,16965,19973,-3008,-15.06,1619
2022-01-08,12885,15477,-2592,-16.75,1619
2022-01-09,8886,11935,-3049,-25.55,1619
2022-01-10,16015,19232,-3217,-16.73,1619
2022-01-11,16338,19515,-3177,-16.28,1619
2022-01-12,16338,19491,-3153,-16.18,1619
2022-01-13,16338,19481,-3143,-16.13,1619
2022-01-14,16965,19767,-2802,-14.18,1619
2022-01-15,12885,15322,-2437,-15.91,1619
2022-01-16,8886,11832,-2946,-24.9,1619
2022-01-17,16015,19180,-3165,-16.5,1619
2022-01-18,16338,19513,-3175,-16.27,1619
2022-01-19,16338,19536,-3198,-16.37,1619
2022-01-20,16338,19568,-3230,-16.51,1619
2022-01-21,16965,19893,-2928,-14.72,1619
2022-01-22,12885,15481,-2596,-16.77,1619
2022-01-23,8886,12018,-3132,-26.06,1619
2022-01-24,16015,19388,-3373,-17.4,1619
2022-01-25,16338,19735,-3397,-17.21,1619
2022-01-26,16338,19766,-3428,-17.34,1619
2022-01-27,16338,19801,-3463,-17.49,1619
2022-01-28,16965,20122,-3157,-15.69,1619
2022-01-29,12885,15701,-2816,-17.94,1619
2022-01-30,8886,12224,-3338,-27.31,1619
2020-02-01,4174,3939,235,5.97,1620
2020-02-02,3060,2952,108,3.66,1620
2020-02-03,5352,5458,-106,-1.94,1620
2020-02-04,5346,5503,-157,-2.85,1620
2020-02-05,5346,5498,-152,-2.76,1620
2020-02-06,5346,5496,-150,-2.73,1620
2020-02-07,5624,5537,87,1.57,1620
2020-02-08,4174,3897,277,7.11,1620
2020-02-09,3060,2906,154,5.3,1620
2020-02-10,5352,5410,-58,-1.07,1620
2020-02-11,5346,5455,-109,-2.0,1620
2020-02-12,5346,5454,-108,-1.98,1620
2020-02-13,5346,5458,-112,-2.05,1620
2020-02-14,5624,5507,117,2.12,1620
2020-02-15,4174,3877,297,7.66,1620
2020-02-16,3060,2899,161,5.55,1620
2020-02-17,5352,5418,-66,-1.22,1620
2020-02-18,5346,5480,-134,-2.45,1620
2020-02-19,5346,5496,-150,-2.73,1620
2020-02-20,5346,5519,-173,-3.13,1620
2020-02-21,5624,5587,37,0.66,1620
2020-02-22,4174,3976,198,4.98,1620
2020-02-23,3060,3016,44,1.46,1620
2020-02-24,5352,5552,-200,-3.6,1620
2020-02-25,5346,5630,-284,-5.04,1620
2020-02-26,5346,5660,-314,-5.55,1620
2020-02-27,5346,5695,-349,-6.13,1620
2020-02-28,5624,5773,-149,-2.58,1620
2020-02-29,4174,4169,5,0.12,1620
2020-03-01,2397,3213,-816,-25.4,1620
2020-03-02,4216,5752,-1536,-26.7,1620
2020-03-03,4319,5828,-1509,-25.89,1620
2020-03-04,4319,5855,-1536,-26.23,1620
2020-03-05,4319,5883,-1564,-26.59,1620
2020-03-06,4802,5953,-1151,-19.33,1620
2020-03-07,3210,4338,-1128,-26.0,1620
2020-03-08,2397,3370,-973,-28.87,1620
2020-03-09,4216,5894,-1678,-28.47,1620
2020-03-10,4319,5956,-1637,-27.48,1620
2020-03-11,4319,5968,-1649,-27.63,1620
2020-03-12,4319,5980,-1661,-27.78,1620
2020-03-13,4802,6034,-1232,-20.42,1620
2020-03-14,3210,4405,-1195,-27.13,1620
2020-03-15,2397,3424,-1027,-29.99,1620
2020-03-16,4216,5936,-1720,-28.98,1620
2020-03-17,4319,5988,-1669,-27.87,1620
2020-03-18,4319,5991,-1672,-27.91,1620
2020-03-19,4319,5998,-1679,-27.99,1620
2020-03-20,4802,6048,-1246,-20.6,1620
2020-03-21,3210,4418,-1208,-27.34,1620
2020-03-22,2397,3437,-1040,-30.26,1620
2020-03-23,4216,5953,-1737,-29.18,1620
2020-03-24,4319,6010,-1691,-28.14,1620
2020-03-25,4319,6020,-1701,-28.26,1620
2020-03-26,4319,6036,-1717,-28.45,1620
2020-03-27,4802,6096,-1294,-21.23,1620
2020-03-28,3210,4476,-1266,-28.28,1620
2020-03-29,2397,3507,-1110,-31.65,1620
2020-03-30,4216,6034,-1818,-30.13,1620
2020-03-31,4319,6102,-1783,-29.22,1620
2020-04-01,4113,6123,-2010,-32.83,1620
2020-04-02,4113,6148,-2035,-33.1,1620
2020-04-03,4154,6217,-2063,-33.18,1620
2020-04-04,3221,4604,-1383,-30.04,1620
2020-04-05,2085,3640,-1555,-42.72,1620
2020-04-06,4053,6170,-2117,-34.31,1620
2020-04-07,4113,6239,-2126,-34.08,1620
2020-04-08,4113,6258,-2145,-34.28,1620
2020-04-09,4113,6279,-2166,-34.5,1620
2020-04-10,4154,6342,-2188,-34.5,1620
2020-04-11,3221,4721,-1500,-31.77,1620
2020-04-12,2085,3748,-1663,-44.37,1620
2020-04-13,4053,6267,-2214,-35.33,1620
2020-04-14,4113,6323,-2210,-34.95,1620
2020-04-15,4113,6329,-2216,-35.01,1620
2020-04-16,4113,6337,-2224,-35.1,1620
2020-04-17,4154,6386,-2232,-34.95,1620
2020-04-18,3221,4751,-1530,-32.2,1620
2020-04-19,2085,3764,-1679,-44.61,1620
2020-04-20,4053,6270,-2217,-35.36,1620
2020-04-21,4113,6315,-2202,-34.87,1620
2020-04-22,4113,6311,-2198,-34.83,1620
2020-04-23,4113,6310,-2197,-34.82,1620
2020-04-24,4154,6352,-2198,-34.6,1620
2020-04-25,3221,4712,-1491,-31.64,1620
2020-04-26,2085,3722,-1637,-43.98,1620
2020-04-27,4053,6227,-2174,-34.91,1620
2020-04-28,4113,6272,-2159,-34.42,1620
2020-04-29,4113,6270,-2157,-34.4,1620
2020-04-30,4113,6273,-2160,-34.43,1620
2020-05-01,5571,6320,-749,-11.85,1620
2020-05-02,4180,4686,-506,-10.8,1620
2020-05-03,2829,3703,-874,-23.6,1620
2020-05-04,5359,6215,-856,-13.77,1620
2020-05-05,5446,6268,-822,-13.11,1620
2020-05-06,5446,6273,-827,-13.18,1620
2020-05-07,5446,6283,-837,-13.32,1620
2020-05-08,5571,6336,-765,-12.07,1620
2020-05-09,4180,4708,-528,-11.21,1620
2020-05-10,2829,3729,-900,-24.14,1620
2020-05-11,5359,6245,-886,-14.19,1620
2020-05-12,5446,6299,-853,-13.54,1620
2020-05-13,5446,6306,-860,-13.64,1620
2020-05-14,5446,6314,-868,-13.75,1620
2020-05-15,5571,6366,-795,-12.49,1620
2020-05-16,4180,4734,-554,-11.7,1620
2020-05-17,2829,3751,-922,-24.58,1620
2020-05-18,5359,6261,-902,-14.41,1620
2020-05-19,5446,6310,-864,-13.69,1620
2020-05-20,5446,6310,-864,-13.69,1620
2020-05-21,5446,6313,-867,-13.73,1620
2020-05-22,5571,6359,-788,-12.39,1620
2020-05-23,4180,4722,-542,-11.48,1620
2020-05-24,2829,3734,-905,-24.24,1620
2020-05-25,5359,6241,-882,-14.13,1620
2020-05-26,5446,6288,-842,-13.39,1620
2020-05-27,5446,6287,-841,-13.38,1620
2020-05-28,5446,6291,-845,-13.43,1620
2020-05-29,5571,6339,-768,-12.12,1620
2020-05-30,4180,4706,-526,-11.18,1620
2020-05-31,2829,3723,-894,-24.01,1620
2020-06-01,5822,6237,-415,-6.65,1620
2020-06-02,5950,6292,-342,-5.44,1620
2020-06-03,5950,6301,-351,-5.57,1620
2020-06-04,5950,6314,-364,-5.76,1620
2020-06-05,5838,6371,-533,-8.37,1620
2020-06-06,4300,4748,-448,-9.44,1620
2020-06-07,3097,3775,-678,-17.96,1620
2020-06-08,5822,6298,-476,-7.56,1620
2020-06-09,5950,6360,-410,-6.45,1620
2020-06-10,5950,6373,-423,-6.64,1620
2020-06-11,5950,6390,-440,-6.89,1620
2020-06-12,5838,6448,-610,-9.46,1620
2020-06-13,4300,4823,-523,-10.84,1620
2020-06-14,3097,3845,-748,-19.45,1620
2020-06-15,5822,6360,-538,-8.46,1620
2020-06-16,5950,6411,-461,-7.19,1620
2020-06-17,5950,6410,-460,-7.18,1620
2020-06-18,5950,6409,-459,-7.16,1620
2020-06-19,5838,6448,-610,-9.46,1620
2020-06-20,4300,4800,-500,-10.42,1620
2020-06-21,3097,3797,-700,-18.44,1620
2020-06-22,5822,6285,-463,-7.37,1620
2020-06-23,5950,6308,-358,-5.68,1620
2020-06-24,5950,6279,-329,-5.24,1620
2020-06-25,5950,6249,-299,-4.78,1620
2020-06-26,5838,6259,-421,-6.73,1620
2020-06-27,4300,4584,-284,-6.2,1620
2020-06-28,3097,3555,-458,-12.88,1620
2020-06-29,5822,6019,-197,-3.27,1620
2020-06-30,5950,6022,-72,-1.2,1620
2020-07-01,5337,5975,-638,-10.68,1620
2020-07-02,5337,5932,-595,-10.03,1620
2020-07-03,5500,5932,-432,-7.28,1620
2020-07-04,3932,4252,-320,-7.53,1620
2020-07-05,3115,3223,-108,-3.35,1620
2020-07-06,5243,5691,-448,-7.87,1620
2020-07-07,5337,5702,-365,-6.4,1620
2020-07-08,5337,5669,-332,-5.86,1620
2020-07-09,5337,5643,-306,-5.42,1620
2020-07-10,5500,5664,-164,-2.9,1620
2020-07-11,3932,4009,-77,-1.92,1620
2020-07-12,3115,3007,108,3.59,1620
2020-07-13,5243,5506,-263,-4.78,1620
2020-07-14,5337,5548,-211,-3.8,1620
2020-07-15,5337,5547,-210,-3.79,1620
2020-07-16,5337,5554,-217,-3.91,1620
2020-07-17,5500,5608,-108,-1.93,1620
2020-07-18,3932,3984,-52,-1.31,1620
2020-07-19,3115,3012,103,3.42,1620
2020-07-20,5243,5537,-294,-5.31,1620
2020-07-21,5337,5604,-267,-4.76,1620
2020-07-22,5337,5623,-286,-5.09,1620
2020-07-23,5337,5647,-310,-5.49,1620
2020-07-24,5500,5714,-214,-3.75,1620
2020-07-25,3932,4098,-166,-4.05,1620
2020-07-26,3115,3130,-15,-0.48,1620
2020-07-27,5243,5655,-412,-7.29,1620
2020-07-28,5337,5717,-380,-6.65,1620
2020-07-29,5337,5728,-391,-6.83,1620
2020-07-30,5337,5740,-403,-7.02,1620
2020-07-31,5500,5792,-292,-5.04,1620
2020-08-01,3870,4158,-288,-6.93,1620
2020-08-02,3112,3172,-60,-1.89,1620
2020-08-03,4907,5676,-769,-13.55,1620
2020-08-04,4973,5718,-745,-13.03,1620
2020-08-05,4973,5709,-736,-12.89,1620
2020-08-06,4973,5701,-728,-12.77,1620
2020-08-07,5068,5736,-668,-11.65,1620
2020-08-08,3870,4087,-217,-5.31,1620
2020-08-09,3112,3088,24,0.78,1620
2020-08-10,4907,5583,-676,-12.11,1620
2020-08-11,4973,5619,-646,-11.5,1620
2020-08-12,4973,5609,-636,-11.34,1620
2020-08-13,4973,5604,-631,-11.26,1620
2020-08-14,5068,5646,-578,-10.24,1620
2020-08-15,3870,4009,-139,-3.47,1620
2020-08-16,3112,3025,87,2.88,1620
2020-08-17,4907,5540,-633,-11.43,1620
2020-08-18,4973,5600,-627,-11.2,1620
2020-08-19,4973,5616,-643,-11.45,1620
2020-08-20,4973,5640,-667,-11.83,1620
2020-08-21,5068,5713,-645,-11.29,1620
2020-08-22,3870,4108,-238,-5.79,1620
2020-08-23,3112,3157,-45,-1.43,1620
2020-08-24,4907,5706,-799,-14.0,1620
2020-08-25,4973,5797,-824,-14.21,1620
2020-08-26,4973,5844,-871,-14.9,1620
2020-08-27,4973,5897,-924,-15.67,1620
2020-08-28,5068,5995,-927,-15.46,1620
2020-08-29,3870,4413,-543,-12.3,1620
2020-08-30,3112,3481,-369,-10.6,1620
2020-08-31,4907,6043,-1136,-18.8,1620
2020-09-01,5885,6145,-260,-4.23,1620
2020-09-02,5885,6197,-312,-5.03,1620
2020-09-03,5885,6251,-366,-5.86,1620
2020-09-04,6063,6346,-283,-4.46,1620
2020-09-05,4434,4755,-321,-6.75,1620
2020-09-06,3430,3811,-381,-10.0,1620
2020-09-07,5878,6357,-479,-7.54,1620
2020-09-08,5885,6439,-554,-8.6,1620
2020-09-09,5885,6468,-583,-9.01,1620
2020-09-10,5885,6497,-612,-9.42,1620
2020-09-11,6063,6564,-501,-7.63,1620
2020-09-12,4434,4946,-512,-10.35,1620
2020-09-13,3430,3972,-542,-13.65,1620
2020-09-14,5878,6490,-612,-9.43,1620
2020-09-15,5885,6543,-658,-10.06,1620
2020-09-16,5885,6546,-661,-10.1,1620
2020-09-17,5885,6549,-664,-10.14,1620
2020-09-18,6063,6593,-530,-8.04,1620
2020-09-19,4434,4953,-519,-10.48,1620
2020-09-20,3430,3962,-532,-13.43,1620
2020-09-21,5878,6464,-586,-9.07,1620
2020-09-22,5885,6506,-621,-9.55,1620
2020-09-23,5885,6499,-614,-9.45,1620
2020-09-24,5885,6496,-611,-9.41,1620
2020-09-25,6063,6538,-475,-7.27,1620
2020-09-26,4434,4898,-464,-9.47,1620
2020-09-27,3430,3909,-479,-12.25,1620
2020-09-28,5878,6415,-537,-8.37,1620
2020-09-29,5885,6463,-578,-8.94,1620
2020-09-30,5885,6464,-579,-8.96,1620
2020-10-01,5771,6470,-699,-10.8,1620
2020-10-02,6036,6521,-485,-7.44,1620
2020-10-03,4225,4891,-666,-13.62,1620
2020-10-04,3146,3911,-765,-19.56,1620
2020-10-05,5887,6426,-539,-8.39,1620
2020-10-06,5771,6482,-711,-10.97,1620
2020-10-07,5771,6489,-718,-11.06,1620
2020-10-08,5771,6501,-730,-11.23,1620
2020-10-09,6036,6555,-519,-7.92,1620
2020-10-10,4225,4926,-701,-14.23,1620
2020-10-11,3146,3947,-801,-20.29,1620
2020-10-12,5887,6461,-574,-8.88,1620
2020-10-13,5771,6513,-742,-11.39,1620
2020-10-14,5771,6517,-746,-11.45,1620
2020-10-15,5771,6522,-751,-11.51,1620
2020-10-16,6036,6570,-534,-8.13,1620
2020-10-17,4225,4934,-709,-14.37,1620
2020-10-18,3146,3946,-800,-20.27,1620
2020-10-19,5887,6453,-566,-8.77,1620
2020-10-20,5771,6497,-726,-11.17,1620
2020-10-21,5771,6493,-722,-11.12,1620
2020-10-22,5771,6492,-721,-11.11,1620
2020-10-23,6036,6534,-498,-7.62,1620
2020-10-24,4225,4894,-669,-13.67,1620
2020-10-25,3146,3903,-757,-19.4,1620
2020-10-26,5887,6407,-520,-8.12,1620
2020-10-27,5771,6452,-681,-10.55,1620
2020-10-28,5771,6448,-677,-10.5,1620
2020-10-29,5771,6450,-679,-10.53,1620
2020-10-30,6036,6495,-459,-7.07,1620
2020-10-31,4225,4859,-634,-13.05,1620
2020-11-01,2720,3874,-1154,-29.79,1620
2020-11-02,5426,6385,-959,-15.02,1620
2020-11-03,5099,6436,-1337,-20.77,1620
2020-11-04,5099,6440,-1341,-20.82,1620
2020-11-05,5099,6448,-1349,-20.92,1620
2020-11-06,5494,6500,-1006,-15.48,1620
2020-11-07,3783,4870,-1087,-22.32,1620
2020-11-08,2720,3890,-1170,-30.08,1620
2020-11-09,5426,6405,-979,-15.28,1620
2020-11-10,5099,6459,-1360,-21.06,1620
2020-11-11,5099,6464,-1365,-21.12,1620
2020-11-12,5099,6472,-1373,-21.21,1620
2020-11-13,5494,6522,-1028,-15.76,1620
2020-11-14,3783,4890,-1107,-22.64,1620
2020-11-15,2720,3905,-1185,-30.35,1620
2020-11-16,5426,6414,-988,-15.4,1620
2020-11-17,5099,6460,-1361,-21.07,1620
2020-11-18,5099,6457,-1358,-21.03,1620
2020-11-19,5099,6456,-1357,-21.02,1620
2020-11-20,5494,6497,-1003,-15.44,1620
2020-11-21,3783,4855,-1072,-22.08,1620
2020-11-22,2720,3861,-1141,-29.55,1620
2020-11-23,5426,6360,-934,-14.69,1620
2020-11-24,5099,6398,-1299,-20.3,1620
2020-11-25,5099,6387,-1288,-20.17,1620
2020-11-26,5099,6380,-1281,-20.08,1620
2020-11-27,5494,6416,-922,-14.37,1620
2020-11-28,3783,4769,-986,-20.68,1620
2020-11-29,2720,3773,-1053,-27.91,1620
2020-11-30,5426,6272,-846,-13.49,1620
2020-12-01,5130,6312,-1182,-18.73,1620
2020-12-02,5130,6304,-1174,-18.62,1620
2020-12-03,5130,6301,-1171,-18.58,1620
2020-12-04,5810,6342,-532,-8.39,1620
2020-12-05,3854,4703,-849,-18.05,1620
2020-12-06,2545,3715,-1170,-31.49,1620
2020-12-07,5323,6223,-900,-14.46,1620
2020-12-08,5130,6271,-1141,-18.19,1620
2020-12-09,5130,6273,-1143,-18.22,1620
2020-12-10,5130,6278,-1148,-18.29,1620
2020-12-11,5810,6328,-518,-8.19,1620
2020-12-12,3854,4696,-842,-17.93,1620
2020-12-13,2545,3714,-1169,-31.48,1620
2020-12-14,5323,6226,-903,-14.5,1620
2020-12-15,5130,6277,-1147,-18.27,1620
2020-12-16,5130,6279,-1149,-18.3,1620
2020-12-17,5130,6284,-1154,-18.36,1620
2020-12-18,5810,6330,-520,-8.21,1620
2020-12-19,3854,4693,-839,-17.88,1620
2020-12-20,2545,3703,-1158,-31.27,1620
2020-12-21,5323,6206,-883,-14.23,1620
2020-12-22,5130,6247,-1117,-17.88,1620
2020-12-23,5130,6237,-1107,-17.75,1620
2020-12-24,5130,6228,-1098,-17.63,1620
2020-12-25,5810,6260,-450,-7.19,1620
2020-12-26,3854,4609,-755,-16.38,1620
2020-12-27,2545,3605,-1060,-29.4,1620
2020-12-28,5323,6094,-771,-12.65,1620
2020-12-29,5130,6121,-991,-16.19,1620
2020-12-30,5130,6099,-969,-15.89,1620
2020-12-31,5130,6080,-950,-15.62,1620
2021-01-01,4938,6103,-1165,-19.09,1620
2021-01-02,3238,4445,-1207,-27.15,1620
2021-01-03,2303,3437,-1134,-32.99,1620
2021-01-04,4560,5924,-1364,-23.02,1620
2021-01-05,4691,5952,-1261,-21.19,1620
2021-01-06,4691,5933,-1242,-20.93,1620
2021-01-07,4691,5920,-1229,-20.76,1620
2021-01-08,4938,5953,-1015,-17.05,1620
2021-01-09,3238,4305,-1067,-24.79,1620
2021-01-10,2303,3310,-1007,-30.42,1620
2021-01-11,4560,5812,-1252,-21.54,1620
2021-01-12,4691,5856,-1165,-19.89,1620
2021-01-13,4691,5854,-1163,-19.87,1620
2021-01-14,4691,5859,-1168,-19.94,1620
2021-01-15,4938,5909,-971,-16.43,1620
2021-01-16,3238,4279,-1041,-24.33,1620
2021-01-17,2303,3301,-998,-30.23,1620
2021-01-18,4560,5818,-1258,-21.62,1620
2021-01-19,4691,5877,-1186,-20.18,1620
2021-01-20,4691,5888,-1197,-20.33,1620
2021-01-21,4691,5904,-1213,-20.55,1620
2021-01-22,4938,5962,-1024,-17.18,1620
2021-01-23,3238,4339,-1101,-25.37,1620
2021-01-24,2303,3364,-1061,-31.54,1620
2021-01-25,4560,5883,-1323,-22.49,1620
2021-01-26,4691,5940,-1249,-21.03,1620
2021-01-27,4691,5948,-1257,-21.13,1620
2021-01-28,4691,5957,-1266,-21.25,1620
2021-01-29,4938,6008,-1070,-17.81,1620
2021-01-30,3238,4376,-1138,-26.01,1620
2021-01-31,2303,3391,-1088,-32.08,1620
2021-02-01,5080,5899,-819,-13.88,1620
2021-02-02,5011,5945,-934,-15.71,1620
2021-02-03,5011,5942,-931,-15.67,1620
2021-02-04,5011,5941,-930,-15.65,1620
2021-02-05,5344,5982,-638,-10.67,1620
2021-02-06,3545,4341,-796,-18.34,1620
2021-02-07,2606,3350,-744,-22.21,1620
2021-02-08,5080,5853,-773,-13.21,1620
2021-02-09,5011,5897,-886,-15.02,1620
2021-02-10,5011,5894,-883,-14.98,1620
2021-02-11,5011,5895,-884,-15.0,1620
2021-02-12,5344,5942,-598,-10.06,1620
2021-02-13,3545,4309,-764,-17.73,1620
2021-02-14,2606,3327,-721,-21.67,1620
2021-02-15,5080,5843,-763,-13.06,1620
2021-02-16,5011,5901,-890,-15.08,1620
2021-02-17,5011,5914,-903,-15.27,1620
2021-02-18,5011,5933,-922,-15.54,1620
2021-02-19,5344,5998,-654,-10.9,1620
2021-02-20,3545,4384,-839,-19.14,1620
2021-02-21,2606,3421,-815,-23.82,1620
2021-02-22,5080,5955,-875,-14.69,1620
2021-02-23,5011,6031,-1020,-16.91,1620
2021-02-24,5011,6060,-1049,-17.31,1620
2021-02-25,5011,6094,-1083,-17.77,1620
2021-02-26,5344,6171,-827,-13.4,1620
2021-02-27,3545,4567,-1022,-22.38,1620
2021-02-28,2606,3613,-1007,-27.87,1620
2021-03-01,5288,6152,-864,-14.04,1620
2021-03-02,5385,6230,-845,-13.56,1620
2021-03-03,5385,6259,-874,-13.96,1620
2021-03-04,5385,6290,-905,-14.39,1620
2021-03-05,5658,6362,-704,-11.07,1620
2021-03-06,3999,4750,-751,-15.81,1620
2021-03-07,2676,3785,-1109,-29.3,1620
2021-03-08,5288,6312,-1024,-16.22,1620
2021-03-09,5385,6377,-992,-15.56,1620
2021-03-10,5385,6391,-1006,-15.74,1620
2021-03-11,5385,6406,-1021,-15.94,1620
2021-03-12,5658,6462,-804,-12.44,1620
2021-03-13,3999,4835,-836,-17.29,1620
2021-03-14,2676,3855,-1179,-30.58,1620
2021-03-15,5288,6369,-1081,-16.97,1620
2021-03-16,5385,6421,-1036,-16.13,1620
2021-03-17,5385,6425,-1040,-16.19,1620
2021-03-18,5385,6432,-1047,-16.28,1620
2021-03-19,5658,6481,-823,-12.7,1620
2021-03-20,3999,4850,-851,-17.55,1620
2021-03-21,2676,3868,-1192,-30.82,1620
2021-03-22,5288,6382,-1094,-17.14,1620
2021-03-23,5385,6437,-1052,-16.34,1620
2021-03-24,5385,6445,-1060,-16.45,1620
2021-03-25,5385,6459,-1074,-16.63,1620
2021-03-26,5658,6517,-859,-13.18,1620
2021-03-27,3999,4895,-896,-18.3,1620
2021-03-28,2676,3924,-1248,-31.8,1620
2021-03-29,5288,6449,-1161,-18.0,1620
2021-03-30,5385,6516,-1131,-17.36,1620
2021-03-31,5385,6535,-1150,-17.6,1620
2021-04-01,4997,6559,-1562,-23.81,1620
2021-04-02,5362,6627,-1265,-19.09,1620
2021-04-03,3681,5014,-1333,-26.59,1620
2021-04-04,2711,4050,-1339,-33.06,1620
2021-04-05,5213,6581,-1368,-20.79,1620
2021-04-06,4997,6650,-1653,-24.86,1620
2021-04-07,4997,6671,-1674,-25.09,1620
2021-04-08,4997,6694,-1697,-25.35,1620
2021-04-09,5362,6759,-1397,-20.67,1620
2021-04-10,3681,5141,-1460,-28.4,1620
2021-04-11,2711,4170,-1459,-34.99,1620
2021-04-12,5213,6691,-1478,-22.09,1620
2021-04-13,4997,6750,-1753,-25.97,1620
2021-04-14,4997,6759,-1762,-26.07,1620
2021-04-15,4997,6769,-1772,-26.18,1620
2021-04-16,5362,6820,-1458,-21.38,1620
2021-04-17,3681,5188,-1507,-29.05,1620
2021-04-18,2711,4203,-1492,-35.5,1620
2021-04-19,5213,6711,-1498,-22.32,1620
2021-04-20,4997,6757,-1760,-26.05,1620
2021-04-21,4997,6754,-1757,-26.01,1620
2021-04-22,4997,6753,-1756,-26.0,1620
2021-04-23,5362,6796,-1434,-21.1,1620
2021-04-24,3681,5156,-1475,-28.61,1620
2021-04-25,2711,4165,-1454,-34.91,1620
2021-04-26,5213,6669,-1456,-21.83,1620
2021-04-27,4997,6714,-1717,-25.57,1620
2021-04-28,4997,6711,-1714,-25.54,1620
2021-04-29,4997,6712,-1715,-25.55,1620
2021-04-30,5362,6757,-1395,-20.65,1620
2021-05-01,4249,5122,-873,-17.04,1620
2021-05-02,2984,4137,-1153,-27.87,1620
2021-05-03,5828,6648,-820,-12.33,1620
2021-05-04,5835,6700,-865,-12.91,1620
2021-05-05,5835,6704,-869,-12.96,1620
2021-05-06,5835,6713,-878,-13.08,1620
2021-05-07,5920,6766,-846,-12.5,1620
2021-05-08,4249,5137,-888,-17.29,1620
2021-05-09,2984,4158,-1174,-28.23,1620
2021-05-10,5828,6674,-846,-12.68,1620
2021-05-11,5835,6729,-894,-13.29,1620
2021-05-12,5835,6736,-901,-13.38,1620
2021-05-13,5835,6745,-910,-13.49,1620
2021-05-14,5920,6797,-877,-12.9,1620
2021-05-15,4249,5167,-918,-17.77,1620
2021-05-16,2984,4185,-1201,-28.7,1620
2021-05-17,5828,6696,-868,-12.96,1620
2021-05-18,5835,6747,-912,-13.52,1620
2021-05-19,5835,6748,-913,-13.53,1620
2021-05-20,5835,6752,-917,-13.58,1620
2021-05-21,5920,6798,-878,-12.92,1620
2021-05-22,4249,5161,-912,-17.67,1620
2021-05-23,2984,4174,-1190,-28.51,1620
2021-05-24,5828,6681,-853,-12.77,1620
2021-05-25,5835,6727,-892,-13.26,1620
2021-05-26,5835,6726,-891,-13.25,1620
2021-05-27,5835,6729,-894,-13.29,1620
2021-05-28,5920,6775,-855,-12.62,1620
2021-05-29,4249,5141,-892,-17.35,1620
2021-05-30,2984,4157,-1173,-28.22,1620
2021-05-31,5828,6669,-841,-12.61,1620
2021-06-01,6012,6722,-710,-10.56,1620
2021-06-02,6012,6728,-716,-10.64,1620
2021-06-03,6012,6740,-728,-10.8,1620
2021-06-04,6091,6796,-705,-10.37,1620
2021-06-05,4394,5171,-777,-15.03,1620
2021-06-06,3435,4197,-762,-18.16,1620
2021-06-07,5837,6718,-881,-13.11,1620
2021-06-08,6012,6780,-768,-11.33,1620
2021-06-09,6012,6794,-782,-11.51,1620
2021-06-10,6012,6811,-799,-11.73,1620
2021-06-11,6091,6871,-780,-11.35,1620
2021-06-12,4394,5248,-854,-16.27,1620
2021-06-13,3435,4272,-837,-19.59,1620
2021-06-14,5837,6790,-953,-14.04,1620
2021-06-15,6012,6844,-832,-12.16,1620
2021-06-16,6012,6848,-836,-12.21,1620
2021-06-17,6012,6852,-840,-12.26,1620
2021-06-18,6091,6895,-804,-11.66,1620
2021-06-19,4394,5252,-858,-16.34,1620
2021-06-20,3435,4255,-820,-19.27,1620
2021-06-21,5837,6748,-911,-13.5,1620
2021-06-22,6012,6777,-765,-11.29,1620
2021-06-23,6012,6752,-740,-10.96,1620
2021-06-24,6012,6728,-716,-10.64,1620
2021-06-25,6091,6742,-651,-9.66,1620
2021-06-26,4394,5071,-677,-13.35,1620
2021-06-27,3435,4046,-611,-15.1,1620
2021-06-28,5837,6513,-676,-10.38,1620
2021-06-29,6012,6517,-505,-7.75,1620
2021-06-30,6012,6471,-459,-7.09,1620
2021-07-01,4933,6428,-1495,-23.26,1620
2021-07-02,5266,6428,-1162,-18.08,1620
2021-07-03,3692,4746,-1054,-22.21,1620
2021-07-04,2988,3715,-727,-19.57,1620
2021-07-05,4785,6180,-1395,-22.57,1620
2021-07-06,4933,6187,-1254,-20.27,1620
2021-07-07,4933,6149,-1216,-19.78,1620
2021-07-08,4933,6118,-1185,-19.37,1620
2021-07-09,5266,6134,-868,-14.15,1620
2021-07-10,3692,4472,-780,-17.44,1620
2021-07-11,2988,3465,-477,-13.77,1620
2021-07-12,4785,5957,-1172,-19.67,1620
2021-07-13,4933,5994,-1061,-17.7,1620
2021-07-14,4933,5987,-1054,-17.6,1620
2021-07-15,4933,5988,-1055,-17.62,1620
2021-07-16,5266,6037,-771,-12.77,1620
2021-07-17,3692,4408,-716,-16.24,1620
2021-07-18,2988,3433,-445,-12.96,1620
2021-07-19,4785,5955,-1170,-19.65,1620
2021-07-20,4933,6019,-1086,-18.04,1620
2021-07-21,4933,6037,-1104,-18.29,1620
2021-07-22,4933,6060,-1127,-18.6,1620
2021-07-23,5266,6126,-860,-14.04,1620
2021-07-24,3692,4511,-819,-18.16,1620
2021-07-25,2988,3545,-557,-15.71,1620
2021-07-26,4785,6072,-1287,-21.2,1620
2021-07-27,4933,6137,-1204,-19.62,1620
2021-07-28,4933,6151,-1218,-19.8,1620
2021-07-29,4933,6167,-1234,-20.01,1620
2021-07-30,5266,6222,-956,-15.36,1620
2021-07-31,3692,4593,-901,-19.62,1620
2021-08-01,2752,3610,-858,-23.77,1620
2021-08-02,4586,6118,-1532,-25.04,1620
2021-08-03,4622,6163,-1541,-25.0,1620
2021-08-04,4622,6157,-1535,-24.93,1620
2021-08-05,4622,6153,-1531,-24.88,1620
2021-08-06,4736,6189,-1453,-23.48,1620
2021-08-07,3490,4541,-1051,-23.14,1620
2021-08-08,2752,3542,-790,-22.3,1620
2021-08-09,4586,6037,-1451,-24.04,1620
2021-08-10,4622,6072,-1450,-23.88,1620
2021-08-11,4622,6060,-1438,-23.73,1620
2021-08-12,4622,6052,-1430,-23.63,1620
2021-08-13,4736,6090,-1354,-22.23,1620
2021-08-14,3490,4449,-959,-21.56,1620
2021-08-15,2752,3461,-709,-20.49,1620
2021-08-16,4586,5971,-1385,-23.2,1620
2021-08-17,4622,6024,-1402,-23.27,1620
2021-08-18,4622,6034,-1412,-23.4,1620
2021-08-19,4622,6053,-1431,-23.64,1620
2021-08-20,4736,6119,-1383,-22.6,1620
2021-08-21,3490,4508,-1018,-22.58,1620
2021-08-22,2752,3552,-800,-22.52,1620
2021-08-23,4586,6095,-1509,-24.76,1620
2021-08-24,4622,6181,-1559,-25.22,1620
2021-08-25,4622,6224,-1602,-25.74,1620
2021-08-26,4622,6273,-1651,-26.32,1620
2021-08-27,4736,6369,-1633,-25.64,1620
2021-08-28,3490,4784,-1294,-27.05,1620
2021-08-29,2752,3851,-1099,-28.54,1620
2021-08-30,4586,6414,-1828,-28.5,1620
2021-08-31,4622,6516,-1894,-29.07,1620
2021-09-01,5694,6569,-875,-13.32,1620
2021-09-02,5694,6626,-932,-14.07,1620
2021-09-03,5893,6723,-830,-12.35,1620
2021-09-04,4243,5136,-893,-17.39,1620
2021-09-05,3386,4196,-810,-19.3,1620
2021-09-06,5591,6747,-1156,-17.13,1620
2021-09-07,5694,6834,-1140,-16.68,1620
2021-09-08,5694,6868,-1174,-17.09,1620
2021-09-09,5694,6902,-1208,-17.5,1620
2021-09-10,5893,6975,-1082,-15.51,1620
2021-09-11,4243,5362,-1119,-20.87,1620
2021-09-12,3386,4394,-1008,-22.94,1620
2021-09-13,5591,6916,-1325,-19.16,1620
2021-09-14,5694,6974,-1280,-18.35,1620
2021-09-15,5694,6980,-1286,-18.42,1620
2021-09-16,5694,6986,-1292,-18.49,1620
2021-09-17,5893,7033,-1140,-16.21,1620
2021-09-18,4243,5396,-1153,-21.37,1620
2021-09-19,3386,4406,-1020,-23.15,1620
2021-09-20,5591,6910,-1319,-19.09,1620
2021-09-21,5694,6952,-1258,-18.1,1620
2021-09-22,5694,6945,-1251,-18.01,1620
2021-09-23,5694,6942,-1248,-17.98,1620
2021-09-24,5893,6982,-1089,-15.6,1620
2021-09-25,4243,5341,-1098,-20.56,1620
2021-09-26,3386,4350,-964,-22.16,1620
2021-09-27,5591,6856,-1265,-18.45,1620
2021-09-28,5694,6902,-1208,-17.5,1620
2021-09-29,5694,6901,-1207,-17.49,1620
2021-09-30,5694,6905,-1211,-17.54,1620
2021-10-01,5877,6954,-1077,-15.49,1620
2021-10-02,4172,5322,-1150,-21.61,1620
2021-10-03,3206,4341,-1135,-26.15,1620
2021-10-04,5400,6855,-1455,-21.23,1620
2021-10-05,5539,6910,-1371,-19.84,1620
2021-10-06,5539,6918,-1379,-19.93,1620
2021-10-07,5539,6929,-1390,-20.06,1620
2021-10-08,5877,6983,-1106,-15.84,1620
2021-10-09,4172,5355,-1183,-22.09,1620
2021-10-10,3206,4376,-1170,-26.74,1620
2021-10-11,5400,6891,-1491,-21.64,1620
2021-10-12,5539,6945,-1406,-20.24,1620
2021-10-13,5539,6950,-1411,-20.3,1620
2021-10-14,5539,6957,-1418,-20.38,1620
2021-10-15,5877,7006,-1129,-16.11,1620
2021-10-16,4172,5372,-1200,-22.34,1620
2021-10-17,3206,4386,-1180,-26.9,1620
2021-10-18,5400,6893,-1493,-21.66,1620
2021-10-19,5539,6939,-1400,-20.18,1620
2021-10-20,5539,6936,-1397,-20.14,1620
2021-10-21,5539,6936,-1397,-20.14,1620
2021-10-22,5877,6978,-1101,-15.78,1620
2021-10-23,4172,5338,-1166,-21.84,1620
2021-10-24,3206,4347,-1141,-26.25,1620
2021-10-25,5400,6851,-1451,-21.18,1620
2021-10-26,5539,6894,-1355,-19.65,1620
2021-10-27,5539,6890,-1351,-19.61,1620
2021-10-28,5539,6890,-1351,-19.61,1620
2021-10-29,5877,6934,-1057,-15.24,1620
2021-10-30,4172,5298,-1126,-21.25,1620
2021-10-31,3206,4311,-1105,-25.63,1620
2021-11-01,5171,6820,-1649,-24.18,1620
2021-11-02,5496,6870,-1374,-20.0,1620
2021-11-03,5496,6873,-1377,-20.03,1620
2021-11-04,5496,6880,-1384,-20.12,1620
2021-11-05,5818,6931,-1113,-16.06,1620
2021-11-06,4095,5301,-1206,-22.75,1620
2021-11-07,3012,4320,-1308,-30.28,1620
2021-11-08,5171,6835,-1664,-24.35,1620
2021-11-09,5496,6889,-1393,-20.22,1620
2021-11-10,5496,6895,-1399,-20.29,1620
2021-11-11,5496,6904,-1408,-20.39,1620
2021-11-12,5818,6955,-1137,-16.35,1620
2021-11-13,4095,5324,-1229,-23.08,1620
2021-11-14,3012,4341,-1329,-30.62,1620
2021-11-15,5171,6851,-1680,-24.52,1620
2021-11-16,5496,6900,-1404,-20.35,1620
2021-11-17,5496,6898,-1402,-20.32,1620
2021-11-18,5496,6899,-1403,-20.34,1620
2021-11-19,5818,6942,-1124,-16.19,1620
2021-11-20,4095,5301,-1206,-22.75,1620
2021-11-21,3012,4308,-1296,-30.08,1620
2021-11-22,5171,6809,-1638,-24.06,1620
2021-11-23,5496,6848,-1352,-19.74,1620
2021-11-24,5496,6838,-1342,-19.63,1620
2021-11-25,5496,6831,-1335,-19.54,1620
2021-11-26,5818,6867,-1049,-15.28,1620
2021-11-27,4095,5221,-1126,-21.57,1620
2021-11-28,3012,4224,-1212,-28.69,1620
2021-11-29,5171,6722,-1551,-23.07,1620
2021-11-30,5496,6760,-1264,-18.7,1620
2021-12-01,5114,6751,-1637,-24.25,1620
2021-12-02,5114,6747,-1633,-24.2,1620
2021-12-03,4977,6787,-1810,-26.67,1620
2021-12-04,3769,5146,-1377,-26.76,1620
2021-12-05,2696,4156,-1460,-35.13,1620
2021-12-06,5216,6662,-1446,-21.71,1620
2021-12-07,5114,6709,-1595,-23.77,1620
2021-12-08,5114,6709,-1595,-23.77,1620
2021-12-09,5114,6713,-1599,-23.82,1620
2021-12-10,4977,6762,-1785,-26.4,1620
2021-12-11,3769,5129,-1360,-26.52,1620
2021-12-12,2696,4147,-1451,-34.99,1620
2021-12-13,5216,6659,-1443,-21.67,1620
2021-12-14,5114,6711,-1597,-23.8,1620
2021-12-15,5114,6714,-1600,-23.83,1620
2021-12-16,5114,6720,-1606,-23.9,1620
2021-12-17,4977,6768,-1791,-26.46,1620
2021-12-18,3769,5133,-1364,-26.57,1620
2021-12-19,2696,4145,-1449,-34.96,1620
2021-12-20,5216,6651,-1435,-21.58,1620
2021-12-21,5114,6694,-1580,-23.6,1620
2021-12-22,5114,6686,-1572,-23.51,1620
2021-12-23,5114,6680,-1566,-23.44,1620
2021-12-24,4977,6715,-1738,-25.88,1620
2021-12-25,3769,5066,-1297,-25.6,1620
2021-12-26,2696,4065,-1369,-33.68,1620
2021-12-27,5216,6556,-1340,-20.44,1620
2021-12-28,5114,6585,-1471,-22.34,1620
2021-12-29,5114,6564,-1450,-22.09,1620
2021-12-30,5114,6546,-1432,-21.88,1620
2021-12-31,4977,6570,-1593,-24.25,1620
2022-01-01,3679,4911,-1232,-25.09,1620
2022-01-02,2590,3903,-1313,-33.64,1620
2022-01-03,4898,6389,-1491,-23.34,1620
2022-01-04,4993,6415,-1422,-22.17,1620
2022-01-05,4993,6395,-1402,-21.92,1620
2022-01-06,4993,6379,-1386,-21.73,1620
2022-01-07,5204,6409,-1205,-18.8,1620
2022-01-08,3679,4758,-1079,-22.68,1620
2022-01-09,2590,3760,-1170,-31.12,1620
2022-01-10,4898,6258,-1360,-21.73,1620
2022-01-11,4993,6299,-1306,-20.73,1620
2022-01-12,4993,6294,-1301,-20.67,1620
2022-01-13,4993,6295,-1302,-20.68,1620
2022-01-14,5204,6343,-1139,-17.96,1620
2022-01-15,3679,4710,-1031,-21.89,1620
2022-01-16,2590,3729,-1139,-30.54,1620
2022-01-17,4898,6245,-1347,-21.57,1620
2022-01-18,4993,6302,-1309,-20.77,1620
2022-01-19,4993,6312,-1319,-20.9,1620
2022-01-20,4993,6327,-1334,-21.08,1620
2022-01-21,5204,6385,-1181,-18.5,1620
2022-01-22,3679,4762,-1083,-22.74,1620
2022-01-23,2590,3788,-1198,-31.63,1620
2022-01-24,4898,6307,-1409,-22.34,1620
2022-01-25,4993,6366,-1373,-21.57,1620
2022-01-26,4993,6376,-1383,-21.69,1620
2022-01-27,4993,6387,-1394,-21.83,1620
2022-01-28,5204,6440,-1236,-19.19,1620
2022-01-29,3679,4810,-1131,-23.51,1620
2022-01-30,2590,3827,-1237,-32.32,1620
