ds,traffic_real,traffic_forecast_without_corona,delta,delta_percent,znr
2020-02-01,595,645,-50,-7.75,1131
2020-02-02,362,291,71,24.4,1131
2020-02-03,1196,1158,38,3.28,1131
2020-02-04,1217,1202,15,1.25,1131
2020-02-05,1217,1200,17,1.42,1131
2020-02-06,1217,1200,17,1.42,1131
2020-02-07,1166,1187,-21,-1.77,1131
2020-02-08,595,638,-43,-6.74,1131
2020-02-09,362,282,80,28.37,1131
2020-02-10,1196,1149,47,4.09,1131
2020-02-11,1217,1192,25,2.1,1131
2020-02-12,1217,1192,25,2.1,1131
2020-02-13,1217,1194,23,1.93,1131
2020-02-14,1166,1184,-18,-1.52,1131
2020-02-15,595,640,-45,-7.03,1131
2020-02-16,362,289,73,25.26,1131
2020-02-17,1196,1161,35,3.01,1131
2020-02-18,1217,1210,7,0.58,1131
2020-02-19,1217,1217,0,0.0,1131
2020-02-20,1217,1225,-8,-0.65,1131
2020-02-21,1166,1222,-56,-4.58,1131
2020-02-22,595,685,-90,-13.14,1131
2020-02-23,362,340,22,6.47,1131
2020-02-24,1196,1219,-23,-1.89,1131
2020-02-25,1217,1274,-57,-4.47,1131
2020-02-26,1217,1286,-69,-5.37,1131
2020-02-27,1217,1299,-82,-6.31,1131
2020-02-28,1166,1300,-134,-10.31,1131
2020-02-29,595,765,-170,-22.22,1131
2020-03-01,204,422,-218,-51.66,1131
2020-03-02,766,1301,-535,-41.12,1131
2020-03-03,773,1357,-584,-43.04,1131
2020-03-04,773,1367,-594,-43.45,1131
2020-03-05,773,1379,-606,-43.94,1131
2020-03-06,714,1376,-662,-48.11,1131
2020-03-07,309,838,-529,-63.13,1131
2020-03-08,204,491,-287,-58.45,1131
2020-03-09,766,1366,-600,-43.92,1131
2020-03-10,773,1416,-643,-45.41,1131
2020-03-11,773,1422,-649,-45.64,1131
2020-03-12,773,1428,-655,-45.87,1131
2020-03-13,714,1420,-706,-49.72,1131
2020-03-14,309,877,-568,-64.77,1131
2020-03-15,204,526,-322,-61.22,1131
2020-03-16,766,1396,-630,-45.13,1131
2020-03-17,773,1443,-670,-46.43,1131
2020-03-18,773,1445,-672,-46.51,1131
2020-03-19,773,1449,-676,-46.65,1131
2020-03-20,714,1440,-726,-50.42,1131
2020-03-21,309,896,-587,-65.51,1131
2020-03-22,204,544,-340,-62.5,1131
2020-03-23,766,1415,-649,-45.87,1131
2020-03-24,773,1463,-690,-47.16,1131
2020-03-25,773,1467,-694,-47.31,1131
2020-03-26,773,1473,-700,-47.52,1131
2020-03-27,714,1466,-752,-51.3,1131
2020-03-28,309,924,-615,-66.56,1131
2020-03-29,204,575,-371,-64.52,1131
2020-03-30,766,1449,-683,-47.14,1131
2020-03-31,773,1500,-727,-48.47,1131
2020-04-01,583,1506,-923,-61.29,1131
2020-04-02,583,1514,-931,-61.49,1131
2020-04-03,458,1509,-1051,-69.65,1131
2020-04-04,162,969,-807,-83.28,1131
2020-04-05,65,622,-557,-89.55,1131
2020-04-06,591,1496,-905,-60.49,1131
2020-04-07,583,1547,-964,-62.31,1131
2020-04-08,583,1553,-970,-62.46,1131
2020-04-09,583,1561,-978,-62.65,1131
2020-04-10,458,1555,-1097,-70.55,1131
2020-04-11,162,1014,-852,-84.02,1131
2020-04-12,65,665,-600,-90.23,1131
2020-04-13,591,1537,-946,-61.55,1131
2020-04-14,583,1586,-1003,-63.24,1131
2020-04-15,583,1590,-1007,-63.33,1131
2020-04-16,583,1596,-1013,-63.47,1131
2020-04-17,458,1588,-1130,-71.16,1131
2020-04-18,162,1045,-883,-84.5,1131
2020-04-19,65,695,-630,-90.65,1131
2020-04-20,591,1566,-975,-62.26,1131
2020-04-21,583,1615,-1032,-63.9,1131
2020-04-22,583,1619,-1036,-63.99,1131
2020-04-23,583,1625,-1042,-64.12,1131
2020-04-24,458,1619,-1161,-71.71,1131
2020-04-25,162,1077,-915,-84.96,1131
2020-04-26,65,729,-664,-91.08,1131
2020-04-27,591,1603,-1012,-63.13,1131
2020-04-28,583,1654,-1071,-64.75,1131
2020-04-29,583,1661,-1078,-64.9,1131
2020-04-30,583,1670,-1087,-65.09,1131
2020-05-01,712,1666,-954,-57.26,1131
2020-05-02,262,1128,-866,-76.77,1131
2020-05-03,116,782,-666,-85.17,1131
2020-05-04,818,1658,-840,-50.66,1131
2020-05-05,832,1712,-880,-51.4,1131
2020-05-06,832,1720,-888,-51.63,1131
2020-05-07,832,1731,-899,-51.94,1131
2020-05-08,712,1727,-1015,-58.77,1131
2020-05-09,262,1189,-927,-77.96,1131
2020-05-10,116,842,-726,-86.22,1131
2020-05-11,818,1717,-899,-52.36,1131
2020-05-12,832,1768,-936,-52.94,1131
2020-05-13,832,1773,-941,-53.07,1131
2020-05-14,832,1780,-948,-53.26,1131
2020-05-15,712,1772,-1060,-59.82,1131
2020-05-16,262,1229,-967,-78.68,1131
2020-05-17,116,877,-761,-86.77,1131
2020-05-18,818,1746,-928,-53.15,1131
2020-05-19,832,1791,-959,-53.55,1131
2020-05-20,832,1791,-959,-53.55,1131
2020-05-21,832,1792,-960,-53.57,1131
2020-05-22,712,1779,-1067,-59.98,1131
2020-05-23,262,1231,-969,-78.72,1131
2020-05-24,116,874,-758,-86.73,1131
2020-05-25,818,1740,-922,-52.99,1131
2020-05-26,832,1782,-950,-53.31,1131
2020-05-27,832,1779,-947,-53.23,1131
2020-05-28,832,1778,-946,-53.21,1131
2020-05-29,712,1764,-1052,-59.64,1131
2020-05-30,262,1216,-954,-78.45,1131
2020-05-31,116,860,-744,-86.51,1131
2020-06-01,946,1726,-780,-45.19,1131
2020-06-02,950,1770,-820,-46.33,1131
2020-06-03,950,1770,-820,-46.33,1131
2020-06-04,950,1772,-822,-46.39,1131
2020-06-05,801,1762,-961,-54.54,1131
2020-06-06,317,1217,-900,-73.95,1131
2020-06-07,149,865,-716,-82.77,1131
2020-06-08,946,1735,-789,-45.48,1131
2020-06-09,950,1783,-833,-46.72,1131
2020-06-10,950,1786,-836,-46.81,1131
2020-06-11,950,1790,-840,-46.93,1131
2020-06-12,801,1782,-981,-55.05,1131
2020-06-13,317,1238,-921,-74.39,1131
2020-06-14,149,886,-737,-83.18,1131
2020-06-15,946,1756,-810,-46.13,1131
2020-06-16,950,1802,-852,-47.28,1131
2020-06-17,950,1803,-853,-47.31,1131
2020-06-18,950,1804,-854,-47.34,1131
2020-06-19,801,1792,-991,-55.3,1131
2020-06-20,317,1243,-926,-74.5,1131
2020-06-21,149,885,-736,-83.16,1131
2020-06-22,946,1749,-803,-45.91,1131
2020-06-23,950,1788,-838,-46.87,1131
2020-06-24,950,1782,-832,-46.69,1131
2020-06-25,950,1776,-826,-46.51,1131
2020-06-26,801,1756,-955,-54.38,1131
2020-06-27,317,1200,-883,-73.58,1131
2020-06-28,149,836,-687,-82.18,1131
2020-06-29,946,1693,-747,-44.12,1131
2020-06-30,950,1727,-777,-44.99,1131
2020-07-01,961,1715,-754,-43.97,1131
2020-07-02,961,1706,-745,-43.67,1131
2020-07-03,851,1683,-832,-49.44,1131
2020-07-04,303,1125,-822,-73.07,1131
2020-07-05,176,761,-585,-76.87,1131
2020-07-06,920,1618,-698,-43.14,1131
2020-07-07,961,1654,-693,-41.9,1131
2020-07-08,961,1645,-684,-41.58,1131
2020-07-09,961,1639,-678,-41.37,1131
2020-07-10,851,1621,-770,-47.5,1131
2020-07-11,303,1069,-766,-71.66,1131
2020-07-12,176,711,-535,-75.25,1131
2020-07-13,920,1575,-655,-41.59,1131
2020-07-14,961,1618,-657,-40.61,1131
2020-07-15,961,1617,-656,-40.57,1131
2020-07-16,961,1618,-657,-40.61,1131
2020-07-17,851,1607,-756,-47.04,1131
2020-07-18,303,1062,-759,-71.47,1131
2020-07-19,176,710,-534,-75.21,1131
2020-07-20,920,1580,-660,-41.77,1131
2020-07-21,961,1627,-666,-40.93,1131
2020-07-22,961,1630,-669,-41.04,1131
2020-07-23,961,1635,-674,-41.22,1131
2020-07-24,851,1626,-775,-47.66,1131
2020-07-25,303,1081,-778,-71.97,1131
2020-07-26,176,729,-553,-75.86,1131
2020-07-27,920,1598,-678,-42.43,1131
2020-07-28,961,1643,-682,-41.51,1131
2020-07-29,961,1643,-682,-41.51,1131
2020-07-30,961,1643,-682,-41.51,1131
2020-07-31,851,1630,-779,-47.79,1131
2020-08-01,358,1081,-723,-66.88,1131
2020-08-02,212,723,-511,-70.68,1131
2020-08-03,914,1587,-673,-42.41,1131
2020-08-04,977,1626,-649,-39.91,1131
2020-08-05,977,1621,-644,-39.73,1131
2020-08-06,977,1617,-640,-39.58,1131
2020-08-07,904,1600,-696,-43.5,1131
2020-08-08,358,1047,-689,-65.81,1131
2020-08-09,212,687,-475,-69.14,1131
2020-08-10,914,1549,-635,-40.99,1131
2020-08-11,977,1588,-611,-38.48,1131
2020-08-12,977,1582,-605,-38.24,1131
2020-08-13,977,1580,-603,-38.16,1131
2020-08-14,904,1565,-661,-42.24,1131
2020-08-15,358,1015,-657,-64.73,1131
2020-08-16,212,659,-447,-67.83,1131
2020-08-17,914,1526,-612,-40.1,1131
2020-08-18,977,1571,-594,-37.81,1131
2020-08-19,977,1572,-595,-37.85,1131
2020-08-20,977,1576,-599,-38.01,1131
2020-08-21,904,1568,-664,-42.35,1131
2020-08-22,358,1025,-667,-65.07,1131
2020-08-23,212,676,-464,-68.64,1131
2020-08-24,914,1550,-636,-41.03,1131
2020-08-25,977,1601,-624,-38.98,1131
2020-08-26,977,1608,-631,-39.24,1131
2020-08-27,977,1617,-640,-39.58,1131
2020-08-28,904,1613,-709,-43.96,1131
2020-08-29,358,1074,-716,-66.67,1131
2020-08-30,212,727,-515,-70.84,1131
2020-08-31,914,1603,-689,-42.98,1131
2020-09-01,1035,1654,-619,-37.42,1131
2020-09-02,1035,1661,-626,-37.69,1131
2020-09-03,1035,1668,-633,-37.95,1131
2020-09-04,941,1662,-721,-43.38,1131
2020-09-05,363,1119,-756,-67.56,1131
2020-09-06,204,769,-565,-73.47,1131
2020-09-07,965,1639,-674,-41.12,1131
2020-09-08,1035,1685,-650,-38.58,1131
2020-09-09,1035,1686,-651,-38.61,1131
2020-09-10,1035,1688,-653,-38.68,1131
2020-09-11,941,1676,-735,-43.85,1131
2020-09-12,363,1128,-765,-67.82,1131
2020-09-13,204,772,-568,-73.58,1131
2020-09-14,965,1637,-672,-41.05,1131
2020-09-15,1035,1679,-644,-38.36,1131
2020-09-16,1035,1676,-641,-38.25,1131
2020-09-17,1035,1675,-640,-38.21,1131
2020-09-18,941,1660,-719,-43.31,1131
2020-09-19,363,1111,-748,-67.33,1131
2020-09-20,204,754,-550,-72.94,1131
2020-09-21,965,1619,-654,-40.4,1131
2020-09-22,1035,1662,-627,-37.73,1131
2020-09-23,1035,1660,-625,-37.65,1131
2020-09-24,1035,1661,-626,-37.69,1131
2020-09-25,941,1649,-708,-42.94,1131
2020-09-26,363,1103,-740,-67.09,1131
2020-09-27,204,749,-545,-72.76,1131
2020-09-28,965,1618,-653,-40.36,1131
2020-09-29,1035,1664,-629,-37.8,1131
2020-09-30,1035,1666,-631,-37.88,1131
2020-10-01,990,1670,-680,-40.72,1131
2020-10-02,881,1662,-781,-46.99,1131
2020-10-03,337,1118,-781,-69.86,1131
2020-10-04,189,766,-577,-75.33,1131
2020-10-05,966,1637,-671,-40.99,1131
2020-10-06,990,1684,-694,-41.21,1131
2020-10-07,990,1686,-696,-41.28,1131
2020-10-08,990,1690,-700,-41.42,1131
2020-10-09,881,1680,-799,-47.56,1131
2020-10-10,337,1134,-797,-70.28,1131
2020-10-11,189,780,-591,-75.77,1131
2020-10-12,966,1647,-681,-41.35,1131
2020-10-13,990,1690,-700,-41.42,1131
2020-10-14,990,1687,-697,-41.32,1131
2020-10-15,990,1686,-696,-41.28,1131
2020-10-16,881,1670,-789,-47.25,1131
2020-10-17,337,1118,-781,-69.86,1131
2020-10-18,189,758,-569,-75.07,1131
2020-10-19,966,1620,-654,-40.37,1131
2020-10-20,990,1657,-667,-40.25,1131
2020-10-21,990,1649,-659,-39.96,1131
2020-10-22,990,1642,-652,-39.71,1131
2020-10-23,881,1621,-740,-45.65,1131
2020-10-24,337,1065,-728,-68.36,1131
2020-10-25,189,700,-511,-73.0,1131
2020-10-26,966,1558,-592,-38.0,1131
2020-10-27,990,1592,-602,-37.81,1131
2020-10-28,990,1581,-591,-37.38,1131
2020-10-29,990,1572,-582,-37.02,1131
2020-10-30,881,1550,-669,-43.16,1131
2020-10-31,337,993,-656,-66.06,1131
2020-11-01,132,628,-496,-78.98,1131
2020-11-02,893,1486,-593,-39.91,1131
2020-11-03,846,1520,-674,-44.34,1131
2020-11-04,846,1511,-665,-44.01,1131
2020-11-05,846,1503,-657,-43.71,1131
2020-11-06,756,1482,-726,-48.99,1131
2020-11-07,231,927,-696,-75.08,1131
2020-11-08,132,564,-432,-76.6,1131
2020-11-09,893,1424,-531,-37.29,1131
2020-11-10,846,1461,-615,-42.09,1131
2020-11-11,846,1454,-608,-41.82,1131
2020-11-12,846,1449,-603,-41.61,1131
2020-11-13,756,1432,-676,-47.21,1131
2020-11-14,231,880,-649,-73.75,1131
2020-11-15,132,521,-389,-74.66,1131
2020-11-16,893,1384,-491,-35.48,1131
2020-11-17,846,1425,-579,-40.63,1131
2020-11-18,846,1422,-576,-40.51,1131
2020-11-19,846,1421,-575,-40.46,1131
2020-11-20,756,1408,-652,-46.31,1131
2020-11-21,231,861,-630,-73.17,1131
2020-11-22,132,507,-375,-73.96,1131
2020-11-23,893,1375,-482,-35.05,1131
2020-11-24,846,1421,-575,-40.46,1131
2020-11-25,846,1424,-578,-40.59,1131
2020-11-26,846,1429,-583,-40.8,1131
2020-11-27,756,1421,-665,-46.8,1131
2020-11-28,231,880,-649,-73.75,1131
2020-11-29,132,531,-399,-75.14,1131
2020-11-30,893,1405,-512,-36.44,1131
2020-12-01,713,1456,-743,-51.03,1131
2020-12-02,713,1463,-750,-51.26,1131
2020-12-03,713,1472,-759,-51.56,1131
2020-12-04,815,1469,-654,-44.52,1131
2020-12-05,281,930,-649,-69.78,1131
2020-12-06,128,583,-455,-78.04,1131
2020-12-07,726,1458,-732,-50.21,1131
2020-12-08,713,1510,-797,-52.78,1131
2020-12-09,713,1516,-803,-52.97,1131
2020-12-10,713,1522,-809,-53.15,1131
2020-12-11,815,1515,-700,-46.2,1131
2020-12-12,281,971,-690,-71.06,1131
2020-12-13,128,619,-491,-79.32,1131
2020-12-14,726,1487,-761,-51.18,1131
2020-12-15,713,1529,-816,-53.37,1131
2020-12-16,713,1526,-813,-53.28,1131
2020-12-17,713,1522,-809,-53.15,1131
2020-12-18,815,1504,-689,-45.81,1131
2020-12-19,281,948,-667,-70.36,1131
2020-12-20,128,583,-455,-78.04,1131
2020-12-21,726,1438,-712,-49.51,1131
2020-12-22,713,1468,-755,-51.43,1131
2020-12-23,713,1452,-739,-50.9,1131
2020-12-24,713,1436,-723,-50.35,1131
2020-12-25,815,1406,-591,-42.03,1131
2020-12-26,281,839,-558,-66.51,1131
2020-12-27,128,464,-336,-72.41,1131
2020-12-28,726,1310,-584,-44.58,1131
2020-12-29,713,1333,-620,-46.51,1131
2020-12-30,713,1310,-597,-45.57,1131
2020-12-31,713,1290,-577,-44.73,1131
2021-01-01,618,1256,-638,-50.8,1131
2021-01-02,217,689,-472,-68.51,1131
2021-01-03,117,314,-197,-62.74,1131
2021-01-04,674,1162,-488,-42.0,1131
2021-01-05,716,1188,-472,-39.73,1131
2021-01-06,716,1172,-456,-38.91,1131
2021-01-07,716,1158,-442,-38.17,1131
2021-01-08,618,1133,-515,-45.45,1131
2021-01-09,217,575,-358,-62.26,1131
2021-01-10,117,210,-93,-44.29,1131
2021-01-11,674,1070,-396,-37.01,1131
2021-01-12,716,1108,-392,-35.38,1131
2021-01-13,716,1104,-388,-35.14,1131
2021-01-14,716,1102,-386,-35.03,1131
2021-01-15,618,1089,-471,-43.25,1131
2021-01-16,217,542,-325,-59.96,1131
2021-01-17,117,189,-72,-38.1,1131
2021-01-18,674,1059,-385,-36.36,1131
2021-01-19,716,1107,-391,-35.32,1131
2021-01-20,716,1110,-394,-35.5,1131
2021-01-21,716,1116,-400,-35.84,1131
2021-01-22,618,1109,-491,-44.27,1131
2021-01-23,217,567,-350,-61.73,1131
2021-01-24,117,217,-100,-46.08,1131
2021-01-25,674,1089,-415,-38.11,1131
2021-01-26,716,1137,-421,-37.03,1131
2021-01-27,716,1140,-424,-37.19,1131
2021-01-28,716,1144,-428,-37.41,1131
2021-01-29,618,1135,-517,-45.55,1131
2021-01-30,217,590,-373,-63.22,1131
2021-01-31,117,236,-119,-50.42,1131
2021-02-01,811,1104,-293,-26.54,1131
2021-02-02,825,1148,-323,-28.14,1131
2021-02-03,825,1147,-322,-28.07,1131
2021-02-04,825,1147,-322,-28.07,1131
2021-02-05,758,1134,-376,-33.16,1131
2021-02-06,268,586,-318,-54.27,1131
2021-02-07,128,230,-102,-44.35,1131
2021-02-08,811,1096,-285,-26.0,1131
2021-02-09,825,1139,-314,-27.57,1131
2021-02-10,825,1138,-313,-27.5,1131
2021-02-11,825,1139,-314,-27.57,1131
2021-02-12,758,1128,-370,-32.8,1131
2021-02-13,268,582,-314,-53.95,1131
2021-02-14,128,230,-102,-44.35,1131
2021-02-15,811,1101,-290,-26.34,1131
2021-02-16,825,1149,-324,-28.2,1131
2021-02-17,825,1154,-329,-28.51,1131
2021-02-18,825,1162,-337,-29.0,1131
2021-02-19,758,1157,-399,-34.49,1131
2021-02-20,268,619,-351,-56.7,1131
2021-02-21,128,273,-145,-53.11,1131
2021-02-22,811,1151,-340,-29.54,1131
2021-02-23,825,1206,-381,-31.59,1131
2021-02-24,825,1217,-392,-32.21,1131
2021-02-25,825,1230,-405,-32.93,1131
2021-02-26,758,1230,-472,-38.37,1131
2021-02-27,268,695,-427,-61.44,1131
2021-02-28,128,353,-225,-63.74,1131
2021-03-01,854,1232,-378,-30.68,1131
2021-03-02,884,1288,-404,-31.37,1131
2021-03-03,884,1299,-415,-31.95,1131
2021-03-04,884,1312,-428,-32.62,1131
2021-03-05,854,1310,-456,-34.81,1131
2021-03-06,299,773,-474,-61.32,1131
2021-03-07,123,427,-304,-71.19,1131
2021-03-08,854,1302,-448,-34.41,1131
2021-03-09,884,1354,-470,-34.71,1131
2021-03-10,884,1360,-476,-35.0,1131
2021-03-11,884,1367,-483,-35.33,1131
2021-03-12,854,1360,-506,-37.21,1131
2021-03-13,299,818,-519,-63.45,1131
2021-03-14,123,467,-344,-73.66,1131
2021-03-15,854,1338,-484,-36.17,1131
2021-03-16,884,1385,-501,-36.17,1131
2021-03-17,884,1388,-504,-36.31,1131
2021-03-18,884,1392,-508,-36.49,1131
2021-03-19,854,1382,-528,-38.21,1131
2021-03-20,299,838,-539,-64.32,1131
2021-03-21,123,486,-363,-74.69,1131
2021-03-22,854,1356,-502,-37.02,1131
2021-03-23,884,1404,-520,-37.04,1131
2021-03-24,884,1407,-523,-37.17,1131
2021-03-25,884,1412,-528,-37.39,1131
2021-03-26,854,1405,-551,-39.22,1131
2021-03-27,299,863,-564,-65.35,1131
2021-03-28,123,514,-391,-76.07,1131
2021-03-29,854,1387,-533,-38.43,1131
2021-03-30,884,1437,-553,-38.48,1131
2021-03-31,884,1443,-559,-38.74,1131
2021-04-01,859,1451,-592,-40.8,1131
2021-04-02,742,1446,-704,-48.69,1131
2021-04-03,246,906,-660,-72.85,1131
2021-04-04,114,559,-445,-79.61,1131
2021-04-05,878,1433,-555,-38.73,1131
2021-04-06,859,1484,-625,-42.12,1131
2021-04-07,859,1491,-632,-42.39,1131
2021-04-08,859,1499,-640,-42.7,1131
2021-04-09,742,1493,-751,-50.3,1131
2021-04-10,246,952,-706,-74.16,1131
2021-04-11,114,603,-489,-81.09,1131
2021-04-12,878,1476,-598,-40.51,1131
2021-04-13,859,1526,-667,-43.71,1131
2021-04-14,859,1530,-671,-43.86,1131
2021-04-15,859,1536,-677,-44.08,1131
2021-04-16,742,1528,-786,-51.44,1131
2021-04-17,246,986,-740,-75.05,1131
2021-04-18,114,635,-521,-82.05,1131
2021-04-19,878,1507,-629,-41.74,1131
2021-04-20,859,1555,-696,-44.76,1131
2021-04-21,859,1559,-700,-44.9,1131
2021-04-22,859,1565,-706,-45.11,1131
2021-04-23,742,1558,-816,-52.37,1131
2021-04-24,246,1016,-770,-75.79,1131
2021-04-25,114,667,-553,-82.91,1131
2021-04-26,878,1540,-662,-42.99,1131
2021-04-27,859,1591,-732,-46.01,1131
2021-04-28,859,1597,-738,-46.21,1131
2021-04-29,859,1606,-747,-46.51,1131
2021-04-30,742,1602,-860,-53.68,1131
2021-05-01,305,1063,-758,-71.31,1131
2021-05-02,148,717,-569,-79.36,1131
2021-05-03,1098,1593,-495,-31.07,1131
2021-05-04,1143,1646,-503,-30.56,1131
2021-05-05,1143,1655,-512,-30.94,1131
2021-05-06,1143,1665,-522,-31.35,1131
2021-05-07,953,1662,-709,-42.66,1131
2021-05-08,305,1124,-819,-72.86,1131
2021-05-09,148,778,-630,-80.98,1131
2021-05-10,1098,1653,-555,-33.58,1131
2021-05-11,1143,1705,-562,-32.96,1131
2021-05-12,1143,1711,-568,-33.2,1131
2021-05-13,1143,1719,-576,-33.51,1131
2021-05-14,953,1712,-759,-44.33,1131
2021-05-15,305,1170,-865,-73.93,1131
2021-05-16,148,819,-671,-81.93,1131
2021-05-17,1098,1689,-591,-34.99,1131
2021-05-18,1143,1736,-593,-34.16,1131
2021-05-19,1143,1736,-593,-34.16,1131
2021-05-20,1143,1738,-595,-34.23,1131
2021-05-21,953,1726,-773,-44.79,1131
2021-05-22,305,1178,-873,-74.11,1131
2021-05-23,148,822,-674,-82.0,1131
2021-05-24,1098,1688,-590,-34.95,1131
2021-05-25,1143,1730,-587,-33.93,1131
2021-05-26,1143,1727,-584,-33.82,1131
2021-05-27,1143,1726,-583,-33.78,1131
2021-05-28,953,1712,-759,-44.33,1131
2021-05-29,305,1163,-858,-73.77,1131
2021-05-30,148,807,-659,-81.66,1131
2021-05-31,1098,1673,-575,-34.37,1131
2021-06-01,1191,1716,-525,-30.59,1131
2021-06-02,1191,1715,-524,-30.55,1131
2021-06-03,1191,1717,-526,-30.63,1131
2021-06-04,1014,1706,-692,-40.56,1131
2021-06-05,381,1160,-779,-67.16,1131
2021-06-06,190,807,-617,-76.46,1131
2021-06-07,1196,1677,-481,-28.68,1131
2021-06-08,1191,1724,-533,-30.92,1131
2021-06-09,1191,1727,-536,-31.04,1131
2021-06-10,1191,1732,-541,-31.24,1131
2021-06-11,1014,1723,-709,-41.15,1131
2021-06-12,381,1180,-799,-67.71,1131
2021-06-13,190,828,-638,-77.05,1131
2021-06-14,1196,1699,-503,-29.61,1131
2021-06-15,1191,1745,-554,-31.75,1131
2021-06-16,1191,1747,-556,-31.83,1131
2021-06-17,1191,1749,-558,-31.9,1131
2021-06-18,1014,1738,-724,-41.66,1131
2021-06-19,381,1190,-809,-67.98,1131
2021-06-20,190,834,-644,-77.22,1131
2021-06-21,1196,1699,-503,-29.61,1131
2021-06-22,1191,1740,-549,-31.55,1131
2021-06-23,1191,1735,-544,-31.35,1131
2021-06-24,1191,1730,-539,-31.16,1131
2021-06-25,1014,1711,-697,-40.74,1131
2021-06-26,381,1157,-776,-67.07,1131
2021-06-27,190,793,-603,-76.04,1131
2021-06-28,1196,1651,-455,-27.56,1131
2021-06-29,1191,1685,-494,-29.32,1131
2021-06-30,1191,1674,-483,-28.85,1131
2021-07-01,1129,1665,-536,-32.19,1131
2021-07-02,955,1642,-687,-41.84,1131
2021-07-03,348,1084,-736,-67.9,1131
2021-07-04,186,719,-533,-74.13,1131
2021-07-05,1071,1576,-505,-32.04,1131
2021-07-06,1129,1610,-481,-29.88,1131
2021-07-07,1129,1601,-472,-29.48,1131
2021-07-08,1129,1594,-465,-29.17,1131
2021-07-09,955,1575,-620,-39.37,1131
2021-07-10,348,1021,-673,-65.92,1131
2021-07-11,186,661,-475,-71.86,1131
2021-07-12,1071,1525,-454,-29.77,1131
2021-07-13,1129,1566,-437,-27.91,1131
2021-07-14,1129,1563,-434,-27.77,1131
2021-07-15,1129,1564,-435,-27.81,1131
2021-07-16,955,1552,-597,-38.47,1131
2021-07-17,348,1006,-658,-65.41,1131
2021-07-18,186,653,-467,-71.52,1131
2021-07-19,1071,1522,-451,-29.63,1131
2021-07-20,1129,1569,-440,-28.04,1131
2021-07-21,1129,1572,-443,-28.18,1131
2021-07-22,1129,1576,-447,-28.36,1131
2021-07-23,955,1568,-613,-39.09,1131
2021-07-24,348,1024,-676,-66.02,1131
2021-07-25,186,672,-486,-72.32,1131
2021-07-26,1071,1541,-470,-30.5,1131
2021-07-27,1129,1587,-458,-28.86,1131
2021-07-28,1129,1588,-459,-28.9,1131
2021-07-29,1129,1589,-460,-28.95,1131
2021-07-30,955,1577,-622,-39.44,1131
2021-07-31,348,1029,-681,-66.18,1131
2021-08-01,245,672,-427,-63.54,1131
2021-08-02,1066,1537,-471,-30.64,1131
2021-08-03,1106,1577,-471,-29.87,1131
2021-08-04,1106,1573,-467,-29.69,1131
2021-08-05,1106,1569,-463,-29.51,1131
2021-08-06,905,1552,-647,-41.69,1131
2021-08-07,418,1000,-582,-58.2,1131
2021-08-08,245,639,-394,-61.66,1131
2021-08-09,1066,1501,-435,-28.98,1131
2021-08-10,1106,1540,-434,-28.18,1131
2021-08-11,1106,1534,-428,-27.9,1131
2021-08-12,1106,1530,-424,-27.71,1131
2021-08-13,905,1514,-609,-40.22,1131
2021-08-14,418,964,-546,-56.64,1131
2021-08-15,245,607,-362,-59.64,1131
2021-08-16,1066,1472,-406,-27.58,1131
2021-08-17,1106,1516,-410,-27.04,1131
2021-08-18,1106,1516,-410,-27.04,1131
2021-08-19,1106,1518,-412,-27.14,1131
2021-08-20,905,1509,-604,-40.03,1131
2021-08-21,418,965,-547,-56.68,1131
2021-08-22,245,615,-370,-60.16,1131
2021-08-23,1066,1488,-422,-28.36,1131
2021-08-24,1106,1538,-432,-28.09,1131
2021-08-25,1106,1544,-438,-28.37,1131
2021-08-26,1106,1553,-447,-28.78,1131
2021-08-27,905,1549,-644,-41.58,1131
2021-08-28,418,1010,-592,-58.61,1131
2021-08-29,245,663,-418,-63.05,1131
2021-08-30,1066,1538,-472,-30.69,1131
2021-08-31,1106,1590,-484,-30.44,1131
2021-09-01,1427,1597,-170,-10.64,1131
2021-09-02,1427,1606,-179,-11.15,1131
2021-09-03,1268,1600,-332,-20.75,1131
2021-09-04,584,1059,-475,-44.85,1131
2021-09-05,314,709,-395,-55.71,1131
2021-09-06,1376,1581,-205,-12.97,1131
2021-09-07,1427,1628,-201,-12.35,1131
2021-09-08,1427,1630,-203,-12.45,1131
2021-09-09,1427,1633,-206,-12.61,1131
2021-09-10,1268,1622,-354,-21.82,1131
2021-09-11,584,1075,-491,-45.67,1131
2021-09-12,314,719,-405,-56.33,1131
2021-09-13,1376,1585,-209,-13.19,1131
2021-09-14,1427,1628,-201,-12.35,1131
2021-09-15,1427,1625,-198,-12.18,1131
2021-09-16,1427,1624,-197,-12.13,1131
2021-09-17,1268,1609,-341,-21.19,1131
2021-09-18,584,1060,-476,-44.91,1131
2021-09-19,314,702,-388,-55.27,1131
2021-09-20,1376,1567,-191,-12.19,1131
2021-09-21,1427,1609,-182,-11.31,1131
2021-09-22,1427,1607,-180,-11.2,1131
2021-09-23,1427,1607,-180,-11.2,1131
2021-09-24,1268,1595,-327,-20.5,1131
2021-09-25,584,1048,-464,-44.27,1131
2021-09-26,314,693,-379,-54.69,1131
2021-09-27,1376,1562,-186,-11.91,1131
2021-09-28,1427,1607,-180,-11.2,1131
2021-09-29,1427,1609,-182,-11.31,1131
2021-09-30,1427,1612,-185,-11.48,1131
2021-10-01,1220,1603,-383,-23.89,1131
2021-10-02,505,1059,-554,-52.31,1131
2021-10-03,293,708,-415,-58.62,1131
2021-10-04,1214,1579,-365,-23.12,1131
2021-10-05,1329,1626,-297,-18.27,1131
2021-10-06,1329,1629,-300,-18.42,1131
2021-10-07,1329,1633,-304,-18.62,1131
2021-10-08,1220,1623,-403,-24.83,1131
2021-10-09,505,1078,-573,-53.15,1131
2021-10-10,293,725,-432,-59.59,1131
2021-10-11,1214,1593,-379,-23.79,1131
2021-10-12,1329,1637,-308,-18.81,1131
2021-10-13,1329,1635,-306,-18.72,1131
2021-10-14,1329,1635,-306,-18.72,1131
2021-10-15,1220,1620,-400,-24.69,1131
2021-10-16,505,1070,-565,-52.8,1131
2021-10-17,293,711,-418,-58.79,1131
2021-10-18,1214,1573,-359,-22.82,1131
2021-10-19,1329,1611,-282,-17.5,1131
2021-10-20,1329,1604,-275,-17.14,1131
2021-10-21,1329,1597,-268,-16.78,1131
2021-10-22,1220,1577,-357,-22.64,1131
2021-10-23,505,1022,-517,-50.59,1131
2021-10-24,293,658,-365,-55.47,1131
2021-10-25,1214,1516,-302,-19.92,1131
2021-10-26,1329,1550,-221,-14.26,1131
2021-10-27,1329,1540,-211,-13.7,1131
2021-10-28,1329,1531,-202,-13.19,1131
2021-10-29,1220,1509,-289,-19.15,1131
2021-10-30,505,951,-446,-46.9,1131
2021-10-31,293,586,-293,-50.0,1131
2021-11-01,1092,1444,-352,-24.38,1131
2021-11-02,1207,1478,-271,-18.34,1131
2021-11-03,1207,1468,-261,-17.78,1131
2021-11-04,1207,1460,-253,-17.33,1131
2021-11-05,1048,1439,-391,-27.17,1131
2021-11-06,432,883,-451,-51.08,1131
2021-11-07,230,520,-290,-55.77,1131
2021-11-08,1092,1379,-287,-20.81,1131
2021-11-09,1207,1416,-209,-14.76,1131
2021-11-10,1207,1408,-201,-14.28,1131
2021-11-11,1207,1403,-196,-13.97,1131
2021-11-12,1048,1385,-337,-24.33,1131
2021-11-13,432,832,-400,-48.08,1131
2021-11-14,230,472,-242,-51.27,1131
2021-11-15,1092,1335,-243,-18.2,1131
2021-11-16,1207,1375,-168,-12.22,1131
2021-11-17,1207,1371,-164,-11.96,1131
2021-11-18,1207,1369,-162,-11.83,1131
2021-11-19,1048,1356,-308,-22.71,1131
2021-11-20,432,807,-375,-46.47,1131
2021-11-21,230,452,-222,-49.12,1131
2021-11-22,1092,1319,-227,-17.21,1131
2021-11-23,1207,1365,-158,-11.58,1131
2021-11-24,1207,1366,-159,-11.64,1131
2021-11-25,1207,1370,-163,-11.9,1131
2021-11-26,1048,1361,-313,-23.0,1131
2021-11-27,432,819,-387,-47.25,1131
2021-11-28,230,469,-239,-50.96,1131
2021-11-29,1092,1342,-250,-18.63,1131
2021-11-30,1207,1393,-186,-13.35,1131
2021-12-01,927,1400,-473,-33.79,1131
2021-12-02,927,1408,-481,-34.16,1131
2021-12-03,691,1404,-713,-50.78,1131
2021-12-04,307,865,-558,-64.51,1131
2021-12-05,169,519,-350,-67.44,1131
2021-12-06,956,1394,-438,-31.42,1131
2021-12-07,927,1446,-519,-35.89,1131
2021-12-08,927,1453,-526,-36.2,1131
2021-12-09,927,1461,-534,-36.55,1131
2021-12-10,691,1455,-764,-52.51,1131
2021-12-11,307,913,-606,-66.37,1131
2021-12-12,169,562,-393,-69.93,1131
2021-12-13,956,1431,-475,-33.19,1131
2021-12-14,927,1476,-549,-37.2,1131
2021-12-15,927,1475,-548,-37.15,1131
2021-12-16,927,1474,-547,-37.11,1131
2021-12-17,691,1458,-767,-52.61,1131
2021-12-18,307,904,-597,-66.04,1131
2021-12-19,169,542,-373,-68.82,1131
2021-12-20,956,1399,-443,-31.67,1131
2021-12-21,927,1431,-504,-35.22,1131
2021-12-22,927,1417,-490,-34.58,1131
2021-12-23,927,1403,-476,-33.93,1131
2021-12-24,691,1374,-683,-49.71,1131
2021-12-25,307,809,-502,-62.05,1131
2021-12-26,169,435,-266,-61.15,1131
2021-12-27,956,1282,-326,-25.43,1131
2021-12-28,927,1305,-378,-28.97,1131
2021-12-29,927,1283,-356,-27.75,1131
2021-12-30,927,1263,-336,-26.6,1131
2021-12-31,691,1229,-538,-43.78,1131
2022-01-01,307,660,-353,-53.48,1131
2022-01-02,160,285,-125,-43.86,1131
2022-01-03,853,1132,-279,-24.65,1131
2022-01-04,906,1157,-251,-21.69,1131
2022-01-05,906,1138,-232,-20.39,1131
2022-01-06,906,1122,-216,-19.25,1131
2022-01-07,807,1095,-288,-26.3,1131
2022-01-08,307,535,-228,-42.62,1131
2022-01-09,160,168,-8,-4.76,1131
2022-01-10,853,1026,-173,-16.86,1131
2022-01-11,906,1062,-156,-14.69,1131
2022-01-12,906,1055,-149,-14.12,1131
2022-01-13,906,1051,-145,-13.8,1131
2022-01-14,807,1036,-229,-22.1,1131
2022-01-15,307,488,-181,-37.09,1131
2022-01-16,160,133,27,20.3,1131
2022-01-17,853,1002,-149,-14.87,1131
2022-01-18,906,1048,-142,-13.55,1131
2022-01-19,906,1051,-145,-13.8,1131
2022-01-20,906,1056,-150,-14.2,1131
2022-01-21,807,1049,-242,-23.07,1131
2022-01-22,307,506,-199,-39.33,1131
2022-01-23,160,156,4,2.56,1131
2022-01-24,853,1029,-176,-17.1,1131
2022-01-25,906,1077,-171,-15.88,1131
2022-01-26,906,1081,-175,-16.19,1131
2022-01-27,906,1086,-180,-16.57,1131
2022-01-28,807,1078,-271,-25.14,1131
2022-01-29,307,533,-226,-42.4,1131
2022-01-30,160,180,-20,-11.11,1131
2020-02-01,1109,1008,101,10.02,1170
2020-02-02,687,463,224,48.38,1170
2020-02-03,2596,2442,154,6.31,1170
2020-02-04,2721,2548,173,6.79,1170
2020-02-05,2721,2548,173,6.79,1170
2020-02-06,2721,2548,173,6.79,1170
2020-02-07,2495,2382,113,4.74,1170
2020-02-08,1109,1003,106,10.57,1170
2020-02-09,687,455,232,50.99,1170
2020-02-10,2596,2432,164,6.74,1170
2020-02-11,2721,2538,183,7.21,1170
2020-02-12,2721,2539,182,7.17,1170
2020-02-13,2721,2542,179,7.04,1170
2020-02-14,2495,2381,114,4.79,1170
2020-02-15,1109,1008,101,10.02,1170
2020-02-16,687,467,220,47.11,1170
2020-02-17,2596,2454,142,5.79,1170
2020-02-18,2721,2569,152,5.92,1170
2020-02-19,2721,2581,140,5.42,1170
2020-02-20,2721,2595,126,4.86,1170
2020-02-21,2495,2446,49,2.0,1170
2020-02-22,1109,1084,25,2.31,1170
2020-02-23,687,555,132,23.78,1170
2020-02-24,2596,2552,44,1.72,1170
2020-02-25,2721,2677,44,1.64,1170
2020-02-26,2721,2698,23,0.85,1170
2020-02-27,2721,2720,1,0.04,1170
2020-02-28,2495,2576,-81,-3.14,1170
2020-02-29,1109,1219,-110,-9.02,1170
2020-03-01,422,693,-271,-39.11,1170
2020-03-02,1957,2691,-734,-27.28,1170
2020-03-03,2021,2815,-794,-28.21,1170
2020-03-04,2021,2833,-812,-28.66,1170
2020-03-05,2021,2851,-830,-29.11,1170
2020-03-06,1803,2702,-899,-33.27,1170
2020-03-07,685,1339,-654,-48.84,1170
2020-03-08,422,805,-383,-47.58,1170
2020-03-09,1957,2794,-837,-29.96,1170
2020-03-10,2021,2910,-889,-30.55,1170
2020-03-11,2021,2918,-897,-30.74,1170
2020-03-12,2021,2927,-906,-30.95,1170
2020-03-13,1803,2769,-966,-34.89,1170
2020-03-14,685,1398,-713,-51.0,1170
2020-03-15,422,856,-434,-50.7,1170
2020-03-16,1957,2839,-882,-31.07,1170
2020-03-17,2021,2948,-927,-31.45,1170
2020-03-18,2021,2953,-932,-31.56,1170
2020-03-19,2021,2959,-938,-31.7,1170
2020-03-20,1803,2799,-996,-35.58,1170
2020-03-21,685,1427,-742,-52.0,1170
2020-03-22,422,887,-465,-52.42,1170
2020-03-23,1957,2872,-915,-31.86,1170
2020-03-24,2021,2985,-964,-32.29,1170
2020-03-25,2021,2994,-973,-32.5,1170
2020-03-26,2021,3005,-984,-32.75,1170
2020-03-27,1803,2852,-1049,-36.78,1170
2020-03-28,685,1487,-802,-53.93,1170
2020-03-29,422,953,-531,-55.72,1170
2020-03-30,1957,2945,-988,-33.55,1170
2020-03-31,2021,3065,-1044,-34.06,1170
2020-04-01,1595,3080,-1485,-48.21,1170
2020-04-02,1595,3096,-1501,-48.48,1170
2020-04-03,1308,2948,-1640,-55.63,1170
2020-04-04,411,1586,-1175,-74.09,1170
2020-04-05,174,1054,-880,-83.49,1170
2020-04-06,1610,3048,-1438,-47.18,1170
2020-04-07,1595,3168,-1573,-49.65,1170
2020-04-08,1595,3182,-1587,-49.87,1170
2020-04-09,1595,3197,-1602,-50.11,1170
2020-04-10,1308,3045,-1737,-57.04,1170
2020-04-11,411,1679,-1268,-75.52,1170
2020-04-12,174,1143,-969,-84.78,1170
2020-04-13,1610,3131,-1521,-48.58,1170
2020-04-14,1595,3245,-1650,-50.85,1170
2020-04-15,1595,3253,-1658,-50.97,1170
2020-04-16,1595,3261,-1666,-51.09,1170
2020-04-17,1308,3103,-1795,-57.85,1170
2020-04-18,411,1731,-1320,-76.26,1170
2020-04-19,174,1190,-1016,-85.38,1170
2020-04-20,1610,3173,-1563,-49.26,1170
2020-04-21,1595,3283,-1688,-51.42,1170
2020-04-22,1595,3288,-1693,-51.49,1170
2020-04-23,1595,3294,-1699,-51.58,1170
2020-04-24,1308,3135,-1827,-58.28,1170
2020-04-25,411,1763,-1352,-76.69,1170
2020-04-26,174,1223,-1049,-85.77,1170
2020-04-27,1610,3208,-1598,-49.81,1170
2020-04-28,1595,3322,-1727,-51.99,1170
2020-04-29,1595,3331,-1736,-52.12,1170
2020-04-30,1595,3341,-1746,-52.26,1170
2020-05-01,1873,3187,-1314,-41.23,1170
2020-05-02,597,1820,-1223,-67.2,1170
2020-05-03,279,1285,-1006,-78.29,1170
2020-05-04,2119,3276,-1157,-35.32,1170
2020-05-05,2285,3394,-1109,-32.68,1170
2020-05-06,2285,3406,-1121,-32.91,1170
2020-05-07,2285,3420,-1135,-33.19,1170
2020-05-08,1873,3269,-1396,-42.7,1170
2020-05-09,597,1903,-1306,-68.63,1170
2020-05-10,279,1368,-1089,-79.61,1170
2020-05-11,2119,3358,-1239,-36.9,1170
2020-05-12,2285,3473,-1188,-34.21,1170
2020-05-13,2285,3483,-1198,-34.4,1170
2020-05-14,2285,3492,-1207,-34.56,1170
2020-05-15,1873,3335,-1462,-43.84,1170
2020-05-16,597,1963,-1366,-69.59,1170
2020-05-17,279,1420,-1141,-80.35,1170
2020-05-18,2119,3401,-1282,-37.69,1170
2020-05-19,2285,3509,-1224,-34.88,1170
2020-05-20,2285,3509,-1224,-34.88,1170
2020-05-21,2285,3510,-1225,-34.9,1170
2020-05-22,1873,3344,-1471,-43.99,1170
2020-05-23,597,1964,-1367,-69.6,1170
2020-05-24,279,1414,-1135,-80.27,1170
2020-05-25,2119,3388,-1269,-37.46,1170
2020-05-26,2285,3490,-1205,-34.53,1170
2020-05-27,2285,3486,-1201,-34.45,1170
2020-05-28,2285,3484,-1199,-34.41,1170
2020-05-29,1873,3316,-1443,-43.52,1170
2020-05-30,597,1935,-1338,-69.15,1170
2020-05-31,279,1386,-1107,-79.87,1170
2020-06-01,2458,3362,-904,-26.89,1170
2020-06-02,2600,3467,-867,-25.01,1170
2020-06-03,2600,3467,-867,-25.01,1170
2020-06-04,2600,3470,-870,-25.07,1170
2020-06-05,2119,3307,-1188,-35.92,1170
2020-06-06,758,1933,-1175,-60.79,1170
2020-06-07,389,1390,-1001,-72.01,1170
2020-06-08,2458,3372,-914,-27.11,1170
2020-06-09,2600,3483,-883,-25.35,1170
2020-06-10,2600,3488,-888,-25.46,1170
2020-06-11,2600,3495,-895,-25.61,1170
2020-06-12,2119,3336,-1217,-36.48,1170
2020-06-13,758,1963,-1205,-61.39,1170
2020-06-14,389,1421,-1032,-72.62,1170
2020-06-15,2458,3403,-945,-27.77,1170
2020-06-16,2600,3511,-911,-25.95,1170
2020-06-17,2600,3512,-912,-25.97,1170
2020-06-18,2600,3513,-913,-25.99,1170
2020-06-19,2119,3347,-1228,-36.69,1170
2020-06-20,758,1966,-1208,-61.44,1170
2020-06-21,389,1415,-1026,-72.51,1170
2020-06-22,2458,3386,-928,-27.41,1170
2020-06-23,2600,3482,-882,-25.33,1170
2020-06-24,2600,3472,-872,-25.12,1170
2020-06-25,2600,3461,-861,-24.88,1170
2020-06-26,2119,3282,-1163,-35.44,1170
2020-06-27,758,1889,-1131,-59.87,1170
2020-06-28,389,1326,-937,-70.66,1170
2020-06-29,2458,3287,-829,-25.22,1170
2020-06-30,2600,3374,-774,-22.94,1170
2020-07-01,2594,3356,-762,-22.71,1170
2020-07-02,2594,3339,-745,-22.31,1170
2020-07-03,2258,3156,-898,-28.45,1170
2020-07-04,876,1761,-885,-50.26,1170
2020-07-05,469,1197,-728,-60.82,1170
2020-07-06,2522,3159,-637,-20.16,1170
2020-07-07,2594,3250,-656,-20.18,1170
2020-07-08,2594,3237,-643,-19.86,1170
2020-07-09,2594,3226,-632,-19.59,1170
2020-07-10,2258,3052,-794,-26.02,1170
2020-07-11,876,1667,-791,-47.45,1170
2020-07-12,469,1114,-645,-57.9,1170
2020-07-13,2522,3088,-566,-18.33,1170
2020-07-14,2594,3192,-598,-18.73,1170
2020-07-15,2594,3191,-597,-18.71,1170
2020-07-16,2594,3193,-599,-18.76,1170
2020-07-17,2258,3031,-773,-25.5,1170
2020-07-18,876,1657,-781,-47.13,1170
2020-07-19,469,1114,-645,-57.9,1170
2020-07-20,2522,3097,-575,-18.57,1170
2020-07-21,2594,3208,-614,-19.14,1170
2020-07-22,2594,3213,-619,-19.27,1170
2020-07-23,2594,3219,-625,-19.42,1170
2020-07-24,2258,3058,-800,-26.16,1170
2020-07-25,876,1684,-808,-47.98,1170
2020-07-26,469,1139,-670,-58.82,1170
2020-07-27,2522,3118,-596,-19.11,1170
2020-07-28,2594,3223,-629,-19.52,1170
2020-07-29,2594,3221,-627,-19.47,1170
2020-07-30,2594,3219,-625,-19.42,1170
2020-07-31,2258,3049,-791,-25.94,1170
2020-08-01,892,1665,-773,-46.43,1170
2020-08-02,509,1110,-601,-54.14,1170
2020-08-03,2382,3079,-697,-22.64,1170
2020-08-04,2535,3174,-639,-20.13,1170
2020-08-05,2535,3163,-628,-19.85,1170
2020-08-06,2535,3152,-617,-19.57,1170
2020-08-07,2256,2976,-720,-24.19,1170
2020-08-08,892,1586,-694,-43.76,1170
2020-08-09,509,1027,-518,-50.44,1170
2020-08-10,2382,2994,-612,-20.44,1170
2020-08-11,2535,3089,-554,-17.93,1170
2020-08-12,2535,3079,-544,-17.67,1170
2020-08-13,2535,3073,-538,-17.51,1170
2020-08-14,2256,2902,-646,-22.26,1170
2020-08-15,892,1520,-628,-41.32,1170
2020-08-16,509,971,-462,-47.58,1170
2020-08-17,2382,2949,-567,-19.23,1170
2020-08-18,2535,3057,-522,-17.08,1170
2020-08-19,2535,3062,-527,-17.21,1170
2020-08-20,2535,3069,-534,-17.4,1170
2020-08-21,2256,2914,-658,-22.58,1170
2020-08-22,892,1547,-655,-42.34,1170
2020-08-23,509,1013,-504,-49.75,1170
2020-08-24,2382,3005,-623,-20.73,1170
2020-08-25,2535,3126,-591,-18.91,1170
2020-08-26,2535,3142,-607,-19.32,1170
2020-08-27,2535,3161,-626,-19.8,1170
2020-08-28,2256,3014,-758,-25.15,1170
2020-08-29,892,1654,-762,-46.07,1170
2020-08-30,509,1125,-616,-54.76,1170
2020-08-31,2382,3120,-738,-23.65,1170
2020-09-01,2622,3241,-619,-19.1,1170
2020-09-02,2622,3257,-635,-19.5,1170
2020-09-03,2622,3271,-649,-19.84,1170
2020-09-04,2342,3119,-777,-24.91,1170
2020-09-05,908,1753,-845,-48.2,1170
2020-09-06,469,1215,-746,-61.4,1170
2020-09-07,2548,3200,-652,-20.38,1170
2020-09-08,2622,3311,-689,-20.81,1170
2020-09-09,2622,3315,-693,-20.9,1170
2020-09-10,2622,3318,-696,-20.98,1170
2020-09-11,2342,3154,-812,-25.75,1170
2020-09-12,908,1776,-868,-48.87,1170
2020-09-13,469,1227,-758,-61.78,1170
2020-09-14,2548,3202,-654,-20.42,1170
2020-09-15,2622,3304,-682,-20.64,1170
2020-09-16,2622,3300,-678,-20.55,1170
2020-09-17,2622,3297,-675,-20.47,1170
2020-09-18,2342,3128,-786,-25.13,1170
2020-09-19,908,1746,-838,-48.0,1170
2020-09-20,469,1196,-727,-60.79,1170
2020-09-21,2548,3171,-623,-19.65,1170
2020-09-22,2622,3274,-652,-19.91,1170
2020-09-23,2622,3273,-651,-19.89,1170
2020-09-24,2622,3274,-652,-19.91,1170
2020-09-25,2342,3111,-769,-24.72,1170
2020-09-26,908,1735,-827,-47.67,1170
2020-09-27,469,1191,-722,-60.62,1170
2020-09-28,2548,3173,-625,-19.7,1170
2020-09-29,2622,3284,-662,-20.16,1170
2020-09-30,2622,3290,-668,-20.3,1170
2020-10-01,2649,3297,-648,-19.65,1170
2020-10-02,2373,3140,-767,-24.43,1170
2020-10-03,862,1769,-907,-51.27,1170
2020-10-04,405,1229,-824,-67.05,1170
2020-10-05,2514,3214,-700,-21.78,1170
2020-10-06,2649,3326,-677,-20.35,1170
2020-10-07,2649,3333,-684,-20.52,1170
2020-10-08,2649,3339,-690,-20.66,1170
2020-10-09,2373,3178,-805,-25.33,1170
2020-10-10,862,1804,-942,-52.22,1170
2020-10-11,405,1259,-854,-67.83,1170
2020-10-12,2514,3237,-723,-22.34,1170
2020-10-13,2649,3342,-693,-20.74,1170
2020-10-14,2649,3339,-690,-20.66,1170
2020-10-15,2649,3336,-687,-20.59,1170
2020-10-16,2373,3166,-793,-25.05,1170
2020-10-17,862,1782,-920,-51.63,1170
2020-10-18,405,1226,-821,-66.97,1170
2020-10-19,2514,3195,-681,-21.31,1170
2020-10-20,2649,3290,-641,-19.48,1170
2020-10-21,2649,3278,-629,-19.19,1170
2020-10-22,2649,3267,-618,-18.92,1170
2020-10-23,2373,3090,-717,-23.2,1170
2020-10-24,862,1699,-837,-49.26,1170
2020-10-25,405,1138,-733,-64.41,1170
2020-10-26,2514,3102,-588,-18.96,1170
2020-10-27,2649,3194,-545,-17.06,1170
2020-10-28,2649,3180,-531,-16.7,1170
2020-10-29,2649,3168,-519,-16.38,1170
2020-10-30,2373,2991,-618,-20.66,1170
2020-10-31,862,1601,-739,-46.16,1170
2020-11-01,330,1042,-712,-68.33,1170
2020-11-02,2444,3009,-565,-18.78,1170
2020-11-03,2308,3103,-795,-25.62,1170
2020-11-04,2308,3093,-785,-25.38,1170
2020-11-05,2308,3085,-777,-25.19,1170
2020-11-06,2100,2911,-811,-27.86,1170
2020-11-07,685,1525,-840,-55.08,1170
2020-11-08,330,970,-640,-65.98,1170
2020-11-09,2444,2941,-497,-16.9,1170
2020-11-10,2308,3039,-731,-24.05,1170
2020-11-11,2308,3032,-724,-23.88,1170
2020-11-12,2308,3026,-718,-23.73,1170
2020-11-13,2100,2855,-755,-26.44,1170
2020-11-14,685,1471,-786,-53.43,1170
2020-11-15,330,919,-589,-64.09,1170
2020-11-16,2444,2891,-447,-15.46,1170
2020-11-17,2308,2991,-683,-22.84,1170
2020-11-18,2308,2986,-678,-22.71,1170
2020-11-19,2308,2982,-674,-22.6,1170
2020-11-20,2100,2814,-714,-25.37,1170
2020-11-21,685,1432,-747,-52.16,1170
2020-11-22,330,883,-553,-62.63,1170
2020-11-23,2444,2858,-414,-14.49,1170
2020-11-24,2308,2962,-654,-22.08,1170
2020-11-25,2308,2962,-654,-22.08,1170
2020-11-26,2308,2963,-655,-22.11,1170
2020-11-27,2100,2800,-700,-25.0,1170
2020-11-28,685,1425,-740,-51.93,1170
2020-11-29,330,882,-552,-62.59,1170
2020-11-30,2444,2864,-420,-14.66,1170
2020-12-01,1997,2975,-978,-32.87,1170
2020-12-02,1997,2982,-985,-33.03,1170
2020-12-03,1997,2990,-993,-33.21,1170
2020-12-04,2339,2834,-495,-17.47,1170
2020-12-05,799,1464,-665,-45.42,1170
2020-12-06,329,926,-597,-64.47,1170
2020-12-07,2011,2912,-901,-30.94,1170
2020-12-08,1997,3026,-1029,-34.01,1170
2020-12-09,1997,3034,-1037,-34.18,1170
2020-12-10,1997,3042,-1045,-34.35,1170
2020-12-11,2339,2883,-544,-18.87,1170
2020-12-12,799,1510,-711,-47.09,1170
2020-12-13,329,966,-637,-65.94,1170
2020-12-14,2011,2945,-934,-31.71,1170
2020-12-15,1997,3048,-1051,-34.48,1170
2020-12-16,1997,3045,-1048,-34.42,1170
2020-12-17,1997,3039,-1042,-34.29,1170
2020-12-18,2339,2865,-526,-18.36,1170
2020-12-19,799,1475,-676,-45.83,1170
2020-12-20,329,913,-584,-63.96,1170
2020-12-21,2011,2873,-862,-30.0,1170
2020-12-22,1997,2957,-960,-32.47,1170
2020-12-23,1997,2934,-937,-31.94,1170
2020-12-24,1997,2908,-911,-31.33,1170
2020-12-25,2339,2715,-376,-13.85,1170
2020-12-26,799,1307,-508,-38.87,1170
2020-12-27,329,728,-399,-54.81,1170
2020-12-28,2011,2672,-661,-24.74,1170
2020-12-29,1997,2743,-746,-27.2,1170
2020-12-30,1997,2708,-711,-26.26,1170
2020-12-31,1997,2673,-676,-25.29,1170
2021-01-01,1710,2474,-764,-30.88,1170
2021-01-02,580,1062,-482,-45.39,1170
2021-01-03,314,482,-168,-34.85,1170
2021-01-04,1847,2429,-582,-23.96,1170
2021-01-05,1942,2504,-562,-22.44,1170
2021-01-06,1942,2477,-535,-21.6,1170
2021-01-07,1942,2453,-511,-20.83,1170
2021-01-08,1710,2266,-556,-24.54,1170
2021-01-09,580,869,-289,-33.26,1170
2021-01-10,314,306,8,2.61,1170
2021-01-11,1847,2271,-424,-18.67,1170
2021-01-12,1942,2366,-424,-17.92,1170
2021-01-13,1942,2359,-417,-17.68,1170
2021-01-14,1942,2356,-414,-17.57,1170
2021-01-15,1710,2190,-480,-21.92,1170
2021-01-16,580,813,-233,-28.66,1170
2021-01-17,314,270,44,16.3,1170
2021-01-18,1847,2253,-406,-18.02,1170
2021-01-19,1942,2365,-423,-17.89,1170
2021-01-20,1942,2373,-431,-18.16,1170
2021-01-21,1942,2383,-441,-18.51,1170
2021-01-22,1710,2228,-518,-23.25,1170
2021-01-23,580,860,-280,-32.56,1170
2021-01-24,314,323,-9,-2.79,1170
2021-01-25,1847,2311,-464,-20.08,1170
2021-01-26,1942,2425,-483,-19.92,1170
2021-01-27,1942,2433,-491,-20.18,1170
2021-01-28,1942,2442,-500,-20.48,1170
2021-01-29,1710,2283,-573,-25.1,1170
2021-01-30,580,911,-331,-36.33,1170
2021-01-31,314,367,-53,-14.44,1170
2021-02-01,2329,2348,-19,-0.81,1170
2021-02-02,2305,2455,-150,-6.11,1170
2021-02-03,2305,2456,-151,-6.15,1170
2021-02-04,2305,2456,-151,-6.15,1170
2021-02-05,1985,2291,-306,-13.36,1170
2021-02-06,708,912,-204,-22.37,1170
2021-02-07,328,364,-36,-9.89,1170
2021-02-08,2329,2341,-12,-0.51,1170
2021-02-09,2305,2445,-140,-5.73,1170
2021-02-10,2305,2445,-140,-5.73,1170
2021-02-11,2305,2447,-142,-5.8,1170
2021-02-12,1985,2284,-299,-13.09,1170
2021-02-13,708,909,-201,-22.11,1170
2021-02-14,328,367,-39,-10.63,1170
2021-02-15,2329,2351,-22,-0.94,1170
2021-02-16,2305,2464,-159,-6.45,1170
2021-02-17,2305,2474,-169,-6.83,1170
2021-02-18,2305,2486,-181,-7.28,1170
2021-02-19,1985,2335,-350,-14.99,1170
2021-02-20,708,972,-264,-27.16,1170
2021-02-21,328,441,-113,-25.62,1170
2021-02-22,2329,2436,-107,-4.39,1170
2021-02-23,2305,2560,-255,-9.96,1170
2021-02-24,2305,2580,-275,-10.66,1170
2021-02-25,2305,2601,-296,-11.38,1170
2021-02-26,1985,2457,-472,-19.21,1170
2021-02-27,708,1101,-393,-35.69,1170
2021-02-28,328,575,-247,-42.96,1170
2021-03-01,2395,2573,-178,-6.92,1170
2021-03-02,2434,2699,-265,-9.82,1170
2021-03-03,2434,2718,-284,-10.45,1170
2021-03-04,2434,2737,-303,-11.07,1170
2021-03-05,2144,2590,-446,-17.22,1170
2021-03-06,745,1228,-483,-39.33,1170
2021-03-07,333,696,-363,-52.16,1170
2021-03-08,2395,2687,-292,-10.87,1170
2021-03-09,2434,2804,-370,-13.2,1170
2021-03-10,2434,2815,-381,-13.53,1170
2021-03-11,2434,2825,-391,-13.84,1170
2021-03-12,2144,2668,-524,-19.64,1170
2021-03-13,745,1298,-553,-42.6,1170
2021-03-14,333,757,-424,-56.01,1170
2021-03-15,2395,2740,-345,-12.59,1170
2021-03-16,2434,2850,-416,-14.6,1170
2021-03-17,2434,2855,-421,-14.75,1170
2021-03-18,2434,2860,-426,-14.9,1170
2021-03-19,2144,2701,-557,-20.62,1170
2021-03-20,745,1328,-583,-43.9,1170
2021-03-21,333,786,-453,-57.63,1170
2021-03-22,2395,2771,-376,-13.57,1170
2021-03-23,2434,2883,-449,-15.57,1170
2021-03-24,2434,2891,-457,-15.81,1170
2021-03-25,2434,2901,-467,-16.1,1170
2021-03-26,2144,2746,-602,-21.92,1170
2021-03-27,745,1379,-634,-45.98,1170
2021-03-28,333,844,-511,-60.55,1170
2021-03-29,2395,2835,-440,-15.52,1170
2021-03-30,2434,2954,-520,-17.6,1170
2021-03-31,2434,2969,-535,-18.02,1170
2021-04-01,2479,2985,-506,-16.95,1170
2021-04-02,2037,2836,-799,-28.17,1170
2021-04-03,673,1474,-801,-54.34,1170
2021-04-04,324,942,-618,-65.61,1170
2021-04-05,2531,2936,-405,-13.79,1170
2021-04-06,2479,3057,-578,-18.91,1170
2021-04-07,2479,3072,-593,-19.3,1170
2021-04-08,2479,3087,-608,-19.7,1170
2021-04-09,2037,2937,-900,-30.64,1170
2021-04-10,673,1572,-899,-57.19,1170
2021-04-11,324,1037,-713,-68.76,1170
2021-04-12,2531,3026,-495,-16.36,1170
2021-04-13,2479,3141,-662,-21.08,1170
2021-04-14,2479,3150,-671,-21.3,1170
2021-04-15,2479,3159,-680,-21.53,1170
2021-04-16,2037,3002,-965,-32.15,1170
2021-04-17,673,1631,-958,-58.74,1170
2021-04-18,324,1090,-766,-70.28,1170
2021-04-19,2531,3074,-543,-17.66,1170
2021-04-20,2479,3184,-705,-22.14,1170
2021-04-21,2479,3189,-710,-22.26,1170
2021-04-22,2479,3195,-716,-22.41,1170
2021-04-23,2037,3036,-999,-32.91,1170
2021-04-24,673,1664,-991,-59.56,1170
2021-04-25,324,1123,-799,-71.15,1170
2021-04-26,2531,3107,-576,-18.54,1170
2021-04-27,2479,3219,-740,-22.99,1170
2021-04-28,2479,3227,-748,-23.18,1170
2021-04-29,2479,3237,-758,-23.42,1170
2021-04-30,2037,3082,-1045,-33.91,1170
2021-05-01,802,1714,-912,-53.21,1170
2021-05-02,388,1178,-790,-67.06,1170
2021-05-03,2737,3168,-431,-13.6,1170
2021-05-04,2794,3285,-491,-14.95,1170
2021-05-05,2794,3298,-504,-15.28,1170
2021-05-06,2794,3312,-518,-15.64,1170
2021-05-07,2355,3160,-805,-25.47,1170
2021-05-08,802,1795,-993,-55.32,1170
2021-05-09,388,1261,-873,-69.23,1170
2021-05-10,2737,3251,-514,-15.81,1170
2021-05-11,2794,3368,-574,-17.04,1170
2021-05-12,2794,3378,-584,-17.29,1170
2021-05-13,2794,3389,-595,-17.56,1170
2021-05-14,2355,3233,-878,-27.16,1170
2021-05-15,802,1863,-1061,-56.95,1170
2021-05-16,388,1322,-934,-70.65,1170
2021-05-17,2737,3305,-568,-17.19,1170
2021-05-18,2794,3414,-620,-18.16,1170
2021-05-19,2794,3416,-622,-18.21,1170
2021-05-20,2794,3418,-624,-18.26,1170
2021-05-21,2355,3253,-898,-27.61,1170
2021-05-22,802,1874,-1072,-57.2,1170
2021-05-23,388,1325,-937,-70.72,1170
2021-05-24,2737,3300,-563,-17.06,1170
2021-05-25,2794,3402,-608,-17.87,1170
2021-05-26,2794,3399,-605,-17.8,1170
2021-05-27,2794,3396,-602,-17.73,1170
2021-05-28,2355,3228,-873,-27.04,1170
2021-05-29,802,1846,-1044,-56.55,1170
2021-05-30,388,1296,-908,-70.06,1170
2021-05-31,2737,3272,-535,-16.35,1170
2021-06-01,2839,3376,-537,-15.91,1170
2021-06-02,2839,3375,-536,-15.88,1170
2021-06-03,2839,3376,-537,-15.91,1170
2021-06-04,2407,3212,-805,-25.06,1170
2021-06-05,869,1837,-968,-52.69,1170
2021-06-06,478,1292,-814,-63.0,1170
2021-06-07,2764,3274,-510,-15.58,1170
2021-06-08,2839,3384,-545,-16.11,1170
2021-06-09,2839,3389,-550,-16.23,1170
2021-06-10,2839,3395,-556,-16.38,1170
2021-06-11,2407,3236,-829,-25.62,1170
2021-06-12,869,1864,-995,-53.38,1170
2021-06-13,478,1323,-845,-63.87,1170
2021-06-14,2764,3305,-541,-16.37,1170
2021-06-15,2839,3415,-576,-16.87,1170
2021-06-16,2839,3418,-579,-16.94,1170
2021-06-17,2839,3421,-582,-17.01,1170
2021-06-18,2407,3257,-850,-26.1,1170
2021-06-19,869,1878,-1009,-53.73,1170
2021-06-20,478,1328,-850,-64.01,1170
2021-06-21,2764,3301,-537,-16.27,1170
2021-06-22,2839,3400,-561,-16.5,1170
2021-06-23,2839,3392,-553,-16.3,1170
2021-06-24,2839,3383,-544,-16.08,1170
2021-06-25,2407,3207,-800,-24.95,1170
2021-06-26,869,1816,-947,-52.15,1170
2021-06-27,478,1254,-776,-61.88,1170
2021-06-28,2764,3216,-452,-14.05,1170
2021-06-29,2839,3304,-465,-14.07,1170
2021-06-30,2839,3287,-448,-13.63,1170
2021-07-01,2461,3269,-808,-24.72,1170
2021-07-02,2168,3086,-918,-29.75,1170
2021-07-03,894,1690,-796,-47.1,1170
2021-07-04,482,1126,-644,-57.19,1170
2021-07-05,2510,3087,-577,-18.69,1170
2021-07-06,2461,3176,-715,-22.51,1170
2021-07-07,2461,3161,-700,-22.14,1170
2021-07-08,2461,3148,-687,-21.82,1170
2021-07-09,2168,2972,-804,-27.05,1170
2021-07-10,894,1585,-691,-43.6,1170
2021-07-11,482,1030,-548,-53.2,1170
2021-07-12,2510,3001,-491,-16.36,1170
2021-07-13,2461,3102,-641,-20.66,1170
2021-07-14,2461,3100,-639,-20.61,1170
2021-07-15,2461,3100,-639,-20.61,1170
2021-07-16,2168,2936,-768,-26.16,1170
2021-07-17,894,1560,-666,-42.69,1170
2021-07-18,482,1017,-535,-52.61,1170
2021-07-19,2510,2999,-489,-16.31,1170
2021-07-20,2461,3109,-648,-20.84,1170
2021-07-21,2461,3114,-653,-20.97,1170
2021-07-22,2461,3120,-659,-21.12,1170
2021-07-23,2168,2961,-793,-26.78,1170
2021-07-24,894,1587,-693,-43.67,1170
2021-07-25,482,1044,-562,-53.83,1170
2021-07-26,2510,3024,-514,-17.0,1170
2021-07-27,2461,3131,-670,-21.4,1170
2021-07-28,2461,3131,-670,-21.4,1170
2021-07-29,2461,3131,-670,-21.4,1170
2021-07-30,2168,2963,-795,-26.83,1170
2021-07-31,894,1581,-687,-43.45,1170
2021-08-01,490,1028,-538,-52.33,1170
2021-08-02,2439,2998,-559,-18.65,1170
2021-08-03,2397,3094,-697,-22.53,1170
2021-08-04,2397,3084,-687,-22.28,1170
2021-08-05,2397,3074,-677,-22.02,1170
2021-08-06,2081,2898,-817,-28.19,1170
2021-08-07,787,1508,-721,-47.81,1170
2021-08-08,490,949,-459,-48.37,1170
2021-08-09,2439,2915,-476,-16.33,1170
2021-08-10,2397,3009,-612,-20.34,1170
2021-08-11,2397,2999,-602,-20.07,1170
2021-08-12,2397,2990,-593,-19.83,1170
2021-08-13,2081,2817,-736,-26.13,1170
2021-08-14,787,1433,-646,-45.08,1170
2021-08-15,490,882,-392,-44.44,1170
2021-08-16,2439,2857,-418,-14.63,1170
2021-08-17,2397,2962,-565,-19.07,1170
2021-08-18,2397,2964,-567,-19.13,1170
2021-08-19,2397,2969,-572,-19.27,1170
2021-08-20,2081,2811,-730,-25.97,1170
2021-08-21,787,1441,-654,-45.39,1170
2021-08-22,490,905,-415,-45.86,1170
2021-08-23,2439,2895,-456,-15.75,1170
2021-08-24,2397,3014,-617,-20.47,1170
2021-08-25,2397,3029,-632,-20.86,1170
2021-08-26,2397,3047,-650,-21.33,1170
2021-08-27,2081,2899,-818,-28.22,1170
2021-08-28,787,1539,-752,-48.86,1170
2021-08-29,490,1010,-520,-51.49,1170
2021-08-30,2439,3006,-567,-18.86,1170
2021-08-31,2397,3128,-731,-23.37,1170
2021-09-01,2879,3145,-266,-8.46,1170
2021-09-02,2879,3161,-282,-8.92,1170
2021-09-03,2590,3011,-421,-13.98,1170
2021-09-04,918,1646,-728,-44.23,1170
2021-09-05,524,1111,-587,-52.84,1170
2021-09-06,2861,3098,-237,-7.65,1170
2021-09-07,2879,3211,-332,-10.34,1170
2021-09-08,2879,3217,-338,-10.51,1170
2021-09-09,2879,3223,-344,-10.67,1170
2021-09-10,2590,3061,-471,-15.39,1170
2021-09-11,918,1684,-766,-45.49,1170
2021-09-12,524,1137,-613,-53.91,1170
2021-09-13,2861,3113,-252,-8.1,1170
2021-09-14,2879,3216,-337,-10.48,1170
2021-09-15,2879,3213,-334,-10.4,1170
2021-09-16,2879,3210,-331,-10.31,1170
2021-09-17,2590,3041,-451,-14.83,1170
2021-09-18,918,1659,-741,-44.67,1170
2021-09-19,524,1108,-584,-52.71,1170
2021-09-20,2861,3082,-221,-7.17,1170
2021-09-21,2879,3185,-306,-9.61,1170
2021-09-22,2879,3182,-303,-9.52,1170
2021-09-23,2879,3182,-303,-9.52,1170
2021-09-24,2590,3017,-427,-14.15,1170
2021-09-25,918,1640,-722,-44.02,1170
2021-09-26,524,1095,-571,-52.15,1170
2021-09-27,2861,3076,-215,-6.99,1170
2021-09-28,2879,3185,-306,-9.61,1170
2021-09-29,2879,3190,-311,-9.75,1170
2021-09-30,2879,3197,-318,-9.95,1170
2021-10-01,2691,3039,-348,-11.45,1170
2021-10-02,1035,1668,-633,-37.95,1170
2021-10-03,489,1128,-639,-56.65,1170
2021-10-04,2713,3113,-400,-12.85,1170
2021-10-05,2950,3226,-276,-8.56,1170
2021-10-06,2950,3232,-282,-8.73,1170
2021-10-07,2950,3240,-290,-8.95,1170
2021-10-08,2691,3081,-390,-12.66,1170
2021-10-09,1035,1707,-672,-39.37,1170
2021-10-10,489,1164,-675,-57.99,1170
2021-10-11,2713,3144,-431,-13.71,1170
2021-10-12,2950,3250,-300,-9.23,1170
2021-10-13,2950,3250,-300,-9.23,1170
2021-10-14,2950,3248,-298,-9.17,1170
2021-10-15,2691,3080,-389,-12.63,1170
2021-10-16,1035,1697,-662,-39.01,1170
2021-10-17,489,1144,-655,-57.26,1170
2021-10-18,2713,3114,-401,-12.88,1170
2021-10-19,2950,3210,-260,-8.1,1170
2021-10-20,2950,3200,-250,-7.81,1170
2021-10-21,2950,3190,-240,-7.52,1170
2021-10-22,2691,3013,-322,-10.69,1170
2021-10-23,1035,1623,-588,-36.23,1170
2021-10-24,489,1063,-574,-54.0,1170
2021-10-25,2713,3027,-314,-10.37,1170
2021-10-26,2950,3119,-169,-5.42,1170
2021-10-27,2950,3105,-155,-4.99,1170
2021-10-28,2950,3092,-142,-4.59,1170
2021-10-29,2691,2914,-223,-7.65,1170
2021-10-30,1035,1524,-489,-32.09,1170
2021-10-31,489,964,-475,-49.27,1170
2021-11-01,2792,2930,-138,-4.71,1170
2021-11-02,2847,3024,-177,-5.85,1170
2021-11-03,2847,3014,-167,-5.54,1170
2021-11-04,2847,3004,-157,-5.23,1170
2021-11-05,2621,2830,-209,-7.39,1170
2021-11-06,940,1443,-503,-34.86,1170
2021-11-07,443,888,-445,-50.11,1170
2021-11-08,2792,2858,-66,-2.31,1170
2021-11-09,2847,2955,-108,-3.65,1170
2021-11-10,2847,2948,-101,-3.43,1170
2021-11-11,2847,2942,-95,-3.23,1170
2021-11-12,2621,2771,-150,-5.41,1170
2021-11-13,940,1387,-447,-32.23,1170
2021-11-14,443,834,-391,-46.88,1170
2021-11-15,2792,2806,-14,-0.5,1170
2021-11-16,2847,2905,-58,-2.0,1170
2021-11-17,2847,2900,-53,-1.83,1170
2021-11-18,2847,2896,-49,-1.69,1170
2021-11-19,2621,2726,-105,-3.85,1170
2021-11-20,940,1345,-405,-30.11,1170
2021-11-21,443,794,-351,-44.21,1170
2021-11-22,2792,2769,23,0.83,1170
2021-11-23,2847,2872,-25,-0.87,1170
2021-11-24,2847,2870,-23,-0.8,1170
2021-11-25,2847,2870,-23,-0.8,1170
2021-11-26,2621,2706,-85,-3.14,1170
2021-11-27,940,1330,-390,-29.32,1170
2021-11-28,443,785,-342,-43.57,1170
2021-11-29,2792,2766,26,0.94,1170
2021-11-30,2847,2876,-29,-1.01,1170
2021-12-01,2242,2881,-639,-22.18,1170
2021-12-02,2242,2889,-647,-22.4,1170
2021-12-03,1872,2731,-859,-31.45,1170
2021-12-04,866,1361,-495,-36.37,1170
2021-12-05,397,823,-426,-51.76,1170
2021-12-06,2441,2809,-368,-13.1,1170
2021-12-07,2242,2923,-681,-23.3,1170
2021-12-08,2242,2932,-690,-23.53,1170
2021-12-09,2242,2941,-699,-23.77,1170
2021-12-10,1872,2783,-911,-32.73,1170
2021-12-11,866,1412,-546,-38.67,1170
2021-12-12,397,870,-473,-54.37,1170
2021-12-13,2441,2851,-410,-14.38,1170
2021-12-14,2242,2958,-716,-24.21,1170
2021-12-15,2242,2957,-715,-24.18,1170
2021-12-16,2242,2954,-712,-24.1,1170
2021-12-17,1872,2784,-912,-32.76,1170
2021-12-18,866,1397,-531,-38.01,1170
2021-12-19,397,839,-442,-52.68,1170
2021-12-20,2441,2803,-362,-12.91,1170
2021-12-21,2242,2891,-649,-22.45,1170
2021-12-22,2242,2870,-628,-21.88,1170
2021-12-23,2242,2848,-606,-21.28,1170
2021-12-24,1872,2658,-786,-29.57,1170
2021-12-25,866,1253,-387,-30.89,1170
2021-12-26,397,676,-279,-41.27,1170
2021-12-27,2441,2622,-181,-6.9,1170
2021-12-28,2242,2694,-452,-16.78,1170
2021-12-29,2242,2659,-417,-15.68,1170
2021-12-30,2242,2625,-383,-14.59,1170
2021-12-31,1872,2425,-553,-22.8,1170
2022-01-01,659,1013,-354,-34.95,1170
2022-01-02,348,431,-83,-19.26,1170
2022-01-03,2114,2376,-262,-11.03,1170
2022-01-04,2239,2449,-210,-8.57,1170
2022-01-05,2239,2419,-180,-7.44,1170
2022-01-06,2239,2392,-153,-6.4,1170
2022-01-07,1950,2202,-252,-11.44,1170
2022-01-08,659,801,-142,-17.73,1170
2022-01-09,348,234,114,48.72,1170
2022-01-10,2114,2195,-81,-3.69,1170
2022-01-11,2239,2287,-48,-2.1,1170
2022-01-12,2239,2276,-37,-1.63,1170
2022-01-13,2239,2269,-30,-1.32,1170
2022-01-14,1950,2100,-150,-7.14,1170
2022-01-15,659,720,-61,-8.47,1170
2022-01-16,348,173,175,101.16,1170
2022-01-17,2114,2154,-40,-1.86,1170
2022-01-18,2239,2264,-25,-1.1,1170
2022-01-19,2239,2271,-32,-1.41,1170
2022-01-20,2239,2279,-40,-1.76,1170
2022-01-21,1950,2124,-174,-8.19,1170
2022-01-22,659,756,-97,-12.83,1170
2022-01-23,348,219,129,58.9,1170
2022-01-24,2114,2206,-92,-4.17,1170
2022-01-25,2239,2321,-82,-3.53,1170
2022-01-26,2239,2331,-92,-3.95,1170
2022-01-27,2239,2340,-101,-4.32,1170
2022-01-28,1950,2183,-233,-10.67,1170
2022-01-29,659,812,-153,-18.84,1170
2022-01-30,348,270,78,28.89,1170
2020-02-01,263,93,170,182.8,1177
2020-02-02,178,51,127,249.02,1177
2020-02-03,1268,1216,52,4.28,1177
2020-02-04,1266,1191,75,6.3,1177
2020-02-05,1266,1192,74,6.21,1177
2020-02-06,1266,1190,76,6.39,1177
2020-02-07,1062,1011,51,5.04,1177
2020-02-08,263,91,172,189.01,1177
2020-02-09,178,48,130,270.83,1177
2020-02-10,1268,1211,57,4.71,1177
2020-02-11,1266,1187,79,6.66,1177
2020-02-12,1266,1189,77,6.48,1177
2020-02-13,1266,1189,77,6.48,1177
2020-02-14,1062,1012,50,4.94,1177
2020-02-15,263,97,166,171.13,1177
2020-02-16,178,47,131,278.72,1177
2020-02-17,1268,1227,41,3.34,1177
2020-02-18,1266,1209,57,4.71,1177
2020-02-19,1266,1217,49,4.03,1177
2020-02-20,1266,1224,42,3.43,1177
2020-02-21,1062,1055,7,0.66,1177
2020-02-22,263,146,117,80.14,1177
2020-02-23,178,14,164,1171.43,1177
2020-02-24,1268,1290,-22,-1.71,1177
2020-02-25,1266,1278,-12,-0.94,1177
2020-02-26,1266,1292,-26,-2.01,1177
2020-02-27,1266,1304,-38,-2.91,1177
2020-02-28,1062,1138,-76,-6.68,1177
2020-02-29,263,232,31,13.36,1177
2020-03-01,106,103,3,2.91,1177
2020-03-02,998,1380,-382,-27.68,1177
2020-03-03,981,1367,-386,-28.24,1177
2020-03-04,981,1380,-399,-28.91,1177
2020-03-05,981,1390,-409,-29.42,1177
2020-03-06,820,1222,-402,-32.9,1177
2020-03-07,175,312,-137,-43.91,1177
2020-03-08,106,178,-72,-40.45,1177
2020-03-09,998,1450,-452,-31.17,1177
2020-03-10,981,1432,-451,-31.49,1177
2020-03-11,981,1438,-457,-31.78,1177
2020-03-12,981,1443,-462,-32.02,1177
2020-03-13,820,1268,-448,-35.33,1177
2020-03-14,175,352,-177,-50.28,1177
2020-03-15,106,212,-106,-50.0,1177
2020-03-16,998,1479,-481,-32.52,1177
2020-03-17,981,1456,-475,-32.62,1177
2020-03-18,981,1459,-478,-32.76,1177
2020-03-19,981,1460,-479,-32.81,1177
2020-03-20,820,1282,-462,-36.04,1177
2020-03-21,175,365,-190,-52.05,1177
2020-03-22,106,224,-118,-52.68,1177
2020-03-23,998,1490,-492,-33.02,1177
2020-03-24,981,1468,-487,-33.17,1177
2020-03-25,981,1472,-491,-33.36,1177
2020-03-26,981,1475,-494,-33.49,1177
2020-03-27,820,1300,-480,-36.92,1177
2020-03-28,175,385,-210,-54.55,1177
2020-03-29,106,247,-141,-57.09,1177
2020-03-30,998,1517,-519,-34.21,1177
2020-03-31,981,1498,-517,-34.51,1177
2020-04-01,835,1505,-670,-44.52,1177
2020-04-02,835,1511,-676,-44.74,1177
2020-04-03,693,1339,-646,-48.24,1177
2020-04-04,154,427,-273,-63.93,1177
2020-04-05,61,291,-230,-79.04,1177
2020-04-06,910,1562,-652,-41.74,1177
2020-04-07,835,1544,-709,-45.92,1177
2020-04-08,835,1551,-716,-46.16,1177
2020-04-09,835,1557,-722,-46.37,1177
2020-04-10,693,1384,-691,-49.93,1177
2020-04-11,154,470,-316,-67.23,1177
2020-04-12,61,333,-272,-81.68,1177
2020-04-13,910,1601,-691,-43.16,1177
2020-04-14,835,1581,-746,-47.19,1177
2020-04-15,835,1585,-750,-47.32,1177
2020-04-16,835,1588,-753,-47.42,1177
2020-04-17,693,1412,-719,-50.92,1177
2020-04-18,154,495,-341,-68.89,1177
2020-04-19,61,355,-294,-82.82,1177
2020-04-20,910,1621,-711,-43.86,1177
2020-04-21,835,1598,-763,-47.75,1177
2020-04-22,835,1601,-766,-47.85,1177
2020-04-23,835,1602,-767,-47.88,1177
2020-04-24,693,1425,-732,-51.37,1177
2020-04-25,154,508,-354,-69.69,1177
2020-04-26,61,368,-307,-83.42,1177
2020-04-27,910,1635,-725,-44.34,1177
2020-04-28,835,1613,-778,-48.23,1177
2020-04-29,835,1617,-782,-48.36,1177
2020-04-30,835,1620,-785,-48.46,1177
2020-05-01,883,1445,-562,-38.89,1177
2020-05-02,230,531,-301,-56.69,1177
2020-05-03,88,393,-305,-77.61,1177
2020-05-04,1150,1662,-512,-30.81,1177
2020-05-05,1240,1643,-403,-24.53,1177
2020-05-06,1240,1649,-409,-24.8,1177
2020-05-07,1240,1654,-414,-25.03,1177
2020-05-08,883,1480,-597,-40.34,1177
2020-05-09,230,567,-337,-59.44,1177
2020-05-10,88,429,-341,-79.49,1177
2020-05-11,1150,1698,-548,-32.27,1177
2020-05-12,1240,1678,-438,-26.1,1177
2020-05-13,1240,1683,-443,-26.32,1177
2020-05-14,1240,1686,-446,-26.45,1177
2020-05-15,883,1510,-627,-41.52,1177
2020-05-16,230,593,-363,-61.21,1177
2020-05-17,88,452,-364,-80.53,1177
2020-05-18,1150,1717,-567,-33.02,1177
2020-05-19,1240,1693,-453,-26.76,1177
2020-05-20,1240,1693,-453,-26.76,1177
2020-05-21,1240,1692,-452,-26.71,1177
2020-05-22,883,1511,-628,-41.56,1177
2020-05-23,230,591,-361,-61.08,1177
2020-05-24,88,446,-358,-80.27,1177
2020-05-25,1150,1707,-557,-32.63,1177
2020-05-26,1240,1680,-440,-26.19,1177
2020-05-27,1240,1679,-439,-26.15,1177
2020-05-28,1240,1675,-435,-25.97,1177
2020-05-29,883,1494,-611,-40.9,1177
2020-05-30,230,573,-343,-59.86,1177
2020-05-31,88,428,-340,-79.44,1177
2020-06-01,1392,1691,-299,-17.68,1177
2020-06-02,1467,1665,-198,-11.89,1177
2020-06-03,1467,1666,-199,-11.94,1177
2020-06-04,1467,1665,-198,-11.89,1177
2020-06-05,1088,1486,-398,-26.78,1177
2020-06-06,256,568,-312,-54.93,1177
2020-06-07,118,427,-309,-72.37,1177
2020-06-08,1392,1693,-301,-17.78,1177
2020-06-09,1467,1671,-204,-12.21,1177
2020-06-10,1467,1674,-207,-12.37,1177
2020-06-11,1467,1676,-209,-12.47,1177
2020-06-12,1088,1499,-411,-27.42,1177
2020-06-13,256,582,-326,-56.01,1177
2020-06-14,118,441,-323,-73.24,1177
2020-06-15,1392,1707,-315,-18.45,1177
2020-06-16,1467,1683,-216,-12.83,1177
2020-06-17,1467,1685,-218,-12.94,1177
2020-06-18,1467,1683,-216,-12.83,1177
2020-06-19,1088,1503,-415,-27.61,1177
2020-06-20,256,582,-326,-56.01,1177
2020-06-21,118,436,-318,-72.94,1177
2020-06-22,1392,1695,-303,-17.88,1177
2020-06-23,1467,1665,-198,-11.89,1177
2020-06-24,1467,1660,-193,-11.63,1177
2020-06-25,1467,1652,-185,-11.2,1177
2020-06-26,1088,1464,-376,-25.68,1177
2020-06-27,256,536,-280,-52.24,1177
2020-06-28,118,384,-266,-69.27,1177
2020-06-29,1392,1638,-246,-15.02,1177
2020-06-30,1467,1602,-135,-8.43,1177
2020-07-01,1594,1592,2,0.13,1177
2020-07-02,1594,1580,14,0.89,1177
2020-07-03,1262,1390,-128,-9.21,1177
2020-07-04,284,460,-176,-38.26,1177
2020-07-05,161,307,-146,-47.56,1177
2020-07-06,1429,1562,-133,-8.51,1177
2020-07-07,1594,1528,66,4.32,1177
2020-07-08,1594,1521,73,4.8,1177
2020-07-09,1594,1513,81,5.35,1177
2020-07-10,1262,1328,-66,-4.97,1177
2020-07-11,284,403,-119,-29.53,1177
2020-07-12,161,257,-96,-37.35,1177
2020-07-13,1429,1518,-89,-5.86,1177
2020-07-14,1594,1491,103,6.91,1177
2020-07-15,1594,1491,103,6.91,1177
2020-07-16,1594,1491,103,6.91,1177
2020-07-17,1262,1312,-50,-3.81,1177
2020-07-18,284,395,-111,-28.1,1177
2020-07-19,161,255,-94,-36.86,1177
2020-07-20,1429,1521,-92,-6.05,1177
2020-07-21,1594,1499,95,6.34,1177
2020-07-22,1594,1503,91,6.05,1177
2020-07-23,1594,1505,89,5.91,1177
2020-07-24,1262,1329,-67,-5.04,1177
2020-07-25,284,412,-128,-31.07,1177
2020-07-26,161,271,-110,-40.59,1177
2020-07-27,1429,1536,-107,-6.97,1177
2020-07-28,1594,1511,83,5.49,1177
2020-07-29,1594,1512,82,5.42,1177
2020-07-30,1594,1510,84,5.56,1177
2020-07-31,1262,1328,-66,-4.97,1177
2020-08-01,292,406,-114,-28.08,1177
2020-08-02,156,259,-103,-39.77,1177
2020-08-03,1412,1519,-107,-7.04,1177
2020-08-04,1474,1488,-14,-0.94,1177
2020-08-05,1474,1483,-9,-0.61,1177
2020-08-06,1474,1476,-2,-0.14,1177
2020-08-07,1190,1291,-101,-7.82,1177
2020-08-08,292,365,-73,-20.0,1177
2020-08-09,156,216,-60,-27.78,1177
2020-08-10,1412,1473,-61,-4.14,1177
2020-08-11,1474,1443,31,2.15,1177
2020-08-12,1474,1439,35,2.43,1177
2020-08-13,1474,1434,40,2.79,1177
2020-08-14,1190,1251,-61,-4.88,1177
2020-08-15,292,330,-38,-11.52,1177
2020-08-16,156,186,-30,-16.13,1177
2020-08-17,1412,1450,-38,-2.62,1177
2020-08-18,1474,1427,47,3.29,1177
2020-08-19,1474,1431,43,3.0,1177
2020-08-20,1474,1434,40,2.79,1177
2020-08-21,1190,1260,-70,-5.56,1177
2020-08-22,292,348,-56,-16.09,1177
2020-08-23,156,213,-57,-26.76,1177
2020-08-24,1412,1485,-73,-4.92,1177
2020-08-25,1474,1470,4,0.27,1177
2020-08-26,1474,1482,-8,-0.54,1177
2020-08-27,1474,1492,-18,-1.21,1177
2020-08-28,1190,1324,-134,-10.12,1177
2020-08-29,292,416,-124,-29.81,1177
2020-08-30,156,285,-129,-45.26,1177
2020-08-31,1412,1560,-148,-9.49,1177
2020-09-01,1487,1546,-59,-3.82,1177
2020-09-02,1487,1557,-70,-4.5,1177
2020-09-03,1487,1565,-78,-4.98,1177
2020-09-04,1146,1395,-249,-17.85,1177
2020-09-05,267,483,-216,-44.72,1177
2020-09-06,144,347,-203,-58.5,1177
2020-09-07,1417,1617,-200,-12.37,1177
2020-09-08,1487,1597,-110,-6.89,1177
2020-09-09,1487,1601,-114,-7.12,1177
2020-09-10,1487,1602,-115,-7.18,1177
2020-09-11,1146,1424,-278,-19.52,1177
2020-09-12,267,506,-239,-47.23,1177
2020-09-13,144,362,-218,-60.22,1177
2020-09-14,1417,1625,-208,-12.8,1177
2020-09-15,1487,1598,-111,-6.95,1177
2020-09-16,1487,1597,-110,-6.89,1177
2020-09-17,1487,1593,-106,-6.65,1177
2020-09-18,1146,1411,-265,-18.78,1177
2020-09-19,267,489,-222,-45.4,1177
2020-09-20,144,343,-199,-58.02,1177
2020-09-21,1417,1604,-187,-11.66,1177
2020-09-22,1487,1576,-89,-5.65,1177
2020-09-23,1487,1575,-88,-5.59,1177
2020-09-24,1487,1572,-85,-5.41,1177
2020-09-25,1146,1392,-246,-17.67,1177
2020-09-26,267,471,-204,-43.31,1177
2020-09-27,144,328,-184,-56.1,1177
2020-09-28,1417,1592,-175,-10.99,1177
2020-09-29,1487,1568,-81,-5.17,1177
2020-09-30,1487,1569,-82,-5.23,1177
2020-10-01,1466,1570,-104,-6.62,1177
2020-10-02,1143,1392,-249,-17.89,1177
2020-10-03,243,474,-231,-48.73,1177
2020-10-04,128,333,-205,-61.56,1177
2020-10-05,1483,1599,-116,-7.25,1177
2020-10-06,1466,1575,-109,-6.92,1177
2020-10-07,1466,1578,-112,-7.1,1177
2020-10-08,1466,1578,-112,-7.1,1177
2020-10-09,1143,1399,-256,-18.3,1177
2020-10-10,243,480,-237,-49.38,1177
2020-10-11,128,337,-209,-62.02,1177
2020-10-12,1483,1600,-117,-7.31,1177
2020-10-13,1466,1574,-108,-6.86,1177
2020-10-14,1466,1573,-107,-6.8,1177
2020-10-15,1466,1570,-104,-6.62,1177
2020-10-16,1143,1387,-244,-17.59,1177
2020-10-17,243,465,-222,-47.74,1177
2020-10-18,128,318,-190,-59.75,1177
2020-10-19,1483,1578,-95,-6.02,1177
2020-10-20,1466,1549,-83,-5.36,1177
2020-10-21,1466,1546,-80,-5.17,1177
2020-10-22,1466,1540,-74,-4.81,1177
2020-10-23,1143,1356,-213,-15.71,1177
2020-10-24,243,433,-190,-43.88,1177
2020-10-25,128,286,-158,-55.24,1177
2020-10-26,1483,1546,-63,-4.08,1177
2020-10-27,1466,1518,-52,-3.43,1177
2020-10-28,1466,1516,-50,-3.3,1177
2020-10-29,1466,1513,-47,-3.11,1177
2020-10-30,1143,1332,-189,-14.19,1177
2020-10-31,243,411,-168,-40.88,1177
2020-11-01,107,267,-160,-59.93,1177
2020-11-02,1248,1531,-283,-18.48,1177
2020-11-03,1226,1506,-280,-18.59,1177
2020-11-04,1226,1507,-281,-18.65,1177
2020-11-05,1226,1506,-280,-18.59,1177
2020-11-06,1051,1328,-277,-20.86,1177
2020-11-07,210,410,-200,-48.78,1177
2020-11-08,107,267,-160,-59.93,1177
2020-11-09,1248,1532,-284,-18.54,1177
2020-11-10,1226,1507,-281,-18.65,1177
2020-11-11,1226,1508,-282,-18.7,1177
2020-11-12,1226,1507,-281,-18.65,1177
2020-11-13,1051,1326,-275,-20.74,1177
2020-11-14,210,406,-196,-48.28,1177
2020-11-15,107,261,-154,-59.0,1177
2020-11-16,1248,1522,-274,-18.0,1177
2020-11-17,1226,1493,-267,-17.88,1177
2020-11-18,1226,1490,-264,-17.72,1177
2020-11-19,1226,1484,-258,-17.39,1177
2020-11-20,1051,1299,-248,-19.09,1177
2020-11-21,210,374,-164,-43.85,1177
2020-11-22,107,224,-117,-52.23,1177
2020-11-23,1248,1481,-233,-15.73,1177
2020-11-24,1226,1449,-223,-15.39,1177
2020-11-25,1226,1443,-217,-15.04,1177
2020-11-26,1226,1434,-208,-14.5,1177
2020-11-27,1051,1247,-196,-15.72,1177
2020-11-28,210,321,-111,-34.58,1177
2020-11-29,107,171,-64,-37.43,1177
2020-11-30,1248,1428,-180,-12.61,1177
2020-12-01,1011,1396,-385,-27.58,1177
2020-12-02,1011,1391,-380,-27.32,1177
2020-12-03,1011,1385,-374,-27.0,1177
2020-12-04,1142,1201,-59,-4.91,1177
2020-12-05,234,278,-44,-15.83,1177
2020-12-06,105,132,-27,-20.45,1177
2020-12-07,1003,1393,-390,-28.0,1177
2020-12-08,1011,1365,-354,-25.93,1177
2020-12-09,1011,1364,-353,-25.88,1177
2020-12-10,1011,1362,-351,-25.77,1177
2020-12-11,1142,1182,-40,-3.38,1177
2020-12-12,234,261,-27,-10.34,1177
2020-12-13,105,117,-12,-10.26,1177
2020-12-14,1003,1380,-377,-27.32,1177
2020-12-15,1011,1354,-343,-25.33,1177
2020-12-16,1011,1353,-342,-25.28,1177
2020-12-17,1011,1350,-339,-25.11,1177
2020-12-18,1142,1169,-27,-2.31,1177
2020-12-19,234,246,-12,-4.88,1177
2020-12-20,105,99,6,6.06,1177
2020-12-21,1003,1358,-355,-26.14,1177
2020-12-22,1011,1327,-316,-23.81,1177
2020-12-23,1011,1322,-311,-23.52,1177
2020-12-24,1011,1313,-302,-23.0,1177
2020-12-25,1142,1126,16,1.42,1177
2020-12-26,234,197,37,18.78,1177
2020-12-27,105,45,60,133.33,1177
2020-12-28,1003,1298,-295,-22.73,1177
2020-12-29,1011,1262,-251,-19.89,1177
2020-12-30,1011,1252,-241,-19.25,1177
2020-12-31,1011,1239,-228,-18.4,1177
2021-01-01,837,1048,-211,-20.13,1177
2021-01-02,181,117,64,54.7,1177
2021-01-03,107,72,35,48.61,1177
2021-01-04,845,1216,-371,-30.51,1177
2021-01-05,950,1181,-231,-19.56,1177
2021-01-06,950,1172,-222,-18.94,1177
2021-01-07,950,1163,-213,-18.31,1177
2021-01-08,837,976,-139,-14.24,1177
2021-01-09,181,50,131,262.0,1177
2021-01-10,107,43,64,148.84,1177
2021-01-11,845,1161,-316,-27.22,1177
2021-01-12,950,1133,-183,-16.15,1177
2021-01-13,950,1132,-182,-16.08,1177
2021-01-14,950,1130,-180,-15.93,1177
2021-01-15,837,951,-114,-11.99,1177
2021-01-16,181,34,147,432.35,1177
2021-01-17,107,39,68,174.36,1177
2021-01-18,845,1160,-315,-27.16,1177
2021-01-19,950,1139,-189,-16.59,1177
2021-01-20,950,1144,-194,-16.96,1177
2021-01-21,950,1147,-197,-17.18,1177
2021-01-22,837,973,-136,-13.98,1177
2021-01-23,181,59,122,206.78,1177
2021-01-24,107,51,56,109.8,1177
2021-01-25,845,1189,-344,-28.93,1177
2021-01-26,950,1169,-219,-18.73,1177
2021-01-27,950,1173,-223,-19.01,1177
2021-01-28,950,1176,-226,-19.22,1177
2021-01-29,837,1000,-163,-16.3,1177
2021-01-30,181,83,98,118.07,1177
2021-01-31,107,67,40,59.7,1177
2021-02-01,1110,1207,-97,-8.04,1177
2021-02-02,1086,1182,-96,-8.12,1177
2021-02-03,1086,1183,-97,-8.2,1177
2021-02-04,1086,1182,-96,-8.12,1177
2021-02-05,944,1003,-59,-5.88,1177
2021-02-06,188,83,105,126.51,1177
2021-02-07,109,64,45,70.31,1177
2021-02-08,1110,1203,-93,-7.73,1177
2021-02-09,1086,1178,-92,-7.81,1177
2021-02-10,1086,1179,-93,-7.89,1177
2021-02-11,1086,1179,-93,-7.89,1177
2021-02-12,944,1001,-57,-5.69,1177
2021-02-13,188,84,104,123.81,1177
2021-02-14,109,68,41,60.29,1177
2021-02-15,1110,1212,-102,-8.42,1177
2021-02-16,1086,1192,-106,-8.89,1177
2021-02-17,1086,1199,-113,-9.42,1177
2021-02-18,1086,1205,-119,-9.88,1177
2021-02-19,944,1034,-90,-8.7,1177
2021-02-20,188,125,63,50.4,1177
2021-02-21,109,88,21,23.86,1177
2021-02-22,1110,1267,-157,-12.39,1177
2021-02-23,1086,1254,-168,-13.4,1177
2021-02-24,1086,1267,-181,-14.29,1177
2021-02-25,1086,1279,-193,-15.09,1177
2021-02-26,944,1113,-169,-15.18,1177
2021-02-27,188,207,-19,-9.18,1177
2021-02-28,109,78,31,39.74,1177
2021-03-01,1201,1355,-154,-11.37,1177
2021-03-02,1275,1343,-68,-5.06,1177
2021-03-03,1275,1356,-81,-5.97,1177
2021-03-04,1275,1367,-92,-6.73,1177
2021-03-05,1051,1200,-149,-12.42,1177
2021-03-06,221,291,-70,-24.05,1177
2021-03-07,125,158,-33,-20.89,1177
2021-03-08,1201,1431,-230,-16.07,1177
2021-03-09,1275,1414,-139,-9.83,1177
2021-03-10,1275,1422,-147,-10.34,1177
2021-03-11,1275,1427,-152,-10.65,1177
2021-03-12,1051,1253,-202,-16.12,1177
2021-03-13,221,339,-118,-34.81,1177
2021-03-14,125,200,-75,-37.5,1177
2021-03-15,1201,1467,-266,-18.13,1177
2021-03-16,1275,1445,-170,-11.76,1177
2021-03-17,1275,1448,-173,-11.95,1177
2021-03-18,1275,1449,-174,-12.01,1177
2021-03-19,1051,1271,-220,-17.31,1177
2021-03-20,221,354,-133,-37.57,1177
2021-03-21,125,213,-88,-41.31,1177
2021-03-22,1201,1479,-278,-18.8,1177
2021-03-23,1275,1456,-181,-12.43,1177
2021-03-24,1275,1460,-185,-12.67,1177
2021-03-25,1275,1462,-187,-12.79,1177
2021-03-26,1051,1286,-235,-18.27,1177
2021-03-27,221,371,-150,-40.43,1177
2021-03-28,125,232,-107,-46.12,1177
2021-03-29,1201,1501,-300,-19.99,1177
2021-03-30,1275,1482,-207,-13.97,1177
2021-03-31,1275,1489,-214,-14.37,1177
2021-04-01,1254,1494,-240,-16.06,1177
2021-04-02,1044,1321,-277,-20.97,1177
2021-04-03,235,409,-174,-42.54,1177
2021-04-04,106,273,-167,-61.17,1177
2021-04-05,1324,1544,-220,-14.25,1177
2021-04-06,1254,1527,-273,-17.88,1177
2021-04-07,1254,1534,-280,-18.25,1177
2021-04-08,1254,1540,-286,-18.57,1177
2021-04-09,1044,1367,-323,-23.63,1177
2021-04-10,235,454,-219,-48.24,1177
2021-04-11,106,317,-211,-66.56,1177
2021-04-12,1324,1587,-263,-16.57,1177
2021-04-13,1254,1567,-313,-19.97,1177
2021-04-14,1254,1572,-318,-20.23,1177
2021-04-15,1254,1575,-321,-20.38,1177
2021-04-16,1044,1399,-355,-25.38,1177
2021-04-17,235,483,-248,-51.35,1177
2021-04-18,106,343,-237,-69.1,1177
2021-04-19,1324,1609,-285,-17.71,1177
2021-04-20,1254,1587,-333,-20.98,1177
2021-04-21,1254,1590,-336,-21.13,1177
2021-04-22,1254,1591,-337,-21.18,1177
2021-04-23,1044,1414,-370,-26.17,1177
2021-04-24,235,497,-262,-52.72,1177
2021-04-25,106,356,-250,-70.22,1177
2021-04-26,1324,1622,-298,-18.37,1177
2021-04-27,1254,1600,-346,-21.62,1177
2021-04-28,1254,1604,-350,-21.82,1177
2021-04-29,1254,1607,-353,-21.97,1177
2021-04-30,1044,1431,-387,-27.04,1177
2021-05-01,264,516,-252,-48.84,1177
2021-05-02,132,378,-246,-65.08,1177
2021-05-03,1702,1647,55,3.34,1177
2021-05-04,1645,1627,18,1.11,1177
2021-05-05,1645,1634,11,0.67,1177
2021-05-06,1645,1638,7,0.43,1177
2021-05-07,1220,1465,-245,-16.72,1177
2021-05-08,264,551,-287,-52.09,1177
2021-05-09,132,414,-282,-68.12,1177
2021-05-10,1702,1683,19,1.13,1177
2021-05-11,1645,1663,-18,-1.08,1177
2021-05-12,1645,1669,-24,-1.44,1177
2021-05-13,1645,1672,-27,-1.61,1177
2021-05-14,1220,1497,-277,-18.5,1177
2021-05-15,264,581,-317,-54.56,1177
2021-05-16,132,441,-309,-70.07,1177
2021-05-17,1702,1707,-5,-0.29,1177
2021-05-18,1645,1683,-38,-2.26,1177
2021-05-19,1645,1685,-40,-2.37,1177
2021-05-20,1645,1684,-39,-2.32,1177
2021-05-21,1220,1504,-284,-18.88,1177
2021-05-22,264,584,-320,-54.79,1177
2021-05-23,132,439,-307,-69.93,1177
2021-05-24,1702,1701,1,0.06,1177
2021-05-25,1645,1674,-29,-1.73,1177
2021-05-26,1645,1673,-28,-1.67,1177
2021-05-27,1645,1669,-24,-1.44,1177
2021-05-28,1220,1488,-268,-18.01,1177
2021-05-29,264,566,-302,-53.36,1177
2021-05-30,132,422,-290,-68.72,1177
2021-05-31,1702,1684,18,1.07,1177
2021-06-01,1533,1658,-125,-7.54,1177
2021-06-02,1533,1657,-124,-7.48,1177
2021-06-03,1533,1656,-123,-7.43,1177
2021-06-04,1286,1477,-191,-12.93,1177
2021-06-05,309,558,-249,-44.62,1177
2021-06-06,168,417,-249,-59.71,1177
2021-06-07,1743,1682,61,3.63,1177
2021-06-08,1533,1659,-126,-7.59,1177
2021-06-09,1533,1662,-129,-7.76,1177
2021-06-10,1533,1664,-131,-7.87,1177
2021-06-11,1286,1487,-201,-13.52,1177
2021-06-12,309,571,-262,-45.88,1177
2021-06-13,168,430,-262,-60.93,1177
2021-06-14,1743,1696,47,2.77,1177
2021-06-15,1533,1673,-140,-8.37,1177
2021-06-16,1533,1675,-142,-8.48,1177
2021-06-17,1533,1675,-142,-8.48,1177
2021-06-18,1286,1496,-210,-14.04,1177
2021-06-19,309,575,-266,-46.26,1177
2021-06-20,168,431,-263,-61.02,1177
2021-06-21,1743,1692,51,3.01,1177
2021-06-22,1533,1663,-130,-7.82,1177
2021-06-23,1533,1659,-126,-7.59,1177
2021-06-24,1533,1652,-119,-7.2,1177
2021-06-25,1286,1466,-180,-12.28,1177
2021-06-26,309,539,-230,-42.67,1177
2021-06-27,168,387,-219,-56.59,1177
2021-06-28,1743,1642,101,6.15,1177
2021-06-29,1533,1607,-74,-4.6,1177
2021-06-30,1533,1597,-64,-4.01,1177
2021-07-01,1575,1585,-10,-0.63,1177
2021-07-02,1280,1395,-115,-8.24,1177
2021-07-03,332,465,-133,-28.6,1177
2021-07-04,198,312,-114,-36.54,1177
2021-07-05,1586,1565,21,1.34,1177
2021-07-06,1575,1531,44,2.87,1177
2021-07-07,1575,1522,53,3.48,1177
2021-07-08,1575,1513,62,4.1,1177
2021-07-09,1280,1327,-47,-3.54,1177
2021-07-10,332,401,-69,-17.21,1177
2021-07-11,198,253,-55,-21.74,1177
2021-07-12,1586,1513,73,4.82,1177
2021-07-13,1575,1485,90,6.06,1177
2021-07-14,1575,1484,91,6.13,1177
2021-07-15,1575,1482,93,6.28,1177
2021-07-16,1280,1303,-23,-1.77,1177
2021-07-17,332,384,-52,-13.54,1177
2021-07-18,198,243,-45,-18.52,1177
2021-07-19,1586,1509,77,5.1,1177
2021-07-20,1575,1487,88,5.92,1177
2021-07-21,1575,1491,84,5.63,1177
2021-07-22,1575,1493,82,5.49,1177
2021-07-23,1280,1317,-37,-2.81,1177
2021-07-24,332,400,-68,-17.0,1177
2021-07-25,198,260,-62,-23.85,1177
2021-07-26,1586,1526,60,3.93,1177
2021-07-27,1575,1502,73,4.86,1177
2021-07-28,1575,1504,71,4.72,1177
2021-07-29,1575,1502,73,4.86,1177
2021-07-30,1280,1322,-42,-3.18,1177
2021-07-31,332,401,-69,-17.21,1177
2021-08-01,200,255,-55,-21.57,1177
2021-08-02,1495,1516,-21,-1.39,1177
2021-08-03,1452,1486,-34,-2.29,1177
2021-08-04,1452,1482,-30,-2.02,1177
2021-08-05,1452,1475,-23,-1.56,1177
2021-08-06,1194,1290,-96,-7.44,1177
2021-08-07,328,364,-36,-9.89,1177
2021-08-08,200,215,-15,-6.98,1177
2021-08-09,1495,1472,23,1.56,1177
2021-08-10,1452,1441,11,0.76,1177
2021-08-11,1452,1436,16,1.11,1177
2021-08-12,1452,1430,22,1.54,1177
2021-08-13,1194,1247,-53,-4.25,1177
2021-08-14,328,324,4,1.23,1177
2021-08-15,200,179,21,11.73,1177
2021-08-16,1495,1441,54,3.75,1177
2021-08-17,1452,1416,36,2.54,1177
2021-08-18,1452,1418,34,2.4,1177
2021-08-19,1452,1420,32,2.25,1177
2021-08-20,1194,1245,-51,-4.1,1177
2021-08-21,328,331,-3,-0.91,1177
2021-08-22,200,194,6,3.09,1177
2021-08-23,1495,1466,29,1.98,1177
2021-08-24,1452,1450,2,0.14,1177
2021-08-25,1452,1460,-8,-0.55,1177
2021-08-26,1452,1469,-17,-1.16,1177
2021-08-27,1194,1301,-107,-8.22,1177
2021-08-28,328,393,-65,-16.54,1177
2021-08-29,200,262,-62,-23.66,1177
2021-08-30,1495,1537,-42,-2.73,1177
2021-08-31,1452,1523,-71,-4.66,1177
2021-09-01,1562,1535,27,1.76,1177
2021-09-02,1562,1545,17,1.1,1177
2021-09-03,1346,1375,-29,-2.11,1177
2021-09-04,328,465,-137,-29.46,1177
2021-09-05,219,330,-111,-33.64,1177
2021-09-06,1666,1601,65,4.06,1177
2021-09-07,1562,1582,-20,-1.26,1177
2021-09-08,1562,1588,-26,-1.64,1177
2021-09-09,1562,1590,-28,-1.76,1177
2021-09-10,1346,1414,-68,-4.81,1177
2021-09-11,328,496,-168,-33.87,1177
2021-09-12,219,354,-135,-38.14,1177
2021-09-13,1666,1618,48,2.97,1177
2021-09-14,1562,1592,-30,-1.88,1177
2021-09-15,1562,1591,-29,-1.82,1177
2021-09-16,1562,1588,-26,-1.64,1177
2021-09-17,1346,1406,-60,-4.27,1177
2021-09-18,328,484,-156,-32.23,1177
2021-09-19,219,338,-119,-35.21,1177
2021-09-20,1666,1599,67,4.19,1177
2021-09-21,1562,1571,-9,-0.57,1177
2021-09-22,1562,1569,-7,-0.45,1177
2021-09-23,1562,1566,-4,-0.26,1177
2021-09-24,1346,1385,-39,-2.82,1177
2021-09-25,328,464,-136,-29.31,1177
2021-09-26,219,320,-101,-31.56,1177
2021-09-27,1666,1583,83,5.24,1177
2021-09-28,1562,1558,4,0.26,1177
2021-09-29,1562,1560,2,0.13,1177
2021-09-30,1562,1559,3,0.19,1177
2021-10-01,1344,1381,-37,-2.68,1177
2021-10-02,351,464,-113,-24.35,1177
2021-10-03,190,322,-132,-40.99,1177
2021-10-04,1500,1588,-88,-5.54,1177
2021-10-05,1564,1565,-1,-0.06,1177
2021-10-06,1564,1567,-3,-0.19,1177
2021-10-07,1564,1568,-4,-0.26,1177
2021-10-08,1344,1390,-46,-3.31,1177
2021-10-09,351,471,-120,-25.48,1177
2021-10-10,190,329,-139,-42.25,1177
2021-10-11,1500,1592,-92,-5.78,1177
2021-10-12,1564,1567,-3,-0.19,1177
2021-10-13,1564,1567,-3,-0.19,1177
2021-10-14,1564,1564,0,0.0,1177
2021-10-15,1344,1382,-38,-2.75,1177
2021-10-16,351,460,-109,-23.7,1177
2021-10-17,190,314,-124,-39.49,1177
2021-10-18,1500,1575,-75,-4.76,1177
2021-10-19,1564,1546,18,1.16,1177
2021-10-20,1564,1542,22,1.43,1177
2021-10-21,1564,1537,27,1.76,1177
2021-10-22,1344,1353,-9,-0.67,1177
2021-10-23,351,430,-79,-18.37,1177
2021-10-24,190,283,-93,-32.86,1177
2021-10-25,1500,1542,-42,-2.72,1177
2021-10-26,1564,1514,50,3.3,1177
2021-10-27,1564,1511,53,3.51,1177
2021-10-28,1564,1507,57,3.78,1177
2021-10-29,1344,1326,18,1.36,1177
2021-10-30,351,404,-53,-13.12,1177
2021-10-31,190,260,-70,-26.92,1177
2021-11-01,1337,1523,-186,-12.21,1177
2021-11-02,1392,1497,-105,-7.01,1177
2021-11-03,1392,1498,-106,-7.08,1177
2021-11-04,1392,1497,-105,-7.01,1177
2021-11-05,1174,1318,-144,-10.93,1177
2021-11-06,263,400,-137,-34.25,1177
2021-11-07,158,258,-100,-38.76,1177
2021-11-08,1337,1522,-185,-12.16,1177
2021-11-09,1392,1498,-106,-7.08,1177
2021-11-10,1392,1499,-107,-7.14,1177
2021-11-11,1392,1498,-106,-7.08,1177
2021-11-12,1174,1319,-145,-10.99,1177
2021-11-13,263,399,-136,-34.09,1177
2021-11-14,158,255,-97,-38.04,1177
2021-11-15,1337,1517,-180,-11.87,1177
2021-11-16,1392,1489,-97,-6.51,1177
2021-11-17,1392,1486,-94,-6.33,1177
2021-11-18,1392,1481,-89,-6.01,1177
2021-11-19,1174,1297,-123,-9.48,1177
2021-11-20,263,373,-110,-29.49,1177
2021-11-21,158,224,-66,-29.46,1177
2021-11-22,1337,1481,-144,-9.72,1177
2021-11-23,1392,1450,-58,-4.0,1177
2021-11-24,1392,1443,-51,-3.53,1177
2021-11-25,1392,1435,-43,-3.0,1177
2021-11-26,1174,1248,-74,-5.93,1177
2021-11-27,263,321,-58,-18.07,1177
2021-11-28,158,171,-13,-7.6,1177
2021-11-29,1337,1428,-91,-6.37,1177
2021-11-30,1392,1396,-4,-0.29,1177
2021-12-01,971,1390,-419,-30.14,1177
2021-12-02,971,1383,-412,-29.79,1177
2021-12-03,711,1199,-488,-40.7,1177
2021-12-04,226,275,-49,-17.82,1177
2021-12-05,131,127,4,3.15,1177
2021-12-06,1087,1388,-301,-21.69,1177
2021-12-07,971,1360,-389,-28.6,1177
2021-12-08,971,1358,-387,-28.5,1177
2021-12-09,971,1355,-384,-28.34,1177
2021-12-10,711,1174,-463,-39.44,1177
2021-12-11,226,254,-28,-11.02,1177
2021-12-12,131,110,21,19.09,1177
2021-12-13,1087,1373,-286,-20.83,1177
2021-12-14,971,1347,-376,-27.91,1177
2021-12-15,971,1347,-376,-27.91,1177
2021-12-16,971,1344,-373,-27.75,1177
2021-12-17,711,1163,-452,-38.87,1177
2021-12-18,226,241,-15,-6.22,1177
2021-12-19,131,95,36,37.89,1177
2021-12-20,1087,1355,-268,-19.78,1177
2021-12-21,971,1326,-355,-26.77,1177
2021-12-22,971,1321,-350,-26.5,1177
2021-12-23,971,1314,-343,-26.1,1177
2021-12-24,711,1127,-416,-36.91,1177
2021-12-25,226,200,26,13.0,1177
2021-12-26,131,48,83,172.92,1177
2021-12-27,1087,1302,-215,-16.51,1177
2021-12-28,971,1267,-296,-23.36,1177
2021-12-29,971,1257,-286,-22.75,1177
2021-12-30,971,1245,-274,-22.01,1177
2021-12-31,711,1054,-343,-32.54,1177
2022-01-01,176,123,53,43.09,1177
2022-01-02,105,148,-43,-29.05,1177
2022-01-03,955,1221,-266,-21.79,1177
2022-01-04,918,1185,-267,-22.53,1177
2022-01-05,918,1176,-258,-21.94,1177
2022-01-06,918,1165,-247,-21.2,1177
2022-01-07,848,977,-129,-13.2,1177
2022-01-08,176,50,126,252.0,1177
2022-01-09,105,127,-22,-17.32,1177
2022-01-10,955,1158,-203,-17.53,1177
2022-01-11,918,1129,-211,-18.69,1177
2022-01-12,918,1126,-208,-18.47,1177
2022-01-13,918,1123,-205,-18.25,1177
2022-01-14,848,943,-95,-10.07,1177
2022-01-15,176,23,153,665.22,1177
2022-01-16,105,115,-10,-8.7,1177
2022-01-17,955,1148,-193,-16.81,1177
2022-01-18,918,1126,-208,-18.47,1177
2022-01-19,918,1130,-212,-18.76,1177
2022-01-20,918,1133,-215,-18.98,1177
2022-01-21,848,958,-110,-11.48,1177
2022-01-22,176,44,132,300.0,1177
2022-01-23,105,128,-23,-17.97,1177
2022-01-24,955,1175,-220,-18.72,1177
2022-01-25,918,1155,-237,-20.52,1177
2022-01-26,918,1160,-242,-20.86,1177
2022-01-27,918,1163,-245,-21.07,1177
2022-01-28,848,987,-139,-14.08,1177
2022-01-29,176,71,105,147.89,1177
2022-01-30,105,141,-36,-25.53,1177
2020-02-01,341,281,60,21.35,1220
2020-02-02,198,110,88,80.0,1220
2020-02-03,832,794,38,4.79,1220
2020-02-04,844,891,-47,-5.27,1220
2020-02-05,844,887,-43,-4.85,1220
2020-02-06,844,883,-39,-4.42,1220
2020-02-07,826,793,33,4.16,1220
2020-02-08,341,273,68,24.91,1220
2020-02-09,198,101,97,96.04,1220
2020-02-10,832,787,45,5.72,1220
2020-02-11,844,885,-41,-4.63,1220
2020-02-12,844,882,-38,-4.31,1220
2020-02-13,844,880,-36,-4.09,1220
2020-02-14,826,793,33,4.16,1220
2020-02-15,341,276,65,23.55,1220
2020-02-16,198,108,90,83.33,1220
2020-02-17,832,797,35,4.39,1220
2020-02-18,844,899,-55,-6.12,1220
2020-02-19,844,900,-56,-6.22,1220
2020-02-20,844,902,-58,-6.43,1220
2020-02-21,826,819,7,0.85,1220
2020-02-22,341,305,36,11.8,1220
2020-02-23,198,140,58,41.43,1220
2020-02-24,832,832,0,0.0,1220
2020-02-25,844,936,-92,-9.83,1220
2020-02-26,844,939,-95,-10.12,1220
2020-02-27,844,942,-98,-10.4,1220
2020-02-28,826,860,-34,-3.95,1220
2020-02-29,341,346,-5,-1.45,1220
2020-03-01,106,181,-75,-41.44,1220
2020-03-02,543,872,-329,-37.73,1220
2020-03-03,549,975,-426,-43.69,1220
2020-03-04,549,977,-428,-43.81,1220
2020-03-05,549,978,-429,-43.87,1220
2020-03-06,464,894,-430,-48.1,1220
2020-03-07,167,378,-211,-55.82,1220
2020-03-08,106,210,-104,-49.52,1220
2020-03-09,543,899,-356,-39.6,1220
2020-03-10,549,1001,-452,-45.15,1220
2020-03-11,549,1001,-452,-45.15,1220
2020-03-12,549,1000,-451,-45.1,1220
2020-03-13,464,914,-450,-49.23,1220
2020-03-14,167,397,-230,-57.93,1220
2020-03-15,106,230,-124,-53.91,1220
2020-03-16,543,919,-376,-40.91,1220
2020-03-17,549,1020,-471,-46.18,1220
2020-03-18,549,1021,-472,-46.23,1220
2020-03-19,549,1021,-472,-46.23,1220
2020-03-20,464,937,-473,-50.48,1220
2020-03-21,167,422,-255,-60.43,1220
2020-03-22,106,256,-150,-58.59,1220
2020-03-23,543,947,-404,-42.66,1220
2020-03-24,549,1051,-502,-47.76,1220
2020-03-25,549,1054,-505,-47.91,1220
2020-03-26,549,1057,-508,-48.06,1220
2020-03-27,464,974,-510,-52.36,1220
2020-03-28,167,461,-294,-63.77,1220
2020-03-29,106,297,-191,-64.31,1220
2020-03-30,543,989,-446,-45.1,1220
2020-03-31,549,1093,-544,-49.77,1220
2020-04-01,372,1096,-724,-66.06,1220
2020-04-02,372,1098,-726,-66.12,1220
2020-04-03,277,1015,-738,-72.71,1220
2020-04-04,94,501,-407,-81.24,1220
2020-04-05,35,334,-299,-89.52,1220
2020-04-06,368,1024,-656,-64.06,1220
2020-04-07,372,1126,-754,-66.96,1220
2020-04-08,372,1127,-755,-66.99,1220
2020-04-09,372,1126,-754,-66.96,1220
2020-04-10,277,1040,-763,-73.37,1220
2020-04-11,94,523,-429,-82.03,1220
2020-04-12,35,354,-319,-90.11,1220
2020-04-13,368,1041,-673,-64.65,1220
2020-04-14,372,1141,-769,-67.4,1220
2020-04-15,372,1140,-768,-67.37,1220
2020-04-16,372,1138,-766,-67.31,1220
2020-04-17,277,1051,-774,-73.64,1220
2020-04-18,94,534,-440,-82.4,1220
2020-04-19,35,366,-331,-90.44,1220
2020-04-20,368,1054,-686,-65.09,1220
2020-04-21,372,1156,-784,-67.82,1220
2020-04-22,372,1158,-786,-67.88,1220
2020-04-23,372,1159,-787,-67.9,1220
2020-04-24,277,1077,-800,-74.28,1220
2020-04-25,94,563,-469,-83.3,1220
2020-04-26,35,400,-365,-91.25,1220
2020-04-27,368,1093,-725,-66.33,1220
2020-04-28,372,1200,-828,-69.0,1220
2020-04-29,372,1207,-835,-69.18,1220
2020-04-30,372,1213,-841,-69.33,1220
2020-05-01,488,1135,-647,-57.0,1220
2020-05-02,150,626,-476,-76.04,1220
2020-05-03,61,466,-405,-86.91,1220
2020-05-04,570,1162,-592,-50.95,1220
2020-05-05,600,1271,-671,-52.79,1220
2020-05-06,600,1279,-679,-53.09,1220
2020-05-07,600,1286,-686,-53.34,1220
2020-05-08,488,1207,-719,-59.57,1220
2020-05-09,150,696,-546,-78.45,1220
2020-05-10,61,533,-472,-88.56,1220
2020-05-11,570,1226,-656,-53.51,1220
2020-05-12,600,1331,-731,-54.92,1220
2020-05-13,600,1333,-733,-54.99,1220
2020-05-14,600,1333,-733,-54.99,1220
2020-05-15,488,1248,-760,-60.9,1220
2020-05-16,150,729,-579,-79.42,1220
2020-05-17,61,559,-498,-89.09,1220
2020-05-18,570,1244,-674,-54.18,1220
2020-05-19,600,1340,-740,-55.22,1220
2020-05-20,600,1334,-734,-55.02,1220
2020-05-21,600,1327,-727,-54.79,1220
2020-05-22,488,1234,-746,-60.45,1220
2020-05-23,150,709,-559,-78.84,1220
2020-05-24,61,533,-472,-88.56,1220
2020-05-25,570,1213,-643,-53.01,1220
2020-05-26,600,1305,-705,-54.02,1220
2020-05-27,600,1295,-695,-53.67,1220
2020-05-28,600,1286,-686,-53.34,1220
2020-05-29,488,1191,-703,-59.03,1220
2020-05-30,150,666,-516,-77.48,1220
2020-05-31,61,490,-429,-87.55,1220
2020-06-01,673,1171,-498,-42.53,1220
2020-06-02,729,1266,-537,-42.42,1220
2020-06-03,729,1259,-530,-42.1,1220
2020-06-04,729,1253,-524,-41.82,1220
2020-06-05,582,1163,-581,-49.96,1220
2020-06-06,187,642,-455,-70.87,1220
2020-06-07,85,471,-386,-81.95,1220
2020-06-08,673,1156,-483,-41.78,1220
2020-06-09,729,1255,-526,-41.91,1220
2020-06-10,729,1253,-524,-41.82,1220
2020-06-11,729,1250,-521,-41.68,1220
2020-06-12,582,1163,-581,-49.96,1220
2020-06-13,187,645,-458,-71.01,1220
2020-06-14,85,475,-390,-82.11,1220
2020-06-15,673,1161,-488,-42.03,1220
2020-06-16,729,1260,-531,-42.14,1220
2020-06-17,729,1257,-528,-42.0,1220
2020-06-18,729,1253,-524,-41.82,1220
2020-06-19,582,1163,-581,-49.96,1220
2020-06-20,187,641,-454,-70.83,1220
2020-06-21,85,467,-382,-81.8,1220
2020-06-22,673,1149,-476,-41.43,1220
2020-06-23,729,1243,-514,-41.35,1220
2020-06-24,729,1235,-506,-40.97,1220
2020-06-25,729,1226,-497,-40.54,1220
2020-06-26,582,1131,-549,-48.54,1220
2020-06-27,187,603,-416,-68.99,1220
2020-06-28,85,425,-340,-80.0,1220
2020-06-29,673,1103,-430,-38.98,1220
2020-06-30,729,1193,-464,-38.89,1220
2020-07-01,735,1181,-446,-37.76,1220
2020-07-02,735,1169,-434,-37.13,1220
2020-07-03,641,1073,-432,-40.26,1220
2020-07-04,181,545,-364,-66.79,1220
2020-07-05,98,367,-269,-73.3,1220
2020-07-06,695,1046,-351,-33.56,1220
2020-07-07,735,1138,-403,-35.41,1220
2020-07-08,735,1129,-394,-34.9,1220
2020-07-09,735,1121,-386,-34.43,1220
2020-07-10,641,1028,-387,-37.65,1220
2020-07-11,181,505,-324,-64.16,1220
2020-07-12,98,332,-234,-70.48,1220
2020-07-13,695,1016,-321,-31.59,1220
2020-07-14,735,1114,-379,-34.02,1220
2020-07-15,735,1110,-375,-33.78,1220
2020-07-16,735,1107,-372,-33.6,1220
2020-07-17,641,1020,-379,-37.16,1220
2020-07-18,181,501,-320,-63.87,1220
2020-07-19,98,332,-234,-70.48,1220
2020-07-20,695,1019,-324,-31.8,1220
2020-07-21,735,1119,-384,-34.32,1220
2020-07-22,735,1117,-382,-34.2,1220
2020-07-23,735,1115,-380,-34.08,1220
2020-07-24,641,1027,-386,-37.59,1220
2020-07-25,181,507,-326,-64.3,1220
2020-07-26,98,336,-238,-70.83,1220
2020-07-27,695,1021,-326,-31.93,1220
2020-07-28,735,1117,-382,-34.2,1220
2020-07-29,735,1111,-376,-33.84,1220
2020-07-30,735,1105,-370,-33.48,1220
2020-07-31,641,1012,-371,-36.66,1220
2020-08-01,214,487,-273,-56.06,1220
2020-08-02,121,311,-190,-61.09,1220
2020-08-03,691,991,-300,-30.27,1220
2020-08-04,764,1083,-319,-29.46,1220
2020-08-05,764,1073,-309,-28.8,1220
2020-08-06,764,1063,-299,-28.13,1220
2020-08-07,642,968,-326,-33.68,1220
2020-08-08,214,441,-227,-51.47,1220
2020-08-09,121,264,-143,-54.17,1220
2020-08-10,691,944,-253,-26.8,1220
2020-08-11,764,1037,-273,-26.33,1220
2020-08-12,764,1029,-265,-25.75,1220
2020-08-13,764,1022,-258,-25.24,1220
2020-08-14,642,931,-289,-31.04,1220
2020-08-15,214,409,-195,-47.68,1220
2020-08-16,121,238,-117,-49.16,1220
2020-08-17,691,924,-233,-25.22,1220
2020-08-18,764,1024,-260,-25.39,1220
2020-08-19,764,1024,-260,-25.39,1220
2020-08-20,764,1024,-260,-25.39,1220
2020-08-21,642,941,-299,-31.77,1220
2020-08-22,214,427,-213,-49.88,1220
2020-08-23,121,263,-142,-53.99,1220
2020-08-24,691,957,-266,-27.8,1220
2020-08-25,764,1063,-299,-28.13,1220
2020-08-26,764,1069,-305,-28.53,1220
2020-08-27,764,1074,-310,-28.86,1220
2020-08-28,642,995,-353,-35.48,1220
2020-08-29,214,485,-271,-55.88,1220
2020-08-30,121,323,-202,-62.54,1220
2020-08-31,691,1018,-327,-32.12,1220
2020-09-01,870,1124,-254,-22.6,1220
2020-09-02,870,1129,-259,-22.94,1220
2020-09-03,870,1133,-263,-23.21,1220
2020-09-04,733,1052,-319,-30.32,1220
2020-09-05,235,538,-303,-56.32,1220
2020-09-06,126,372,-246,-66.13,1220
2020-09-07,732,1062,-330,-31.07,1220
2020-09-08,870,1164,-294,-25.26,1220
2020-09-09,870,1163,-293,-25.19,1220
2020-09-10,870,1162,-292,-25.13,1220
2020-09-11,733,1075,-342,-31.81,1220
2020-09-12,235,555,-320,-57.66,1220
2020-09-13,126,385,-259,-67.27,1220
2020-09-14,732,1070,-338,-31.59,1220
2020-09-15,870,1167,-297,-25.45,1220
2020-09-16,870,1163,-293,-25.19,1220
2020-09-17,870,1159,-289,-24.94,1220
2020-09-18,733,1069,-336,-31.43,1220
2020-09-19,235,549,-314,-57.19,1220
2020-09-20,126,377,-251,-66.58,1220
2020-09-21,732,1062,-330,-31.07,1220
2020-09-22,870,1160,-290,-25.0,1220
2020-09-23,870,1158,-288,-24.87,1220
2020-09-24,870,1155,-285,-24.68,1220
2020-09-25,733,1068,-335,-31.37,1220
2020-09-26,235,550,-315,-57.27,1220
2020-09-27,126,382,-256,-67.02,1220
2020-09-28,732,1070,-338,-31.59,1220
2020-09-29,870,1171,-301,-25.7,1220
2020-09-30,870,1172,-302,-25.77,1220
2020-10-01,727,1172,-445,-37.97,1220
2020-10-02,688,1088,-400,-36.76,1220
2020-10-03,197,572,-375,-65.56,1220
2020-10-04,84,406,-322,-79.31,1220
2020-10-05,668,1095,-427,-39.0,1220
2020-10-06,727,1198,-471,-39.32,1220
2020-10-07,727,1198,-471,-39.32,1220
2020-10-08,727,1198,-471,-39.32,1220
2020-10-09,688,1112,-424,-38.13,1220
2020-10-10,197,595,-398,-66.89,1220
2020-10-11,84,426,-342,-80.28,1220
2020-10-12,668,1112,-444,-39.93,1220
2020-10-13,727,1211,-484,-39.97,1220
2020-10-14,727,1207,-480,-39.77,1220
2020-10-15,727,1202,-475,-39.52,1220
2020-10-16,688,1112,-424,-38.13,1220
2020-10-17,197,589,-392,-66.55,1220
2020-10-18,84,415,-331,-79.76,1220
2020-10-19,668,1096,-428,-39.05,1220
2020-10-20,727,1190,-463,-38.91,1220
2020-10-21,727,1181,-454,-38.44,1220
2020-10-22,727,1171,-444,-37.92,1220
2020-10-23,688,1076,-388,-36.06,1220
2020-10-24,197,550,-353,-64.18,1220
2020-10-25,84,371,-287,-77.36,1220
2020-10-26,668,1049,-381,-36.32,1220
2020-10-27,727,1140,-413,-36.23,1220
2020-10-28,727,1129,-402,-35.61,1220
2020-10-29,727,1117,-390,-34.91,1220
2020-10-30,688,1021,-333,-32.62,1220
2020-10-31,197,493,-296,-60.04,1220
2020-11-01,69,314,-245,-78.03,1220
2020-11-02,584,992,-408,-41.13,1220
2020-11-03,579,1083,-504,-46.54,1220
2020-11-04,579,1073,-494,-46.04,1220
2020-11-05,579,1062,-483,-45.48,1220
2020-11-06,499,967,-468,-48.4,1220
2020-11-07,132,441,-309,-70.07,1220
2020-11-08,69,264,-195,-73.86,1220
2020-11-09,584,944,-360,-38.14,1220
2020-11-10,579,1037,-458,-44.17,1220
2020-11-11,579,1029,-450,-43.73,1220
2020-11-12,579,1022,-443,-43.35,1220
2020-11-13,499,929,-430,-46.29,1220
2020-11-14,132,406,-274,-67.49,1220
2020-11-15,69,233,-164,-70.39,1220
2020-11-16,584,916,-332,-36.24,1220
2020-11-17,579,1012,-433,-42.79,1220
2020-11-18,579,1008,-429,-42.56,1220
2020-11-19,579,1004,-425,-42.33,1220
2020-11-20,499,915,-416,-45.46,1220
2020-11-21,132,396,-264,-66.67,1220
2020-11-22,69,226,-157,-69.47,1220
2020-11-23,584,914,-330,-36.11,1220
2020-11-24,579,1014,-435,-42.9,1220
2020-11-25,579,1014,-435,-42.9,1220
2020-11-26,579,1014,-435,-42.9,1220
2020-11-27,499,930,-431,-46.34,1220
2020-11-28,132,414,-282,-68.12,1220
2020-11-29,69,248,-179,-72.18,1220
2020-11-30,584,939,-355,-37.81,1220
2020-12-01,532,1043,-511,-48.99,1220
2020-12-02,532,1046,-514,-49.14,1220
2020-12-03,532,1049,-517,-49.29,1220
2020-12-04,551,966,-415,-42.96,1220
2020-12-05,163,453,-290,-64.02,1220
2020-12-06,67,288,-221,-76.74,1220
2020-12-07,524,979,-455,-46.48,1220
2020-12-08,532,1082,-550,-50.83,1220
2020-12-09,532,1083,-551,-50.88,1220
2020-12-10,532,1083,-551,-50.88,1220
2020-12-11,551,998,-447,-44.79,1220
2020-12-12,163,480,-317,-66.04,1220
2020-12-13,67,310,-243,-78.39,1220
2020-12-14,524,996,-472,-47.39,1220
2020-12-15,532,1093,-561,-51.33,1220
2020-12-16,532,1087,-555,-51.06,1220
2020-12-17,532,1080,-548,-50.74,1220
2020-12-18,551,986,-435,-44.12,1220
2020-12-19,163,460,-297,-64.57,1220
2020-12-20,67,281,-214,-76.16,1220
2020-12-21,524,958,-434,-45.3,1220
2020-12-22,532,1046,-514,-49.14,1220
2020-12-23,532,1032,-500,-48.45,1220
2020-12-24,532,1017,-485,-47.69,1220
2020-12-25,551,916,-365,-39.85,1220
2020-12-26,163,382,-219,-57.33,1220
2020-12-27,67,198,-131,-66.16,1220
2020-12-28,524,869,-345,-39.7,1220
2020-12-29,532,953,-421,-44.18,1220
2020-12-30,532,936,-404,-43.16,1220
2020-12-31,532,918,-386,-42.05,1220
2021-01-01,400,816,-416,-50.98,1220
2021-01-02,133,282,-149,-52.84,1220
2021-01-03,69,99,-30,-30.3,1220
2021-01-04,418,773,-355,-45.92,1220
2021-01-05,468,859,-391,-45.52,1220
2021-01-06,468,846,-378,-44.68,1220
2021-01-07,468,834,-366,-43.88,1220
2021-01-08,400,737,-337,-45.73,1220
2021-01-09,133,210,-77,-36.67,1220
2021-01-10,69,34,35,102.94,1220
2021-01-11,418,714,-296,-41.46,1220
2021-01-12,468,809,-341,-42.15,1220
2021-01-13,468,803,-335,-41.72,1220
2021-01-14,468,798,-330,-41.35,1220
2021-01-15,400,709,-309,-43.58,1220
2021-01-16,133,189,-56,-29.63,1220
2021-01-17,69,18,51,283.33,1220
2021-01-18,418,705,-287,-40.71,1220
2021-01-19,468,804,-336,-41.79,1220
2021-01-20,468,803,-335,-41.72,1220
2021-01-21,468,801,-333,-41.57,1220
2021-01-22,400,715,-315,-44.06,1220
2021-01-23,133,197,-64,-32.49,1220
2021-01-24,69,28,41,146.43,1220
2021-01-25,418,715,-297,-41.54,1220
2021-01-26,468,815,-347,-42.58,1220
2021-01-27,468,812,-344,-42.36,1220
2021-01-28,468,810,-342,-42.22,1220
2021-01-29,400,721,-321,-44.52,1220
2021-01-30,133,201,-68,-33.83,1220
2021-01-31,69,30,39,130.0,1220
2021-02-01,545,715,-170,-23.78,1220
2021-02-02,629,813,-184,-22.63,1220
2021-02-03,629,809,-180,-22.25,1220
2021-02-04,629,804,-175,-21.77,1220
2021-02-05,600,714,-114,-15.97,1220
2021-02-06,210,193,17,8.81,1220
2021-02-07,60,22,38,172.73,1220
2021-02-08,545,707,-162,-22.91,1220
2021-02-09,629,805,-176,-21.86,1220
2021-02-10,629,802,-173,-21.57,1220
2021-02-11,629,799,-170,-21.28,1220
2021-02-12,600,711,-111,-15.61,1220
2021-02-13,210,193,17,8.81,1220
2021-02-14,60,24,36,150.0,1220
2021-02-15,545,713,-168,-23.56,1220
2021-02-16,629,814,-185,-22.73,1220
2021-02-17,629,815,-186,-22.82,1220
2021-02-18,629,816,-187,-22.92,1220
2021-02-19,600,732,-132,-18.03,1220
2021-02-20,210,217,-7,-3.23,1220
2021-02-21,60,52,8,15.38,1220
2021-02-22,545,744,-199,-26.75,1220
2021-02-23,629,848,-219,-25.83,1220
2021-02-24,629,851,-222,-26.09,1220
2021-02-25,629,854,-225,-26.35,1220
2021-02-26,600,772,-172,-22.28,1220
2021-02-27,210,258,-48,-18.6,1220
2021-02-28,60,93,-33,-35.48,1220
2021-03-01,639,785,-146,-18.6,1220
2021-03-02,717,889,-172,-19.35,1220
2021-03-03,717,891,-174,-19.53,1220
2021-03-04,717,892,-175,-19.62,1220
2021-03-05,732,808,-76,-9.41,1220
2021-03-06,216,293,-77,-26.28,1220
2021-03-07,66,126,-60,-47.62,1220
2021-03-08,639,815,-176,-21.6,1220
2021-03-09,717,917,-200,-21.81,1220
2021-03-10,717,917,-200,-21.81,1220
2021-03-11,717,916,-199,-21.72,1220
2021-03-12,732,831,-99,-11.91,1220
2021-03-13,216,314,-98,-31.21,1220
2021-03-14,66,146,-80,-54.79,1220
2021-03-15,639,834,-195,-23.38,1220
2021-03-16,717,936,-219,-23.4,1220
2021-03-17,717,936,-219,-23.4,1220
2021-03-18,717,936,-219,-23.4,1220
2021-03-19,732,852,-120,-14.08,1220
2021-03-20,216,336,-120,-35.71,1220
2021-03-21,66,170,-104,-61.18,1220
2021-03-22,639,861,-222,-25.78,1220
2021-03-23,717,964,-247,-25.62,1220
2021-03-24,717,966,-249,-25.78,1220
2021-03-25,717,969,-252,-26.01,1220
2021-03-26,732,886,-154,-17.38,1220
2021-03-27,216,373,-157,-42.09,1220
2021-03-28,66,208,-142,-68.27,1220
2021-03-29,639,901,-262,-29.08,1220
2021-03-30,717,1005,-288,-28.66,1220
2021-03-31,717,1008,-291,-28.87,1220
2021-04-01,643,1011,-368,-36.4,1220
2021-04-02,510,928,-418,-45.04,1220
2021-04-03,126,414,-288,-69.57,1220
2021-04-04,57,248,-191,-77.02,1220
2021-04-05,622,939,-317,-33.76,1220
2021-04-06,643,1041,-398,-38.23,1220
2021-04-07,643,1042,-399,-38.29,1220
2021-04-08,643,1042,-399,-38.29,1220
2021-04-09,510,957,-447,-46.71,1220
2021-04-10,126,440,-314,-71.36,1220
2021-04-11,57,271,-214,-78.97,1220
2021-04-12,622,959,-337,-35.14,1220
2021-04-13,643,1059,-416,-39.28,1220
2021-04-14,643,1057,-414,-39.17,1220
2021-04-15,643,1056,-413,-39.11,1220
2021-04-16,510,969,-459,-47.37,1220
2021-04-17,126,451,-325,-72.06,1220
2021-04-18,57,282,-225,-79.79,1220
2021-04-19,622,970,-348,-35.88,1220
2021-04-20,643,1072,-429,-40.02,1220
2021-04-21,643,1072,-429,-40.02,1220
2021-04-22,643,1073,-430,-40.07,1220
2021-04-23,510,989,-479,-48.43,1220
2021-04-24,126,475,-349,-73.47,1220
2021-04-25,57,310,-253,-81.61,1220
2021-04-26,622,1003,-381,-37.99,1220
2021-04-27,643,1109,-466,-42.02,1220
2021-04-28,643,1115,-472,-42.33,1220
2021-04-29,643,1120,-477,-42.59,1220
2021-04-30,510,1042,-532,-51.06,1220
2021-05-01,189,532,-343,-64.47,1220
2021-05-02,90,372,-282,-75.81,1220
2021-05-03,862,1069,-207,-19.36,1220
2021-05-04,1026,1178,-152,-12.9,1220
2021-05-05,1026,1185,-159,-13.42,1220
2021-05-06,1026,1193,-167,-14.0,1220
2021-05-07,844,1115,-271,-24.3,1220
2021-05-08,189,605,-416,-68.76,1220
2021-05-09,90,443,-353,-79.68,1220
2021-05-10,862,1137,-275,-24.19,1220
2021-05-11,1026,1243,-217,-17.46,1220
2021-05-12,1026,1246,-220,-17.66,1220
2021-05-13,1026,1248,-222,-17.79,1220
2021-05-14,844,1164,-320,-27.49,1220
2021-05-15,189,647,-458,-70.79,1220
2021-05-16,90,478,-388,-81.17,1220
2021-05-17,862,1164,-302,-25.95,1220
2021-05-18,1026,1262,-236,-18.7,1220
2021-05-19,1026,1258,-232,-18.44,1220
2021-05-20,1026,1251,-225,-17.99,1220
2021-05-21,844,1160,-316,-27.24,1220
2021-05-22,189,635,-446,-70.24,1220
2021-05-23,90,460,-370,-80.43,1220
2021-05-24,862,1140,-278,-24.39,1220
2021-05-25,1026,1232,-206,-16.72,1220
2021-05-26,1026,1223,-197,-16.11,1220
2021-05-27,1026,1213,-187,-15.42,1220
2021-05-28,844,1119,-275,-24.58,1220
2021-05-29,189,593,-404,-68.13,1220
2021-05-30,90,416,-326,-78.37,1220
2021-05-31,862,1097,-235,-21.42,1220
2021-06-01,1103,1190,-87,-7.31,1220
2021-06-02,1103,1183,-80,-6.76,1220
2021-06-03,1103,1176,-73,-6.21,1220
2021-06-04,796,1085,-289,-26.64,1220
2021-06-05,341,564,-223,-39.54,1220
2021-06-06,116,391,-275,-70.33,1220
2021-06-07,1080,1076,4,0.37,1220
2021-06-08,1103,1174,-71,-6.05,1220
2021-06-09,1103,1172,-69,-5.89,1220
2021-06-10,1103,1169,-66,-5.65,1220
2021-06-11,796,1082,-286,-26.43,1220
2021-06-12,341,563,-222,-39.43,1220
2021-06-13,116,393,-277,-70.48,1220
2021-06-14,1080,1080,0,0.0,1220
2021-06-15,1103,1179,-76,-6.45,1220
2021-06-16,1103,1177,-74,-6.29,1220
2021-06-17,1103,1173,-70,-5.97,1220
2021-06-18,796,1084,-288,-26.57,1220
2021-06-19,341,563,-222,-39.43,1220
2021-06-20,116,391,-275,-70.33,1220
2021-06-21,1080,1074,6,0.56,1220
2021-06-22,1103,1168,-65,-5.57,1220
2021-06-23,1103,1161,-58,-5.0,1220
2021-06-24,1103,1153,-50,-4.34,1220
2021-06-25,796,1059,-263,-24.83,1220
2021-06-26,341,532,-191,-35.9,1220
2021-06-27,116,354,-238,-67.23,1220
2021-06-28,1080,1033,47,4.55,1220
2021-06-29,1103,1123,-20,-1.78,1220
2021-06-30,1103,1112,-9,-0.81,1220
2021-07-01,1083,1100,-17,-1.55,1220
2021-07-02,933,1003,-70,-6.98,1220
2021-07-03,216,475,-259,-54.53,1220
2021-07-04,132,296,-164,-55.41,1220
2021-07-05,942,974,-32,-3.29,1220
2021-07-06,1083,1065,18,1.69,1220
2021-07-07,1083,1056,27,2.56,1220
2021-07-08,1083,1047,36,3.44,1220
2021-07-09,933,953,-20,-2.1,1220
2021-07-10,216,429,-213,-49.65,1220
2021-07-11,132,255,-123,-48.24,1220
2021-07-12,942,938,4,0.43,1220
2021-07-13,1083,1035,48,4.64,1220
2021-07-14,1083,1031,52,5.04,1220
2021-07-15,1083,1027,56,5.45,1220
2021-07-16,933,939,-6,-0.64,1220
2021-07-17,216,420,-204,-48.57,1220
2021-07-18,132,250,-118,-47.2,1220
2021-07-19,942,937,5,0.53,1220
2021-07-20,1083,1037,46,4.44,1220
2021-07-21,1083,1035,48,4.64,1220
2021-07-22,1083,1033,50,4.84,1220
2021-07-23,933,946,-13,-1.37,1220
2021-07-24,216,427,-211,-49.41,1220
2021-07-25,132,257,-125,-48.64,1220
2021-07-26,942,942,0,0.0,1220
2021-07-27,1083,1039,44,4.23,1220
2021-07-28,1083,1034,49,4.74,1220
2021-07-29,1083,1028,55,5.35,1220
2021-07-30,933,937,-4,-0.43,1220
2021-07-31,216,413,-197,-47.7,1220
2021-08-01,165,238,-73,-30.67,1220
2021-08-02,882,918,-36,-3.92,1220
2021-08-03,949,1011,-62,-6.13,1220
2021-08-04,949,1001,-52,-5.19,1220
2021-08-05,949,991,-42,-4.24,1220
2021-08-06,783,896,-113,-12.61,1220
2021-08-07,271,370,-99,-26.76,1220
2021-08-08,165,192,-27,-14.06,1220
2021-08-09,882,871,11,1.26,1220
2021-08-10,949,963,-14,-1.45,1220
2021-08-11,949,955,-6,-0.63,1220
2021-08-12,949,947,2,0.21,1220
2021-08-13,783,854,-71,-8.31,1220
2021-08-14,271,332,-61,-18.37,1220
2021-08-15,165,159,6,3.77,1220
2021-08-16,882,844,38,4.5,1220
2021-08-17,949,942,7,0.74,1220
2021-08-18,949,940,9,0.96,1220
2021-08-19,949,939,10,1.06,1220
2021-08-20,783,855,-72,-8.42,1220
2021-08-21,271,340,-69,-20.29,1220
2021-08-22,165,175,-10,-5.71,1220
2021-08-23,882,867,15,1.73,1220
2021-08-24,949,973,-24,-2.47,1220
2021-08-25,949,978,-29,-2.97,1220
2021-08-26,949,983,-34,-3.46,1220
2021-08-27,783,903,-120,-13.29,1220
2021-08-28,271,393,-122,-31.04,1220
2021-08-29,165,231,-66,-28.57,1220
2021-08-30,882,926,-44,-4.75,1220
2021-08-31,949,1033,-84,-8.13,1220
2021-09-01,1517,1039,478,46.01,1220
2021-09-02,1517,1044,473,45.31,1220
2021-09-03,1381,963,418,43.41,1220
2021-09-04,464,450,14,3.11,1220
2021-09-05,232,285,-53,-18.6,1220
2021-09-06,1460,976,484,49.59,1220
2021-09-07,1517,1079,438,40.59,1220
2021-09-08,1517,1080,437,40.46,1220
2021-09-09,1517,1079,438,40.59,1220
2021-09-10,1381,993,388,39.07,1220
2021-09-11,464,474,-10,-2.11,1220
2021-09-12,232,304,-72,-23.68,1220
2021-09-13,1460,990,470,47.47,1220
2021-09-14,1517,1088,429,39.43,1220
2021-09-15,1517,1084,433,39.94,1220
2021-09-16,1517,1080,437,40.46,1220
2021-09-17,1381,991,390,39.35,1220
2021-09-18,464,470,-6,-1.28,1220
2021-09-19,232,298,-66,-22.15,1220
2021-09-20,1460,983,477,48.52,1220
2021-09-21,1517,1080,437,40.46,1220
2021-09-22,1517,1077,440,40.85,1220
2021-09-23,1517,1074,443,41.25,1220
2021-09-24,1381,986,395,40.06,1220
2021-09-25,464,468,-4,-0.85,1220
2021-09-26,232,299,-67,-22.41,1220
2021-09-27,1460,986,474,48.07,1220
2021-09-28,1517,1087,430,39.56,1220
2021-09-29,1517,1087,430,39.56,1220
2021-09-30,1517,1087,430,39.56,1220
2021-10-01,1174,1003,171,17.05,1220
2021-10-02,321,487,-166,-34.09,1220
2021-10-03,196,320,-124,-38.75,1220
2021-10-04,978,1010,-32,-3.17,1220
2021-10-05,1220,1112,108,9.71,1220
2021-10-06,1220,1113,107,9.61,1220
2021-10-07,1220,1114,106,9.52,1220
2021-10-08,1174,1029,145,14.09,1220
2021-10-09,321,512,-191,-37.3,1220
2021-10-10,196,343,-147,-42.86,1220
2021-10-11,978,1031,-53,-5.14,1220
2021-10-12,1220,1130,90,7.96,1220
2021-10-13,1220,1128,92,8.16,1220
2021-10-14,1220,1124,96,8.54,1220
2021-10-15,1174,1034,140,13.54,1220
2021-10-16,321,513,-192,-37.43,1220
2021-10-17,196,339,-143,-42.18,1220
2021-10-18,978,1022,-44,-4.31,1220
2021-10-19,1220,1116,104,9.32,1220
2021-10-20,1220,1108,112,10.11,1220
2021-10-21,1220,1099,121,11.01,1220
2021-10-22,1174,1004,170,16.93,1220
2021-10-23,321,478,-157,-32.85,1220
2021-10-24,196,300,-104,-34.67,1220
2021-10-25,978,979,-1,-0.1,1220
2021-10-26,1220,1069,151,14.13,1220
2021-10-27,1220,1058,162,15.31,1220
2021-10-28,1220,1047,173,16.52,1220
2021-10-29,1174,951,223,23.45,1220
2021-10-30,321,423,-102,-24.11,1220
2021-10-31,196,244,-48,-19.67,1220
2021-11-01,850,922,-72,-7.81,1220
2021-11-02,1005,1012,-7,-0.69,1220
2021-11-03,1005,1001,4,0.4,1220
2021-11-04,1005,991,14,1.41,1220
2021-11-05,1022,895,127,14.19,1220
2021-11-06,270,369,-99,-26.83,1220
2021-11-07,151,191,-40,-20.94,1220
2021-11-08,850,871,-21,-2.41,1220
2021-11-09,1005,964,41,4.25,1220
2021-11-10,1005,955,50,5.24,1220
2021-11-11,1005,947,58,6.12,1220
2021-11-12,1022,854,168,19.67,1220
2021-11-13,270,330,-60,-18.18,1220
2021-11-14,151,156,-5,-3.21,1220
2021-11-15,850,839,11,1.31,1220
2021-11-16,1005,934,71,7.6,1220
2021-11-17,1005,929,76,8.18,1220
2021-11-18,1005,925,80,8.65,1220
2021-11-19,1022,835,187,22.4,1220
2021-11-20,270,315,-45,-14.29,1220
2021-11-21,151,145,6,4.14,1220
2021-11-22,850,831,19,2.29,1220
2021-11-23,1005,931,74,7.95,1220
2021-11-24,1005,930,75,8.06,1220
2021-11-25,1005,929,76,8.18,1220
2021-11-26,1022,844,178,21.09,1220
2021-11-27,270,328,-58,-17.68,1220
2021-11-28,151,162,-11,-6.79,1220
2021-11-29,850,853,-3,-0.35,1220
2021-11-30,1005,956,49,5.13,1220
2021-12-01,801,959,-158,-16.48,1220
2021-12-02,801,961,-160,-16.65,1220
2021-12-03,572,879,-307,-34.93,1220
2021-12-04,177,365,-188,-51.51,1220
2021-12-05,115,200,-85,-42.5,1220
2021-12-06,806,892,-86,-9.64,1220
2021-12-07,801,995,-194,-19.5,1220
2021-12-08,801,997,-196,-19.66,1220
2021-12-09,801,999,-198,-19.82,1220
2021-12-10,572,914,-342,-37.42,1220
2021-12-11,177,397,-220,-55.42,1220
2021-12-12,115,229,-114,-49.78,1220
2021-12-13,806,916,-110,-12.01,1220
2021-12-14,801,1014,-213,-21.01,1220
2021-12-15,801,1010,-209,-20.69,1220
2021-12-16,801,1004,-203,-20.22,1220
2021-12-17,572,912,-340,-37.28,1220
2021-12-18,177,387,-210,-54.26,1220
2021-12-19,115,210,-95,-45.24,1220
2021-12-20,806,889,-83,-9.34,1220
2021-12-21,801,978,-177,-18.1,1220
2021-12-22,801,966,-165,-17.08,1220
2021-12-23,801,951,-150,-15.77,1220
2021-12-24,572,851,-279,-32.78,1220
2021-12-25,177,319,-142,-44.51,1220
2021-12-26,115,135,-20,-14.81,1220
2021-12-27,806,807,-1,-0.12,1220
2021-12-28,801,891,-90,-10.1,1220
2021-12-29,801,873,-72,-8.25,1220
2021-12-30,801,856,-55,-6.43,1220
2021-12-31,572,753,-181,-24.04,1220
2022-01-01,210,219,-9,-4.11,1220
2022-01-02,87,35,52,148.57,1220
2022-01-03,566,707,-141,-19.94,1220
2022-01-04,602,793,-191,-24.09,1220
2022-01-05,602,779,-177,-22.72,1220
2022-01-06,602,765,-163,-21.31,1220
2022-01-07,564,667,-103,-15.44,1220
2022-01-08,210,139,71,51.08,1220
2022-01-09,87,31,56,180.65,1220
2022-01-10,566,640,-74,-11.56,1220
2022-01-11,602,734,-132,-17.98,1220
2022-01-12,602,727,-125,-17.19,1220
2022-01-13,602,720,-118,-16.39,1220
2022-01-14,564,630,-66,-10.48,1220
2022-01-15,210,109,101,92.66,1220
2022-01-16,87,23,64,278.26,1220
2022-01-17,566,624,-58,-9.29,1220
2022-01-18,602,723,-121,-16.74,1220
2022-01-19,602,721,-119,-16.5,1220
2022-01-20,602,719,-117,-16.27,1220
2022-01-21,564,632,-68,-10.76,1220
2022-01-22,210,114,96,84.21,1220
2022-01-23,87,25,62,248.0,1220
2022-01-24,566,633,-67,-10.58,1220
2022-01-25,602,733,-131,-17.87,1220
2022-01-26,602,731,-129,-17.65,1220
2022-01-27,602,729,-127,-17.42,1220
2022-01-28,564,641,-77,-12.01,1220
2022-01-29,210,121,89,73.55,1220
2022-01-30,87,28,59,210.71,1220
2020-02-01,89,99,-10,-10.1,1625
2020-02-02,47,4,43,1075.0,1625
2020-02-03,354,336,18,5.36,1625
2020-02-04,361,342,19,5.56,1625
2020-02-05,361,335,26,7.76,1625
2020-02-06,361,331,30,9.06,1625
2020-02-07,340,285,55,19.3,1625
2020-02-08,89,71,18,25.35,1625
2020-02-09,47,32,15,46.88,1625
2020-02-10,354,311,43,13.83,1625
2020-02-11,361,318,43,13.52,1625
2020-02-12,361,314,47,14.97,1625
2020-02-13,361,313,48,15.34,1625
2020-02-14,340,270,70,25.93,1625
2020-02-15,89,59,30,50.85,1625
2020-02-16,47,35,12,34.29,1625
2020-02-17,354,306,48,15.69,1625
2020-02-18,361,318,43,13.52,1625
2020-02-19,361,317,44,13.88,1625
2020-02-20,361,320,41,12.81,1625
2020-02-21,340,281,59,21.0,1625
2020-02-22,89,73,16,21.92,1625
2020-02-23,47,37,10,27.03,1625
2020-02-24,354,325,29,8.92,1625
2020-02-25,361,338,23,6.8,1625
2020-02-26,361,339,22,6.49,1625
2020-02-27,361,343,18,5.25,1625
2020-02-28,340,304,36,11.84,1625
2020-02-29,89,96,-7,-7.29,1625
2020-03-01,35,8,27,337.5,1625
2020-03-02,263,347,-84,-24.21,1625
2020-03-03,265,359,-94,-26.18,1625
2020-03-04,265,359,-94,-26.18,1625
2020-03-05,265,361,-96,-26.59,1625
2020-03-06,246,319,-73,-22.88,1625
2020-03-07,74,109,-35,-32.11,1625
2020-03-08,35,19,16,84.21,1625
2020-03-09,263,356,-93,-26.12,1625
2020-03-10,265,366,-101,-27.6,1625
2020-03-11,265,363,-98,-27.0,1625
2020-03-12,265,363,-98,-27.0,1625
2020-03-13,246,320,-74,-23.12,1625
2020-03-14,74,109,-35,-32.11,1625
2020-03-15,35,17,18,105.88,1625
2020-03-16,263,353,-90,-25.5,1625
2020-03-17,265,362,-97,-26.8,1625
2020-03-18,265,359,-94,-26.18,1625
2020-03-19,265,360,-95,-26.39,1625
2020-03-20,246,317,-71,-22.4,1625
2020-03-21,74,107,-33,-30.84,1625
2020-03-22,35,16,19,118.75,1625
2020-03-23,263,353,-90,-25.5,1625
2020-03-24,265,364,-99,-27.2,1625
2020-03-25,265,363,-98,-27.0,1625
2020-03-26,265,365,-100,-27.4,1625
2020-03-27,246,324,-78,-24.07,1625
2020-03-28,74,114,-40,-35.09,1625
2020-03-29,35,25,10,40.0,1625
2020-03-30,263,363,-100,-27.55,1625
2020-03-31,265,375,-110,-29.33,1625
2020-04-01,197,374,-177,-47.33,1625
2020-04-02,197,376,-179,-47.61,1625
2020-04-03,160,335,-175,-52.24,1625
2020-04-04,58,126,-68,-53.97,1625
2020-04-05,39,36,3,8.33,1625
2020-04-06,220,374,-154,-41.18,1625
2020-04-07,197,384,-187,-48.7,1625
2020-04-08,197,382,-185,-48.43,1625
2020-04-09,197,383,-186,-48.56,1625
2020-04-10,160,341,-181,-53.08,1625
2020-04-11,58,130,-72,-55.38,1625
2020-04-12,39,39,0,0.0,1625
2020-04-13,220,375,-155,-41.33,1625
2020-04-14,197,384,-187,-48.7,1625
2020-04-15,197,380,-183,-48.16,1625
2020-04-16,197,380,-183,-48.16,1625
2020-04-17,160,337,-177,-52.52,1625
2020-04-18,58,125,-67,-53.6,1625
2020-04-19,39,33,6,18.18,1625
2020-04-20,220,369,-149,-40.38,1625
2020-04-21,197,378,-181,-47.88,1625
2020-04-22,197,375,-178,-47.47,1625
2020-04-23,197,375,-178,-47.47,1625
2020-04-24,160,333,-173,-51.95,1625
2020-04-25,58,122,-64,-52.46,1625
2020-04-26,39,31,8,25.81,1625
2020-04-27,220,368,-148,-40.22,1625
2020-04-28,197,378,-181,-47.88,1625
2020-04-29,197,376,-179,-47.61,1625
2020-04-30,197,378,-181,-47.88,1625
2020-05-01,251,336,-85,-25.3,1625
2020-05-02,77,126,-49,-38.89,1625
2020-05-03,41,37,4,10.81,1625
2020-05-04,304,374,-70,-18.72,1625
2020-05-05,281,385,-104,-27.01,1625
2020-05-06,281,383,-102,-26.63,1625
2020-05-07,281,385,-104,-27.01,1625
2020-05-08,251,343,-92,-26.82,1625
2020-05-09,77,133,-56,-42.11,1625
2020-05-10,41,42,-1,-2.38,1625
2020-05-11,304,378,-74,-19.58,1625
2020-05-12,281,388,-107,-27.58,1625
2020-05-13,281,385,-104,-27.01,1625
2020-05-14,281,385,-104,-27.01,1625
2020-05-15,251,342,-91,-26.61,1625
2020-05-16,77,130,-53,-40.77,1625
2020-05-17,41,38,3,7.89,1625
2020-05-18,304,373,-69,-18.5,1625
2020-05-19,281,381,-100,-26.25,1625
2020-05-20,281,377,-96,-25.46,1625
2020-05-21,281,376,-95,-25.27,1625
2020-05-22,251,332,-81,-24.4,1625
2020-05-23,77,119,-42,-35.29,1625
2020-05-24,41,27,14,51.85,1625
2020-05-25,304,361,-57,-15.79,1625
2020-05-26,281,370,-89,-24.05,1625
2020-05-27,281,366,-85,-23.22,1625
2020-05-28,281,366,-85,-23.22,1625
2020-05-29,251,322,-71,-22.05,1625
2020-05-30,77,111,-34,-30.63,1625
2020-05-31,41,20,21,105.0,1625
2020-06-01,323,356,-33,-9.27,1625
2020-06-02,312,366,-54,-14.75,1625
2020-06-03,312,363,-51,-14.05,1625
2020-06-04,312,364,-52,-14.29,1625
2020-06-05,244,322,-78,-24.22,1625
2020-06-06,90,111,-21,-18.92,1625
2020-06-07,55,21,34,161.9,1625
2020-06-08,323,357,-34,-9.52,1625
2020-06-09,312,368,-56,-15.22,1625
2020-06-10,312,365,-53,-14.52,1625
2020-06-11,312,365,-53,-14.52,1625
2020-06-12,244,323,-79,-24.46,1625
2020-06-13,90,111,-21,-18.92,1625
2020-06-14,55,20,35,175.0,1625
2020-06-15,323,355,-32,-9.01,1625
2020-06-16,312,363,-51,-14.05,1625
2020-06-17,312,359,-47,-13.09,1625
2020-06-18,312,357,-45,-12.61,1625
2020-06-19,244,313,-69,-22.04,1625
2020-06-20,90,99,-9,-9.09,1625
2020-06-21,55,6,49,816.67,1625
2020-06-22,323,339,-16,-4.72,1625
2020-06-23,312,346,-34,-9.83,1625
2020-06-24,312,341,-29,-8.5,1625
2020-06-25,312,338,-26,-7.69,1625
2020-06-26,244,293,-49,-16.72,1625
2020-06-27,90,79,11,13.92,1625
2020-06-28,55,40,15,37.5,1625
2020-06-29,323,320,3,0.94,1625
2020-06-30,312,328,-16,-4.88,1625
2020-07-01,311,323,-12,-3.72,1625
2020-07-02,311,322,-11,-3.42,1625
2020-07-03,273,279,-6,-2.15,1625
2020-07-04,90,67,23,34.33,1625
2020-07-05,53,36,17,47.22,1625
2020-07-06,303,312,-9,-2.88,1625
2020-07-07,311,322,-11,-3.42,1625
2020-07-08,311,320,-9,-2.81,1625
2020-07-09,311,321,-10,-3.12,1625
2020-07-10,273,279,-6,-2.15,1625
2020-07-11,90,69,21,30.43,1625
2020-07-12,53,36,17,47.22,1625
2020-07-13,303,315,-12,-3.81,1625
2020-07-14,311,325,-14,-4.31,1625
2020-07-15,311,322,-11,-3.42,1625
2020-07-16,311,322,-11,-3.42,1625
2020-07-17,273,278,-5,-1.8,1625
2020-07-18,90,65,25,38.46,1625
2020-07-19,53,38,15,39.47,1625
2020-07-20,303,305,-2,-0.66,1625
2020-07-21,311,311,0,0.0,1625
2020-07-22,311,303,8,2.64,1625
2020-07-23,311,298,13,4.36,1625
2020-07-24,273,249,24,9.64,1625
2020-07-25,90,31,59,190.32,1625
2020-07-26,53,19,34,178.95,1625
2020-07-27,303,260,43,16.54,1625
2020-07-28,311,261,50,19.16,1625
2020-07-29,311,249,62,24.9,1625
2020-07-30,311,239,72,30.13,1625
2020-07-31,273,187,86,45.99,1625
2020-08-01,109,35,74,211.43,1625
2020-08-02,51,35,16,45.71,1625
2020-08-03,308,191,117,61.26,1625
2020-08-04,303,191,112,58.64,1625
2020-08-05,303,179,124,69.27,1625
2020-08-06,303,170,133,78.24,1625
2020-08-07,266,119,147,123.53,1625
2020-08-08,109,3,106,3533.33,1625
2020-08-09,51,3,48,1600.0,1625
2020-08-10,308,134,174,129.85,1625
2020-08-11,303,139,164,117.99,1625
2020-08-12,303,132,171,129.55,1625
2020-08-13,303,130,173,133.08,1625
2020-08-14,266,86,180,209.3,1625
2020-08-15,109,86,23,26.74,1625
2020-08-16,51,86,-35,-40.7,1625
2020-08-17,308,120,188,156.67,1625
2020-08-18,303,132,171,129.55,1625
2020-08-19,303,132,171,129.55,1625
2020-08-20,303,135,168,124.44,1625
2020-08-21,266,96,170,177.08,1625
2020-08-22,109,96,13,13.54,1625
2020-08-23,51,96,-45,-46.88,1625
2020-08-24,308,143,165,115.38,1625
2020-08-25,303,157,146,92.99,1625
2020-08-26,303,158,145,91.77,1625
2020-08-27,303,162,141,87.04,1625
2020-08-28,266,123,143,116.26,1625
2020-08-29,109,12,97,808.33,1625
2020-08-30,51,12,39,325.0,1625
2020-08-31,308,166,142,85.54,1625
2020-09-01,325,178,147,82.58,1625
2020-09-02,325,176,149,84.66,1625
2020-09-03,325,177,148,83.62,1625
2020-09-04,316,135,181,134.07,1625
2020-09-05,87,22,65,295.45,1625
2020-09-06,78,22,56,254.55,1625
2020-09-07,349,167,182,108.98,1625
2020-09-08,325,176,149,84.66,1625
2020-09-09,325,172,153,88.95,1625
2020-09-10,325,171,154,90.06,1625
2020-09-11,316,127,189,148.82,1625
2020-09-12,87,14,73,521.43,1625
2020-09-13,78,14,64,457.14,1625
2020-09-14,349,158,191,120.89,1625
2020-09-15,325,168,157,93.45,1625
2020-09-16,325,165,160,96.97,1625
2020-09-17,325,166,159,95.78,1625
2020-09-18,316,124,192,154.84,1625
2020-09-19,87,11,76,690.91,1625
2020-09-20,78,11,67,609.09,1625
2020-09-21,349,165,184,111.52,1625
2020-09-22,325,179,146,81.56,1625
2020-09-23,325,180,145,80.56,1625
2020-09-24,325,184,141,76.63,1625
2020-09-25,316,147,169,114.97,1625
2020-09-26,87,24,63,262.5,1625
2020-09-27,78,24,54,225.0,1625
2020-09-28,349,197,152,77.16,1625
2020-09-29,325,212,113,53.3,1625
2020-09-30,325,215,110,51.16,1625
2020-10-01,337,221,116,52.49,1625
2020-10-02,285,184,101,54.89,1625
2020-10-03,105,45,60,133.33,1625
2020-10-04,60,2,58,2900.0,1625
2020-10-05,342,231,111,48.05,1625
2020-10-06,337,245,92,37.55,1625
2020-10-07,337,245,92,37.55,1625
2020-10-08,337,248,89,35.89,1625
2020-10-09,285,207,78,37.68,1625
2020-10-10,105,56,49,87.5,1625
2020-10-11,60,10,50,500.0,1625
2020-10-12,342,244,98,40.16,1625
2020-10-13,337,254,83,32.68,1625
2020-10-14,337,251,86,34.26,1625
2020-10-15,337,250,87,34.8,1625
2020-10-16,285,207,78,37.68,1625
2020-10-17,105,54,51,94.44,1625
2020-10-18,60,9,51,566.67,1625
2020-10-19,342,237,105,44.3,1625
2020-10-20,337,245,92,37.55,1625
2020-10-21,337,241,96,39.83,1625
2020-10-22,337,240,97,40.42,1625
2020-10-23,285,197,88,44.67,1625
2020-10-24,105,54,51,94.44,1625
2020-10-25,60,9,51,566.67,1625
2020-10-26,342,231,111,48.05,1625
2020-10-27,337,241,96,39.83,1625
2020-10-28,337,239,98,41.0,1625
2020-10-29,337,241,96,39.83,1625
2020-10-30,285,200,85,42.5,1625
2020-10-31,105,55,50,90.91,1625
2020-11-01,37,13,24,184.62,1625
2020-11-02,306,242,64,26.45,1625
2020-11-03,280,254,26,10.24,1625
2020-11-04,280,254,26,10.24,1625
2020-11-05,280,258,22,8.53,1625
2020-11-06,254,218,36,16.51,1625
2020-11-07,82,10,72,720.0,1625
2020-11-08,37,22,15,68.18,1625
2020-11-09,306,260,46,17.69,1625
2020-11-10,280,272,8,2.94,1625
2020-11-11,280,271,9,3.32,1625
2020-11-12,280,272,8,2.94,1625
2020-11-13,254,231,23,9.96,1625
2020-11-14,82,20,62,310.0,1625
2020-11-15,37,26,11,42.31,1625
2020-11-16,306,265,41,15.47,1625
2020-11-17,280,275,5,1.82,1625
2020-11-18,280,271,9,3.32,1625
2020-11-19,280,270,10,3.7,1625
2020-11-20,254,226,28,12.39,1625
2020-11-21,82,13,69,530.77,1625
2020-11-22,37,24,13,54.17,1625
2020-11-23,306,254,52,20.47,1625
2020-11-24,280,262,18,6.87,1625
2020-11-25,280,258,22,8.53,1625
2020-11-26,280,256,24,9.38,1625
2020-11-27,254,212,42,19.81,1625
2020-11-28,82,0,82,inf,1625
2020-11-29,37,15,22,146.67,1625
2020-11-30,306,243,63,25.93,1625
2020-12-01,273,252,21,8.33,1625
2020-12-02,273,249,24,9.64,1625
2020-12-03,273,250,23,9.2,1625
2020-12-04,302,207,95,45.89,1625
2020-12-05,94,60,34,56.67,1625
2020-12-06,45,21,24,114.29,1625
2020-12-07,262,244,18,7.38,1625
2020-12-08,273,255,18,7.06,1625
2020-12-09,273,254,19,7.48,1625
2020-12-10,273,256,17,6.64,1625
2020-12-11,302,215,87,40.47,1625
2020-12-12,94,5,89,1780.0,1625
2020-12-13,45,26,19,73.08,1625
2020-12-14,262,252,10,3.97,1625
2020-12-15,273,262,11,4.2,1625
2020-12-16,273,260,13,5.0,1625
2020-12-17,273,260,13,5.0,1625
2020-12-18,302,217,85,39.17,1625
2020-12-19,94,5,89,1780.0,1625
2020-12-20,45,26,19,73.08,1625
2020-12-21,262,247,15,6.07,1625
2020-12-22,273,255,18,7.06,1625
2020-12-23,273,250,23,9.2,1625
2020-12-24,273,247,26,10.53,1625
2020-12-25,302,202,100,49.5,1625
2020-12-26,94,64,30,46.88,1625
2020-12-27,45,14,31,221.43,1625
2020-12-28,262,226,36,15.93,1625
2020-12-29,273,232,41,17.67,1625
2020-12-30,273,226,47,20.8,1625
2020-12-31,273,223,50,22.42,1625
2021-01-01,239,177,62,35.03,1625
2021-01-02,77,47,30,63.83,1625
2021-01-03,42,9,33,366.67,1625
2021-01-04,263,203,60,29.56,1625
2021-01-05,249,211,38,18.01,1625
2021-01-06,249,207,42,20.29,1625
2021-01-07,249,206,43,20.87,1625
2021-01-08,239,163,76,46.63,1625
2021-01-09,77,43,34,79.07,1625
2021-01-10,42,4,38,950.0,1625
2021-01-11,263,196,67,34.18,1625
2021-01-12,249,207,42,20.29,1625
2021-01-13,249,205,44,21.46,1625
2021-01-14,249,206,43,20.87,1625
2021-01-15,239,164,75,45.73,1625
2021-01-16,77,49,28,57.14,1625
2021-01-17,42,8,34,425.0,1625
2021-01-18,263,201,62,30.85,1625
2021-01-19,249,212,37,17.45,1625
2021-01-20,249,209,40,19.14,1625
2021-01-21,249,210,39,18.57,1625
2021-01-22,239,167,72,43.11,1625
2021-01-23,77,48,29,60.42,1625
2021-01-24,42,6,36,600.0,1625
2021-01-25,263,198,65,32.83,1625
2021-01-26,249,206,43,20.87,1625
2021-01-27,249,200,49,24.5,1625
2021-01-28,249,198,51,25.76,1625
2021-01-29,239,152,87,57.24,1625
2021-01-30,77,43,34,79.07,1625
2021-01-31,42,43,-1,-2.33,1625
2021-02-01,348,175,173,98.86,1625
2021-02-02,300,181,119,65.75,1625
2021-02-03,300,174,126,72.41,1625
2021-02-04,300,170,130,76.47,1625
2021-02-05,263,124,139,112.1,1625
2021-02-06,74,29,45,155.17,1625
2021-02-07,42,29,13,44.83,1625
2021-02-08,348,148,200,135.14,1625
2021-02-09,300,155,145,93.55,1625
2021-02-10,300,150,150,100.0,1625
2021-02-11,300,149,151,101.34,1625
2021-02-12,263,105,158,150.48,1625
2021-02-13,74,23,51,221.74,1625
2021-02-14,42,23,19,82.61,1625
2021-02-15,348,139,209,150.36,1625
2021-02-16,300,150,150,100.0,1625
2021-02-17,300,149,151,101.34,1625
2021-02-18,300,151,149,98.68,1625
2021-02-19,263,111,152,136.94,1625
2021-02-20,74,32,42,131.25,1625
2021-02-21,42,32,10,31.25,1625
2021-02-22,348,155,193,124.52,1625
2021-02-23,300,168,132,78.57,1625
2021-02-24,300,169,131,77.51,1625
2021-02-25,300,173,127,73.41,1625
2021-02-26,263,134,129,96.27,1625
2021-02-27,74,41,33,80.49,1625
2021-02-28,42,1,41,4100.0,1625
2021-03-01,333,178,155,87.08,1625
2021-03-02,318,190,128,67.37,1625
2021-03-03,318,190,128,67.37,1625
2021-03-04,318,193,125,64.77,1625
2021-03-05,293,152,141,92.76,1625
2021-03-06,78,55,23,41.82,1625
2021-03-07,40,11,29,263.64,1625
2021-03-08,333,189,144,76.19,1625
2021-03-09,318,200,118,59.0,1625
2021-03-10,318,197,121,61.42,1625
2021-03-11,318,197,121,61.42,1625
2021-03-12,293,155,138,89.03,1625
2021-03-13,78,59,19,32.2,1625
2021-03-14,40,13,27,207.69,1625
2021-03-15,333,188,145,77.13,1625
2021-03-16,318,197,121,61.42,1625
2021-03-17,318,194,124,63.92,1625
2021-03-18,318,194,124,63.92,1625
2021-03-19,293,151,142,94.04,1625
2021-03-20,78,56,22,39.29,1625
2021-03-21,40,9,31,344.44,1625
2021-03-22,333,187,146,78.07,1625
2021-03-23,318,197,121,61.42,1625
2021-03-24,318,195,123,63.08,1625
2021-03-25,318,197,121,61.42,1625
2021-03-26,293,156,137,87.82,1625
2021-03-27,78,60,18,30.0,1625
2021-03-28,40,13,27,207.69,1625
2021-03-29,333,195,138,70.77,1625
2021-03-30,318,207,111,53.62,1625
2021-03-31,318,206,112,54.37,1625
2021-04-01,308,208,100,48.08,1625
2021-04-02,267,167,100,59.88,1625
2021-04-03,84,70,14,20.0,1625
2021-04-04,44,25,19,76.0,1625
2021-04-05,295,206,89,43.2,1625
2021-04-06,308,217,91,41.94,1625
2021-04-07,308,215,93,43.26,1625
2021-04-08,308,217,91,41.94,1625
2021-04-09,267,175,92,52.57,1625
2021-04-10,84,77,7,9.09,1625
2021-04-11,44,19,25,131.58,1625
2021-04-12,295,209,86,41.15,1625
2021-04-13,308,219,89,40.64,1625
2021-04-14,308,215,93,43.26,1625
2021-04-15,308,215,93,43.26,1625
2021-04-16,267,172,95,55.23,1625
2021-04-17,84,66,18,27.27,1625
2021-04-18,44,32,12,37.5,1625
2021-04-19,295,204,91,44.61,1625
2021-04-20,308,213,95,44.6,1625
2021-04-21,308,210,98,46.67,1625
2021-04-22,308,210,98,46.67,1625
2021-04-23,267,167,100,59.88,1625
2021-04-24,84,71,13,18.31,1625
2021-04-25,44,27,17,62.96,1625
2021-04-26,295,201,94,46.77,1625
2021-04-27,308,212,96,45.28,1625
2021-04-28,308,209,99,47.37,1625
2021-04-29,308,211,97,45.97,1625
2021-04-30,267,169,98,57.99,1625
2021-05-01,84,78,6,7.69,1625
2021-05-02,49,29,20,68.97,1625
2021-05-03,351,207,144,69.57,1625
2021-05-04,338,218,120,55.05,1625
2021-05-05,338,216,122,56.48,1625
2021-05-06,338,217,121,55.76,1625
2021-05-07,289,176,113,64.2,1625
2021-05-08,84,81,3,3.7,1625
2021-05-09,49,34,15,44.12,1625
2021-05-10,351,212,139,65.57,1625
2021-05-11,338,222,116,52.25,1625
2021-05-12,338,220,118,53.64,1625
2021-05-13,338,220,118,53.64,1625
2021-05-14,289,177,112,63.28,1625
2021-05-15,84,81,3,3.7,1625
2021-05-16,49,41,8,19.51,1625
2021-05-17,351,208,143,68.75,1625
2021-05-18,338,217,121,55.76,1625
2021-05-19,338,213,125,58.69,1625
2021-05-20,338,212,126,59.43,1625
2021-05-21,289,168,121,72.02,1625
2021-05-22,84,75,9,12.0,1625
2021-05-23,49,31,18,58.06,1625
2021-05-24,351,197,154,78.17,1625
2021-05-25,338,206,132,64.08,1625
2021-05-26,338,202,136,67.33,1625
2021-05-27,338,201,137,68.16,1625
2021-05-28,289,157,132,84.08,1625
2021-05-29,84,75,9,12.0,1625
2021-05-30,49,30,19,63.33,1625
2021-05-31,351,190,161,84.74,1625
2021-06-01,313,200,113,56.5,1625
2021-06-02,313,197,116,58.88,1625
2021-06-03,313,198,115,58.08,1625
2021-06-04,257,155,102,65.81,1625
2021-06-05,65,81,-16,-19.75,1625
2021-06-06,37,34,3,8.82,1625
2021-06-07,332,191,141,73.82,1625
2021-06-08,313,201,112,55.72,1625
2021-06-09,313,199,114,57.29,1625
2021-06-10,313,199,114,57.29,1625
2021-06-11,257,157,100,63.69,1625
2021-06-12,65,80,-15,-18.75,1625
2021-06-13,37,34,3,8.82,1625
2021-06-14,332,190,142,74.74,1625
2021-06-15,313,199,114,57.29,1625
2021-06-16,313,195,118,60.51,1625
2021-06-17,313,194,119,61.34,1625
2021-06-18,257,149,108,72.48,1625
2021-06-19,65,77,-12,-15.58,1625
2021-06-20,37,35,2,5.71,1625
2021-06-21,332,177,155,87.57,1625
2021-06-22,313,184,129,70.11,1625
2021-06-23,313,178,135,75.84,1625
2021-06-24,313,176,137,77.84,1625
2021-06-25,257,130,127,97.69,1625
2021-06-26,65,68,-3,-4.41,1625
2021-06-27,37,23,14,60.87,1625
2021-06-28,332,157,175,111.46,1625
2021-06-29,313,164,149,90.85,1625
2021-06-30,313,159,154,96.86,1625
2021-07-01,270,158,112,70.89,1625
2021-07-02,238,114,124,108.77,1625
2021-07-03,50,64,-14,-21.88,1625
2021-07-04,18,16,2,12.5,1625
2021-07-05,269,146,123,84.25,1625
2021-07-06,270,156,114,73.08,1625
2021-07-07,270,153,117,76.47,1625
2021-07-08,270,154,116,75.32,1625
2021-07-09,238,112,126,112.5,1625
2021-07-10,50,67,-17,-25.37,1625
2021-07-11,18,25,-7,-28.0,1625
2021-07-12,269,149,120,80.54,1625
2021-07-13,270,159,111,69.81,1625
2021-07-14,270,156,114,73.08,1625
2021-07-15,270,157,113,71.97,1625
2021-07-16,238,114,124,108.77,1625
2021-07-17,50,62,-12,-19.35,1625
2021-07-18,18,25,-7,-28.0,1625
2021-07-19,269,143,126,88.11,1625
2021-07-20,270,150,120,80.0,1625
2021-07-21,270,143,127,88.81,1625
2021-07-22,270,139,131,94.24,1625
2021-07-23,238,91,147,161.54,1625
2021-07-24,50,53,-3,-5.66,1625
2021-07-25,18,9,9,100.0,1625
2021-07-26,269,105,164,156.19,1625
2021-07-27,270,107,163,152.34,1625
2021-07-28,270,95,175,184.21,1625
2021-07-29,270,86,184,213.95,1625
2021-07-30,238,34,204,600.0,1625
2021-07-31,50,31,19,61.29,1625
2021-08-01,28,31,-3,-9.68,1625
2021-08-02,262,37,225,608.11,1625
2021-08-03,266,37,229,618.92,1625
2021-08-04,266,24,242,1008.33,1625
2021-08-05,266,15,251,1673.33,1625
2021-08-06,204,105,99,94.29,1625
2021-08-07,44,105,-61,-58.1,1625
2021-08-08,28,105,-77,-73.33,1625
2021-08-09,262,113,149,131.86,1625
2021-08-10,266,114,152,133.33,1625
2021-08-11,266,109,157,144.04,1625
2021-08-12,266,111,155,139.64,1625
2021-08-13,204,86,118,137.21,1625
2021-08-14,44,86,-42,-48.84,1625
2021-08-15,28,86,-58,-67.44,1625
2021-08-16,262,105,157,149.52,1625
2021-08-17,266,104,162,155.77,1625
2021-08-18,266,105,161,153.33,1625
2021-08-19,266,111,155,139.64,1625
2021-08-20,204,91,113,124.18,1625
2021-08-21,44,91,-47,-51.65,1625
2021-08-22,28,91,-63,-69.23,1625
2021-08-23,262,119,143,120.17,1625
2021-08-24,266,121,145,119.83,1625
2021-08-25,266,128,138,107.81,1625
2021-08-26,266,127,139,109.45,1625
2021-08-27,204,112,92,82.14,1625
2021-08-28,44,112,-68,-60.71,1625
2021-08-29,28,112,-84,-75.0,1625
2021-08-30,262,125,137,109.6,1625
2021-08-31,266,9,257,2855.56,1625
2021-09-01,336,9,327,3633.33,1625
2021-09-02,336,10,326,3260.0,1625
2021-09-03,291,111,180,162.16,1625
2021-09-04,62,5,57,1140.0,1625
2021-09-05,23,5,18,360.0,1625
2021-09-06,342,3,339,11300.0,1625
2021-09-07,336,12,324,2700.0,1625
2021-09-08,336,8,328,4100.0,1625
2021-09-09,336,7,329,4700.0,1625
2021-09-10,291,114,177,155.26,1625
2021-09-11,62,3,59,1966.67,1625
2021-09-12,23,3,20,666.67,1625
2021-09-13,342,130,212,163.08,1625
2021-09-14,336,2,334,16700.0,1625
2021-09-15,336,126,210,166.67,1625
2021-09-16,336,130,206,158.46,1625
2021-09-17,291,120,171,142.5,1625
2021-09-18,62,9,53,588.89,1625
2021-09-19,23,9,14,155.56,1625
2021-09-20,342,126,216,171.43,1625
2021-09-21,336,9,327,3633.33,1625
2021-09-22,336,9,327,3633.33,1625
2021-09-23,336,13,323,2484.62,1625
2021-09-24,291,123,168,136.59,1625
2021-09-25,62,17,45,264.71,1625
2021-09-26,23,17,6,35.29,1625
2021-09-27,342,24,318,1325.0,1625
2021-09-28,336,39,297,761.54,1625
2021-09-29,336,42,294,700.0,1625
2021-09-30,336,48,288,600.0,1625
2021-10-01,303,11,292,2654.55,1625
2021-10-02,72,39,33,84.62,1625
2021-10-03,26,4,22,550.0,1625
2021-10-04,338,60,278,463.33,1625
2021-10-05,368,74,294,397.3,1625
2021-10-06,368,75,293,390.67,1625
2021-10-07,368,79,289,365.82,1625
2021-10-08,303,39,264,676.92,1625
2021-10-09,72,54,18,33.33,1625
2021-10-10,26,11,15,136.36,1625
2021-10-11,338,78,260,333.33,1625
2021-10-12,368,88,280,318.18,1625
2021-10-13,368,85,283,332.94,1625
2021-10-14,368,85,283,332.94,1625
2021-10-15,303,42,261,621.43,1625
2021-10-16,72,58,14,24.14,1625
2021-10-17,26,11,15,136.36,1625
2021-10-18,338,73,265,363.01,1625
2021-10-19,368,81,287,354.32,1625
2021-10-20,368,77,291,377.92,1625
2021-10-21,368,76,292,384.21,1625
2021-10-22,303,32,271,846.88,1625
2021-10-23,72,57,15,26.32,1625
2021-10-24,26,13,13,100.0,1625
2021-10-25,338,65,273,420.0,1625
2021-10-26,368,75,293,390.67,1625
2021-10-27,368,72,296,411.11,1625
2021-10-28,368,74,294,397.3,1625
2021-10-29,303,32,271,846.88,1625
2021-10-30,72,57,15,26.32,1625
2021-10-31,26,19,7,36.84,1625
2021-11-01,339,73,266,364.38,1625
2021-11-02,356,85,271,318.82,1625
2021-11-03,356,85,271,318.82,1625
2021-11-04,356,88,268,304.55,1625
2021-11-05,304,49,255,520.41,1625
2021-11-06,64,66,-2,-3.03,1625
2021-11-07,23,22,1,4.55,1625
2021-11-08,339,91,248,272.53,1625
2021-11-09,356,103,253,245.63,1625
2021-11-10,356,103,253,245.63,1625
2021-11-11,356,105,251,239.05,1625
2021-11-12,304,64,240,375.0,1625
2021-11-13,64,77,-13,-16.88,1625
2021-11-14,23,35,-12,-34.29,1625
2021-11-15,339,100,239,239.0,1625
2021-11-16,356,109,247,226.61,1625
2021-11-17,356,106,250,235.85,1625
2021-11-18,356,105,251,239.05,1625
2021-11-19,304,62,242,390.32,1625
2021-11-20,64,80,-16,-20.0,1625
2021-11-21,23,29,-6,-20.69,1625
2021-11-22,339,91,248,272.53,1625
2021-11-23,356,99,257,259.6,1625
2021-11-24,356,94,262,278.72,1625
2021-11-25,356,93,263,282.8,1625
2021-11-26,304,48,256,533.33,1625
2021-11-27,64,73,-9,-12.33,1625
2021-11-28,23,32,-9,-28.12,1625
2021-11-29,339,78,261,334.62,1625
2021-11-30,356,87,269,309.2,1625
2021-12-01,277,84,193,229.76,1625
2021-12-02,277,84,193,229.76,1625
2021-12-03,232,41,191,465.85,1625
2021-12-04,59,72,-13,-18.06,1625
2021-12-05,17,33,-16,-48.48,1625
2021-12-06,318,77,241,312.99,1625
2021-12-07,277,88,189,214.77,1625
2021-12-08,277,86,191,222.09,1625
2021-12-09,277,88,189,214.77,1625
2021-12-10,232,47,185,393.62,1625
2021-12-11,59,75,-16,-21.33,1625
2021-12-12,17,35,-18,-51.43,1625
2021-12-13,318,85,233,274.12,1625
2021-12-14,277,96,181,188.54,1625
2021-12-15,277,93,184,197.85,1625
2021-12-16,277,94,183,194.68,1625
2021-12-17,232,52,180,346.15,1625
2021-12-18,59,86,-27,-31.4,1625
2021-12-19,17,37,-20,-54.05,1625
2021-12-20,318,83,235,283.13,1625
2021-12-21,277,92,185,201.09,1625
2021-12-22,277,87,190,218.39,1625
2021-12-23,277,85,192,225.88,1625
2021-12-24,232,40,192,480.0,1625
2021-12-25,59,74,-15,-20.27,1625
2021-12-26,17,31,-14,-45.16,1625
2021-12-27,318,64,254,396.88,1625
2021-12-28,277,71,206,290.14,1625
2021-12-29,277,64,213,332.81,1625
2021-12-30,277,61,216,354.1,1625
2021-12-31,232,15,217,1446.67,1625
2022-01-01,56,68,-12,-17.65,1625
2022-01-02,20,16,4,25.0,1625
2022-01-03,299,40,259,647.5,1625
2022-01-04,285,48,237,493.75,1625
2022-01-05,285,43,242,562.79,1625
2022-01-06,285,41,244,595.12,1625
2022-01-07,241,178,63,35.39,1625
2022-01-08,56,66,-10,-15.15,1625
2022-01-09,20,15,5,33.33,1625
2022-01-10,299,30,269,896.67,1625
2022-01-11,285,40,245,612.5,1625
2022-01-12,285,38,247,650.0,1625
2022-01-13,285,39,246,630.77,1625
2022-01-14,241,169,72,42.6,1625
2022-01-15,56,67,-11,-16.42,1625
2022-01-16,20,21,-1,-4.76,1625
2022-01-17,299,34,265,779.41,1625
2022-01-18,285,45,240,533.33,1625
2022-01-19,285,43,242,562.79,1625
2022-01-20,285,44,241,547.73,1625
2022-01-21,241,1,240,24000.0,1625
2022-01-22,56,67,-11,-16.42,1625
2022-01-23,20,18,2,11.11,1625
2022-01-24,299,34,265,779.41,1625
2022-01-25,285,42,243,578.57,1625
2022-01-26,285,37,248,670.27,1625
2022-01-27,285,35,250,714.29,1625
2022-01-28,241,172,69,40.12,1625
2022-01-29,56,78,-22,-28.21,1625
2022-01-30,20,13,7,53.85,1625
2020-02-01,3110,3296,-186,-5.64,1608
2020-02-02,2288,2792,-504,-18.05,1608
2020-02-03,5923,5536,387,6.99,1608
2020-02-04,6147,5622,525,9.34,1608
2020-02-05,6147,5630,517,9.18,1608
2020-02-06,6147,5630,517,9.18,1608
2020-02-07,5670,5207,463,8.89,1608
2020-02-08,3110,3373,-263,-7.8,1608
2020-02-09,2288,2862,-574,-20.06,1608
2020-02-10,5923,5600,323,5.77,1608
2020-02-11,6147,5682,465,8.18,1608
2020-02-12,6147,5686,461,8.11,1608
2020-02-13,6147,5685,462,8.13,1608
2020-02-14,5670,5261,409,7.77,1608
2020-02-15,3110,3428,-318,-9.28,1608
2020-02-16,2288,2920,-632,-21.64,1608
2020-02-17,5923,5662,261,4.61,1608
2020-02-18,6147,5748,399,6.94,1608
2020-02-19,6147,5758,389,6.76,1608
2020-02-20,6147,5763,384,6.66,1608
2020-02-21,5670,5347,323,6.04,1608
2020-02-22,3110,3520,-410,-11.65,1608
2020-02-23,2288,3019,-731,-24.21,1608
2020-02-24,5923,5768,155,2.69,1608
2020-02-25,6147,5860,287,4.9,1608
2020-02-26,6147,5876,271,4.61,1608
2020-02-27,6147,5885,262,4.45,1608
2020-02-28,5670,5472,198,3.62,1608
2020-02-29,3110,3647,-537,-14.72,1608
2020-03-01,1861,3147,-1286,-40.86,1608
2020-03-02,4798,5895,-1097,-18.61,1608
2020-03-03,4665,5986,-1321,-22.07,1608
2020-03-04,4665,5999,-1334,-22.24,1608
2020-03-05,4665,6004,-1339,-22.3,1608
2020-03-06,4296,5586,-1290,-23.09,1608
2020-03-07,2795,3755,-960,-25.57,1608
2020-03-08,1861,3248,-1387,-42.7,1608
2020-03-09,4798,5989,-1191,-19.89,1608
2020-03-10,4665,6072,-1407,-23.17,1608
2020-03-11,4665,6077,-1412,-23.24,1608
2020-03-12,4665,6074,-1409,-23.2,1608
2020-03-13,4296,5648,-1352,-23.94,1608
2020-03-14,2795,3811,-1016,-26.66,1608
2020-03-15,1861,3298,-1437,-43.57,1608
2020-03-16,4798,6033,-1235,-20.47,1608
2020-03-17,4665,6112,-1447,-23.67,1608
2020-03-18,4665,6114,-1449,-23.7,1608
2020-03-19,4665,6109,-1444,-23.64,1608
2020-03-20,4296,5682,-1386,-24.39,1608
2020-03-21,2795,3844,-1049,-27.29,1608
2020-03-22,1861,3332,-1471,-44.15,1608
2020-03-23,4798,6069,-1271,-20.94,1608
2020-03-24,4665,6150,-1485,-24.15,1608
2020-03-25,4665,6155,-1490,-24.21,1608
2020-03-26,4665,6154,-1489,-24.2,1608
2020-03-27,4296,5731,-1435,-25.04,1608
2020-03-28,2795,3898,-1103,-28.3,1608
2020-03-29,1861,3389,-1528,-45.09,1608
2020-03-30,4798,6131,-1333,-21.74,1608
2020-03-31,4665,6215,-1550,-24.94,1608
2020-04-01,4599,6223,-1624,-26.1,1608
2020-04-02,4599,6224,-1625,-26.11,1608
2020-04-03,3804,5803,-1999,-34.45,1608
2020-04-04,2175,3970,-1795,-45.21,1608
2020-04-05,1080,3462,-2382,-68.8,1608
2020-04-06,4687,6202,-1515,-24.43,1608
2020-04-07,4599,6285,-1686,-26.83,1608
2020-04-08,4599,6290,-1691,-26.88,1608
2020-04-09,4599,6288,-1689,-26.86,1608
2020-04-10,3804,5862,-2058,-35.11,1608
2020-04-11,2175,4025,-1850,-45.96,1608
2020-04-12,1080,3512,-2432,-69.25,1608
2020-04-13,4687,6247,-1560,-24.97,1608
2020-04-14,4599,6324,-1725,-27.28,1608
2020-04-15,4599,6324,-1725,-27.28,1608
2020-04-16,4599,6317,-1718,-27.2,1608
2020-04-17,3804,5887,-2083,-35.38,1608
2020-04-18,2175,4047,-1872,-46.26,1608
2020-04-19,1080,3531,-2451,-69.41,1608
2020-04-20,4687,6264,-1577,-25.18,1608
2020-04-21,4599,6341,-1742,-27.47,1608
2020-04-22,4599,6341,-1742,-27.47,1608
2020-04-23,4599,6335,-1736,-27.4,1608
2020-04-24,3804,5908,-2104,-35.61,1608
2020-04-25,2175,4071,-1896,-46.57,1608
2020-04-26,1080,3559,-2479,-69.65,1608
2020-04-27,4687,6297,-1610,-25.57,1608
2020-04-28,4599,6379,-1780,-27.9,1608
2020-04-29,4599,6385,-1786,-27.97,1608
2020-04-30,4599,6385,-1786,-27.97,1608
2020-05-01,4996,5963,-967,-16.22,1608
2020-05-02,3108,4132,-1024,-24.78,1608
2020-05-03,1918,3625,-1707,-47.09,1608
2020-05-04,5584,6368,-784,-12.31,1608
2020-05-05,5783,6454,-671,-10.4,1608
2020-05-06,5783,6463,-680,-10.52,1608
2020-05-07,5783,6465,-682,-10.55,1608
2020-05-08,4996,6045,-1049,-17.35,1608
2020-05-09,3108,4213,-1105,-26.23,1608
2020-05-10,1918,3705,-1787,-48.23,1608
2020-05-11,5584,6445,-861,-13.36,1608
2020-05-12,5783,6527,-744,-11.4,1608
2020-05-13,5783,6531,-748,-11.45,1608
2020-05-14,5783,6527,-744,-11.4,1608
2020-05-15,4996,6099,-1103,-18.08,1608
2020-05-16,3108,4259,-1151,-27.03,1608
2020-05-17,1918,3743,-1825,-48.76,1608
2020-05-18,5584,6474,-890,-13.75,1608
2020-05-19,5783,6547,-764,-11.67,1608
2020-05-20,5783,6542,-759,-11.6,1608
2020-05-21,5783,6529,-746,-11.43,1608
2020-05-22,4996,6094,-1098,-18.02,1608
2020-05-23,3108,4246,-1138,-26.8,1608
2020-05-24,1918,3723,-1805,-48.48,1608
2020-05-25,5584,6448,-864,-13.4,1608
2020-05-26,5783,6517,-734,-11.26,1608
2020-05-27,5783,6509,-726,-11.15,1608
2020-05-28,5783,6494,-711,-10.95,1608
2020-05-29,4996,6057,-1061,-17.52,1608
2020-05-30,3108,4210,-1102,-26.18,1608
2020-05-31,1918,3689,-1771,-48.01,1608
2020-06-01,6311,6417,-106,-1.65,1608
2020-06-02,6401,6489,-88,-1.36,1608
2020-06-03,6401,6486,-85,-1.31,1608
2020-06-04,6401,6476,-75,-1.16,1608
2020-06-05,5530,6045,-515,-8.52,1608
2020-06-06,2884,4204,-1320,-31.4,1608
2020-06-07,1923,3688,-1765,-47.86,1608
2020-06-08,6311,6423,-112,-1.74,1608
2020-06-09,6401,6500,-99,-1.52,1608
2020-06-10,6401,6502,-101,-1.55,1608
2020-06-11,6401,6497,-96,-1.48,1608
2020-06-12,5530,6069,-539,-8.88,1608
2020-06-13,2884,4231,-1347,-31.84,1608
2020-06-14,1923,3718,-1795,-48.28,1608
2020-06-15,6311,6453,-142,-2.2,1608
2020-06-16,6401,6530,-129,-1.98,1608
2020-06-17,6401,6531,-130,-1.99,1608
2020-06-18,6401,6524,-123,-1.89,1608
2020-06-19,5530,6095,-565,-9.27,1608
2020-06-20,2884,4253,-1369,-32.19,1608
2020-06-21,1923,3736,-1813,-48.53,1608
2020-06-22,6311,6468,-157,-2.43,1608
2020-06-23,6401,6542,-141,-2.16,1608
2020-06-24,6401,6539,-138,-2.11,1608
2020-06-25,6401,6529,-128,-1.96,1608
2020-06-26,5530,6096,-566,-9.28,1608
2020-06-27,2884,4253,-1369,-32.19,1608
2020-06-28,1923,3734,-1811,-48.5,1608
2020-06-29,6311,6465,-154,-2.38,1608
2020-06-30,6401,6539,-138,-2.11,1608
2020-07-01,5577,6537,-960,-14.69,1608
2020-07-02,5577,6529,-952,-14.58,1608
2020-07-03,5021,6099,-1078,-17.68,1608
2020-07-04,2559,4259,-1700,-39.92,1608
2020-07-05,1768,3745,-1977,-52.79,1608
2020-07-06,5598,6480,-882,-13.61,1608
2020-07-07,5577,6559,-982,-14.97,1608
2020-07-08,5577,6562,-985,-15.01,1608
2020-07-09,5577,6559,-982,-14.97,1608
2020-07-10,5021,6134,-1113,-18.14,1608
2020-07-11,2559,4298,-1739,-40.46,1608
2020-07-12,1768,3786,-2018,-53.3,1608
2020-07-13,5598,6523,-925,-14.18,1608
2020-07-14,5577,6603,-1026,-15.54,1608
2020-07-15,5577,6605,-1028,-15.56,1608
2020-07-16,5577,6598,-1021,-15.47,1608
2020-07-17,5021,6168,-1147,-18.6,1608
2020-07-18,2559,4325,-1766,-40.83,1608
2020-07-19,1768,3805,-2037,-53.53,1608
2020-07-20,5598,6532,-934,-14.3,1608
2020-07-21,5577,6599,-1022,-15.49,1608
2020-07-22,5577,6586,-1009,-15.32,1608
2020-07-23,5577,6565,-988,-15.05,1608
2020-07-24,5021,6118,-1097,-17.93,1608
2020-07-25,2559,4257,-1698,-39.89,1608
2020-07-26,1768,3719,-1951,-52.46,1608
2020-07-27,5598,6427,-829,-12.9,1608
2020-07-28,5577,6476,-899,-13.88,1608
2020-07-29,5577,6447,-870,-13.49,1608
2020-07-30,5577,6409,-832,-12.98,1608
2020-07-31,5021,5948,-927,-15.59,1608
2020-08-01,2728,4074,-1346,-33.04,1608
2020-08-02,1999,3525,-1526,-43.29,1608
2020-08-03,5953,6226,-273,-4.38,1608
2020-08-04,6004,6270,-266,-4.24,1608
2020-08-05,6004,6238,-234,-3.75,1608
2020-08-06,6004,6201,-197,-3.18,1608
2020-08-07,5428,5744,-316,-5.5,1608
2020-08-08,2728,3878,-1150,-29.65,1608
2020-08-09,1999,3340,-1341,-40.15,1608
2020-08-10,5953,6054,-101,-1.67,1608
2020-08-11,6004,6115,-111,-1.82,1608
2020-08-12,6004,6103,-99,-1.62,1608
2020-08-13,6004,6087,-83,-1.36,1608
2020-08-14,5428,5654,-226,-4.0,1608
2020-08-15,2728,3813,-1085,-28.46,1608
2020-08-16,1999,3301,-1302,-39.44,1608
2020-08-17,5953,6041,-88,-1.46,1608
2020-08-18,6004,6128,-124,-2.02,1608
2020-08-19,6004,6142,-138,-2.25,1608
2020-08-20,6004,6151,-147,-2.39,1608
2020-08-21,5428,5741,-313,-5.45,1608
2020-08-22,2728,3922,-1194,-30.44,1608
2020-08-23,1999,3429,-1430,-41.7,1608
2020-08-24,5953,6186,-233,-3.77,1608
2020-08-25,6004,6288,-284,-4.52,1608
2020-08-26,6004,6312,-308,-4.88,1608
2020-08-27,6004,6330,-326,-5.15,1608
2020-08-28,5428,5925,-497,-8.39,1608
2020-08-29,2728,4108,-1380,-33.59,1608
2020-08-30,1999,3615,-1616,-44.7,1608
2020-08-31,5953,6369,-416,-6.53,1608
2020-09-01,6704,6465,239,3.7,1608
2020-09-02,6704,6482,222,3.42,1608
2020-09-03,6704,6490,214,3.3,1608
2020-09-04,5982,6075,-93,-1.53,1608
2020-09-05,3234,4246,-1012,-23.83,1608
2020-09-06,2237,3741,-1504,-40.2,1608
2020-09-07,6571,6484,87,1.34,1608
2020-09-08,6704,6568,136,2.07,1608
2020-09-09,6704,6575,129,1.96,1608
2020-09-10,6704,6574,130,1.98,1608
2020-09-11,5982,6151,-169,-2.75,1608
2020-09-12,3234,4317,-1083,-25.09,1608
2020-09-13,2237,3808,-1571,-41.26,1608
2020-09-14,6571,6550,21,0.32,1608
2020-09-15,6704,6635,69,1.04,1608
2020-09-16,6704,6645,59,0.89,1608
2020-09-17,6704,6650,54,0.81,1608
2020-09-18,5982,6234,-252,-4.04,1608
2020-09-19,3234,4410,-1176,-26.67,1608
2020-09-20,2237,3912,-1675,-42.82,1608
2020-09-21,6571,6665,-94,-1.41,1608
2020-09-22,6704,6764,-60,-0.89,1608
2020-09-23,6704,6788,-84,-1.24,1608
2020-09-24,6704,6806,-102,-1.5,1608
2020-09-25,5982,6404,-422,-6.59,1608
2020-09-26,3234,4593,-1359,-29.59,1608
2020-09-27,2237,4107,-1870,-45.53,1608
2020-09-28,6571,6871,-300,-4.37,1608
2020-09-29,6704,6978,-274,-3.93,1608
2020-09-30,6704,7008,-304,-4.34,1608
2020-10-01,6910,7032,-122,-1.73,1608
2020-10-02,6226,6632,-406,-6.12,1608
2020-10-03,3289,4820,-1531,-31.76,1608
2020-10-04,2098,4331,-2233,-51.56,1608
2020-10-05,6991,7089,-98,-1.38,1608
2020-10-06,6910,7189,-279,-3.88,1608
2020-10-07,6910,7210,-300,-4.16,1608
2020-10-08,6910,7222,-312,-4.32,1608
2020-10-09,6226,6809,-583,-8.56,1608
2020-10-10,3289,4983,-1694,-34.0,1608
2020-10-11,2098,4480,-2382,-53.17,1608
2020-10-12,6991,7224,-233,-3.23,1608
2020-10-13,6910,7309,-399,-5.46,1608
2020-10-14,6910,7316,-406,-5.55,1608
2020-10-15,6910,7314,-404,-5.52,1608
2020-10-16,6226,6890,-664,-9.64,1608
2020-10-17,3289,5055,-1766,-34.94,1608
2020-10-18,2098,4544,-2446,-53.83,1608
2020-10-19,6991,7282,-291,-4.0,1608
2020-10-20,6910,7364,-454,-6.17,1608
2020-10-21,6910,7370,-460,-6.24,1608
2020-10-22,6910,7372,-462,-6.27,1608
2020-10-23,6226,6952,-726,-10.44,1608
2020-10-24,3289,5124,-1835,-35.81,1608
2020-10-25,2098,4622,-2524,-54.61,1608
2020-10-26,6991,7372,-381,-5.17,1608
2020-10-27,6910,7467,-557,-7.46,1608
2020-10-28,6910,7488,-578,-7.72,1608
2020-10-29,6910,7504,-594,-7.92,1608
2020-10-30,6226,7101,-875,-12.32,1608
2020-10-31,3289,5288,-1999,-37.8,1608
2020-11-01,1830,4801,-2971,-61.88,1608
2020-11-02,6818,7565,-747,-9.87,1608
2020-11-03,6835,7673,-838,-10.92,1608
2020-11-04,6835,7704,-869,-11.28,1608
2020-11-05,6835,7728,-893,-11.56,1608
2020-11-06,6027,7330,-1303,-17.78,1608
2020-11-07,2908,5520,-2612,-47.32,1608
2020-11-08,1830,5033,-3203,-63.64,1608
2020-11-09,6818,7794,-976,-12.52,1608
2020-11-10,6835,7895,-1060,-13.43,1608
2020-11-11,6835,7916,-1081,-13.66,1608
2020-11-12,6835,7928,-1093,-13.79,1608
2020-11-13,6027,7515,-1488,-19.8,1608
2020-11-14,2908,5687,-2779,-48.87,1608
2020-11-15,1830,5180,-3350,-64.67,1608
2020-11-16,6818,7919,-1101,-13.9,1608
2020-11-17,6835,7997,-1162,-14.53,1608
2020-11-18,6835,7995,-1160,-14.51,1608
2020-11-19,6835,7983,-1148,-14.38,1608
2020-11-20,6027,7546,-1519,-20.13,1608
2020-11-21,2908,5695,-2787,-48.94,1608
2020-11-22,1830,5167,-3337,-64.58,1608
2020-11-23,6818,7885,-1067,-13.53,1608
2020-11-24,6835,7946,-1111,-13.98,1608
2020-11-25,6835,7929,-1094,-13.8,1608
2020-11-26,6835,7904,-1069,-13.52,1608
2020-11-27,6027,7457,-1430,-19.18,1608
2020-11-28,2908,5600,-2692,-48.07,1608
2020-11-29,1830,5068,-3238,-63.89,1608
2020-11-30,6818,7787,-969,-12.44,1608
2020-12-01,5549,7850,-2301,-29.31,1608
2020-12-02,5549,7838,-2289,-29.2,1608
2020-12-03,5549,7821,-2272,-29.05,1608
2020-12-04,6393,7385,-992,-13.43,1608
2020-12-05,3086,5539,-2453,-44.29,1608
2020-12-06,1741,5021,-3280,-65.33,1608
2020-12-07,5431,7753,-2322,-29.95,1608
2020-12-08,5549,7831,-2282,-29.14,1608
2020-12-09,5549,7833,-2284,-29.16,1608
2020-12-10,5549,7831,-2282,-29.14,1608
2020-12-11,6393,7407,-1014,-13.69,1608
2020-12-12,3086,5573,-2487,-44.63,1608
2020-12-13,1741,5064,-3323,-65.62,1608
2020-12-14,5431,7804,-2373,-30.41,1608
2020-12-15,5549,7887,-2338,-29.64,1608
2020-12-16,5549,7892,-2343,-29.69,1608
2020-12-17,5549,7889,-2340,-29.66,1608
2020-12-18,6393,7462,-1069,-14.33,1608
2020-12-19,3086,5622,-2536,-45.11,1608
2020-12-20,1741,5105,-3364,-65.9,1608
2020-12-21,5431,7835,-2404,-30.68,1608
2020-12-22,5549,7904,-2355,-29.8,1608
2020-12-23,5549,7895,-2346,-29.72,1608
2020-12-24,5549,7876,-2327,-29.55,1608
2020-12-25,6393,7432,-1039,-13.98,1608
2020-12-26,3086,5575,-2489,-44.65,1608
2020-12-27,1741,5040,-3299,-65.46,1608
2020-12-28,5431,7752,-2321,-29.94,1608
2020-12-29,5549,7806,-2257,-28.91,1608
2020-12-30,5549,7781,-2232,-28.69,1608
2020-12-31,5549,7749,-2200,-28.39,1608
2021-01-01,4943,7293,-2350,-32.22,1608
2021-01-02,2357,5427,-3070,-56.57,1608
2021-01-03,1496,4886,-3390,-69.38,1608
2021-01-04,5534,7595,-2061,-27.14,1608
2021-01-05,5702,7648,-1946,-25.44,1608
2021-01-06,5702,7627,-1925,-25.24,1608
2021-01-07,5702,7600,-1898,-24.97,1608
2021-01-08,4943,7154,-2211,-30.91,1608
2021-01-09,2357,5299,-2942,-55.52,1608
2021-01-10,1496,4772,-3276,-68.65,1608
2021-01-11,5534,7497,-1963,-26.18,1608
2021-01-12,5702,7568,-1866,-24.66,1608
2021-01-13,5702,7566,-1864,-24.64,1608
2021-01-14,5702,7560,-1858,-24.58,1608
2021-01-15,4943,7134,-2191,-30.71,1608
2021-01-16,2357,5301,-2944,-55.54,1608
2021-01-17,1496,4795,-3299,-68.8,1608
2021-01-18,5534,7541,-2007,-26.61,1608
2021-01-19,5702,7631,-1929,-25.28,1608
2021-01-20,5702,7647,-1945,-25.43,1608
2021-01-21,5702,7657,-1955,-25.53,1608
2021-01-22,4943,7246,-2303,-31.78,1608
2021-01-23,2357,5424,-3067,-56.54,1608
2021-01-24,1496,4928,-3432,-69.64,1608
2021-01-25,5534,7681,-2147,-27.95,1608
2021-01-26,5702,7776,-2074,-26.67,1608
2021-01-27,5702,7794,-2092,-26.84,1608
2021-01-28,5702,7804,-2102,-26.93,1608
2021-01-29,4943,7391,-2448,-33.12,1608
2021-01-30,2357,5566,-3209,-57.65,1608
2021-01-31,1496,5064,-3568,-70.46,1608
2021-02-01,6414,7810,-1396,-17.87,1608
2021-02-02,6461,7898,-1437,-18.19,1608
2021-02-03,6461,7907,-1446,-18.29,1608
2021-02-04,6461,7908,-1447,-18.3,1608
2021-02-05,5605,7487,-1882,-25.14,1608
2021-02-06,2816,5653,-2837,-50.19,1608
2021-02-07,1708,5143,-3435,-66.79,1608
2021-02-08,6414,7881,-1467,-18.61,1608
2021-02-09,6461,7963,-1502,-18.86,1608
2021-02-10,6461,7967,-1506,-18.9,1608
2021-02-11,6461,7965,-1504,-18.88,1608
2021-02-12,5605,7541,-1936,-25.67,1608
2021-02-13,2816,5707,-2891,-50.66,1608
2021-02-14,1708,5198,-3490,-67.14,1608
2021-02-15,6414,7938,-1524,-19.2,1608
2021-02-16,6461,8023,-1562,-19.47,1608
2021-02-17,6461,8032,-1571,-19.56,1608
2021-02-18,6461,8036,-1575,-19.6,1608
2021-02-19,5605,7618,-2013,-26.42,1608
2021-02-20,2816,5790,-2974,-51.36,1608
2021-02-21,1708,5288,-3580,-67.7,1608
2021-02-22,6414,8036,-1622,-20.18,1608
2021-02-23,6461,8127,-1666,-20.5,1608
2021-02-24,6461,8143,-1682,-20.66,1608
2021-02-25,6461,8152,-1691,-20.74,1608
2021-02-26,5605,7739,-2134,-27.57,1608
2021-02-27,2816,5915,-3099,-52.39,1608
2021-02-28,1708,5415,-3707,-68.46,1608
2021-03-01,6490,8164,-1674,-20.5,1608
2021-03-02,6593,8256,-1663,-20.14,1608
2021-03-03,6593,8270,-1677,-20.28,1608
2021-03-04,6593,8276,-1683,-20.34,1608
2021-03-05,5926,7859,-1933,-24.6,1608
2021-03-06,3206,6030,-2824,-46.83,1608
2021-03-07,1917,5524,-3607,-65.3,1608
2021-03-08,6490,8267,-1777,-21.5,1608
2021-03-09,6593,8351,-1758,-21.05,1608
2021-03-10,6593,8357,-1764,-21.11,1608
2021-03-11,6593,8356,-1763,-21.1,1608
2021-03-12,5926,7931,-2005,-25.28,1608
2021-03-13,3206,6095,-2889,-47.4,1608
2021-03-14,1917,5582,-3665,-65.66,1608
2021-03-15,6490,8318,-1828,-21.98,1608
2021-03-16,6593,8397,-1804,-21.48,1608
2021-03-17,6593,8398,-1805,-21.49,1608
2021-03-18,6593,8393,-1800,-21.45,1608
2021-03-19,5926,7966,-2040,-25.61,1608
2021-03-20,3206,6128,-2922,-47.68,1608
2021-03-21,1917,5615,-3698,-65.86,1608
2021-03-22,6490,8352,-1862,-22.29,1608
2021-03-23,6593,8432,-1839,-21.81,1608
2021-03-24,6593,8436,-1843,-21.85,1608
2021-03-25,6593,8434,-1841,-21.83,1608
2021-03-26,5926,8010,-2084,-26.02,1608
2021-03-27,3206,6176,-2970,-48.09,1608
2021-03-28,1917,5667,-3750,-66.17,1608
2021-03-29,6490,8408,-1918,-22.81,1608
2021-03-30,6593,8492,-1899,-22.36,1608
2021-03-31,6593,8500,-1907,-22.44,1608
2021-04-01,6459,8501,-2042,-24.02,1608
2021-04-02,5596,8080,-2484,-30.74,1608
2021-04-03,2649,6248,-3599,-57.6,1608
2021-04-04,1676,5740,-4064,-70.8,1608
2021-04-05,6459,8481,-2022,-23.84,1608
2021-04-06,6459,8564,-2105,-24.58,1608
2021-04-07,6459,8570,-2111,-24.63,1608
2021-04-08,6459,8569,-2110,-24.62,1608
2021-04-09,5596,8144,-2548,-31.29,1608
2021-04-10,2649,6308,-3659,-58.01,1608
2021-04-11,1676,5796,-4120,-71.08,1608
2021-04-12,6459,8532,-2073,-24.3,1608
2021-04-13,6459,8610,-2151,-24.98,1608
2021-04-14,6459,8611,-2152,-24.99,1608
2021-04-15,6459,8604,-2145,-24.93,1608
2021-04-16,5596,8175,-2579,-31.55,1608
2021-04-17,2649,6335,-3686,-58.18,1608
2021-04-18,1676,5819,-4143,-71.2,1608
2021-04-19,6459,8552,-2093,-24.47,1608
2021-04-20,6459,8628,-2169,-25.14,1608
2021-04-21,6459,8628,-2169,-25.14,1608
2021-04-22,6459,8621,-2162,-25.08,1608
2021-04-23,5596,8193,-2597,-31.7,1608
2021-04-24,2649,6354,-3705,-58.31,1608
2021-04-25,1676,5841,-4165,-71.31,1608
2021-04-26,6459,8578,-2119,-24.7,1608
2021-04-27,6459,8659,-2200,-25.41,1608
2021-04-28,6459,8664,-2205,-25.45,1608
2021-04-29,6459,8663,-2204,-25.44,1608
2021-04-30,5596,8241,-2645,-32.1,1608
2021-05-01,1009,6408,-5399,-84.25,1608
2021-05-02,573,5901,-5328,-90.29,1608
2021-05-03,2391,8643,-6252,-72.34,1608
2021-05-04,2415,8729,-6314,-72.33,1608
2021-05-05,2415,8738,-6323,-72.36,1608
2021-05-06,2415,8741,-6326,-72.37,1608
2021-05-07,2178,8321,-6143,-73.83,1608
2021-05-08,1009,6490,-5481,-84.45,1608
2021-05-09,573,5983,-5410,-90.42,1608
2021-05-10,2391,8724,-6333,-72.59,1608
2021-05-11,2415,8807,-6392,-72.58,1608
2021-05-12,2415,8812,-6397,-72.59,1608
2021-05-13,2415,8810,-6395,-72.59,1608
2021-05-14,2178,8384,-6206,-74.02,1608
2021-05-15,1009,6546,-5537,-84.59,1608
2021-05-16,573,6031,-5458,-90.5,1608
2021-05-17,2391,8764,-6373,-72.72,1608
2021-05-18,2415,8838,-6423,-72.67,1608
2021-05-19,2415,8835,-6420,-72.67,1608
2021-05-20,2415,8823,-6408,-72.63,1608
2021-05-21,2178,8389,-6211,-74.04,1608
2021-05-22,1009,6542,-5533,-84.58,1608
2021-05-23,573,6020,-5447,-90.48,1608
2021-05-24,2391,8745,-6354,-72.66,1608
2021-05-25,2415,8814,-6399,-72.6,1608
2021-05-26,2415,8806,-6391,-72.58,1608
2021-05-27,2415,8791,-6376,-72.53,1608
2021-05-28,2178,8354,-6176,-73.93,1608
2021-05-29,1009,6506,-5497,-84.49,1608
2021-05-30,573,5984,-5411,-90.42,1608
2021-05-31,2391,8711,-6320,-72.55,1608
2021-06-01,2494,8782,-6288,-71.6,1608
2021-06-02,2494,8777,-6283,-71.58,1608
2021-06-03,2494,8766,-6272,-71.55,1608
2021-06-04,2163,8334,-6171,-74.05,1608
2021-06-05,964,6492,-5528,-85.15,1608
2021-06-06,633,5976,-5343,-89.41,1608
2021-06-07,2392,8709,-6317,-72.53,1608
2021-06-08,2494,8786,-6292,-71.61,1608
2021-06-09,2494,8787,-6293,-71.62,1608
2021-06-10,2494,8781,-6287,-71.6,1608
2021-06-11,2163,8354,-6191,-74.11,1608
2021-06-12,964,6516,-5552,-85.21,1608
2021-06-13,633,6002,-5369,-89.45,1608
2021-06-14,2392,8738,-6346,-72.63,1608
2021-06-15,2494,8816,-6322,-71.71,1608
2021-06-16,2494,8817,-6323,-71.71,1608
2021-06-17,2494,8811,-6317,-71.69,1608
2021-06-18,2163,8382,-6219,-74.19,1608
2021-06-19,964,6542,-5578,-85.26,1608
2021-06-20,633,6025,-5392,-89.49,1608
2021-06-21,2392,8757,-6365,-72.68,1608
2021-06-22,2494,8832,-6338,-71.76,1608
2021-06-23,2494,8829,-6335,-71.75,1608
2021-06-24,2494,8820,-6326,-71.72,1608
2021-06-25,2163,8387,-6224,-74.21,1608
2021-06-26,964,6544,-5580,-85.27,1608
2021-06-27,633,6025,-5392,-89.49,1608
2021-06-28,2392,8755,-6363,-72.68,1608
2021-06-29,2494,8829,-6335,-71.75,1608
2021-06-30,2494,8826,-6332,-71.74,1608
2021-07-01,2452,8817,-6365,-72.19,1608
2021-07-02,2220,8387,-6167,-73.53,1608
2021-07-03,1060,6546,-5486,-83.81,1608
2021-07-04,611,6030,-5419,-89.87,1608
2021-07-05,2329,8765,-6436,-73.43,1608
2021-07-06,2452,8843,-6391,-72.27,1608
2021-07-07,2452,8845,-6393,-72.28,1608
2021-07-08,2452,8842,-6390,-72.27,1608
2021-07-09,2220,8416,-6196,-73.62,1608
2021-07-10,1060,6580,-5520,-83.89,1608
2021-07-11,611,6068,-5457,-89.93,1608
2021-07-12,2329,8806,-6477,-73.55,1608
2021-07-13,2452,8886,-6434,-72.41,1608
2021-07-14,2452,8889,-6437,-72.42,1608
2021-07-15,2452,8884,-6432,-72.4,1608
2021-07-16,2220,8456,-6236,-73.75,1608
2021-07-17,1060,6616,-5556,-83.98,1608
2021-07-18,611,6098,-5487,-89.98,1608
2021-07-19,2329,8827,-6498,-73.62,1608
2021-07-20,2452,8897,-6445,-72.44,1608
2021-07-21,2452,8888,-6436,-72.41,1608
2021-07-22,2452,8870,-6418,-72.36,1608
2021-07-23,2220,8426,-6206,-73.65,1608
2021-07-24,1060,6569,-5509,-83.86,1608
2021-07-25,611,6034,-5423,-89.87,1608
2021-07-26,2329,8746,-6417,-73.37,1608
2021-07-27,2452,8798,-6346,-72.13,1608
2021-07-28,2452,8770,-6318,-72.04,1608
2021-07-29,2452,8735,-6283,-71.93,1608
2021-07-30,2220,8275,-6055,-73.17,1608
2021-07-31,1060,6403,-5343,-83.45,1608
2021-08-01,551,5854,-5303,-90.59,1608
2021-08-02,2295,8554,-6259,-73.17,1608
2021-08-03,2337,8598,-6261,-72.82,1608
2021-08-04,2337,8565,-6228,-72.71,1608
2021-08-05,2337,8526,-6189,-72.59,1608
2021-08-06,2026,8066,-6040,-74.88,1608
2021-08-07,912,6198,-5286,-85.29,1608
2021-08-08,551,5656,-5105,-90.26,1608
2021-08-09,2295,8366,-6071,-72.57,1608
2021-08-10,2337,8423,-6086,-72.25,1608
2021-08-11,2337,8406,-6069,-72.2,1608
2021-08-12,2337,8386,-6049,-72.13,1608
2021-08-13,2026,7947,-5921,-74.51,1608
2021-08-14,912,6101,-5189,-85.05,1608
2021-08-15,551,5584,-5033,-90.13,1608
2021-08-16,2295,8320,-6025,-72.42,1608
2021-08-17,2337,8403,-6066,-72.19,1608
2021-08-18,2337,8412,-6075,-72.22,1608
2021-08-19,2337,8418,-6081,-72.24,1608
2021-08-20,2026,8005,-5979,-74.69,1608
2021-08-21,912,6183,-5271,-85.25,1608
2021-08-22,551,5688,-5137,-90.31,1608
2021-08-23,2295,8444,-6149,-72.82,1608
2021-08-24,2337,8544,-6207,-72.65,1608
2021-08-25,2337,8568,-6231,-72.72,1608
2021-08-26,2337,8586,-6249,-72.78,1608
2021-08-27,2026,8182,-6156,-75.24,1608
2021-08-28,912,6366,-5454,-85.67,1608
2021-08-29,551,5874,-5323,-90.62,1608
2021-08-30,2295,8630,-6335,-73.41,1608
2021-08-31,2337,8728,-6391,-73.22,1608
2021-09-01,2562,8747,-6185,-70.71,1608
2021-09-02,2562,8758,-6196,-70.75,1608
2021-09-03,2314,8344,-6030,-72.27,1608
2021-09-04,1096,6518,-5422,-83.19,1608
2021-09-05,671,6015,-5344,-88.84,1608
2021-09-06,2407,8759,-6352,-72.52,1608
2021-09-07,2562,8845,-6283,-71.03,1608
2021-09-08,2562,8853,-6291,-71.06,1608
2021-09-09,2562,8853,-6291,-71.06,1608
2021-09-10,2314,8430,-6116,-72.55,1608
2021-09-11,1096,6596,-5500,-83.38,1608
2021-09-12,671,6087,-5416,-88.98,1608
2021-09-13,2407,8827,-6420,-72.73,1608
2021-09-14,2562,8911,-6349,-71.25,1608
2021-09-15,2562,8919,-6357,-71.27,1608
2021-09-16,2562,8922,-6360,-71.28,1608
2021-09-17,2314,8504,-6190,-72.79,1608
2021-09-18,1096,6678,-5582,-83.59,1608
2021-09-19,671,6177,-5506,-89.14,1608
2021-09-20,2407,8928,-6521,-73.04,1608
2021-09-21,2562,9024,-6462,-71.61,1608
2021-09-22,2562,9045,-6483,-71.67,1608
2021-09-23,2562,9062,-6500,-71.73,1608
2021-09-24,2314,8658,-6344,-73.27,1608
2021-09-25,1096,6844,-5748,-83.99,1608
2021-09-26,671,6357,-5686,-89.44,1608
2021-09-27,2407,9120,-6713,-73.61,1608
2021-09-28,2562,9227,-6665,-72.23,1608
2021-09-29,2562,9257,-6695,-72.32,1608
2021-09-30,2562,9281,-6719,-72.4,1608
2021-10-01,2386,8882,-6496,-73.14,1608
2021-10-02,1105,7071,-5966,-84.37,1608
2021-10-03,665,6584,-5919,-89.9,1608
2021-10-04,2364,9345,-6981,-74.7,1608
2021-10-05,2543,9447,-6904,-73.08,1608
2021-10-06,2543,9470,-6927,-73.15,1608
2021-10-07,2543,9485,-6942,-73.19,1608
2021-10-08,2386,9075,-6689,-73.71,1608
2021-10-09,1105,7252,-6147,-84.76,1608
2021-10-10,665,6751,-6086,-90.15,1608
2021-10-11,2364,9498,-7134,-75.11,1608
2021-10-12,2543,9585,-7042,-73.47,1608
2021-10-13,2543,9594,-7051,-73.49,1608
2021-10-14,2543,9594,-7051,-73.49,1608
2021-10-15,2386,9171,-6785,-73.98,1608
2021-10-16,1105,7336,-6231,-84.94,1608
2021-10-17,665,6825,-6160,-90.26,1608
2021-10-18,2364,9563,-7199,-75.28,1608
2021-10-19,2543,9644,-7101,-73.63,1608
2021-10-20,2543,9649,-7106,-73.64,1608
2021-10-21,2543,9649,-7106,-73.64,1608
2021-10-22,2386,9227,-6841,-74.14,1608
2021-10-23,1105,7396,-6291,-85.06,1608
2021-10-24,665,6892,-6227,-90.35,1608
2021-10-25,2364,9639,-7275,-75.47,1608
2021-10-26,2543,9731,-7188,-73.87,1608
2021-10-27,2543,9749,-7206,-73.92,1608
2021-10-28,2543,9763,-7220,-73.95,1608
2021-10-29,2386,9356,-6970,-74.5,1608
2021-10-30,1105,7541,-6436,-85.35,1608
2021-10-31,665,7052,-6387,-90.57,1608
2021-11-01,4426,9814,-5388,-54.9,1608
2021-11-02,3738,9921,-6183,-62.32,1608
2021-11-03,3738,9952,-6214,-62.44,1608
2021-11-04,3738,9976,-6238,-62.53,1608
2021-11-05,3115,9578,-6463,-67.48,1608
2021-11-06,2212,7770,-5558,-71.53,1608
2021-11-07,1182,7284,-6102,-83.77,1608
2021-11-08,4426,10047,-5621,-55.95,1608
2021-11-09,3738,10151,-6413,-63.18,1608
2021-11-10,3738,10176,-6438,-63.27,1608
2021-11-11,3738,10191,-6453,-63.32,1608
2021-11-12,3115,9782,-6667,-68.16,1608
2021-11-13,2212,7958,-5746,-72.2,1608
2021-11-14,1182,7456,-6274,-84.15,1608
2021-11-15,4426,10199,-5773,-56.6,1608
2021-11-16,3738,10281,-6543,-63.64,1608
2021-11-17,3738,10284,-6546,-63.65,1608
2021-11-18,3738,10276,-6538,-63.62,1608
2021-11-19,3115,9842,-6727,-68.35,1608
2021-11-20,2212,7995,-5783,-72.33,1608
2021-11-21,1182,7469,-6287,-84.17,1608
2021-11-22,4426,10191,-5765,-56.57,1608
2021-11-23,3738,10253,-6515,-63.54,1608
2021-11-24,3738,10237,-6499,-63.49,1608
2021-11-25,3738,10213,-6475,-63.4,1608
2021-11-26,3115,9766,-6651,-68.1,1608
2021-11-27,2212,7909,-5697,-72.03,1608
2021-11-28,1182,7376,-6194,-83.98,1608
2021-11-29,4426,10093,-5667,-56.15,1608
2021-11-30,3738,10154,-6416,-63.19,1608
2021-12-01,5412,10140,-4728,-46.63,1608
2021-12-02,5412,10121,-4709,-46.53,1608
2021-12-03,4618,9681,-5063,-52.3,1608
2021-12-04,3044,7833,-4789,-61.14,1608
2021-12-05,1818,7312,-5494,-75.14,1608
2021-12-06,5754,10042,-4288,-42.7,1608
2021-12-07,5412,10117,-4705,-46.51,1608
2021-12-08,5412,10117,-4705,-46.51,1608
2021-12-09,5412,10113,-4701,-46.48,1608
2021-12-10,4618,9687,-5069,-52.33,1608
2021-12-11,3044,7852,-4808,-61.23,1608
2021-12-12,1818,7343,-5525,-75.24,1608
2021-12-13,5754,10083,-4329,-42.93,1608
2021-12-14,5412,10166,-4754,-46.76,1608
2021-12-15,5412,10172,-4760,-46.8,1608
2021-12-16,5412,10171,-4759,-46.79,1608
2021-12-17,4618,9746,-5128,-52.62,1608
2021-12-18,3044,7909,-4865,-61.51,1608
2021-12-19,1818,7394,-5576,-75.41,1608
2021-12-20,5754,10126,-4372,-43.18,1608
2021-12-21,5412,10199,-4787,-46.94,1608
2021-12-22,5412,10193,-4781,-46.9,1608
2021-12-23,5412,10178,-4766,-46.83,1608
2021-12-24,4618,9737,-5119,-52.57,1608
2021-12-25,3044,7883,-4839,-61.39,1608
2021-12-26,1818,7351,-5533,-75.27,1608
2021-12-27,5754,10066,-4312,-42.84,1608
2021-12-28,5412,10121,-4709,-46.53,1608
2021-12-29,5412,10098,-4686,-46.41,1608
2021-12-30,5412,10067,-4655,-46.24,1608
2021-12-31,4618,9613,-4995,-51.96,1608
2022-01-01,2820,7747,-4927,-63.6,1608
2022-01-02,1780,7205,-5425,-75.29,1608
2022-01-03,5438,9913,-4475,-45.14,1608
2022-01-04,5596,9965,-4369,-43.84,1608
2022-01-05,5596,9941,-4345,-43.71,1608
2022-01-06,5596,9912,-4316,-43.54,1608
2022-01-07,5098,9463,-4365,-46.13,1608
2022-01-08,2820,7605,-4785,-62.92,1608
2022-01-09,1780,7074,-5294,-74.84,1608
2022-01-10,5438,9795,-4357,-44.48,1608
2022-01-11,5596,9862,-4266,-43.26,1608
2022-01-12,5596,9856,-4260,-43.22,1608
2022-01-13,5596,9846,-4250,-43.16,1608
2022-01-14,5098,9417,-4319,-45.86,1608
2022-01-15,2820,7580,-4760,-62.8,1608
2022-01-16,1780,7071,-5291,-74.83,1608
2022-01-17,5438,9813,-4375,-44.58,1608
2022-01-18,5596,9901,-4305,-43.48,1608
2022-01-19,5596,9914,-4318,-43.55,1608
2022-01-20,5596,9923,-4327,-43.61,1608
2022-01-21,5098,9510,-4412,-46.39,1608
2022-01-22,2820,7688,-4868,-63.32,1608
2022-01-23,1780,7191,-5411,-75.25,1608
2022-01-24,5438,9944,-4506,-45.31,1608
2022-01-25,5596,10040,-4444,-44.26,1608
2022-01-26,5596,10058,-4462,-44.36,1608
2022-01-27,5596,10070,-4474,-44.43,1608
2022-01-28,5098,9658,-4560,-47.21,1608
2022-01-29,2820,7834,-5014,-64.0,1608
2022-01-30,1780,7334,-5554,-75.73,1608
2020-02-01,1847,1498,349,23.3,1078
2020-02-02,1189,856,333,38.9,1078
2020-02-03,3090,3020,70,2.32,1078
2020-02-04,3151,3093,58,1.88,1078
2020-02-05,3151,3096,55,1.78,1078
2020-02-06,3151,3103,48,1.55,1078
2020-02-07,3120,2975,145,4.87,1078
2020-02-08,1847,1534,313,20.4,1078
2020-02-09,1189,886,303,34.2,1078
2020-02-10,3090,3045,45,1.48,1078
2020-02-11,3151,3113,38,1.22,1078
2020-02-12,3151,3114,37,1.19,1078
2020-02-13,3151,3118,33,1.06,1078
2020-02-14,3120,2990,130,4.35,1078
2020-02-15,1847,1549,298,19.24,1078
2020-02-16,1189,903,286,31.67,1078
2020-02-17,3090,3065,25,0.82,1078
2020-02-18,3151,3138,13,0.41,1078
2020-02-19,3151,3143,8,0.25,1078
2020-02-20,3151,3154,-3,-0.1,1078
2020-02-21,3120,3032,88,2.9,1078
2020-02-22,1847,1598,249,15.58,1078
2020-02-23,1189,958,231,24.11,1078
2020-02-24,3090,3128,-38,-1.21,1078
2020-02-25,3151,3207,-56,-1.75,1078
2020-02-26,3151,3218,-67,-2.08,1078
2020-02-27,3151,3235,-84,-2.6,1078
2020-02-28,3120,3117,3,0.1,1078
2020-02-29,1847,1687,160,9.48,1078
2020-03-01,751,1050,-299,-28.48,1078
2020-03-02,2543,3221,-678,-21.05,1078
2020-03-03,2531,3300,-769,-23.3,1078
2020-03-04,2531,3311,-780,-23.56,1078
2020-03-05,2531,3325,-794,-23.88,1078
2020-03-06,2410,3204,-794,-24.78,1078
2020-03-07,1164,1769,-605,-34.2,1078
2020-03-08,751,1127,-376,-33.36,1078
2020-03-09,2543,3292,-749,-22.75,1078
2020-03-10,2531,3365,-834,-24.78,1078
2020-03-11,2531,3368,-837,-24.85,1078
2020-03-12,2531,3375,-844,-25.01,1078
2020-03-13,2410,3248,-838,-25.8,1078
2020-03-14,1164,1806,-642,-35.55,1078
2020-03-15,751,1157,-406,-35.09,1078
2020-03-16,2543,3316,-773,-23.31,1078
2020-03-17,2531,3384,-853,-25.21,1078
2020-03-18,2531,3383,-852,-25.18,1078
2020-03-19,2531,3387,-856,-25.27,1078
2020-03-20,2410,3257,-847,-26.01,1078
2020-03-21,1164,1814,-650,-35.83,1078
2020-03-22,751,1165,-414,-35.54,1078
2020-03-23,2543,3325,-782,-23.52,1078
2020-03-24,2531,3394,-863,-25.43,1078
2020-03-25,2531,3396,-865,-25.47,1078
2020-03-26,2531,3403,-872,-25.62,1078
2020-03-27,2410,3277,-867,-26.46,1078
2020-03-28,1164,1838,-674,-36.67,1078
2020-03-29,751,1194,-443,-37.1,1078
2020-03-30,2543,3358,-815,-24.27,1078
2020-03-31,2531,3432,-901,-26.25,1078
2020-04-01,2301,3438,-1137,-33.07,1078
2020-04-02,2301,3449,-1148,-33.29,1078
2020-04-03,1962,3326,-1364,-41.01,1078
2020-04-04,834,1890,-1056,-55.87,1078
2020-04-05,412,1248,-836,-66.99,1078
2020-04-06,2337,3413,-1076,-31.53,1078
2020-04-07,2301,3487,-1186,-34.01,1078
2020-04-08,2301,3493,-1192,-34.13,1078
2020-04-09,2301,3502,-1201,-34.29,1078
2020-04-10,1962,3377,-1415,-41.9,1078
2020-04-11,834,1938,-1104,-56.97,1078
2020-04-12,412,1292,-880,-68.11,1078
2020-04-13,2337,3454,-1117,-32.34,1078
2020-04-14,2301,3524,-1223,-34.7,1078
2020-04-15,2301,3526,-1225,-34.74,1078
2020-04-16,2301,3531,-1230,-34.83,1078
2020-04-17,1962,3402,-1440,-42.33,1078
2020-04-18,834,1960,-1126,-57.45,1078
2020-04-19,412,1312,-900,-68.6,1078
2020-04-20,2337,3471,-1134,-32.67,1078
2020-04-21,2301,3540,-1239,-35.0,1078
2020-04-22,2301,3540,-1239,-35.0,1078
2020-04-23,2301,3546,-1245,-35.11,1078
2020-04-24,1962,3418,-1456,-42.6,1078
2020-04-25,834,1978,-1144,-57.84,1078
2020-04-26,412,1332,-920,-69.07,1078
2020-04-27,2337,3495,-1158,-33.13,1078
2020-04-28,2301,3568,-1267,-35.51,1078
2020-04-29,2301,3573,-1272,-35.6,1078
2020-04-30,2301,3584,-1283,-35.8,1078
2020-05-01,2750,3462,-712,-20.57,1078
2020-05-02,1414,2026,-612,-30.21,1078
2020-05-03,753,1386,-633,-45.67,1078
2020-05-04,2894,3553,-659,-18.55,1078
2020-05-05,2990,3630,-640,-17.63,1078
2020-05-06,2990,3638,-648,-17.81,1078
2020-05-07,2990,3651,-661,-18.1,1078
2020-05-08,2750,3530,-780,-22.1,1078
2020-05-09,1414,2095,-681,-32.51,1078
2020-05-10,753,1453,-700,-48.18,1078
2020-05-11,2894,3619,-725,-20.03,1078
2020-05-12,2990,3692,-702,-19.01,1078
2020-05-13,2990,3696,-706,-19.1,1078
2020-05-14,2990,3704,-714,-19.28,1078
2020-05-15,2750,3576,-826,-23.1,1078
2020-05-16,1414,2134,-720,-33.74,1078
2020-05-17,753,1484,-731,-49.26,1078
2020-05-18,2894,3641,-747,-20.52,1078
2020-05-19,2990,3707,-717,-19.34,1078
2020-05-20,2990,3703,-713,-19.25,1078
2020-05-21,2990,3702,-712,-19.23,1078
2020-05-22,2750,3567,-817,-22.9,1078
2020-05-23,1414,2118,-704,-33.24,1078
2020-05-24,753,1463,-710,-48.53,1078
2020-05-25,2894,3615,-721,-19.94,1078
2020-05-26,2990,3677,-687,-18.68,1078
2020-05-27,2990,3671,-681,-18.55,1078
2020-05-28,2990,3669,-679,-18.51,1078
2020-05-29,2750,3535,-785,-22.21,1078
2020-05-30,1414,2088,-674,-32.28,1078
2020-05-31,753,1437,-684,-47.6,1078
2020-06-01,3163,3594,-431,-11.99,1078
2020-06-02,3222,3661,-439,-11.99,1078
2020-06-03,3222,3662,-440,-12.02,1078
2020-06-04,3222,3668,-446,-12.16,1078
2020-06-05,2948,3541,-593,-16.75,1078
2020-06-06,1531,2102,-571,-27.16,1078
2020-06-07,932,1458,-526,-36.08,1078
2020-06-08,3163,3622,-459,-12.67,1078
2020-06-09,3222,3695,-473,-12.8,1078
2020-06-10,3222,3701,-479,-12.94,1078
2020-06-11,3222,3710,-488,-13.15,1078
2020-06-12,2948,3586,-638,-17.79,1078
2020-06-13,1531,2147,-616,-28.69,1078
2020-06-14,932,1501,-569,-37.91,1078
2020-06-15,3163,3661,-498,-13.6,1078
2020-06-16,3222,3729,-507,-13.6,1078
2020-06-17,3222,3726,-504,-13.53,1078
2020-06-18,3222,3726,-504,-13.53,1078
2020-06-19,2948,3589,-641,-17.86,1078
2020-06-20,1531,2137,-606,-28.36,1078
2020-06-21,932,1476,-544,-36.86,1078
2020-06-22,3163,3620,-457,-12.62,1078
2020-06-23,3222,3670,-448,-12.21,1078
2020-06-24,3222,3650,-428,-11.73,1078
2020-06-25,3222,3632,-410,-11.29,1078
2020-06-26,2948,3478,-530,-15.24,1078
2020-06-27,1531,2009,-478,-23.79,1078
2020-06-28,932,1333,-401,-30.08,1078
2020-06-29,3163,3463,-300,-8.66,1078
2020-06-30,3222,3501,-279,-7.97,1078
2020-07-01,2992,3470,-478,-13.78,1078
2020-07-02,2992,3445,-453,-13.15,1078
2020-07-03,2782,3285,-503,-15.31,1078
2020-07-04,1478,1814,-336,-18.52,1078
2020-07-05,914,1137,-223,-19.61,1078
2020-07-06,2958,3270,-312,-9.54,1078
2020-07-07,2992,3314,-322,-9.72,1078
2020-07-08,2992,3292,-300,-9.11,1078
2020-07-09,2992,3276,-284,-8.67,1078
2020-07-10,2782,3130,-348,-11.12,1078
2020-07-11,1478,1672,-194,-11.6,1078
2020-07-12,914,1012,-98,-9.68,1078
2020-07-13,2958,3162,-204,-6.45,1078
2020-07-14,2992,3223,-231,-7.17,1078
2020-07-15,2992,3219,-227,-7.05,1078
2020-07-16,2992,3221,-229,-7.11,1078
2020-07-17,2782,3092,-310,-10.03,1078
2020-07-18,1478,1650,-172,-10.42,1078
2020-07-19,914,1004,-90,-8.96,1078
2020-07-20,2958,3166,-208,-6.57,1078
2020-07-21,2992,3238,-246,-7.6,1078
2020-07-22,2992,3241,-249,-7.68,1078
2020-07-23,2992,3248,-256,-7.88,1078
2020-07-24,2782,3121,-339,-10.86,1078
2020-07-25,1478,1679,-201,-11.97,1078
2020-07-26,914,1030,-116,-11.26,1078
2020-07-27,2958,3186,-228,-7.16,1078
2020-07-28,2992,3250,-258,-7.94,1078
2020-07-29,2992,3243,-251,-7.74,1078
2020-07-30,2992,3239,-247,-7.63,1078
2020-07-31,2782,3098,-316,-10.2,1078
2020-08-01,1480,1642,-162,-9.87,1078
2020-08-02,951,978,-27,-2.76,1078
2020-08-03,2877,3120,-243,-7.79,1078
2020-08-04,2960,3170,-210,-6.62,1078
2020-08-05,2960,3150,-190,-6.03,1078
2020-08-06,2960,3134,-174,-5.55,1078
2020-08-07,2720,2984,-264,-8.85,1078
2020-08-08,1480,1520,-40,-2.63,1078
2020-08-09,951,851,100,11.75,1078
2020-08-10,2877,2991,-114,-3.81,1078
2020-08-11,2960,3042,-82,-2.7,1078
2020-08-12,2960,3027,-67,-2.21,1078
2020-08-13,2960,3018,-58,-1.92,1078
2020-08-14,2720,2879,-159,-5.52,1078
2020-08-15,1480,1429,51,3.57,1078
2020-08-16,951,777,174,22.39,1078
2020-08-17,2877,2937,-60,-2.04,1078
2020-08-18,2960,3009,-49,-1.63,1078
2020-08-19,2960,3018,-58,-1.92,1078
2020-08-20,2960,3034,-74,-2.44,1078
2020-08-21,2720,2921,-201,-6.88,1078
2020-08-22,1480,1499,-19,-1.27,1078
2020-08-23,951,873,78,8.93,1078
2020-08-24,2877,3059,-182,-5.95,1078
2020-08-25,2960,3157,-197,-6.24,1078
2020-08-26,2960,3188,-228,-7.15,1078
2020-08-27,2960,3226,-266,-8.25,1078
2020-08-28,2720,3132,-412,-13.15,1078
2020-08-29,1480,1725,-245,-14.2,1078
2020-08-30,951,1112,-161,-14.48,1078
2020-08-31,2877,3307,-430,-13.0,1078
2020-09-01,3167,3411,-244,-7.15,1078
2020-09-02,3167,3445,-278,-8.07,1078
2020-09-03,3167,3481,-314,-9.02,1078
2020-09-04,2934,3382,-448,-13.25,1078
2020-09-05,1638,1967,-329,-16.73,1078
2020-09-06,979,1344,-365,-27.16,1078
2020-09-07,3041,3525,-484,-13.73,1078
2020-09-08,3167,3612,-445,-12.32,1078
2020-09-09,3167,3628,-461,-12.71,1078
2020-09-10,3167,3645,-478,-13.11,1078
2020-09-11,2934,3526,-592,-16.79,1078
2020-09-12,1638,2090,-452,-21.63,1078
2020-09-13,979,1445,-466,-32.25,1078
2020-09-14,3041,3605,-564,-15.64,1078
2020-09-15,3167,3672,-505,-13.75,1078
2020-09-16,3167,3669,-502,-13.68,1078
2020-09-17,3167,3669,-502,-13.68,1078
2020-09-18,2934,3534,-600,-16.98,1078
2020-09-19,1638,2085,-447,-21.44,1078
2020-09-20,979,1429,-450,-31.49,1078
2020-09-21,3041,3581,-540,-15.08,1078
2020-09-22,3167,3642,-475,-13.04,1078
2020-09-23,3167,3636,-469,-12.9,1078
2020-09-24,3167,3634,-467,-12.85,1078
2020-09-25,2934,3500,-566,-16.17,1078
2020-09-26,1638,2053,-415,-20.21,1078
2020-09-27,979,1402,-423,-30.17,1078
2020-09-28,3041,3560,-519,-14.58,1078
2020-09-29,3167,3628,-461,-12.71,1078
2020-09-30,3167,3629,-462,-12.73,1078
2020-10-01,3236,3636,-400,-11.0,1078
2020-10-02,2998,3510,-512,-14.59,1078
2020-10-03,1653,2072,-419,-20.22,1078
2020-10-04,921,1428,-507,-35.5,1078
2020-10-05,3256,3592,-336,-9.35,1078
2020-10-06,3236,3666,-430,-11.73,1078
2020-10-07,3236,3671,-435,-11.85,1078
2020-10-08,3236,3681,-445,-12.09,1078
2020-10-09,2998,3556,-558,-15.69,1078
2020-10-10,1653,2117,-464,-21.92,1078
2020-10-11,921,1472,-551,-37.43,1078
2020-10-12,3256,3632,-376,-10.35,1078
2020-10-13,3236,3701,-465,-12.56,1078
2020-10-14,3236,3700,-464,-12.54,1078
2020-10-15,3236,3702,-466,-12.59,1078
2020-10-16,2998,3569,-571,-16.0,1078
2020-10-17,1653,2121,-468,-22.07,1078
2020-10-18,921,1466,-545,-37.18,1078
2020-10-19,3256,3617,-361,-9.98,1078
2020-10-20,3236,3676,-440,-11.97,1078
2020-10-21,3236,3666,-430,-11.73,1078
2020-10-22,3236,3659,-423,-11.56,1078
2020-10-23,2998,3518,-520,-14.78,1078
2020-10-24,1653,2063,-410,-19.87,1078
2020-10-25,921,1402,-481,-34.31,1078
2020-10-26,3256,3549,-293,-8.26,1078
2020-10-27,3236,3605,-369,-10.24,1078
2020-10-28,3236,3593,-357,-9.94,1078
2020-10-29,3236,3586,-350,-9.76,1078
2020-10-30,2998,3446,-448,-13.0,1078
2020-10-31,1653,1994,-341,-17.1,1078
2020-11-01,842,1336,-494,-36.98,1078
2020-11-02,3133,3487,-354,-10.15,1078
2020-11-03,3183,3548,-365,-10.29,1078
2020-11-04,3183,3541,-358,-10.11,1078
2020-11-05,3183,3540,-357,-10.08,1078
2020-11-06,2973,3406,-433,-12.71,1078
2020-11-07,1506,1959,-453,-23.12,1078
2020-11-08,842,1307,-465,-35.58,1078
2020-11-09,3133,3463,-330,-9.53,1078
2020-11-10,3183,3528,-345,-9.78,1078
2020-11-11,3183,3525,-342,-9.7,1078
2020-11-12,3183,3526,-343,-9.73,1078
2020-11-13,2973,3393,-420,-12.38,1078
2020-11-14,1506,1946,-440,-22.61,1078
2020-11-15,842,1293,-451,-34.88,1078
2020-11-16,3133,3447,-314,-9.11,1078
2020-11-17,3183,3509,-326,-9.29,1078
2020-11-18,3183,3502,-319,-9.11,1078
2020-11-19,3183,3499,-316,-9.03,1078
2020-11-20,2973,3361,-388,-11.54,1078
2020-11-21,1506,1909,-403,-21.11,1078
2020-11-22,842,1250,-408,-32.64,1078
2020-11-23,3133,3398,-265,-7.8,1078
2020-11-24,3183,3455,-272,-7.87,1078
2020-11-25,3183,3444,-261,-7.58,1078
2020-11-26,3183,3436,-253,-7.36,1078
2020-11-27,2973,3295,-322,-9.77,1078
2020-11-28,1506,1840,-334,-18.15,1078
2020-11-29,842,1180,-338,-28.64,1078
2020-11-30,3133,3328,-195,-5.86,1078
2020-12-01,2549,3386,-837,-24.72,1078
2020-12-02,2549,3375,-826,-24.47,1078
2020-12-03,2549,3371,-822,-24.38,1078
2020-12-04,3135,3233,-98,-3.03,1078
2020-12-05,1594,1783,-189,-10.6,1078
2020-12-06,786,1128,-342,-30.32,1078
2020-12-07,2434,3281,-847,-25.82,1078
2020-12-08,2549,3344,-795,-23.77,1078
2020-12-09,2549,3340,-791,-23.68,1078
2020-12-10,2549,3340,-791,-23.68,1078
2020-12-11,3135,3208,-73,-2.28,1078
2020-12-12,1594,1762,-168,-9.53,1078
2020-12-13,786,1110,-324,-29.19,1078
2020-12-14,2434,3265,-831,-25.45,1078
2020-12-15,2549,3329,-780,-23.43,1078
2020-12-16,2549,3325,-776,-23.34,1078
2020-12-17,2549,3323,-774,-23.29,1078
2020-12-18,3135,3187,-52,-1.63,1078
2020-12-19,1594,1736,-142,-8.18,1078
2020-12-20,786,1078,-292,-27.09,1078
2020-12-21,2434,3225,-791,-24.53,1078
2020-12-22,2549,3281,-732,-22.31,1078
2020-12-23,2549,3266,-717,-21.95,1078
2020-12-24,2549,3253,-704,-21.64,1078
2020-12-25,3135,3105,30,0.97,1078
2020-12-26,1594,1642,-48,-2.92,1078
2020-12-27,786,972,-186,-19.14,1078
2020-12-28,2434,3107,-673,-21.66,1078
2020-12-29,2549,3151,-602,-19.11,1078
2020-12-30,2549,3126,-577,-18.46,1078
2020-12-31,2549,3104,-555,-17.88,1078
2021-01-01,2582,2948,-366,-12.42,1078
2021-01-02,1253,1479,-226,-15.28,1078
2021-01-03,680,804,-124,-15.42,1078
2021-01-04,2679,2937,-258,-8.78,1078
2021-01-05,2806,2980,-174,-5.84,1078
2021-01-06,2806,2957,-151,-5.11,1078
2021-01-07,2806,2939,-133,-4.53,1078
2021-01-08,2582,2790,-208,-7.46,1078
2021-01-09,1253,1329,-76,-5.72,1078
2021-01-10,680,664,16,2.41,1078
2021-01-11,2679,2810,-131,-4.66,1078
2021-01-12,2806,2867,-61,-2.13,1078
2021-01-13,2806,2859,-53,-1.85,1078
2021-01-14,2806,2857,-51,-1.79,1078
2021-01-15,2582,2725,-143,-5.25,1078
2021-01-16,1253,1281,-28,-2.19,1078
2021-01-17,680,634,46,7.26,1078
2021-01-18,2679,2796,-117,-4.18,1078
2021-01-19,2806,2870,-64,-2.23,1078
2021-01-20,2806,2877,-71,-2.47,1078
2021-01-21,2806,2890,-84,-2.91,1078
2021-01-22,2582,2771,-189,-6.82,1078
2021-01-23,1253,1338,-85,-6.35,1078
2021-01-24,680,701,-21,-3.0,1078
2021-01-25,2679,2871,-192,-6.69,1078
2021-01-26,2806,2950,-144,-4.88,1078
2021-01-27,2806,2961,-155,-5.23,1078
2021-01-28,2806,2976,-170,-5.71,1078
2021-01-29,2582,2856,-274,-9.59,1078
2021-01-30,1253,1422,-169,-11.88,1078
2021-01-31,680,782,-102,-13.04,1078
2021-02-01,3142,2948,194,6.58,1078
2021-02-02,3160,3022,138,4.57,1078
2021-02-03,3160,3026,134,4.43,1078
2021-02-04,3160,3034,126,4.15,1078
2021-02-05,3013,2908,105,3.61,1078
2021-02-06,1627,1467,160,10.91,1078
2021-02-07,918,819,99,12.09,1078
2021-02-08,3142,2979,163,5.47,1078
2021-02-09,3160,3048,112,3.67,1078
2021-02-10,3160,3048,112,3.67,1078
2021-02-11,3160,3052,108,3.54,1078
2021-02-12,3013,2924,89,3.04,1078
2021-02-13,1627,1482,145,9.78,1078
2021-02-14,918,835,83,9.94,1078
2021-02-15,3142,2996,146,4.87,1078
2021-02-16,3160,3067,93,3.03,1078
2021-02-17,3160,3071,89,2.9,1078
2021-02-18,3160,3081,79,2.56,1078
2021-02-19,3013,2957,56,1.89,1078
2021-02-20,1627,1522,105,6.9,1078
2021-02-21,918,881,37,4.2,1078
2021-02-22,3142,3050,92,3.02,1078
2021-02-23,3160,3128,32,1.02,1078
2021-02-24,3160,3139,21,0.67,1078
2021-02-25,3160,3154,6,0.19,1078
2021-02-26,3013,3037,-24,-0.79,1078
2021-02-27,1627,1606,21,1.31,1078
2021-02-28,918,970,-52,-5.36,1078
2021-03-01,3148,3141,7,0.22,1078
2021-03-02,3215,3221,-6,-0.19,1078
2021-03-03,3215,3232,-17,-0.53,1078
2021-03-04,3215,3247,-32,-0.99,1078
2021-03-05,3090,3128,-38,-1.21,1078
2021-03-06,1714,1694,20,1.18,1078
2021-03-07,948,1053,-105,-9.97,1078
2021-03-08,3148,3219,-71,-2.21,1078
2021-03-09,3215,3293,-78,-2.37,1078
2021-03-10,3215,3298,-83,-2.52,1078
2021-03-11,3215,3306,-91,-2.75,1078
2021-03-12,3090,3180,-90,-2.83,1078
2021-03-13,1714,1739,-25,-1.44,1078
2021-03-14,948,1091,-143,-13.11,1078
2021-03-15,3148,3251,-103,-3.17,1078
2021-03-16,3215,3319,-104,-3.13,1078
2021-03-17,3215,3319,-104,-3.13,1078
2021-03-18,3215,3322,-107,-3.22,1078
2021-03-19,3090,3192,-102,-3.2,1078
2021-03-20,1714,1749,-35,-2.0,1078
2021-03-21,948,1100,-152,-13.82,1078
2021-03-22,3148,3259,-111,-3.41,1078
2021-03-23,3215,3328,-113,-3.4,1078
2021-03-24,3215,3329,-114,-3.42,1078
2021-03-25,3215,3335,-120,-3.6,1078
2021-03-26,3090,3208,-118,-3.68,1078
2021-03-27,1714,1768,-54,-3.05,1078
2021-03-28,948,1123,-175,-15.58,1078
2021-03-29,3148,3287,-139,-4.23,1078
2021-03-30,3215,3360,-145,-4.32,1078
2021-03-31,3215,3365,-150,-4.46,1078
2021-04-01,2096,3376,-1280,-37.91,1078
2021-04-02,1964,3253,-1289,-39.62,1078
2021-04-03,770,1816,-1046,-57.6,1078
2021-04-04,445,1174,-729,-62.1,1078
2021-04-05,2064,3340,-1276,-38.2,1078
2021-04-06,2096,3414,-1318,-38.61,1078
2021-04-07,2096,3420,-1324,-38.71,1078
2021-04-08,2096,3430,-1334,-38.89,1078
2021-04-09,1964,3306,-1342,-40.59,1078
2021-04-10,770,1868,-1098,-58.78,1078
2021-04-11,445,1223,-778,-63.61,1078
2021-04-12,2064,3385,-1321,-39.03,1078
2021-04-13,2096,3456,-1360,-39.35,1078
2021-04-14,2096,3458,-1362,-39.39,1078
2021-04-15,2096,3464,-1368,-39.49,1078
2021-04-16,1964,3336,-1372,-41.13,1078
2021-04-17,770,1894,-1124,-59.35,1078
2021-04-18,445,1246,-801,-64.29,1078
2021-04-19,2064,3405,-1341,-39.38,1078
2021-04-20,2096,3474,-1378,-39.67,1078
2021-04-21,2096,3474,-1378,-39.67,1078
2021-04-22,2096,3479,-1383,-39.75,1078
2021-04-23,1964,3351,-1387,-41.39,1078
2021-04-24,770,1910,-1140,-59.69,1078
2021-04-25,445,1263,-818,-64.77,1078
2021-04-26,2064,3425,-1361,-39.74,1078
2021-04-27,2096,3497,-1401,-40.06,1078
2021-04-28,2096,3501,-1405,-40.13,1078
2021-04-29,2096,3511,-1415,-40.3,1078
2021-04-30,1964,3388,-1424,-42.03,1078
2021-05-01,912,1952,-1040,-53.28,1078
2021-05-02,473,1310,-837,-63.89,1078
2021-05-03,2150,3477,-1327,-38.17,1078
2021-05-04,2189,3554,-1365,-38.41,1078
2021-05-05,2189,3562,-1373,-38.55,1078
2021-05-06,2189,3575,-1386,-38.77,1078
2021-05-07,2026,3454,-1428,-41.34,1078
2021-05-08,912,2020,-1108,-54.85,1078
2021-05-09,473,1379,-906,-65.7,1078
2021-05-10,2150,3545,-1395,-39.35,1078
2021-05-11,2189,3620,-1431,-39.53,1078
2021-05-12,2189,3625,-1436,-39.61,1078
2021-05-13,2189,3634,-1445,-39.76,1078
2021-05-14,2026,3508,-1482,-42.25,1078
2021-05-15,912,2068,-1156,-55.9,1078
2021-05-16,473,1420,-947,-66.69,1078
2021-05-17,2150,3578,-1428,-39.91,1078
2021-05-18,2189,3645,-1456,-39.95,1078
2021-05-19,2189,3642,-1453,-39.9,1078
2021-05-20,2189,3643,-1454,-39.91,1078
2021-05-21,2026,3509,-1483,-42.26,1078
2021-05-22,912,2060,-1148,-55.73,1078
2021-05-23,473,1405,-932,-66.33,1078
2021-05-24,2150,3558,-1408,-39.57,1078
2021-05-25,2189,3620,-1431,-39.53,1078
2021-05-26,2189,3613,-1424,-39.41,1078
2021-05-27,2189,3611,-1422,-39.38,1078
2021-05-28,2026,3476,-1450,-41.71,1078
2021-05-29,912,2028,-1116,-55.03,1078
2021-05-30,473,1375,-902,-65.6,1078
2021-05-31,2150,3531,-1381,-39.11,1078
2021-06-01,2286,3597,-1311,-36.45,1078
2021-06-02,2286,3596,-1310,-36.43,1078
2021-06-03,2286,3600,-1314,-36.5,1078
2021-06-04,2038,3473,-1435,-41.32,1078
2021-06-05,913,2032,-1119,-55.07,1078
2021-06-06,578,1387,-809,-58.33,1078
2021-06-07,2303,3550,-1247,-35.13,1078
2021-06-08,2286,3623,-1337,-36.9,1078
2021-06-09,2286,3629,-1343,-37.01,1078
2021-06-10,2286,3638,-1352,-37.16,1078
2021-06-11,2038,3514,-1476,-42.0,1078
2021-06-12,913,2077,-1164,-56.04,1078
2021-06-13,578,1432,-854,-59.64,1078
2021-06-14,2303,3594,-1291,-35.92,1078
2021-06-15,2286,3664,-1378,-37.61,1078
2021-06-16,2286,3664,-1378,-37.61,1078
2021-06-17,2286,3666,-1380,-37.64,1078
2021-06-18,2038,3532,-1494,-42.3,1078
2021-06-19,913,2083,-1170,-56.17,1078
2021-06-20,578,1425,-847,-59.44,1078
2021-06-21,2303,3573,-1270,-35.54,1078
2021-06-22,2286,3627,-1341,-36.97,1078
2021-06-23,2286,3610,-1324,-36.68,1078
2021-06-24,2286,3594,-1308,-36.39,1078
2021-06-25,2038,3443,-1405,-40.81,1078
2021-06-26,913,1977,-1064,-53.82,1078
2021-06-27,578,1302,-724,-55.61,1078
2021-06-28,2303,3433,-1130,-32.92,1078
2021-06-29,2286,3473,-1187,-34.18,1078
2021-06-30,2286,3443,-1157,-33.6,1078
2021-07-01,2352,3417,-1065,-31.17,1078
2021-07-02,2178,3257,-1079,-33.13,1078
2021-07-03,887,1785,-898,-50.31,1078
2021-07-04,511,1107,-596,-53.84,1078
2021-07-05,2312,3237,-925,-28.58,1078
2021-07-06,2352,3279,-927,-28.27,1078
2021-07-07,2352,3254,-902,-27.72,1078
2021-07-08,2352,3236,-884,-27.32,1078
2021-07-09,2178,3086,-908,-29.42,1078
2021-07-10,887,1626,-739,-45.45,1078
2021-07-11,511,962,-451,-46.88,1078
2021-07-12,2312,3108,-796,-25.61,1078
2021-07-13,2352,3167,-815,-25.73,1078
2021-07-14,2352,3159,-807,-25.55,1078
2021-07-15,2352,3159,-807,-25.55,1078
2021-07-16,2178,3027,-849,-28.05,1078
2021-07-17,887,1583,-696,-43.97,1078
2021-07-18,511,936,-425,-45.41,1078
2021-07-19,2312,3097,-785,-25.35,1078
2021-07-20,2352,3168,-816,-25.76,1078
2021-07-21,2352,3171,-819,-25.83,1078
2021-07-22,2352,3179,-827,-26.01,1078
2021-07-23,2178,3053,-875,-28.66,1078
2021-07-24,887,1612,-725,-44.98,1078
2021-07-25,511,965,-454,-47.05,1078
2021-07-26,2312,3124,-812,-25.99,1078
2021-07-27,2352,3190,-838,-26.27,1078
2021-07-28,2352,3186,-834,-26.18,1078
2021-07-29,2352,3184,-832,-26.13,1078
2021-07-30,2178,3046,-868,-28.5,1078
2021-07-31,887,1593,-706,-44.32,1078
2021-08-01,516,932,-416,-44.64,1078
2021-08-02,2277,3076,-799,-25.98,1078
2021-08-03,2254,3128,-874,-27.94,1078
2021-08-04,2254,3109,-855,-27.5,1078
2021-08-05,2254,3094,-840,-27.15,1078
2021-08-06,2072,2944,-872,-29.62,1078
2021-08-07,865,1481,-616,-41.59,1078
2021-08-08,516,811,-295,-36.37,1078
2021-08-09,2277,2950,-673,-22.81,1078
2021-08-10,2254,2999,-745,-24.84,1078
2021-08-11,2254,2981,-727,-24.39,1078
2021-08-12,2254,2969,-715,-24.08,1078
2021-08-13,2072,2826,-754,-26.68,1078
2021-08-14,865,1373,-508,-37.0,1078
2021-08-15,516,717,-201,-28.03,1078
2021-08-16,2277,2871,-594,-20.69,1078
2021-08-17,2254,2939,-685,-23.31,1078
2021-08-18,2254,2942,-688,-23.39,1078
2021-08-19,2254,2954,-700,-23.7,1078
2021-08-20,2072,2836,-764,-26.94,1078
2021-08-21,865,1409,-544,-38.61,1078
2021-08-22,516,779,-263,-33.76,1078
2021-08-23,2277,2961,-684,-23.1,1078
2021-08-24,2254,3055,-801,-26.22,1078
2021-08-25,2254,3084,-830,-26.91,1078
2021-08-26,2254,3119,-865,-27.73,1078
2021-08-27,2072,3023,-951,-31.46,1078
2021-08-28,865,1615,-750,-46.44,1078
2021-08-29,516,1002,-486,-48.5,1078
2021-08-30,2277,3197,-920,-28.78,1078
2021-08-31,2254,3301,-1047,-31.72,1078
2021-09-01,2430,3337,-907,-27.18,1078
2021-09-02,2430,3375,-945,-28.0,1078
2021-09-03,2322,3279,-957,-29.19,1078
2021-09-04,1091,1867,-776,-41.56,1078
2021-09-05,663,1247,-584,-46.83,1078
2021-09-06,2458,3431,-973,-28.36,1078
2021-09-07,2430,3523,-1093,-31.02,1078
2021-09-08,2430,3542,-1112,-31.39,1078
2021-09-09,2430,3563,-1133,-31.8,1078
2021-09-10,2322,3448,-1126,-32.66,1078
2021-09-11,1091,2015,-924,-45.86,1078
2021-09-12,663,1374,-711,-51.75,1078
2021-09-13,2458,3538,-1080,-30.53,1078
2021-09-14,2430,3608,-1178,-32.65,1078
2021-09-15,2430,3607,-1177,-32.63,1078
2021-09-16,2430,3609,-1179,-32.67,1078
2021-09-17,2322,3476,-1154,-33.2,1078
2021-09-18,1091,2028,-937,-46.2,1078
2021-09-19,663,1373,-710,-51.71,1078
2021-09-20,2458,3525,-1067,-30.27,1078
2021-09-21,2430,3586,-1156,-32.24,1078
2021-09-22,2430,3578,-1148,-32.08,1078
2021-09-23,2430,3576,-1146,-32.05,1078
2021-09-24,2322,3441,-1119,-32.52,1078
2021-09-25,1091,1993,-902,-45.26,1078
2021-09-26,663,1340,-677,-50.52,1078
2021-09-27,2458,3496,-1038,-29.69,1078
2021-09-28,2430,3563,-1133,-31.8,1078
2021-09-29,2430,3562,-1132,-31.78,1078
2021-09-30,2430,3568,-1138,-31.89,1078
2021-10-01,2300,3441,-1141,-33.16,1078
2021-10-02,1082,2001,-919,-45.93,1078
2021-10-03,647,1356,-709,-52.29,1078
2021-10-04,2304,3520,-1216,-34.55,1078
2021-10-05,2356,3594,-1238,-34.45,1078
2021-10-06,2356,3599,-1243,-34.54,1078
2021-10-07,2356,3609,-1253,-34.72,1078
2021-10-08,2300,3485,-1185,-34.0,1078
2021-10-09,1082,2047,-965,-47.14,1078
2021-10-10,647,1403,-756,-53.88,1078
2021-10-11,2304,3565,-1261,-35.37,1078
2021-10-12,2356,3635,-1279,-35.19,1078
2021-10-13,2356,3636,-1280,-35.2,1078
2021-10-14,2356,3640,-1284,-35.27,1078
2021-10-15,2300,3508,-1208,-34.44,1078
2021-10-16,1082,2062,-980,-47.53,1078
2021-10-17,647,1408,-761,-54.05,1078
2021-10-18,2304,3561,-1257,-35.3,1078
2021-10-19,2356,3622,-1266,-34.95,1078
2021-10-20,2356,3613,-1257,-34.79,1078
2021-10-21,2356,3607,-1251,-34.68,1078
2021-10-22,2300,3467,-1167,-33.66,1078
2021-10-23,1082,2013,-931,-46.25,1078
2021-10-24,647,1352,-705,-52.14,1078
2021-10-25,2304,3499,-1195,-34.15,1078
2021-10-26,2356,3555,-1199,-33.73,1078
2021-10-27,2356,3542,-1186,-33.48,1078
2021-10-28,2356,3535,-1179,-33.35,1078
2021-10-29,2300,3394,-1094,-32.23,1078
2021-10-30,1082,1941,-859,-44.26,1078
2021-10-31,647,1282,-635,-49.53,1078
2021-11-01,2187,3432,-1245,-36.28,1078
2021-11-02,2203,3492,-1289,-36.91,1078
2021-11-03,2203,3484,-1281,-36.77,1078
2021-11-04,2203,3482,-1279,-36.73,1078
2021-11-05,2053,3347,-1294,-38.66,1078
2021-11-06,957,1899,-942,-49.61,1078
2021-11-07,583,1246,-663,-53.21,1078
2021-11-08,2187,3402,-1215,-35.71,1078
2021-11-09,2203,3466,-1263,-36.44,1078
2021-11-10,2203,3463,-1260,-36.38,1078
2021-11-11,2203,3465,-1262,-36.42,1078
2021-11-12,2053,3332,-1279,-38.39,1078
2021-11-13,957,1886,-929,-49.26,1078
2021-11-14,583,1233,-650,-52.72,1078
2021-11-15,2187,3388,-1201,-35.45,1078
2021-11-16,2203,3451,-1248,-36.16,1078
2021-11-17,2203,3445,-1242,-36.05,1078
2021-11-18,2203,3443,-1240,-36.02,1078
2021-11-19,2053,3306,-1253,-37.9,1078
2021-11-20,957,1855,-898,-48.41,1078
2021-11-21,583,1197,-614,-51.29,1078
2021-11-22,2187,3346,-1159,-34.64,1078
2021-11-23,2203,3404,-1201,-35.28,1078
2021-11-24,2203,3393,-1190,-35.07,1078
2021-11-25,2203,3386,-1183,-34.94,1078
2021-11-26,2053,3244,-1191,-36.71,1078
2021-11-27,957,1790,-833,-46.54,1078
2021-11-28,583,1129,-546,-48.36,1078
2021-11-29,2187,3277,-1090,-33.26,1078
2021-11-30,2203,3333,-1130,-33.9,1078
2021-12-01,1875,3323,-1448,-43.58,1078
2021-12-02,1875,3317,-1442,-43.47,1078
2021-12-03,1508,3178,-1670,-52.55,1078
2021-12-04,934,1727,-793,-45.92,1078
2021-12-05,462,1071,-609,-56.86,1078
2021-12-06,1948,3223,-1275,-39.56,1078
2021-12-07,1875,3285,-1410,-42.92,1078
2021-12-08,1875,3280,-1405,-42.84,1078
2021-12-09,1875,3280,-1405,-42.84,1078
2021-12-10,1508,3146,-1638,-52.07,1078
2021-12-11,934,1700,-766,-45.06,1078
2021-12-12,462,1048,-586,-55.92,1078
2021-12-13,1948,3204,-1256,-39.2,1078
2021-12-14,1875,3269,-1394,-42.64,1078
2021-12-15,1875,3265,-1390,-42.57,1078
2021-12-16,1875,3265,-1390,-42.57,1078
2021-12-17,1508,3130,-1622,-51.82,1078
2021-12-18,934,1681,-747,-44.44,1078
2021-12-19,462,1024,-562,-54.88,1078
2021-12-20,1948,3174,-1226,-38.63,1078
2021-12-21,1875,3231,-1356,-41.97,1078
2021-12-22,1875,3219,-1344,-41.75,1078
2021-12-23,1875,3208,-1333,-41.55,1078
2021-12-24,1508,3063,-1555,-50.77,1078
2021-12-25,934,1602,-668,-41.7,1078
2021-12-26,462,933,-471,-50.48,1078
2021-12-27,1948,3071,-1123,-36.57,1078
2021-12-28,1875,3116,-1241,-39.83,1078
2021-12-29,1875,3092,-1217,-39.36,1078
2021-12-30,1875,3071,-1196,-38.94,1078
2021-12-31,1508,2916,-1408,-48.29,1078
2022-01-01,890,1446,-556,-38.45,1078
2022-01-02,439,771,-332,-43.06,1078
2022-01-03,1844,2904,-1060,-36.5,1078
2022-01-04,1901,2946,-1045,-35.47,1078
2022-01-05,1901,2921,-1020,-34.92,1078
2022-01-06,1901,2901,-1000,-34.47,1078
2022-01-07,1733,2750,-1017,-36.98,1078
2022-01-08,890,1286,-396,-30.79,1078
2022-01-09,439,619,-180,-29.08,1078
2022-01-10,1844,2761,-917,-33.21,1078
2022-01-11,1901,2816,-915,-32.49,1078
2022-01-12,1901,2804,-903,-32.2,1078
2022-01-13,1901,2799,-898,-32.08,1078
2022-01-14,1733,2664,-931,-34.95,1078
2022-01-15,890,1217,-327,-26.87,1078
2022-01-16,439,567,-128,-22.57,1078
2022-01-17,1844,2727,-883,-32.38,1078
2022-01-18,1901,2798,-897,-32.06,1078
2022-01-19,1901,2803,-902,-32.18,1078
2022-01-20,1901,2814,-913,-32.44,1078
2022-01-21,1733,2693,-960,-35.65,1078
2022-01-22,890,1260,-370,-29.37,1078
2022-01-23,439,621,-182,-29.31,1078
2022-01-24,1844,2791,-947,-33.93,1078
2022-01-25,1901,2871,-970,-33.79,1078
2022-01-26,1901,2882,-981,-34.04,1078
2022-01-27,1901,2897,-996,-34.38,1078
2022-01-28,1733,2779,-1046,-37.64,1078
2022-01-29,890,1346,-456,-33.88,1078
2022-01-30,439,706,-267,-37.82,1078
2020-02-01,206,161,45,27.95,1217
2020-02-02,104,6,98,1633.33,1217
2020-02-03,596,549,47,8.56,1217
2020-02-04,620,589,31,5.26,1217
2020-02-05,620,588,32,5.44,1217
2020-02-06,620,587,33,5.62,1217
2020-02-07,559,546,13,2.38,1217
2020-02-08,206,152,54,35.53,1217
2020-02-09,104,29,75,258.62,1217
2020-02-10,596,539,57,10.58,1217
2020-02-11,620,579,41,7.08,1217
2020-02-12,620,579,41,7.08,1217
2020-02-13,620,580,40,6.9,1217
2020-02-14,559,542,17,3.14,1217
2020-02-15,206,150,56,37.33,1217
2020-02-16,104,29,75,258.62,1217
2020-02-17,596,544,52,9.56,1217
2020-02-18,620,588,32,5.44,1217
2020-02-19,620,592,28,4.73,1217
2020-02-20,620,597,23,3.85,1217
2020-02-21,559,563,-4,-0.71,1217
2020-02-22,206,175,31,17.71,1217
2020-02-23,104,26,78,300.0,1217
2020-02-24,596,577,19,3.29,1217
2020-02-25,620,624,-4,-0.64,1217
2020-02-26,620,631,-11,-1.74,1217
2020-02-27,620,639,-19,-2.97,1217
2020-02-28,559,606,-47,-7.76,1217
2020-02-29,206,220,-14,-6.36,1217
2020-03-01,68,71,-3,-4.23,1217
2020-03-02,408,622,-214,-34.41,1217
2020-03-03,420,669,-249,-37.22,1217
2020-03-04,420,675,-255,-37.78,1217
2020-03-05,420,680,-260,-38.24,1217
2020-03-06,380,646,-266,-41.18,1217
2020-03-07,130,257,-127,-49.42,1217
2020-03-08,68,105,-37,-35.24,1217
2020-03-09,408,653,-245,-37.52,1217
2020-03-10,420,696,-276,-39.66,1217
2020-03-11,420,699,-279,-39.91,1217
2020-03-12,420,701,-281,-40.09,1217
2020-03-13,380,664,-284,-42.77,1217
2020-03-14,130,272,-142,-52.21,1217
2020-03-15,68,118,-50,-42.37,1217
2020-03-16,408,663,-255,-38.46,1217
2020-03-17,420,705,-285,-40.43,1217
2020-03-18,420,706,-286,-40.51,1217
2020-03-19,420,707,-287,-40.59,1217
2020-03-20,380,669,-289,-43.2,1217
2020-03-21,130,277,-147,-53.07,1217
2020-03-22,68,124,-56,-45.16,1217
2020-03-23,408,670,-262,-39.1,1217
2020-03-24,420,713,-293,-41.09,1217
2020-03-25,420,715,-295,-41.26,1217
2020-03-26,420,718,-298,-41.5,1217
2020-03-27,380,682,-302,-44.28,1217
2020-03-28,130,292,-162,-55.48,1217
2020-03-29,68,140,-72,-51.43,1217
2020-03-30,408,688,-280,-40.7,1217
2020-03-31,420,732,-312,-42.62,1217
2020-04-01,328,736,-408,-55.43,1217
2020-04-02,328,740,-412,-55.68,1217
2020-04-03,257,704,-447,-63.49,1217
2020-04-04,97,314,-217,-69.11,1217
2020-04-05,29,163,-134,-82.21,1217
2020-04-06,329,710,-381,-53.66,1217
2020-04-07,328,754,-426,-56.5,1217
2020-04-08,328,757,-429,-56.67,1217
2020-04-09,328,760,-432,-56.84,1217
2020-04-10,257,723,-466,-64.45,1217
2020-04-11,97,332,-235,-70.78,1217
2020-04-12,29,179,-150,-83.8,1217
2020-04-13,329,725,-396,-54.62,1217
2020-04-14,328,768,-440,-57.29,1217
2020-04-15,328,770,-442,-57.4,1217
2020-04-16,328,772,-444,-57.51,1217
2020-04-17,257,735,-478,-65.03,1217
2020-04-18,97,343,-246,-71.72,1217
2020-04-19,29,191,-162,-84.82,1217
2020-04-20,329,737,-408,-55.36,1217
2020-04-21,328,781,-453,-58.0,1217
2020-04-22,328,784,-456,-58.16,1217
2020-04-23,328,789,-461,-58.43,1217
2020-04-24,257,754,-497,-65.92,1217
2020-04-25,97,365,-268,-73.42,1217
2020-04-26,29,216,-187,-86.57,1217
2020-04-27,329,766,-437,-57.05,1217
2020-04-28,328,813,-485,-59.66,1217
2020-04-29,328,820,-492,-60.0,1217
2020-04-30,328,828,-500,-60.39,1217
2020-05-01,410,797,-387,-48.56,1217
2020-05-02,136,412,-276,-66.99,1217
2020-05-03,50,265,-215,-81.13,1217
2020-05-04,450,818,-368,-44.99,1217
2020-05-05,478,867,-389,-44.87,1217
2020-05-06,478,876,-398,-45.43,1217
2020-05-07,478,884,-406,-45.93,1217
2020-05-08,410,853,-443,-51.93,1217
2020-05-09,136,467,-331,-70.88,1217
2020-05-10,50,318,-268,-84.28,1217
2020-05-11,450,869,-419,-48.22,1217
2020-05-12,478,914,-436,-47.7,1217
2020-05-13,478,919,-441,-47.99,1217
2020-05-14,478,923,-445,-48.21,1217
2020-05-15,410,886,-476,-53.72,1217
2020-05-16,136,494,-358,-72.47,1217
2020-05-17,50,339,-289,-85.25,1217
2020-05-18,450,882,-432,-48.98,1217
2020-05-19,478,921,-443,-48.1,1217
2020-05-20,478,919,-441,-47.99,1217
2020-05-21,478,915,-437,-47.76,1217
2020-05-22,410,872,-462,-52.98,1217
2020-05-23,136,473,-337,-71.25,1217
2020-05-24,50,313,-263,-84.03,1217
2020-05-25,450,851,-401,-47.12,1217
2020-05-26,478,885,-407,-45.99,1217
2020-05-27,478,879,-401,-45.62,1217
2020-05-28,478,873,-395,-45.25,1217
2020-05-29,410,827,-417,-50.42,1217
2020-05-30,136,427,-291,-68.15,1217
2020-05-31,50,266,-216,-81.2,1217
2020-06-01,527,805,-278,-34.53,1217
2020-06-02,585,840,-255,-30.36,1217
2020-06-03,585,836,-251,-30.02,1217
2020-06-04,585,832,-247,-29.69,1217
2020-06-05,454,790,-336,-42.53,1217
2020-06-06,152,394,-242,-61.42,1217
2020-06-07,61,237,-176,-74.26,1217
2020-06-08,527,780,-253,-32.44,1217
2020-06-09,585,820,-235,-28.66,1217
2020-06-10,585,820,-235,-28.66,1217
2020-06-11,585,820,-235,-28.66,1217
2020-06-12,454,782,-328,-41.94,1217
2020-06-13,152,389,-237,-60.93,1217
2020-06-14,61,235,-174,-74.04,1217
2020-06-15,527,780,-253,-32.44,1217
2020-06-16,585,821,-236,-28.75,1217
2020-06-17,585,822,-237,-28.83,1217
2020-06-18,585,822,-237,-28.83,1217
2020-06-19,454,783,-329,-42.02,1217
2020-06-20,152,388,-236,-60.82,1217
2020-06-21,61,232,-171,-73.71,1217
2020-06-22,527,774,-247,-31.91,1217
2020-06-23,585,812,-227,-27.96,1217
2020-06-24,585,809,-224,-27.69,1217
2020-06-25,585,805,-220,-27.33,1217
2020-06-26,454,761,-307,-40.34,1217
2020-06-27,152,362,-210,-58.01,1217
2020-06-28,61,201,-140,-69.65,1217
2020-06-29,527,739,-212,-28.69,1217
2020-06-30,585,773,-188,-24.32,1217
2020-07-01,582,766,-184,-24.02,1217
2020-07-02,582,759,-177,-23.32,1217
2020-07-03,482,713,-231,-32.4,1217
2020-07-04,142,313,-171,-54.63,1217
2020-07-05,64,151,-87,-57.62,1217
2020-07-06,530,688,-158,-22.97,1217
2020-07-07,582,723,-141,-19.5,1217
2020-07-08,582,718,-136,-18.94,1217
2020-07-09,582,713,-131,-18.37,1217
2020-07-10,482,670,-188,-28.06,1217
2020-07-11,142,273,-131,-47.99,1217
2020-07-12,64,115,-51,-44.35,1217
2020-07-13,530,657,-127,-19.33,1217
2020-07-14,582,697,-115,-16.5,1217
2020-07-15,582,696,-114,-16.38,1217
2020-07-16,582,697,-115,-16.5,1217
2020-07-17,482,659,-177,-26.86,1217
2020-07-18,142,267,-125,-46.82,1217
2020-07-19,64,114,-50,-43.86,1217
2020-07-20,530,660,-130,-19.7,1217
2020-07-21,582,703,-121,-17.21,1217
2020-07-22,582,706,-124,-17.56,1217
2020-07-23,582,709,-127,-17.91,1217
2020-07-24,482,672,-190,-28.27,1217
2020-07-25,142,281,-139,-49.47,1217
2020-07-26,64,128,-64,-50.0,1217
2020-07-27,530,674,-144,-21.36,1217
2020-07-28,582,716,-134,-18.72,1217
2020-07-29,582,717,-135,-18.83,1217
2020-07-30,582,717,-135,-18.83,1217
2020-07-31,482,678,-196,-28.91,1217
2020-08-01,154,283,-129,-45.58,1217
2020-08-02,61,127,-66,-51.97,1217
2020-08-03,503,669,-166,-24.81,1217
2020-08-04,548,707,-159,-22.49,1217
2020-08-05,548,704,-156,-22.16,1217
2020-08-06,548,701,-153,-21.83,1217
2020-08-07,482,659,-177,-26.86,1217
2020-08-08,154,262,-108,-41.22,1217
2020-08-09,61,103,-42,-40.78,1217
2020-08-10,503,644,-141,-21.89,1217
2020-08-11,548,681,-133,-19.53,1217
2020-08-12,548,679,-131,-19.29,1217
2020-08-13,548,677,-129,-19.05,1217
2020-08-14,482,636,-154,-24.21,1217
2020-08-15,154,241,-87,-36.1,1217
2020-08-16,61,86,-25,-29.07,1217
2020-08-17,503,630,-127,-20.16,1217
2020-08-18,548,672,-124,-18.45,1217
2020-08-19,548,674,-126,-18.69,1217
2020-08-20,548,678,-130,-19.17,1217
2020-08-21,482,642,-160,-24.92,1217
2020-08-22,154,253,-99,-39.13,1217
2020-08-23,61,104,-43,-41.35,1217
2020-08-24,503,654,-151,-23.09,1217
2020-08-25,548,701,-153,-21.83,1217
2020-08-26,548,708,-160,-22.6,1217
2020-08-27,548,716,-168,-23.46,1217
2020-08-28,482,685,-203,-29.64,1217
2020-08-29,154,300,-146,-48.67,1217
2020-08-30,61,153,-92,-60.13,1217
2020-08-31,503,705,-202,-28.65,1217
2020-09-01,600,753,-153,-20.32,1217
2020-09-02,600,761,-161,-21.16,1217
2020-09-03,600,769,-169,-21.98,1217
2020-09-04,500,736,-236,-32.07,1217
2020-09-05,168,349,-181,-51.86,1217
2020-09-06,82,200,-118,-59.0,1217
2020-09-07,554,749,-195,-26.03,1217
2020-09-08,600,794,-194,-24.43,1217
2020-09-09,600,798,-198,-24.81,1217
2020-09-10,600,801,-201,-25.09,1217
2020-09-11,500,764,-264,-34.55,1217
2020-09-12,168,373,-205,-54.96,1217
2020-09-13,82,219,-137,-62.56,1217
2020-09-14,554,764,-210,-27.49,1217
2020-09-15,600,804,-204,-25.37,1217
2020-09-16,600,804,-204,-25.37,1217
2020-09-17,600,804,-204,-25.37,1217
2020-09-18,500,764,-264,-34.55,1217
2020-09-19,168,370,-202,-54.59,1217
2020-09-20,82,214,-132,-61.68,1217
2020-09-21,554,757,-203,-26.82,1217
2020-09-22,600,797,-197,-24.72,1217
2020-09-23,600,796,-196,-24.62,1217
2020-09-24,600,796,-196,-24.62,1217
2020-09-25,500,756,-256,-33.86,1217
2020-09-26,168,362,-194,-53.59,1217
2020-09-27,82,207,-125,-60.39,1217
2020-09-28,554,751,-197,-26.23,1217
2020-09-29,600,792,-192,-24.24,1217
2020-09-30,600,793,-193,-24.34,1217
2020-10-01,611,794,-183,-23.05,1217
2020-10-02,511,755,-244,-32.32,1217
2020-10-03,169,363,-194,-53.44,1217
2020-10-04,80,209,-129,-61.72,1217
2020-10-05,581,754,-173,-22.94,1217
2020-10-06,611,796,-185,-23.24,1217
2020-10-07,611,797,-186,-23.34,1217
2020-10-08,611,798,-187,-23.43,1217
2020-10-09,511,760,-249,-32.76,1217
2020-10-10,169,367,-198,-53.95,1217
2020-10-11,80,212,-132,-62.26,1217
2020-10-12,581,756,-175,-23.15,1217
2020-10-13,611,797,-186,-23.34,1217
2020-10-14,611,796,-185,-23.24,1217
2020-10-15,611,796,-185,-23.24,1217
2020-10-16,511,756,-245,-32.41,1217
2020-10-17,169,361,-192,-53.19,1217
2020-10-18,80,205,-125,-60.98,1217
2020-10-19,581,747,-166,-22.22,1217
2020-10-20,611,786,-175,-22.26,1217
2020-10-21,611,784,-173,-22.07,1217
2020-10-22,611,783,-172,-21.97,1217
2020-10-23,511,741,-230,-31.04,1217
2020-10-24,169,346,-177,-51.16,1217
2020-10-25,80,189,-109,-57.67,1217
2020-10-26,581,731,-150,-20.52,1217
2020-10-27,611,770,-159,-20.65,1217
2020-10-28,611,769,-158,-20.55,1217
2020-10-29,611,767,-156,-20.34,1217
2020-10-30,511,727,-216,-29.71,1217
2020-10-31,169,332,-163,-49.1,1217
2020-11-01,60,176,-116,-65.91,1217
2020-11-02,514,719,-205,-28.51,1217
2020-11-03,497,759,-262,-34.52,1217
2020-11-04,497,758,-261,-34.43,1217
2020-11-05,497,758,-261,-34.43,1217
2020-11-06,405,718,-313,-43.59,1217
2020-11-07,128,324,-196,-60.49,1217
2020-11-08,60,168,-108,-64.29,1217
2020-11-09,514,712,-198,-27.81,1217
2020-11-10,497,752,-255,-33.91,1217
2020-11-11,497,751,-254,-33.82,1217
2020-11-12,497,750,-253,-33.73,1217
2020-11-13,405,710,-305,-42.96,1217
2020-11-14,128,316,-188,-59.49,1217
2020-11-15,60,159,-99,-62.26,1217
2020-11-16,514,702,-188,-26.78,1217
2020-11-17,497,742,-245,-33.02,1217
2020-11-18,497,740,-243,-32.84,1217
2020-11-19,497,739,-242,-32.75,1217
2020-11-20,405,699,-294,-42.06,1217
2020-11-21,128,304,-176,-57.89,1217
2020-11-22,60,148,-88,-59.46,1217
2020-11-23,514,692,-178,-25.72,1217
2020-11-24,497,732,-235,-32.1,1217
2020-11-25,497,731,-234,-32.01,1217
2020-11-26,497,732,-235,-32.1,1217
2020-11-27,405,692,-287,-41.47,1217
2020-11-28,128,300,-172,-57.33,1217
2020-11-29,60,146,-86,-58.9,1217
2020-11-30,514,691,-177,-25.62,1217
2020-12-01,446,733,-287,-39.15,1217
2020-12-02,446,735,-289,-39.32,1217
2020-12-03,446,738,-292,-39.57,1217
2020-12-04,509,701,-192,-27.39,1217
2020-12-05,145,311,-166,-53.38,1217
2020-12-06,60,158,-98,-62.03,1217
2020-12-07,444,705,-261,-37.02,1217
2020-12-08,446,749,-303,-40.45,1217
2020-12-09,446,752,-306,-40.69,1217
2020-12-10,446,754,-308,-40.85,1217
2020-12-11,509,717,-208,-29.01,1217
2020-12-12,145,326,-181,-55.52,1217
2020-12-13,60,172,-112,-65.12,1217
2020-12-14,444,716,-272,-37.99,1217
2020-12-15,446,756,-310,-41.01,1217
2020-12-16,446,755,-309,-40.93,1217
2020-12-17,446,754,-308,-40.85,1217
2020-12-18,509,712,-203,-28.51,1217
2020-12-19,145,315,-170,-53.97,1217
2020-12-20,60,155,-95,-61.29,1217
2020-12-21,444,693,-249,-35.93,1217
2020-12-22,446,727,-281,-38.65,1217
2020-12-23,446,720,-274,-38.06,1217
2020-12-24,446,712,-266,-37.36,1217
2020-12-25,509,664,-155,-23.34,1217
2020-12-26,145,261,-116,-44.44,1217
2020-12-27,60,96,-36,-37.5,1217
2020-12-28,444,630,-186,-29.52,1217
2020-12-29,446,659,-213,-32.32,1217
2020-12-30,446,649,-203,-31.28,1217
2020-12-31,446,638,-192,-30.09,1217
2021-01-01,290,588,-298,-50.68,1217
2021-01-02,105,184,-79,-42.93,1217
2021-01-03,55,19,36,189.47,1217
2021-01-04,341,554,-213,-38.45,1217
2021-01-05,348,586,-238,-40.61,1217
2021-01-06,348,578,-230,-39.79,1217
2021-01-07,348,571,-223,-39.05,1217
2021-01-08,290,525,-235,-44.76,1217
2021-01-09,105,127,-22,-17.32,1217
2021-01-10,55,19,36,189.47,1217
2021-01-11,341,508,-167,-32.87,1217
2021-01-12,348,546,-198,-36.26,1217
2021-01-13,348,545,-197,-36.15,1217
2021-01-14,348,544,-196,-36.03,1217
2021-01-15,290,505,-215,-42.57,1217
2021-01-16,105,113,-8,-7.08,1217
2021-01-17,55,14,41,292.86,1217
2021-01-18,341,505,-164,-32.48,1217
2021-01-19,348,548,-200,-36.5,1217
2021-01-20,348,551,-203,-36.84,1217
2021-01-21,348,554,-206,-37.18,1217
2021-01-22,290,518,-228,-44.02,1217
2021-01-23,105,127,-22,-17.32,1217
2021-01-24,55,20,35,175.0,1217
2021-01-25,341,522,-181,-34.67,1217
2021-01-26,348,564,-216,-38.3,1217
2021-01-27,348,566,-218,-38.52,1217
2021-01-28,348,568,-220,-38.73,1217
2021-01-29,290,530,-240,-45.28,1217
2021-01-30,105,137,-32,-23.36,1217
2021-01-31,55,23,32,139.13,1217
2021-02-01,366,526,-160,-30.42,1217
2021-02-02,370,566,-196,-34.63,1217
2021-02-03,370,565,-195,-34.51,1217
2021-02-04,370,564,-194,-34.4,1217
2021-02-05,289,524,-235,-44.85,1217
2021-02-06,118,129,-11,-8.53,1217
2021-02-07,53,21,32,152.38,1217
2021-02-08,366,516,-150,-29.07,1217
2021-02-09,370,556,-186,-33.45,1217
2021-02-10,370,555,-185,-33.33,1217
2021-02-11,370,555,-185,-33.33,1217
2021-02-12,289,516,-227,-43.99,1217
2021-02-13,118,124,-6,-4.84,1217
2021-02-14,53,17,36,211.76,1217
2021-02-15,366,516,-150,-29.07,1217
2021-02-16,370,559,-189,-33.81,1217
2021-02-17,370,563,-193,-34.28,1217
2021-02-18,370,567,-197,-34.74,1217
2021-02-19,289,532,-243,-45.68,1217
2021-02-20,118,144,-26,-18.06,1217
2021-02-21,53,33,20,60.61,1217
2021-02-22,366,545,-179,-32.84,1217
2021-02-23,370,592,-222,-37.5,1217
2021-02-24,370,598,-228,-38.13,1217
2021-02-25,370,606,-236,-38.94,1217
2021-02-26,289,573,-284,-49.56,1217
2021-02-27,118,187,-69,-36.9,1217
2021-02-28,53,39,14,35.9,1217
2021-03-01,392,590,-198,-33.56,1217
2021-03-02,400,637,-237,-37.21,1217
2021-03-03,400,643,-243,-37.79,1217
2021-03-04,400,649,-249,-38.37,1217
2021-03-05,356,615,-259,-42.11,1217
2021-03-06,135,227,-92,-40.53,1217
2021-03-07,50,76,-26,-34.21,1217
2021-03-08,392,624,-232,-37.18,1217
2021-03-09,400,668,-268,-40.12,1217
2021-03-10,400,671,-271,-40.39,1217
2021-03-11,400,674,-274,-40.65,1217
2021-03-12,356,637,-281,-44.11,1217
2021-03-13,135,246,-111,-45.12,1217
2021-03-14,50,92,-42,-45.65,1217
2021-03-15,392,638,-246,-38.56,1217
2021-03-16,400,679,-279,-41.09,1217
2021-03-17,400,680,-280,-41.18,1217
2021-03-18,400,682,-282,-41.35,1217
2021-03-19,356,644,-288,-44.72,1217
2021-03-20,135,252,-117,-46.43,1217
2021-03-21,50,98,-48,-48.98,1217
2021-03-22,392,643,-251,-39.04,1217
2021-03-23,400,686,-286,-41.69,1217
2021-03-24,400,688,-288,-41.86,1217
2021-03-25,400,691,-291,-42.11,1217
2021-03-26,356,654,-298,-45.57,1217
2021-03-27,135,264,-129,-48.86,1217
2021-03-28,50,112,-62,-55.36,1217
2021-03-29,392,659,-267,-40.52,1217
2021-03-30,400,703,-303,-43.1,1217
2021-03-31,400,707,-307,-43.42,1217
2021-04-01,392,711,-319,-44.87,1217
2021-04-02,302,675,-373,-55.26,1217
2021-04-03,110,286,-176,-61.54,1217
2021-04-04,51,134,-83,-61.94,1217
2021-04-05,381,682,-301,-44.13,1217
2021-04-06,392,726,-334,-46.01,1217
2021-04-07,392,729,-337,-46.23,1217
2021-04-08,392,732,-340,-46.45,1217
2021-04-09,302,696,-394,-56.61,1217
2021-04-10,110,305,-195,-63.93,1217
2021-04-11,51,152,-101,-66.45,1217
2021-04-12,381,699,-318,-45.49,1217
2021-04-13,392,741,-349,-47.1,1217
2021-04-14,392,743,-351,-47.24,1217
2021-04-15,392,746,-354,-47.45,1217
2021-04-16,302,708,-406,-57.34,1217
2021-04-17,110,317,-207,-65.3,1217
2021-04-18,51,164,-113,-68.9,1217
2021-04-19,381,710,-329,-46.34,1217
2021-04-20,392,753,-361,-47.94,1217
2021-04-21,392,756,-364,-48.15,1217
2021-04-22,392,760,-368,-48.42,1217
2021-04-23,302,724,-422,-58.29,1217
2021-04-24,110,335,-225,-67.16,1217
2021-04-25,51,185,-134,-72.43,1217
2021-04-26,381,734,-353,-48.09,1217
2021-04-27,392,781,-389,-49.81,1217
2021-04-28,392,787,-395,-50.19,1217
2021-04-29,392,795,-403,-50.69,1217
2021-04-30,302,763,-461,-60.42,1217
2021-05-01,122,377,-255,-67.64,1217
2021-05-02,64,230,-166,-72.17,1217
2021-05-03,464,783,-319,-40.74,1217
2021-05-04,481,832,-351,-42.19,1217
2021-05-05,481,841,-360,-42.81,1217
2021-05-06,481,850,-369,-43.41,1217
2021-05-07,394,819,-425,-51.89,1217
2021-05-08,122,433,-311,-71.82,1217
2021-05-09,64,286,-222,-77.62,1217
2021-05-10,464,837,-373,-44.56,1217
2021-05-11,481,884,-403,-45.59,1217
2021-05-12,481,889,-408,-45.89,1217
2021-05-13,481,894,-413,-46.2,1217
2021-05-14,394,858,-464,-54.08,1217
2021-05-15,122,468,-346,-73.93,1217
2021-05-16,64,314,-250,-79.62,1217
2021-05-17,464,859,-395,-45.98,1217
2021-05-18,481,899,-418,-46.5,1217
2021-05-19,481,898,-417,-46.44,1217
2021-05-20,481,896,-415,-46.32,1217
2021-05-21,394,853,-459,-53.81,1217
2021-05-22,122,455,-333,-73.19,1217
2021-05-23,64,296,-232,-78.38,1217
2021-05-24,464,834,-370,-44.36,1217
2021-05-25,481,869,-388,-44.65,1217
2021-05-26,481,863,-382,-44.26,1217
2021-05-27,481,856,-375,-43.81,1217
2021-05-28,394,811,-417,-51.42,1217
2021-05-29,122,411,-289,-70.32,1217
2021-05-30,64,249,-185,-74.3,1217
2021-05-31,464,787,-323,-41.04,1217
2021-06-01,490,822,-332,-40.39,1217
2021-06-02,490,817,-327,-40.02,1217
2021-06-03,490,813,-323,-39.73,1217
2021-06-04,374,770,-396,-51.43,1217
2021-06-05,143,373,-230,-61.66,1217
2021-06-06,58,215,-157,-73.02,1217
2021-06-07,466,757,-291,-38.44,1217
2021-06-08,490,797,-307,-38.52,1217
2021-06-09,490,796,-306,-38.44,1217
2021-06-10,490,796,-306,-38.44,1217
2021-06-11,374,757,-383,-50.59,1217
2021-06-12,143,364,-221,-60.71,1217
2021-06-13,58,210,-152,-72.38,1217
2021-06-14,466,755,-289,-38.28,1217
2021-06-15,490,796,-306,-38.44,1217
2021-06-16,490,797,-307,-38.52,1217
2021-06-17,490,798,-308,-38.6,1217
2021-06-18,374,759,-385,-50.72,1217
2021-06-19,143,365,-222,-60.82,1217
2021-06-20,58,209,-151,-72.25,1217
2021-06-21,466,752,-286,-38.03,1217
2021-06-22,490,791,-301,-38.05,1217
2021-06-23,490,789,-299,-37.9,1217
2021-06-24,490,786,-296,-37.66,1217
2021-06-25,374,742,-368,-49.6,1217
2021-06-26,143,344,-201,-58.43,1217
2021-06-27,58,184,-126,-68.48,1217
2021-06-28,466,723,-257,-35.55,1217
2021-06-29,490,757,-267,-35.27,1217
2021-06-30,490,751,-261,-34.75,1217
2021-07-01,330,744,-414,-55.65,1217
2021-07-02,264,698,-434,-62.18,1217
2021-07-03,86,297,-211,-71.04,1217
2021-07-04,51,135,-84,-62.22,1217
2021-07-05,374,672,-298,-44.35,1217
2021-07-06,330,706,-376,-53.26,1217
2021-07-07,330,700,-370,-52.86,1217
2021-07-08,330,695,-365,-52.52,1217
2021-07-09,264,651,-387,-59.45,1217
2021-07-10,86,253,-167,-66.01,1217
2021-07-11,51,94,-43,-45.74,1217
2021-07-12,374,636,-262,-41.19,1217
2021-07-13,330,674,-344,-51.04,1217
2021-07-14,330,673,-343,-50.97,1217
2021-07-15,330,673,-343,-50.97,1217
2021-07-16,264,633,-369,-58.29,1217
2021-07-17,86,241,-155,-64.32,1217
2021-07-18,51,87,-36,-41.38,1217
2021-07-19,374,633,-259,-40.92,1217
2021-07-20,330,676,-346,-51.18,1217
2021-07-21,330,678,-348,-51.33,1217
2021-07-22,330,681,-351,-51.54,1217
2021-07-23,264,645,-381,-59.07,1217
2021-07-24,86,254,-168,-66.14,1217
2021-07-25,51,101,-50,-49.5,1217
2021-07-26,374,648,-274,-42.28,1217
2021-07-27,330,690,-360,-52.17,1217
2021-07-28,330,691,-361,-52.24,1217
2021-07-29,330,693,-363,-52.38,1217
2021-07-30,264,654,-390,-59.63,1217
2021-07-31,86,260,-174,-66.92,1217
2021-08-01,14,104,-90,-86.54,1217
2021-08-02,161,647,-486,-75.12,1217
2021-08-03,155,686,-531,-77.41,1217
2021-08-04,155,683,-528,-77.31,1217
2021-08-05,155,681,-526,-77.24,1217
2021-08-06,122,639,-517,-80.91,1217
2021-08-07,33,242,-209,-86.36,1217
2021-08-08,14,83,-69,-83.13,1217
2021-08-09,161,624,-463,-74.2,1217
2021-08-10,155,661,-506,-76.55,1217
2021-08-11,155,658,-503,-76.44,1217
2021-08-12,155,655,-500,-76.34,1217
2021-08-13,122,614,-492,-80.13,1217
2021-08-14,33,218,-185,-84.86,1217
2021-08-15,14,62,-48,-77.42,1217
2021-08-16,161,606,-445,-73.43,1217
2021-08-17,155,646,-491,-76.01,1217
2021-08-18,155,648,-493,-76.08,1217
2021-08-19,155,650,-495,-76.15,1217
2021-08-20,122,613,-491,-80.1,1217
2021-08-21,33,224,-191,-85.27,1217
2021-08-22,14,73,-59,-80.82,1217
2021-08-23,161,622,-461,-74.12,1217
2021-08-24,155,669,-514,-76.83,1217
2021-08-25,155,675,-520,-77.04,1217
2021-08-26,155,683,-528,-77.31,1217
2021-08-27,122,651,-529,-81.26,1217
2021-08-28,33,265,-232,-87.55,1217
2021-08-29,14,118,-104,-88.14,1217
2021-08-30,161,671,-510,-76.01,1217
2021-08-31,155,719,-564,-78.44,1217
2021-09-01,337,727,-390,-53.65,1217
2021-09-02,337,735,-398,-54.15,1217
2021-09-03,287,704,-417,-59.23,1217
2021-09-04,116,317,-201,-63.41,1217
2021-09-05,52,168,-116,-69.05,1217
2021-09-06,328,718,-390,-54.32,1217
2021-09-07,337,764,-427,-55.89,1217
2021-09-08,337,769,-432,-56.18,1217
2021-09-09,337,773,-436,-56.4,1217
2021-09-10,287,737,-450,-61.06,1217
2021-09-11,116,346,-230,-66.47,1217
2021-09-12,52,193,-141,-73.06,1217
2021-09-13,328,738,-410,-55.56,1217
2021-09-14,337,780,-443,-56.79,1217
2021-09-15,337,780,-443,-56.79,1217
2021-09-16,337,781,-444,-56.85,1217
2021-09-17,287,741,-454,-61.27,1217
2021-09-18,116,347,-231,-66.57,1217
2021-09-19,52,191,-139,-72.77,1217
2021-09-20,328,734,-406,-55.31,1217
2021-09-21,337,774,-437,-56.46,1217
2021-09-22,337,773,-436,-56.4,1217
2021-09-23,337,772,-435,-56.35,1217
2021-09-24,287,732,-445,-60.79,1217
2021-09-25,116,338,-222,-65.68,1217
2021-09-26,52,183,-131,-71.58,1217
2021-09-27,328,727,-399,-54.88,1217
2021-09-28,337,767,-430,-56.06,1217
2021-09-29,337,768,-431,-56.12,1217
2021-09-30,337,769,-432,-56.18,1217
2021-10-01,256,730,-474,-64.93,1217
2021-10-02,88,338,-250,-73.96,1217
2021-10-03,46,184,-138,-75.0,1217
2021-10-04,273,729,-456,-62.55,1217
2021-10-05,303,770,-467,-60.65,1217
2021-10-06,303,772,-469,-60.75,1217
2021-10-07,303,773,-470,-60.8,1217
2021-10-08,256,735,-479,-65.17,1217
2021-10-09,88,342,-254,-74.27,1217
2021-10-10,46,187,-141,-75.4,1217
2021-10-11,273,732,-459,-62.7,1217
2021-10-12,303,773,-470,-60.8,1217
2021-10-13,303,773,-470,-60.8,1217
2021-10-14,303,772,-469,-60.75,1217
2021-10-15,256,732,-476,-65.03,1217
2021-10-16,88,338,-250,-73.96,1217
2021-10-17,46,182,-136,-74.73,1217
2021-10-18,273,725,-452,-62.34,1217
2021-10-19,303,764,-461,-60.34,1217
2021-10-20,303,762,-459,-60.24,1217
2021-10-21,303,761,-458,-60.18,1217
2021-10-22,256,720,-464,-64.44,1217
2021-10-23,88,324,-236,-72.84,1217
2021-10-24,46,167,-121,-72.46,1217
2021-10-25,273,709,-436,-61.5,1217
2021-10-26,303,748,-445,-59.49,1217
2021-10-27,303,746,-443,-59.38,1217
2021-10-28,303,745,-442,-59.33,1217
2021-10-29,256,704,-448,-63.64,1217
2021-10-30,88,310,-222,-71.61,1217
2021-10-31,46,153,-107,-69.93,1217
2021-11-01,403,696,-293,-42.1,1217
2021-11-02,426,736,-310,-42.12,1217
2021-11-03,426,735,-309,-42.04,1217
2021-11-04,426,735,-309,-42.04,1217
2021-11-05,405,695,-290,-41.73,1217
2021-11-06,157,301,-144,-47.84,1217
2021-11-07,66,145,-79,-54.48,1217
2021-11-08,403,688,-285,-41.42,1217
2021-11-09,426,728,-302,-41.48,1217
2021-11-10,426,728,-302,-41.48,1217
2021-11-11,426,727,-301,-41.4,1217
2021-11-12,405,687,-282,-41.05,1217
2021-11-13,157,293,-136,-46.42,1217
2021-11-14,66,137,-71,-51.82,1217
2021-11-15,403,680,-277,-40.74,1217
2021-11-16,426,719,-293,-40.75,1217
2021-11-17,426,718,-292,-40.67,1217
2021-11-18,426,717,-291,-40.59,1217
2021-11-19,405,676,-271,-40.09,1217
2021-11-20,157,282,-125,-44.33,1217
2021-11-21,66,125,-59,-47.2,1217
2021-11-22,403,668,-265,-39.67,1217
2021-11-23,426,708,-282,-39.83,1217
2021-11-24,426,708,-282,-39.83,1217
2021-11-25,426,707,-281,-39.75,1217
2021-11-26,405,668,-263,-39.37,1217
2021-11-27,157,275,-118,-42.91,1217
2021-11-28,66,120,-54,-45.0,1217
2021-11-29,403,665,-262,-39.4,1217
2021-11-30,426,707,-281,-39.75,1217
2021-12-01,354,709,-355,-50.07,1217
2021-12-02,354,711,-357,-50.21,1217
2021-12-03,276,674,-398,-59.05,1217
2021-12-04,154,283,-129,-45.58,1217
2021-12-05,72,131,-59,-45.04,1217
2021-12-06,371,678,-307,-45.28,1217
2021-12-07,354,721,-367,-50.9,1217
2021-12-08,354,724,-370,-51.1,1217
2021-12-09,354,727,-373,-51.31,1217
2021-12-10,276,690,-414,-60.0,1217
2021-12-11,154,299,-145,-48.49,1217
2021-12-12,72,146,-74,-50.68,1217
2021-12-13,371,691,-320,-46.31,1217
2021-12-14,354,732,-378,-51.64,1217
2021-12-15,354,732,-378,-51.64,1217
2021-12-16,354,732,-378,-51.64,1217
2021-12-17,276,691,-415,-60.06,1217
2021-12-18,154,295,-141,-47.8,1217
2021-12-19,72,136,-64,-47.06,1217
2021-12-20,371,676,-305,-45.12,1217
2021-12-21,354,711,-357,-50.21,1217
2021-12-22,354,705,-351,-49.79,1217
2021-12-23,354,698,-344,-49.28,1217
2021-12-24,276,651,-375,-57.6,1217
2021-12-25,154,249,-95,-38.15,1217
2021-12-26,72,84,-12,-14.29,1217
2021-12-27,371,618,-247,-39.97,1217
2021-12-28,354,649,-295,-45.45,1217
2021-12-29,354,638,-284,-44.51,1217
2021-12-30,354,627,-273,-43.54,1217
2021-12-31,276,577,-301,-52.17,1217
2022-01-01,141,173,-32,-18.5,1217
2022-01-02,61,8,53,662.5,1217
2022-01-03,368,542,-174,-32.1,1217
2022-01-04,387,573,-186,-32.46,1217
2022-01-05,387,564,-177,-31.38,1217
2022-01-06,387,556,-169,-30.4,1217
2022-01-07,318,509,-191,-37.52,1217
2022-01-08,141,109,32,29.36,1217
2022-01-09,61,19,42,221.05,1217
2022-01-10,368,488,-120,-24.59,1217
2022-01-11,387,525,-138,-26.29,1217
2022-01-12,387,523,-136,-26.0,1217
2022-01-13,387,521,-134,-25.72,1217
2022-01-14,318,481,-163,-33.89,1217
2022-01-15,141,88,53,60.23,1217
2022-01-16,61,12,49,408.33,1217
2022-01-17,368,479,-111,-23.17,1217
2022-01-18,387,521,-134,-25.72,1217
2022-01-19,387,524,-137,-26.15,1217
2022-01-20,387,526,-139,-26.43,1217
2022-01-21,318,490,-172,-35.1,1217
2022-01-22,141,100,41,41.0,1217
2022-01-23,61,19,42,221.05,1217
2022-01-24,368,494,-126,-25.51,1217
2022-01-25,387,537,-150,-27.93,1217
2022-01-26,387,540,-153,-28.33,1217
2022-01-27,387,542,-155,-28.6,1217
2022-01-28,318,504,-186,-36.9,1217
2022-01-29,141,112,29,25.89,1217
2022-01-30,61,25,36,144.0,1217
2020-02-01,2505,3253,-748,-22.99,1621
2020-02-02,1452,2559,-1107,-43.26,1621
2020-02-03,5179,5595,-416,-7.44,1621
2020-02-04,5636,5690,-54,-0.95,1621
2020-02-05,5636,5709,-73,-1.28,1621
2020-02-06,5636,5717,-81,-1.42,1621
2020-02-07,5033,5291,-258,-4.88,1621
2020-02-08,2505,3395,-890,-26.22,1621
2020-02-09,1452,2695,-1243,-46.12,1621
2020-02-10,5179,5724,-545,-9.52,1621
2020-02-11,5636,5812,-176,-3.03,1621
2020-02-12,5636,5823,-187,-3.21,1621
2020-02-13,5636,5823,-187,-3.21,1621
2020-02-14,5033,5388,-355,-6.59,1621
2020-02-15,2505,3485,-980,-28.12,1621
2020-02-16,1452,2777,-1325,-47.71,1621
2020-02-17,5179,5799,-620,-10.69,1621
2020-02-18,5636,5881,-245,-4.17,1621
2020-02-19,5636,5886,-250,-4.25,1621
2020-02-20,5636,5881,-245,-4.17,1621
2020-02-21,5033,5442,-409,-7.52,1621
2020-02-22,2505,3535,-1030,-29.14,1621
2020-02-23,1452,2825,-1373,-48.6,1621
2020-02-24,5179,5845,-666,-11.39,1621
2020-02-25,5636,5925,-289,-4.88,1621
2020-02-26,5636,5930,-294,-4.96,1621
2020-02-27,5636,5926,-290,-4.89,1621
2020-02-28,5033,5487,-454,-8.27,1621
2020-02-29,2505,3582,-1077,-30.07,1621
2020-03-01,1178,2873,-1695,-59.0,1621
2020-03-02,4674,5896,-1222,-20.73,1621
2020-03-03,4598,5978,-1380,-23.08,1621
2020-03-04,4598,5985,-1387,-23.17,1621
2020-03-05,4598,5983,-1385,-23.15,1621
2020-03-06,4056,5546,-1490,-26.87,1621
2020-03-07,1925,3642,-1717,-47.14,1621
2020-03-08,1178,2935,-1757,-59.86,1621
2020-03-09,4674,5958,-1284,-21.55,1621
2020-03-10,4598,6041,-1443,-23.89,1621
2020-03-11,4598,6047,-1449,-23.96,1621
2020-03-12,4598,6044,-1446,-23.92,1621
2020-03-13,4056,5607,-1551,-27.66,1621
2020-03-14,1925,3701,-1776,-47.99,1621
2020-03-15,1178,2992,-1814,-60.63,1621
2020-03-16,4674,6013,-1339,-22.27,1621
2020-03-17,4598,6093,-1495,-24.54,1621
2020-03-18,4598,6096,-1498,-24.57,1621
2020-03-19,4598,6090,-1492,-24.5,1621
2020-03-20,4056,5649,-1593,-28.2,1621
2020-03-21,1925,3741,-1816,-48.54,1621
2020-03-22,1178,3028,-1850,-61.1,1621
2020-03-23,4674,6046,-1372,-22.69,1621
2020-03-24,4598,6124,-1526,-24.92,1621
2020-03-25,4598,6125,-1527,-24.93,1621
2020-03-26,4598,6116,-1518,-24.82,1621
2020-03-27,4056,5674,-1618,-28.52,1621
2020-03-28,1925,3764,-1839,-48.86,1621
2020-03-29,1178,3050,-1872,-61.38,1621
2020-03-30,4674,6068,-1394,-22.97,1621
2020-03-31,4598,6145,-1547,-25.17,1621
2020-04-01,4666,6147,-1481,-24.09,1621
2020-04-02,4666,6139,-1473,-23.99,1621
2020-04-03,3817,5697,-1880,-33.0,1621
2020-04-04,1764,3789,-2025,-53.44,1621
2020-04-05,844,3077,-2233,-72.57,1621
2020-04-06,4701,6096,-1395,-22.88,1621
2020-04-07,4666,6175,-1509,-24.44,1621
2020-04-08,4666,6179,-1513,-24.49,1621
2020-04-09,4666,6173,-1507,-24.41,1621
2020-04-10,3817,5734,-1917,-33.43,1621
2020-04-11,1764,3827,-2063,-53.91,1621
2020-04-12,844,3116,-2272,-72.91,1621
2020-04-13,4701,6137,-1436,-23.4,1621
2020-04-14,4666,6217,-1551,-24.95,1621
2020-04-15,4666,6221,-1555,-25.0,1621
2020-04-16,4666,6215,-1549,-24.92,1621
2020-04-17,3817,5776,-1959,-33.92,1621
2020-04-18,1764,3868,-2104,-54.4,1621
2020-04-19,844,3157,-2313,-73.27,1621
2020-04-20,4701,6176,-1475,-23.88,1621
2020-04-21,4666,6254,-1588,-25.39,1621
2020-04-22,4666,6255,-1589,-25.4,1621
2020-04-23,4666,6247,-1581,-25.31,1621
2020-04-24,3817,5804,-1987,-34.24,1621
2020-04-25,1764,3894,-2130,-54.7,1621
2020-04-26,844,3179,-2335,-73.45,1621
2020-04-27,4701,6194,-1493,-24.1,1621
2020-04-28,4666,6269,-1603,-25.57,1621
2020-04-29,4666,6267,-1601,-25.55,1621
2020-04-30,4666,6255,-1589,-25.4,1621
2020-05-01,4792,5809,-1017,-17.51,1621
2020-05-02,2583,3896,-1313,-33.7,1621
2020-05-03,1453,3178,-1725,-54.28,1621
2020-05-04,5353,6192,-839,-13.55,1621
2020-05-05,5664,6264,-600,-9.58,1621
2020-05-06,5664,6262,-598,-9.55,1621
2020-05-07,5664,6250,-586,-9.38,1621
2020-05-08,4792,5804,-1012,-17.44,1621
2020-05-09,2583,3891,-1308,-33.62,1621
2020-05-10,1453,3175,-1722,-54.24,1621
2020-05-11,5353,6191,-838,-13.54,1621
2020-05-12,5664,6267,-603,-9.62,1621
2020-05-13,5664,6268,-604,-9.64,1621
2020-05-14,5664,6260,-596,-9.52,1621
2020-05-15,4792,5820,-1028,-17.66,1621
2020-05-16,2583,3913,-1330,-33.99,1621
2020-05-17,1453,3203,-1750,-54.64,1621
2020-05-18,5353,6226,-873,-14.02,1621
2020-05-19,5664,6310,-646,-10.24,1621
2020-05-20,5664,6319,-655,-10.37,1621
2020-05-21,5664,6319,-655,-10.37,1621
2020-05-22,4792,5887,-1095,-18.6,1621
2020-05-23,2583,3989,-1406,-35.25,1621
2020-05-24,1453,3288,-1835,-55.81,1621
2020-05-25,5353,6319,-966,-15.29,1621
2020-05-26,5664,6411,-747,-11.65,1621
2020-05-27,5664,6427,-763,-11.87,1621
2020-05-28,5664,6435,-771,-11.98,1621
2020-05-29,4792,6009,-1217,-20.25,1621
2020-05-30,2583,4117,-1534,-37.26,1621
2020-05-31,1453,3420,-1967,-57.51,1621
2020-06-01,5566,6455,-889,-13.77,1621
2020-06-02,5727,6550,-823,-12.56,1621
2020-06-03,5727,6568,-841,-12.8,1621
2020-06-04,5727,6577,-850,-12.92,1621
2020-06-05,4836,6150,-1314,-21.37,1621
2020-06-06,2498,4256,-1758,-41.31,1621
2020-06-07,1514,3557,-2043,-57.44,1621
2020-06-08,5566,6588,-1022,-15.51,1621
2020-06-09,5727,6678,-951,-14.24,1621
2020-06-10,5727,6690,-963,-14.39,1621
2020-06-11,5727,6691,-964,-14.41,1621
2020-06-12,4836,6257,-1421,-22.71,1621
2020-06-13,2498,4354,-1856,-42.63,1621
2020-06-14,1514,3646,-2132,-58.48,1621
2020-06-15,5566,6668,-1102,-16.53,1621
2020-06-16,5727,6747,-1020,-15.12,1621
2020-06-17,5727,6749,-1022,-15.14,1621
2020-06-18,5727,6741,-1014,-15.04,1621
2020-06-19,4836,6297,-1461,-23.2,1621
2020-06-20,2498,4386,-1888,-43.05,1621
2020-06-21,1514,3669,-2155,-58.74,1621
2020-06-22,5566,6682,-1116,-16.7,1621
2020-06-23,5727,6755,-1028,-15.22,1621
2020-06-24,5727,6751,-1024,-15.17,1621
2020-06-25,5727,6738,-1011,-15.0,1621
2020-06-26,4836,6290,-1454,-23.12,1621
2020-06-27,2498,4376,-1878,-42.92,1621
2020-06-28,1514,3658,-2144,-58.61,1621
2020-06-29,5566,6671,-1105,-16.56,1621
2020-06-30,5727,6745,-1018,-15.09,1621
2020-07-01,5543,6744,-1201,-17.81,1621
2020-07-02,5543,6733,-1190,-17.67,1621
2020-07-03,5034,6290,-1256,-19.97,1621
2020-07-04,2590,4380,-1790,-40.87,1621
2020-07-05,1645,3667,-2022,-55.14,1621
2020-07-06,5474,6686,-1212,-18.13,1621
2020-07-07,5543,6766,-1223,-18.08,1621
2020-07-08,5543,6770,-1227,-18.12,1621
2020-07-09,5543,6765,-1222,-18.06,1621
2020-07-10,5034,6326,-1292,-20.42,1621
2020-07-11,2590,4420,-1830,-41.4,1621
2020-07-12,1645,3710,-2065,-55.66,1621
2020-07-13,5474,6731,-1257,-18.67,1621
2020-07-14,5543,6811,-1268,-18.62,1621
2020-07-15,5543,6814,-1271,-18.65,1621
2020-07-16,5543,6806,-1263,-18.56,1621
2020-07-17,5034,6363,-1329,-20.89,1621
2020-07-18,2590,4452,-1862,-41.82,1621
2020-07-19,1645,3734,-2089,-55.95,1621
2020-07-20,5474,6746,-1272,-18.86,1621
2020-07-21,5543,6815,-1272,-18.66,1621
2020-07-22,5543,6805,-1262,-18.55,1621
2020-07-23,5543,6785,-1242,-18.31,1621
2020-07-24,5034,6327,-1293,-20.44,1621
2020-07-25,2590,4400,-1810,-41.14,1621
2020-07-26,1645,3667,-2022,-55.14,1621
2020-07-27,5474,6663,-1189,-17.84,1621
2020-07-28,5543,6716,-1173,-17.47,1621
2020-07-29,5543,6692,-1149,-17.17,1621
2020-07-30,5543,6656,-1113,-16.72,1621
2020-07-31,5034,6186,-1152,-18.62,1621
2020-08-01,2462,4247,-1785,-42.03,1621
2020-08-02,1634,3503,-1869,-53.35,1621
2020-08-03,5358,6491,-1133,-17.45,1621
2020-08-04,5452,6539,-1087,-16.62,1621
2020-08-05,5452,6511,-1059,-16.26,1621
2020-08-06,5452,6475,-1023,-15.8,1621
2020-08-07,4688,6007,-1319,-21.96,1621
2020-08-08,2462,4073,-1611,-39.55,1621
2020-08-09,1634,3337,-1703,-51.03,1621
2020-08-10,5358,6336,-978,-15.44,1621
2020-08-11,5452,6397,-945,-14.77,1621
2020-08-12,5452,6385,-933,-14.61,1621
2020-08-13,5452,6367,-915,-14.37,1621
2020-08-14,4688,5919,-1231,-20.8,1621
2020-08-15,2462,4008,-1546,-38.57,1621
2020-08-16,1634,3296,-1662,-50.42,1621
2020-08-17,5358,6319,-961,-15.21,1621
2020-08-18,5452,6406,-954,-14.89,1621
2020-08-19,5452,6420,-968,-15.08,1621
2020-08-20,5452,6429,-977,-15.2,1621
2020-08-21,4688,6006,-1318,-21.94,1621
2020-08-22,2462,4119,-1657,-40.23,1621
2020-08-23,1634,3431,-1797,-52.38,1621
2020-08-24,5358,6476,-1118,-17.26,1621
2020-08-25,5452,6582,-1130,-17.17,1621
2020-08-26,5452,6614,-1162,-17.57,1621
2020-08-27,5452,6637,-1185,-17.85,1621
2020-08-28,4688,6227,-1539,-24.71,1621
2020-08-29,2462,4349,-1887,-43.39,1621
2020-08-30,1634,3667,-2033,-55.44,1621
2020-08-31,5358,6716,-1358,-20.22,1621
2020-09-01,6086,6823,-737,-10.8,1621
2020-09-02,6086,6854,-768,-11.21,1621
2020-09-03,6086,6873,-787,-11.45,1621
2020-09-04,5181,6455,-1274,-19.74,1621
2020-09-05,2734,4569,-1835,-40.16,1621
2020-09-06,1707,3877,-2170,-55.97,1621
2020-09-07,5759,6913,-1154,-16.69,1621
2020-09-08,6086,7007,-921,-13.14,1621
2020-09-09,6086,7022,-936,-13.33,1621
2020-09-10,6086,7026,-940,-13.38,1621
2020-09-11,5181,6594,-1413,-21.43,1621
2020-09-12,2734,4692,-1958,-41.73,1621
2020-09-13,1707,3985,-2278,-57.16,1621
2020-09-14,5759,7007,-1248,-17.81,1621
2020-09-15,6086,7088,-1002,-14.14,1621
2020-09-16,6086,7091,-1005,-14.17,1621
2020-09-17,6086,7085,-999,-14.1,1621
2020-09-18,5181,6644,-1463,-22.02,1621
2020-09-19,2734,4735,-2001,-42.26,1621
2020-09-20,1707,4022,-2315,-57.56,1621
2020-09-21,5759,7041,-1282,-18.21,1621
2020-09-22,6086,7119,-1033,-14.51,1621
2020-09-23,6086,7123,-1037,-14.56,1621
2020-09-24,6086,7117,-1031,-14.49,1621
2020-09-25,5181,6678,-1497,-22.42,1621
2020-09-26,2734,4773,-2039,-42.72,1621
2020-09-27,1707,4064,-2357,-58.0,1621
2020-09-28,5759,7088,-1329,-18.75,1621
2020-09-29,6086,7172,-1086,-15.14,1621
2020-09-30,6086,7181,-1095,-15.25,1621
2020-10-01,6272,7181,-909,-12.66,1621
2020-10-02,5405,6747,-1342,-19.89,1621
2020-10-03,2831,4847,-2016,-41.59,1621
2020-10-04,1587,4142,-2555,-61.69,1621
2020-10-05,6250,7169,-919,-12.82,1621
2020-10-06,6272,7255,-983,-13.55,1621
2020-10-07,6272,7266,-994,-13.68,1621
2020-10-08,6272,7266,-994,-13.68,1621
2020-10-09,5405,6832,-1427,-20.89,1621
2020-10-10,2831,4929,-2098,-42.56,1621
2020-10-11,1587,4222,-2635,-62.41,1621
2020-10-12,6250,7245,-995,-13.73,1621
2020-10-13,6272,7327,-1055,-14.4,1621
2020-10-14,6272,7332,-1060,-14.46,1621
2020-10-15,6272,7327,-1055,-14.4,1621
2020-10-16,5405,6887,-1482,-21.52,1621
2020-10-17,2831,4979,-2148,-43.14,1621
2020-10-18,1587,4266,-2679,-62.8,1621
2020-10-19,6250,7284,-1034,-14.2,1621
2020-10-20,6272,7361,-1089,-14.79,1621
2020-10-21,6272,7361,-1089,-14.79,1621
2020-10-22,6272,7353,-1081,-14.7,1621
2020-10-23,5405,6910,-1505,-21.78,1621
2020-10-24,2831,5001,-2170,-43.39,1621
2020-10-25,1587,4288,-2701,-62.99,1621
2020-10-26,6250,7306,-1056,-14.45,1621
2020-10-27,6272,7385,-1113,-15.07,1621
2020-10-28,6272,7389,-1117,-15.12,1621
2020-10-29,6272,7384,-1112,-15.06,1621
2020-10-30,5405,6946,-1541,-22.19,1621
2020-10-31,2831,5042,-2211,-43.85,1621
2020-11-01,1484,4335,-2851,-65.77,1621
2020-11-02,5989,7360,-1371,-18.63,1621
2020-11-03,6140,7445,-1305,-17.53,1621
2020-11-04,6140,7456,-1316,-17.65,1621
2020-11-05,6140,7457,-1317,-17.66,1621
2020-11-06,5446,7025,-1579,-22.48,1621
2020-11-07,2640,5125,-2485,-48.49,1621
2020-11-08,1484,4421,-2937,-66.43,1621
2020-11-09,5989,7449,-1460,-19.6,1621
2020-11-10,6140,7535,-1395,-18.51,1621
2020-11-11,6140,7544,-1404,-18.61,1621
2020-11-12,6140,7544,-1404,-18.61,1621
2020-11-13,5446,7107,-1661,-23.37,1621
2020-11-14,2640,5202,-2562,-49.25,1621
2020-11-15,1484,4491,-3007,-66.96,1621
2020-11-16,5989,7510,-1521,-20.25,1621
2020-11-17,6140,7586,-1446,-19.06,1621
2020-11-18,6140,7584,-1444,-19.04,1621
2020-11-19,6140,7571,-1431,-18.9,1621
2020-11-20,5446,7121,-1675,-23.52,1621
2020-11-21,2640,5202,-2562,-49.25,1621
2020-11-22,1484,4476,-2992,-66.85,1621
2020-11-23,5989,7480,-1491,-19.93,1621
2020-11-24,6140,7542,-1402,-18.59,1621
2020-11-25,6140,7526,-1386,-18.42,1621
2020-11-26,6140,7500,-1360,-18.13,1621
2020-11-27,5446,7038,-1592,-22.62,1621
2020-11-28,2640,5108,-2468,-48.32,1621
2020-11-29,1484,4373,-2889,-66.06,1621
2020-11-30,5989,7369,-1380,-18.73,1621
2020-12-01,4867,7425,-2558,-34.45,1621
2020-12-02,4867,7405,-2538,-34.27,1621
2020-12-03,4867,7377,-2510,-34.02,1621
2020-12-04,5734,6915,-1181,-17.08,1621
2020-12-05,2828,4987,-2159,-43.29,1621
2020-12-06,1421,4257,-2836,-66.62,1621
2020-12-07,4522,7259,-2737,-37.7,1621
2020-12-08,4867,7322,-2455,-33.53,1621
2020-12-09,4867,7312,-2445,-33.44,1621
2020-12-10,4867,7293,-2426,-33.26,1621
2020-12-11,5734,6843,-1109,-16.21,1621
2020-12-12,2828,4927,-2099,-42.6,1621
2020-12-13,1421,4209,-2788,-66.24,1621
2020-12-14,4522,7225,-2703,-37.41,1621
2020-12-15,4867,7301,-2434,-33.34,1621
2020-12-16,4867,7302,-2435,-33.35,1621
2020-12-17,4867,7296,-2429,-33.29,1621
2020-12-18,5734,6857,-1123,-16.38,1621
2020-12-19,2828,4951,-2123,-42.88,1621
2020-12-20,1421,4242,-2821,-66.5,1621
2020-12-21,4522,7264,-2742,-37.75,1621
2020-12-22,4867,7346,-2479,-33.75,1621
2020-12-23,4867,7352,-2485,-33.8,1621
2020-12-24,4867,7348,-2481,-33.76,1621
2020-12-25,5734,6910,-1176,-17.02,1621
2020-12-26,2828,5004,-2176,-43.49,1621
2020-12-27,1421,4293,-2872,-66.9,1621
2020-12-28,4522,7312,-2790,-38.16,1621
2020-12-29,4867,7390,-2523,-34.14,1621
2020-12-30,4867,7391,-2524,-34.15,1621
2020-12-31,4867,7381,-2514,-34.06,1621
2021-01-01,4940,6937,-1997,-28.79,1621
2021-01-02,2431,5024,-2593,-51.61,1621
2021-01-03,1337,4306,-2969,-68.95,1621
2021-01-04,5729,7320,-1591,-21.73,1621
2021-01-05,5834,7392,-1558,-21.08,1621
2021-01-06,5834,7388,-1554,-21.03,1621
2021-01-07,5834,7374,-1540,-20.88,1621
2021-01-08,4940,6927,-1987,-28.68,1621
2021-01-09,2431,5013,-2582,-51.51,1621
2021-01-10,1337,4295,-2958,-68.87,1621
2021-01-11,5729,7309,-1580,-21.62,1621
2021-01-12,5834,7384,-1550,-20.99,1621
2021-01-13,5834,7384,-1550,-20.99,1621
2021-01-14,5834,7376,-1542,-20.91,1621
2021-01-15,4940,6935,-1995,-28.77,1621
2021-01-16,2431,5029,-2598,-51.66,1621
2021-01-17,1337,4320,-2983,-69.05,1621
2021-01-18,5729,7345,-1616,-22.0,1621
2021-01-19,5834,7430,-1596,-21.48,1621
2021-01-20,5834,7441,-1607,-21.6,1621
2021-01-21,5834,7445,-1611,-21.64,1621
2021-01-22,4940,7016,-2076,-29.59,1621
2021-01-23,2431,5121,-2690,-52.53,1621
2021-01-24,1337,4424,-3087,-69.78,1621
2021-01-25,5729,7459,-1730,-23.19,1621
2021-01-26,5834,7554,-1720,-22.77,1621
2021-01-27,5834,7574,-1740,-22.97,1621
2021-01-28,5834,7585,-1751,-23.09,1621
2021-01-29,4940,7163,-2223,-31.03,1621
2021-01-30,2431,5273,-2842,-53.9,1621
2021-01-31,1337,4580,-3243,-70.81,1621
2021-02-01,6376,7617,-1241,-16.29,1621
2021-02-02,6163,7713,-1550,-20.1,1621
2021-02-03,6163,7733,-1570,-20.3,1621
2021-02-04,6163,7742,-1579,-20.4,1621
2021-02-05,5582,7317,-1735,-23.71,1621
2021-02-06,2788,5423,-2635,-48.59,1621
2021-02-07,1456,4724,-3268,-69.18,1621
2021-02-08,6376,7755,-1379,-17.78,1621
2021-02-09,6163,7844,-1681,-21.43,1621
2021-02-10,6163,7856,-1693,-21.55,1621
2021-02-11,6163,7858,-1695,-21.57,1621
2021-02-12,5582,7424,-1842,-24.81,1621
2021-02-13,2788,5523,-2735,-49.52,1621
2021-02-14,1456,4815,-3359,-69.76,1621
2021-02-15,6376,7839,-1463,-18.66,1621
2021-02-16,6163,7921,-1758,-22.19,1621
2021-02-17,6163,7927,-1764,-22.25,1621
2021-02-18,6163,7922,-1759,-22.2,1621
2021-02-19,5582,7483,-1901,-25.4,1621
2021-02-20,2788,5577,-2789,-50.01,1621
2021-02-21,1456,4866,-3410,-70.08,1621
2021-02-22,6376,7887,-1511,-19.16,1621
2021-02-23,6163,7967,-1804,-22.64,1621
2021-02-24,6163,7972,-1809,-22.69,1621
2021-02-25,6163,7967,-1804,-22.64,1621
2021-02-26,5582,7528,-1946,-25.85,1621
2021-02-27,2788,5623,-2835,-50.42,1621
2021-02-28,1456,4913,-3457,-70.36,1621
2021-03-01,6367,7935,-1568,-19.76,1621
2021-03-02,6226,8017,-1791,-22.34,1621
2021-03-03,6226,8024,-1798,-22.41,1621
2021-03-04,6226,8021,-1795,-22.38,1621
2021-03-05,5450,7584,-2134,-28.14,1621
2021-03-06,2852,5681,-2829,-49.8,1621
2021-03-07,1498,4973,-3475,-69.88,1621
2021-03-08,6367,7996,-1629,-20.37,1621
2021-03-09,6226,8079,-1853,-22.94,1621
2021-03-10,6226,8086,-1860,-23.0,1621
2021-03-11,6226,8083,-1857,-22.97,1621
2021-03-12,5450,7646,-2196,-28.72,1621
2021-03-13,2852,5741,-2889,-50.32,1621
2021-03-14,1498,5032,-3534,-70.23,1621
2021-03-15,6367,8054,-1687,-20.95,1621
2021-03-16,6226,8134,-1908,-23.46,1621
2021-03-17,6226,8139,-1913,-23.5,1621
2021-03-18,6226,8133,-1907,-23.45,1621
2021-03-19,5450,7693,-2243,-29.16,1621
2021-03-20,2852,5785,-2933,-50.7,1621
2021-03-21,1498,5073,-3575,-70.47,1621
2021-03-22,6367,8091,-1724,-21.31,1621
2021-03-23,6226,8169,-1943,-23.79,1621
2021-03-24,6226,8170,-1944,-23.79,1621
2021-03-25,6226,8162,-1936,-23.72,1621
2021-03-26,5450,7720,-2270,-29.4,1621
2021-03-27,2852,5810,-2958,-50.91,1621
2021-03-28,1498,5096,-3598,-70.6,1621
2021-03-29,6367,8114,-1747,-21.53,1621
2021-03-30,6226,8190,-1964,-23.98,1621
2021-03-31,6226,8192,-1966,-24.0,1621
2021-04-01,6372,8184,-1812,-22.14,1621
2021-04-02,5432,7742,-2310,-29.84,1621
2021-04-03,2678,5833,-3155,-54.09,1621
2021-04-04,1309,5121,-3812,-74.44,1621
2021-04-05,6229,8140,-1911,-23.48,1621
2021-04-06,6372,8218,-1846,-22.46,1621
2021-04-07,6372,8222,-1850,-22.5,1621
2021-04-08,6372,8216,-1844,-22.44,1621
2021-04-09,5432,7776,-2344,-30.14,1621
2021-04-10,2678,5869,-3191,-54.37,1621
2021-04-11,1309,5158,-3849,-74.62,1621
2021-04-12,6229,8179,-1950,-23.84,1621
2021-04-13,6372,8259,-1887,-22.85,1621
2021-04-14,6372,8263,-1891,-22.89,1621
2021-04-15,6372,8258,-1886,-22.84,1621
2021-04-16,5432,7818,-2386,-30.52,1621
2021-04-17,2678,5911,-3233,-54.69,1621
2021-04-18,1309,5200,-3891,-74.83,1621
2021-04-19,6229,8219,-1990,-24.21,1621
2021-04-20,6372,8298,-1926,-23.21,1621
2021-04-21,6372,8300,-1928,-23.23,1621
2021-04-22,6372,8293,-1921,-23.16,1621
2021-04-23,5432,7851,-2419,-30.81,1621
2021-04-24,2678,5941,-3263,-54.92,1621
2021-04-25,1309,5226,-3917,-74.95,1621
2021-04-26,6229,8242,-2013,-24.42,1621
2021-04-27,6372,8317,-1945,-23.39,1621
2021-04-28,6372,8316,-1944,-23.38,1621
2021-04-29,6372,8305,-1933,-23.28,1621
2021-04-30,5432,7860,-2428,-30.89,1621
2021-05-01,2756,5946,-3190,-53.65,1621
2021-05-02,1455,5229,-3774,-72.17,1621
2021-05-03,5866,8242,-2376,-28.83,1621
2021-05-04,5926,8315,-2389,-28.73,1621
2021-05-05,5926,8312,-2386,-28.71,1621
2021-05-06,5926,8300,-2374,-28.6,1621
2021-05-07,5203,7854,-2651,-33.75,1621
2021-05-08,2756,5941,-3185,-53.61,1621
2021-05-09,1455,5224,-3769,-72.15,1621
2021-05-10,5866,8239,-2373,-28.8,1621
2021-05-11,5926,8314,-2388,-28.72,1621
2021-05-12,5926,8314,-2388,-28.72,1621
2021-05-13,5926,8305,-2379,-28.65,1621
2021-05-14,5203,7863,-2660,-33.83,1621
2021-05-15,2756,5955,-3199,-53.72,1621
2021-05-16,1455,5244,-3789,-72.25,1621
2021-05-17,5866,8266,-2400,-29.03,1621
2021-05-18,5926,8348,-2422,-29.01,1621
2021-05-19,5926,8355,-2429,-29.07,1621
2021-05-20,5926,8354,-2428,-29.06,1621
2021-05-21,5203,7920,-2717,-34.31,1621
2021-05-22,2756,6021,-3265,-54.23,1621
2021-05-23,1455,5318,-3863,-72.64,1621
2021-05-24,5866,8348,-2482,-29.73,1621
2021-05-25,5926,8438,-2512,-29.77,1621
2021-05-26,5926,8454,-2528,-29.9,1621
2021-05-27,5926,8461,-2535,-29.96,1621
2021-05-28,5203,8034,-2831,-35.24,1621
2021-05-29,2756,6141,-3385,-55.12,1621
2021-05-30,1455,5444,-3989,-73.27,1621
2021-05-31,5866,8479,-2613,-30.82,1621
2021-06-01,5803,8574,-2771,-32.32,1621
2021-06-02,5803,8592,-2789,-32.46,1621
2021-06-03,5803,8601,-2798,-32.53,1621
2021-06-04,4970,8176,-3206,-39.21,1621
2021-06-05,2584,6283,-3699,-58.87,1621
2021-06-06,1449,5585,-4136,-74.06,1621
2021-06-07,5837,8617,-2780,-32.26,1621
2021-06-08,5803,8708,-2905,-33.36,1621
2021-06-09,5803,8721,-2918,-33.46,1621
2021-06-10,5803,8725,-2922,-33.49,1621
2021-06-11,4970,8292,-3322,-40.06,1621
2021-06-12,2584,6391,-3807,-59.57,1621
2021-06-13,1449,5685,-4236,-74.51,1621
2021-06-14,5837,8708,-2871,-32.97,1621
2021-06-15,5803,8789,-2986,-33.97,1621
2021-06-16,5803,8793,-2990,-34.0,1621
2021-06-17,5803,8787,-2984,-33.96,1621
2021-06-18,4970,8344,-3374,-40.44,1621
2021-06-19,2584,6434,-3850,-59.84,1621
2021-06-20,1449,5718,-4269,-74.66,1621
2021-06-21,5837,8733,-2896,-33.16,1621
2021-06-22,5803,8806,-3003,-34.1,1621
2021-06-23,5803,8803,-3000,-34.08,1621
2021-06-24,5803,8790,-2987,-33.98,1621
2021-06-25,4970,8342,-3372,-40.42,1621
2021-06-26,2584,6428,-3844,-59.8,1621
2021-06-27,1449,5709,-4260,-74.62,1621
2021-06-28,5837,8722,-2885,-33.08,1621
2021-06-29,5803,8795,-2992,-34.02,1621
2021-06-30,5803,8793,-2990,-34.0,1621
2021-07-01,5826,8782,-2956,-33.66,1621
2021-07-02,5138,8337,-3199,-38.37,1621
2021-07-03,2491,6426,-3935,-61.24,1621
2021-07-04,1302,5712,-4410,-77.21,1621
2021-07-05,5698,8730,-3032,-34.73,1621
2021-07-06,5826,8809,-2983,-33.86,1621
2021-07-07,5826,8812,-2986,-33.89,1621
2021-07-08,5826,8806,-2980,-33.84,1621
2021-07-09,5138,8367,-3229,-38.59,1621
2021-07-10,2491,6461,-3970,-61.45,1621
2021-07-11,1302,5751,-4449,-77.36,1621
2021-07-12,5698,8773,-3075,-35.05,1621
2021-07-13,5826,8853,-3027,-34.19,1621
2021-07-14,5826,8857,-3031,-34.22,1621
2021-07-15,5826,8851,-3025,-34.18,1621
2021-07-16,5138,8410,-3272,-38.91,1621
2021-07-17,2491,6500,-4009,-61.68,1621
2021-07-18,1302,5784,-4482,-77.49,1621
2021-07-19,5698,8798,-3100,-35.24,1621
2021-07-20,5826,8870,-3044,-34.32,1621
2021-07-21,5826,8864,-3038,-34.27,1621
2021-07-22,5826,8846,-3020,-34.14,1621
2021-07-23,5138,8391,-3253,-38.77,1621
2021-07-24,2491,6467,-3976,-61.48,1621
2021-07-25,1302,5737,-4435,-77.31,1621
2021-07-26,5698,8735,-3037,-34.77,1621
2021-07-27,5826,8791,-2965,-33.73,1621
2021-07-28,5826,8769,-2943,-33.56,1621
2021-07-29,5826,8736,-2910,-33.31,1621
2021-07-30,5138,8266,-3128,-37.84,1621
2021-07-31,2491,6329,-3838,-60.64,1621
2021-08-01,1266,5586,-4320,-77.34,1621
2021-08-02,5635,8574,-2939,-34.28,1621
2021-08-03,5775,8621,-2846,-33.01,1621
2021-08-04,5775,8593,-2818,-32.79,1621
2021-08-05,5775,8556,-2781,-32.5,1621
2021-08-06,4889,8085,-3196,-39.53,1621
2021-08-07,2344,6149,-3805,-61.88,1621
2021-08-08,1266,5411,-4145,-76.6,1621
2021-08-09,5635,8406,-2771,-32.96,1621
2021-08-10,5775,8463,-2688,-31.76,1621
2021-08-11,5775,8447,-2672,-31.63,1621
2021-08-12,5775,8425,-2650,-31.45,1621
2021-08-13,4889,7973,-3084,-38.68,1621
2021-08-14,2344,6057,-3713,-61.3,1621
2021-08-15,1266,5340,-4074,-76.29,1621
2021-08-16,5635,8359,-2724,-32.59,1621
2021-08-17,5775,8440,-2665,-31.58,1621
2021-08-18,5775,8450,-2675,-31.66,1621
2021-08-19,5775,8454,-2679,-31.69,1621
2021-08-20,4889,8027,-3138,-39.09,1621
2021-08-21,2344,6137,-3793,-61.81,1621
2021-08-22,1266,5445,-4179,-76.75,1621
2021-08-23,5635,8487,-2852,-33.6,1621
2021-08-24,5775,8591,-2816,-32.78,1621
2021-08-25,5775,8621,-2846,-33.01,1621
2021-08-26,5775,8643,-2868,-33.18,1621
2021-08-27,4889,8232,-3343,-40.61,1621
2021-08-28,2344,6355,-4011,-63.12,1621
2021-08-29,1266,5673,-4407,-77.68,1621
2021-08-30,5635,8723,-3088,-35.4,1621
2021-08-31,5775,8831,-3056,-34.61,1621
2021-09-01,6122,8863,-2741,-30.93,1621
2021-09-02,6122,8884,-2762,-31.09,1621
2021-09-03,5588,8469,-2881,-34.02,1621
2021-09-04,2956,6585,-3629,-55.11,1621
2021-09-05,1546,5896,-4350,-73.78,1621
2021-09-06,6051,8935,-2884,-32.28,1621
2021-09-07,6122,9031,-2909,-32.21,1621
2021-09-08,6122,9050,-2928,-32.35,1621
2021-09-09,6122,9056,-2934,-32.4,1621
2021-09-10,5588,8626,-3038,-35.22,1621
2021-09-11,2956,6728,-3772,-56.06,1621
2021-09-12,1546,6022,-4476,-74.33,1621
2021-09-13,6051,9047,-2996,-33.12,1621
2021-09-14,6122,9129,-3007,-32.94,1621
2021-09-15,6122,9134,-3012,-32.98,1621
2021-09-16,6122,9128,-3006,-32.93,1621
2021-09-17,5588,8688,-3100,-35.68,1621
2021-09-18,2956,6780,-3824,-56.4,1621
2021-09-19,1546,6067,-4521,-74.52,1621
2021-09-20,6051,9085,-3034,-33.4,1621
2021-09-21,6122,9163,-3041,-33.19,1621
2021-09-22,6122,9166,-3044,-33.21,1621
2021-09-23,6122,9159,-3037,-33.16,1621
2021-09-24,5588,8720,-3132,-35.92,1621
2021-09-25,2956,6813,-3857,-56.61,1621
2021-09-26,1546,6104,-4558,-74.67,1621
2021-09-27,6051,9126,-3075,-33.69,1621
2021-09-28,6122,9209,-3087,-33.52,1621
2021-09-29,6122,9217,-3095,-33.58,1621
2021-09-30,6122,9216,-3094,-33.57,1621
2021-10-01,5460,8782,-3322,-37.83,1621
2021-10-02,2755,6881,-4126,-59.96,1621
2021-10-03,1555,6176,-4621,-74.82,1621
2021-10-04,5795,9203,-3408,-37.03,1621
2021-10-05,6064,9289,-3225,-34.72,1621
2021-10-06,6064,9300,-3236,-34.8,1621
2021-10-07,6064,9301,-3237,-34.8,1621
2021-10-08,5460,8867,-3407,-38.42,1621
2021-10-09,2755,6966,-4211,-60.45,1621
2021-10-10,1555,6260,-4705,-75.16,1621
2021-10-11,5795,9284,-3489,-37.58,1621
2021-10-12,6064,9367,-3303,-35.26,1621
2021-10-13,6064,9373,-3309,-35.3,1621
2021-10-14,6064,9369,-3305,-35.28,1621
2021-10-15,5460,8930,-3470,-38.86,1621
2021-10-16,2755,7023,-4268,-60.77,1621
2021-10-17,1555,6311,-4756,-75.36,1621
2021-10-18,5795,9329,-3534,-37.88,1621
2021-10-19,6064,9406,-3342,-35.53,1621
2021-10-20,6064,9408,-3344,-35.54,1621
2021-10-21,6064,9399,-3335,-35.48,1621
2021-10-22,5460,8956,-3496,-39.04,1621
2021-10-23,2755,7046,-4291,-60.9,1621
2021-10-24,1555,6333,-4778,-75.45,1621
2021-10-25,5795,9351,-3556,-38.03,1621
2021-10-26,6064,9428,-3364,-35.68,1621
2021-10-27,6064,9431,-3367,-35.7,1621
2021-10-28,6064,9425,-3361,-35.66,1621
2021-10-29,5460,8986,-3526,-39.24,1621
2021-10-30,2755,7081,-4326,-61.09,1621
2021-10-31,1555,6373,-4818,-75.6,1621
2021-11-01,6188,9397,-3209,-34.15,1621
2021-11-02,6159,9481,-3322,-35.04,1621
2021-11-03,6159,9490,-3331,-35.1,1621
2021-11-04,6159,9491,-3332,-35.11,1621
2021-11-05,5249,9058,-3809,-42.05,1621
2021-11-06,2785,7158,-4373,-61.09,1621
2021-11-07,1506,6455,-4949,-76.67,1621
2021-11-08,6188,9482,-3294,-34.74,1621
2021-11-09,6159,9569,-3410,-35.64,1621
2021-11-10,6159,9580,-3421,-35.71,1621
2021-11-11,6159,9580,-3421,-35.71,1621
2021-11-12,5249,9145,-3896,-42.6,1621
2021-11-13,2785,7242,-4457,-61.54,1621
2021-11-14,1506,6533,-5027,-76.95,1621
2021-11-15,6188,9554,-3366,-35.23,1621
2021-11-16,6159,9633,-3474,-36.06,1621
2021-11-17,6159,9633,-3474,-36.06,1621
2021-11-18,6159,9623,-3464,-36.0,1621
2021-11-19,5249,9175,-3926,-42.79,1621
2021-11-20,2785,7259,-4474,-61.63,1621
2021-11-21,1506,6536,-5030,-76.96,1621
2021-11-22,6188,9543,-3355,-35.16,1621
2021-11-23,6159,9607,-3448,-35.89,1621
2021-11-24,6159,9593,-3434,-35.8,1621
2021-11-25,6159,9568,-3409,-35.63,1621
2021-11-26,5249,9108,-3859,-42.37,1621
2021-11-27,2785,7179,-4394,-61.21,1621
2021-11-28,1506,6445,-4939,-76.63,1621
2021-11-29,6188,9442,-3254,-34.46,1621
2021-11-30,6159,9497,-3338,-35.15,1621
2021-12-01,5304,9477,-4173,-44.03,1621
2021-12-02,5304,9448,-4144,-43.86,1621
2021-12-03,4141,8985,-4844,-53.91,1621
2021-12-04,2902,7056,-4154,-58.87,1621
2021-12-05,1433,6324,-4891,-77.34,1621
2021-12-06,5547,9324,-3777,-40.51,1621
2021-12-07,5304,9385,-4081,-43.48,1621
2021-12-08,5304,9372,-4068,-43.41,1621
2021-12-09,5304,9352,-4048,-43.28,1621
2021-12-10,4141,8899,-4758,-53.47,1621
2021-12-11,2902,6981,-4079,-58.43,1621
2021-12-12,1433,6261,-4828,-77.11,1621
2021-12-13,5547,9274,-3727,-40.19,1621
2021-12-14,5304,9348,-4044,-43.26,1621
2021-12-15,5304,9348,-4044,-43.26,1621
2021-12-16,5304,9340,-4036,-43.21,1621
2021-12-17,4141,8899,-4758,-53.47,1621
2021-12-18,2902,6992,-4090,-58.5,1621
2021-12-19,1433,6282,-4849,-77.19,1621
2021-12-20,5547,9304,-3757,-40.38,1621
2021-12-21,5304,9385,-4081,-43.48,1621
2021-12-22,5304,9391,-4087,-43.52,1621
2021-12-23,5304,9388,-4084,-43.5,1621
2021-12-24,4141,8950,-4809,-53.73,1621
2021-12-25,2902,7045,-4143,-58.81,1621
2021-12-26,1433,6335,-4902,-77.38,1621
2021-12-27,5547,9355,-3808,-40.71,1621
2021-12-28,5304,9434,-4130,-43.78,1621
2021-12-29,5304,9436,-4132,-43.79,1621
2021-12-30,5304,9428,-4124,-43.74,1621
2021-12-31,4141,8985,-4844,-53.91,1621
2022-01-01,4646,7073,-2427,-34.31,1621
2022-01-02,2640,6357,-3717,-58.47,1621
2022-01-03,7616,9371,-1755,-18.73,1621
2022-01-04,7892,9443,-1551,-16.42,1621
2022-01-05,7892,9440,-1548,-16.4,1621
2022-01-06,7892,9427,-1535,-16.28,1621
2022-01-07,7446,8979,-1533,-17.07,1621
2022-01-08,4646,7064,-2418,-34.23,1621
2022-01-09,2640,6346,-3706,-58.4,1621
2022-01-10,7616,9359,-1743,-18.62,1621
2022-01-11,7892,9433,-1541,-16.34,1621
2022-01-12,7892,9431,-1539,-16.32,1621
2022-01-13,7892,9421,-1529,-16.23,1621
2022-01-14,7446,8979,-1533,-17.07,1621
2022-01-15,4646,7071,-2425,-34.3,1621
2022-01-16,2640,6360,-3720,-58.49,1621
2022-01-17,7616,9382,-1766,-18.82,1621
2022-01-18,7892,9465,-1573,-16.62,1621
2022-01-19,7892,9475,-1583,-16.71,1621
2022-01-20,7892,9476,-1584,-16.72,1621
2022-01-21,7446,9045,-1599,-17.68,1621
2022-01-22,4646,7149,-2503,-35.01,1621
2022-01-23,2640,6449,-3809,-59.06,1621
2022-01-24,7616,9483,-1867,-19.69,1621
2022-01-25,7892,9577,-1685,-17.59,1621
2022-01-26,7892,9596,-1704,-17.76,1621
2022-01-27,7892,9607,-1715,-17.85,1621
2022-01-28,7446,9184,-1738,-18.92,1621
2022-01-29,4646,7294,-2648,-36.3,1621
2022-01-30,2640,6600,-3960,-60.0,1621
2020-02-01,92,4,88,2200.0,1184
2020-02-02,33,4,29,725.0,1184
2020-02-03,490,485,5,1.03,1184
2020-02-04,483,499,-16,-3.21,1184
2020-02-05,483,500,-17,-3.4,1184
2020-02-06,483,501,-18,-3.59,1184
2020-02-07,436,417,19,4.56,1184
2020-02-08,92,9,83,922.22,1184
2020-02-09,33,9,24,266.67,1184
2020-02-10,490,489,1,0.2,1184
2020-02-11,483,503,-20,-3.98,1184
2020-02-12,483,504,-21,-4.17,1184
2020-02-13,483,504,-21,-4.17,1184
2020-02-14,436,420,16,3.81,1184
2020-02-15,92,13,79,607.69,1184
2020-02-16,33,13,20,153.85,1184
2020-02-17,490,494,-4,-0.81,1184
2020-02-18,483,509,-26,-5.11,1184
2020-02-19,483,511,-28,-5.48,1184
2020-02-20,483,512,-29,-5.66,1184
2020-02-21,436,429,7,1.63,1184
2020-02-22,92,23,69,300.0,1184
2020-02-23,33,23,10,43.48,1184
2020-02-24,490,506,-16,-3.16,1184
2020-02-25,483,521,-38,-7.29,1184
2020-02-26,483,524,-41,-7.82,1184
2020-02-27,483,526,-43,-8.17,1184
2020-02-28,436,443,-7,-1.58,1184
2020-02-29,92,38,54,142.11,1184
2020-03-01,29,38,-9,-23.68,1184
2020-03-02,449,521,-72,-13.82,1184
2020-03-03,454,536,-82,-15.3,1184
2020-03-04,454,538,-84,-15.61,1184
2020-03-05,454,540,-86,-15.93,1184
2020-03-06,414,457,-43,-9.41,1184
2020-03-07,85,51,34,66.67,1184
2020-03-08,29,51,-22,-43.14,1184
2020-03-09,449,532,-83,-15.6,1184
2020-03-10,454,546,-92,-16.85,1184
2020-03-11,454,548,-94,-17.15,1184
2020-03-12,454,548,-94,-17.15,1184
2020-03-13,414,464,-50,-10.78,1184
2020-03-14,85,57,28,49.12,1184
2020-03-15,29,4,25,625.0,1184
2020-03-16,449,538,-89,-16.54,1184
2020-03-17,454,551,-97,-17.6,1184
2020-03-18,454,552,-98,-17.75,1184
2020-03-19,454,553,-99,-17.9,1184
2020-03-20,414,469,-55,-11.73,1184
2020-03-21,85,62,23,37.1,1184
2020-03-22,29,5,24,480.0,1184
2020-03-23,449,543,-94,-17.31,1184
2020-03-24,454,557,-103,-18.49,1184
2020-03-25,454,559,-105,-18.78,1184
2020-03-26,454,560,-106,-18.93,1184
2020-03-27,414,477,-63,-13.21,1184
2020-03-28,85,71,14,19.72,1184
2020-03-29,29,9,20,222.22,1184
2020-03-30,449,553,-104,-18.81,1184
2020-03-31,454,568,-114,-20.07,1184
2020-04-01,454,571,-117,-20.49,1184
2020-04-02,454,573,-119,-20.77,1184
2020-04-03,379,490,-111,-22.65,1184
2020-04-04,80,84,-4,-4.76,1184
2020-04-05,18,14,4,28.57,1184
2020-04-06,435,567,-132,-23.28,1184
2020-04-07,454,583,-129,-22.13,1184
2020-04-08,454,585,-131,-22.39,1184
2020-04-09,454,586,-132,-22.53,1184
2020-04-10,379,503,-124,-24.65,1184
2020-04-11,80,97,-17,-17.53,1184
2020-04-12,18,22,-4,-18.18,1184
2020-04-13,435,579,-144,-24.87,1184
2020-04-14,454,593,-139,-23.44,1184
2020-04-15,454,595,-141,-23.7,1184
2020-04-16,454,595,-141,-23.7,1184
2020-04-17,379,512,-133,-25.98,1184
2020-04-18,80,105,-25,-23.81,1184
2020-04-19,18,1,17,1700.0,1184
2020-04-20,435,585,-150,-25.64,1184
2020-04-21,454,599,-145,-24.21,1184
2020-04-22,454,600,-146,-24.33,1184
2020-04-23,454,600,-146,-24.33,1184
2020-04-24,379,517,-138,-26.69,1184
2020-04-25,80,110,-30,-27.27,1184
2020-04-26,18,6,12,200.0,1184
2020-04-27,435,590,-155,-26.27,1184
2020-04-28,454,605,-151,-24.96,1184
2020-04-29,454,606,-152,-25.08,1184
2020-04-30,454,607,-153,-25.21,1184
2020-05-01,508,524,-16,-3.05,1184
2020-05-02,116,117,-1,-0.85,1184
2020-05-03,38,14,24,171.43,1184
2020-05-04,529,599,-70,-11.69,1184
2020-05-05,572,613,-41,-6.69,1184
2020-05-06,572,615,-43,-6.99,1184
2020-05-07,572,616,-44,-7.14,1184
2020-05-08,508,533,-25,-4.69,1184
2020-05-09,116,126,-10,-7.94,1184
2020-05-10,38,23,15,65.22,1184
2020-05-11,529,607,-78,-12.85,1184
2020-05-12,572,622,-50,-8.04,1184
2020-05-13,572,623,-51,-8.19,1184
2020-05-14,572,623,-51,-8.19,1184
2020-05-15,508,539,-31,-5.75,1184
2020-05-16,116,131,-15,-11.45,1184
2020-05-17,38,27,11,40.74,1184
2020-05-18,529,611,-82,-13.42,1184
2020-05-19,572,624,-52,-8.33,1184
2020-05-20,572,624,-52,-8.33,1184
2020-05-21,572,623,-51,-8.19,1184
2020-05-22,508,538,-30,-5.58,1184
2020-05-23,116,129,-13,-10.08,1184
2020-05-24,38,24,14,58.33,1184
2020-05-25,529,607,-78,-12.85,1184
2020-05-26,572,620,-48,-7.74,1184
2020-05-27,572,619,-47,-7.59,1184
2020-05-28,572,618,-46,-7.44,1184
2020-05-29,508,533,-25,-4.69,1184
2020-05-30,116,124,-8,-6.45,1184
2020-05-31,38,19,19,100.0,1184
2020-06-01,578,603,-25,-4.15,1184
2020-06-02,599,616,-17,-2.76,1184
2020-06-03,599,616,-17,-2.76,1184
2020-06-04,599,615,-16,-2.6,1184
2020-06-05,498,531,-33,-6.21,1184
2020-06-06,124,123,1,0.81,1184
2020-06-07,43,19,24,126.32,1184
2020-06-08,578,603,-25,-4.15,1184
2020-06-09,599,616,-17,-2.76,1184
2020-06-10,599,617,-18,-2.92,1184
2020-06-11,599,617,-18,-2.92,1184
2020-06-12,498,533,-35,-6.57,1184
2020-06-13,124,125,-1,-0.8,1184
2020-06-14,43,21,22,104.76,1184
2020-06-15,578,604,-26,-4.3,1184
2020-06-16,599,618,-19,-3.07,1184
2020-06-17,599,618,-19,-3.07,1184
2020-06-18,599,617,-18,-2.92,1184
2020-06-19,498,532,-34,-6.39,1184
2020-06-20,124,123,1,0.81,1184
2020-06-21,43,17,26,152.94,1184
2020-06-22,578,600,-22,-3.67,1184
2020-06-23,599,611,-12,-1.96,1184
2020-06-24,599,610,-11,-1.8,1184
2020-06-25,599,608,-9,-1.48,1184
2020-06-26,498,521,-23,-4.41,1184
2020-06-27,124,111,13,11.71,1184
2020-06-28,43,5,38,760.0,1184
2020-06-29,578,586,-8,-1.37,1184
2020-06-30,599,597,2,0.34,1184
2020-07-01,604,595,9,1.51,1184
2020-07-02,604,592,12,2.03,1184
2020-07-03,548,505,43,8.51,1184
2020-07-04,138,95,43,45.26,1184
2020-07-05,40,20,20,100.0,1184
2020-07-06,578,571,7,1.23,1184
2020-07-07,604,582,22,3.78,1184
2020-07-08,604,581,23,3.96,1184
2020-07-09,604,579,25,4.32,1184
2020-07-10,548,494,54,10.93,1184
2020-07-11,138,85,53,62.35,1184
2020-07-12,40,17,23,135.29,1184
2020-07-13,578,563,15,2.66,1184
2020-07-14,604,575,29,5.04,1184
2020-07-15,604,575,29,5.04,1184
2020-07-16,604,575,29,5.04,1184
2020-07-17,548,490,58,11.84,1184
2020-07-18,138,82,56,68.29,1184
2020-07-19,40,14,26,185.71,1184
2020-07-20,578,560,18,3.21,1184
2020-07-21,604,573,31,5.41,1184
2020-07-22,604,572,32,5.59,1184
2020-07-23,604,571,33,5.78,1184
2020-07-24,548,486,62,12.76,1184
2020-07-25,138,77,61,79.22,1184
2020-07-26,40,12,28,233.33,1184
2020-07-27,578,552,26,4.71,1184
2020-07-28,604,563,41,7.28,1184
2020-07-29,604,561,43,7.66,1184
2020-07-30,604,559,45,8.05,1184
2020-07-31,548,471,77,16.35,1184
2020-08-01,137,61,76,124.59,1184
2020-08-02,44,2,42,2100.0,1184
2020-08-03,534,533,1,0.19,1184
2020-08-04,532,543,-11,-2.03,1184
2020-08-05,532,540,-8,-1.48,1184
2020-08-06,532,536,-4,-0.75,1184
2020-08-07,492,449,43,9.58,1184
2020-08-08,137,38,99,260.53,1184
2020-08-09,44,38,6,15.79,1184
2020-08-10,534,511,23,4.5,1184
2020-08-11,532,521,11,2.11,1184
2020-08-12,532,520,12,2.31,1184
2020-08-13,532,517,15,2.9,1184
2020-08-14,492,431,61,14.15,1184
2020-08-15,137,22,115,522.73,1184
2020-08-16,44,22,22,100.0,1184
2020-08-17,534,500,34,6.8,1184
2020-08-18,532,513,19,3.7,1184
2020-08-19,532,513,19,3.7,1184
2020-08-20,532,514,18,3.5,1184
2020-08-21,492,430,62,14.42,1184
2020-08-22,137,23,114,495.65,1184
2020-08-23,44,23,21,91.3,1184
2020-08-24,534,505,29,5.74,1184
2020-08-25,532,520,12,2.31,1184
2020-08-26,532,522,10,1.92,1184
2020-08-27,532,524,8,1.53,1184
2020-08-28,492,441,51,11.56,1184
2020-08-29,137,35,102,291.43,1184
2020-08-30,44,35,9,25.71,1184
2020-08-31,534,517,17,3.29,1184
2020-09-01,563,531,32,6.03,1184
2020-09-02,563,533,30,5.63,1184
2020-09-03,563,533,30,5.63,1184
2020-09-04,504,449,55,12.25,1184
2020-09-05,109,42,67,159.52,1184
2020-09-06,36,42,-6,-14.29,1184
2020-09-07,526,521,5,0.96,1184
2020-09-08,563,534,29,5.43,1184
2020-09-09,563,533,30,5.63,1184
2020-09-10,563,532,31,5.83,1184
2020-09-11,504,447,57,12.75,1184
2020-09-12,109,38,71,186.84,1184
2020-09-13,36,38,-2,-5.26,1184
2020-09-14,526,515,11,2.14,1184
2020-09-15,563,527,36,6.83,1184
2020-09-16,563,527,36,6.83,1184
2020-09-17,563,526,37,7.03,1184
2020-09-18,504,440,64,14.55,1184
2020-09-19,109,32,77,240.62,1184
2020-09-20,36,32,4,12.5,1184
2020-09-21,526,511,15,2.94,1184
2020-09-22,563,524,39,7.44,1184
2020-09-23,563,525,38,7.24,1184
2020-09-24,563,525,38,7.24,1184
2020-09-25,504,441,63,14.29,1184
2020-09-26,109,34,75,220.59,1184
2020-09-27,36,34,2,5.88,1184
2020-09-28,526,515,11,2.14,1184
2020-09-29,563,530,33,6.23,1184
2020-09-30,563,531,32,6.03,1184
2020-10-01,587,533,54,10.13,1184
2020-10-02,525,449,76,16.93,1184
2020-10-03,137,43,94,218.6,1184
2020-10-04,36,1,35,3500.0,1184
2020-10-05,563,524,39,7.44,1184
2020-10-06,587,538,49,9.11,1184
2020-10-07,587,539,48,8.91,1184
2020-10-08,587,540,47,8.7,1184
2020-10-09,525,456,69,15.13,1184
2020-10-10,137,48,89,185.42,1184
2020-10-11,36,0,36,inf,1184
2020-10-12,563,526,37,7.03,1184
2020-10-13,587,539,48,8.91,1184
2020-10-14,587,538,49,9.11,1184
2020-10-15,587,537,50,9.31,1184
2020-10-16,525,451,74,16.41,1184
2020-10-17,137,42,95,226.19,1184
2020-10-18,36,42,-6,-14.29,1184
2020-10-19,563,518,45,8.69,1184
2020-10-20,587,530,57,10.75,1184
2020-10-21,587,529,58,10.96,1184
2020-10-22,587,527,60,11.39,1184
2020-10-23,525,441,84,19.05,1184
2020-10-24,137,33,104,315.15,1184
2020-10-25,36,33,3,9.09,1184
2020-10-26,563,510,53,10.39,1184
2020-10-27,587,523,64,12.24,1184
2020-10-28,587,523,64,12.24,1184
2020-10-29,587,523,64,12.24,1184
2020-10-30,525,438,87,19.86,1184
2020-10-31,137,31,106,341.94,1184
2020-11-01,37,31,6,19.35,1184
2020-11-02,540,511,29,5.68,1184
2020-11-03,553,526,27,5.13,1184
2020-11-04,553,527,26,4.93,1184
2020-11-05,553,528,25,4.73,1184
2020-11-06,537,445,92,20.67,1184
2020-11-07,116,38,78,205.26,1184
2020-11-08,37,38,-1,-2.63,1184
2020-11-09,540,519,21,4.05,1184
2020-11-10,553,533,20,3.75,1184
2020-11-11,553,533,20,3.75,1184
2020-11-12,553,533,20,3.75,1184
2020-11-13,537,448,89,19.87,1184
2020-11-14,116,40,76,190.0,1184
2020-11-15,37,2,35,1750.0,1184
2020-11-16,540,517,23,4.45,1184
2020-11-17,553,529,24,4.54,1184
2020-11-18,553,527,26,4.93,1184
2020-11-19,553,524,29,5.53,1184
2020-11-20,537,437,100,22.88,1184
2020-11-21,116,26,90,346.15,1184
2020-11-22,37,26,11,42.31,1184
2020-11-23,540,498,42,8.43,1184
2020-11-24,553,507,46,9.07,1184
2020-11-25,553,503,50,9.94,1184
2020-11-26,553,499,54,10.82,1184
2020-11-27,537,410,127,30.98,1184
2020-11-28,116,31,85,274.19,1184
2020-11-29,37,31,6,19.35,1184
2020-11-30,540,469,71,15.14,1184
2020-12-01,401,478,-77,-16.11,1184
2020-12-02,401,475,-74,-15.58,1184
2020-12-03,401,471,-70,-14.86,1184
2020-12-04,484,383,101,26.37,1184
2020-12-05,125,19,106,557.89,1184
2020-12-06,37,19,18,94.74,1184
2020-12-07,422,446,-24,-5.38,1184
2020-12-08,401,457,-56,-12.25,1184
2020-12-09,401,455,-54,-11.87,1184
2020-12-10,401,454,-53,-11.67,1184
2020-12-11,484,367,117,31.88,1184
2020-12-12,125,14,111,792.86,1184
2020-12-13,37,14,23,164.29,1184
2020-12-14,422,435,-13,-2.99,1184
2020-12-15,401,448,-47,-10.49,1184
2020-12-16,401,447,-46,-10.29,1184
2020-12-17,401,446,-45,-10.09,1184
2020-12-18,484,360,124,34.44,1184
2020-12-19,125,13,112,861.54,1184
2020-12-20,37,13,24,184.62,1184
2020-12-21,422,427,-5,-1.17,1184
2020-12-22,401,439,-38,-8.66,1184
2020-12-23,401,437,-36,-8.24,1184
2020-12-24,401,435,-34,-7.82,1184
2020-12-25,484,348,136,39.08,1184
2020-12-26,125,3,122,4066.67,1184
2020-12-27,37,3,34,1133.33,1184
2020-12-28,422,411,11,2.68,1184
2020-12-29,401,421,-20,-4.75,1184
2020-12-30,401,418,-17,-4.07,1184
2020-12-31,401,414,-13,-3.14,1184
2021-01-01,352,326,26,7.98,1184
2021-01-02,77,326,-249,-76.38,1184
2021-01-03,27,326,-299,-91.72,1184
2021-01-04,358,387,-29,-7.49,1184
2021-01-05,393,397,-4,-1.01,1184
2021-01-06,393,394,-1,-0.25,1184
2021-01-07,393,391,2,0.51,1184
2021-01-08,352,304,48,15.79,1184
2021-01-09,77,304,-227,-74.67,1184
2021-01-10,27,304,-277,-91.12,1184
2021-01-11,358,369,-11,-2.98,1184
2021-01-12,393,381,12,3.15,1184
2021-01-13,393,380,13,3.42,1184
2021-01-14,393,380,13,3.42,1184
2021-01-15,352,295,57,19.32,1184
2021-01-16,77,295,-218,-73.9,1184
2021-01-17,27,295,-268,-90.85,1184
2021-01-18,358,367,-9,-2.45,1184
2021-01-19,393,381,12,3.15,1184
2021-01-20,393,383,10,2.61,1184
2021-01-21,393,384,9,2.34,1184
2021-01-22,352,301,51,16.94,1184
2021-01-23,77,301,-224,-74.42,1184
2021-01-24,27,301,-274,-91.03,1184
2021-01-25,358,377,-19,-5.04,1184
2021-01-26,393,392,1,0.26,1184
2021-01-27,393,394,-1,-0.25,1184
2021-01-28,393,395,-2,-0.51,1184
2021-01-29,352,312,40,12.82,1184
2021-01-30,77,312,-235,-75.32,1184
2021-01-31,27,312,-285,-91.35,1184
2021-02-01,460,387,73,18.86,1184
2021-02-02,460,401,59,14.71,1184
2021-02-03,460,403,57,14.14,1184
2021-02-04,460,403,57,14.14,1184
2021-02-05,430,319,111,34.8,1184
2021-02-06,100,319,-219,-68.65,1184
2021-02-07,24,319,-295,-92.48,1184
2021-02-08,460,392,68,17.35,1184
2021-02-09,460,406,54,13.3,1184
2021-02-10,460,407,53,13.02,1184
2021-02-11,460,407,53,13.02,1184
2021-02-12,430,323,107,33.13,1184
2021-02-13,100,323,-223,-69.04,1184
2021-02-14,24,323,-299,-92.57,1184
2021-02-15,460,397,63,15.87,1184
2021-02-16,460,411,49,11.92,1184
2021-02-17,460,412,48,11.65,1184
2021-02-18,460,414,46,11.11,1184
2021-02-19,430,330,100,30.3,1184
2021-02-20,100,330,-230,-69.7,1184
2021-02-21,24,330,-306,-92.73,1184
2021-02-22,460,407,53,13.02,1184
2021-02-23,460,422,38,9.0,1184
2021-02-24,460,425,35,8.24,1184
2021-02-25,460,426,34,7.98,1184
2021-02-26,430,344,86,25.0,1184
2021-02-27,100,9,91,1011.11,1184
2021-02-28,24,9,15,166.67,1184
2021-03-01,520,422,98,23.22,1184
2021-03-02,506,437,69,15.79,1184
2021-03-03,506,439,67,15.26,1184
2021-03-04,506,441,65,14.74,1184
2021-03-05,476,358,118,32.96,1184
2021-03-06,131,17,114,670.59,1184
2021-03-07,32,17,15,88.24,1184
2021-03-08,520,434,86,19.82,1184
2021-03-09,506,449,57,12.69,1184
2021-03-10,506,450,56,12.44,1184
2021-03-11,506,451,55,12.2,1184
2021-03-12,476,367,109,29.7,1184
2021-03-13,131,18,113,627.78,1184
2021-03-14,32,18,14,77.78,1184
2021-03-15,520,440,80,18.18,1184
2021-03-16,506,454,52,11.45,1184
2021-03-17,506,455,51,11.21,1184
2021-03-18,506,455,51,11.21,1184
2021-03-19,476,371,105,28.3,1184
2021-03-20,131,23,108,469.57,1184
2021-03-21,32,23,9,39.13,1184
2021-03-22,520,445,75,16.85,1184
2021-03-23,506,459,47,10.24,1184
2021-03-24,506,461,45,9.76,1184
2021-03-25,506,462,44,9.52,1184
2021-03-26,476,378,98,25.93,1184
2021-03-27,131,28,103,367.86,1184
2021-03-28,32,28,4,14.29,1184
2021-03-29,520,454,66,14.54,1184
2021-03-30,506,469,37,7.89,1184
2021-03-31,506,472,34,7.2,1184
2021-04-01,533,473,60,12.68,1184
2021-04-02,496,391,105,26.85,1184
2021-04-03,125,34,91,267.65,1184
2021-04-04,33,34,-1,-2.94,1184
2021-04-05,528,468,60,12.82,1184
2021-04-06,533,484,49,10.12,1184
2021-04-07,533,486,47,9.67,1184
2021-04-08,533,488,45,9.22,1184
2021-04-09,496,405,91,22.47,1184
2021-04-10,125,45,80,177.78,1184
2021-04-11,33,45,-12,-26.67,1184
2021-04-12,528,481,47,9.77,1184
2021-04-13,533,495,38,7.68,1184
2021-04-14,533,497,36,7.24,1184
2021-04-15,533,498,35,7.03,1184
2021-04-16,496,414,82,19.81,1184
2021-04-17,125,7,118,1685.71,1184
2021-04-18,33,7,26,371.43,1184
2021-04-19,528,488,40,8.2,1184
2021-04-20,533,502,31,6.18,1184
2021-04-21,533,503,30,5.96,1184
2021-04-22,533,503,30,5.96,1184
2021-04-23,496,419,77,18.38,1184
2021-04-24,125,12,113,941.67,1184
2021-04-25,33,12,21,175.0,1184
2021-04-26,528,493,35,7.1,1184
2021-04-27,533,507,26,5.13,1184
2021-04-28,533,508,25,4.92,1184
2021-04-29,533,509,24,4.72,1184
2021-04-30,496,426,70,16.43,1184
2021-05-01,120,19,101,531.58,1184
2021-05-02,40,4,36,900.0,1184
2021-05-03,578,500,78,15.6,1184
2021-05-04,581,515,66,12.82,1184
2021-05-05,581,517,64,12.38,1184
2021-05-06,581,518,63,12.16,1184
2021-05-07,494,435,59,13.56,1184
2021-05-08,120,28,92,328.57,1184
2021-05-09,40,7,33,471.43,1184
2021-05-10,578,510,68,13.33,1184
2021-05-11,581,524,57,10.88,1184
2021-05-12,581,525,56,10.67,1184
2021-05-13,581,526,55,10.46,1184
2021-05-14,494,442,52,11.76,1184
2021-05-15,120,35,85,242.86,1184
2021-05-16,40,14,26,185.71,1184
2021-05-17,578,514,64,12.45,1184
2021-05-18,581,527,54,10.25,1184
2021-05-19,581,528,53,10.04,1184
2021-05-20,581,527,54,10.25,1184
2021-05-21,494,442,52,11.76,1184
2021-05-22,120,34,86,252.94,1184
2021-05-23,40,13,27,207.69,1184
2021-05-24,578,511,67,13.11,1184
2021-05-25,581,524,57,10.88,1184
2021-05-26,581,524,57,10.88,1184
2021-05-27,581,523,58,11.09,1184
2021-05-28,494,437,57,13.04,1184
2021-05-29,120,29,91,313.79,1184
2021-05-30,40,11,29,263.64,1184
2021-05-31,578,507,71,14.0,1184
2021-06-01,571,519,52,10.02,1184
2021-06-02,571,519,52,10.02,1184
2021-06-03,571,519,52,10.02,1184
2021-06-04,519,434,85,19.59,1184
2021-06-05,142,27,115,425.93,1184
2021-06-06,46,8,38,475.0,1184
2021-06-07,566,506,60,11.86,1184
2021-06-08,571,519,52,10.02,1184
2021-06-09,571,520,51,9.81,1184
2021-06-10,571,520,51,9.81,1184
2021-06-11,519,436,83,19.04,1184
2021-06-12,142,28,114,407.14,1184
2021-06-13,46,10,36,360.0,1184
2021-06-14,566,508,58,11.42,1184
2021-06-15,571,521,50,9.6,1184
2021-06-16,571,521,50,9.6,1184
2021-06-17,571,521,50,9.6,1184
2021-06-18,519,436,83,19.04,1184
2021-06-19,142,27,115,425.93,1184
2021-06-20,46,13,33,253.85,1184
2021-06-21,566,505,61,12.08,1184
2021-06-22,571,517,54,10.44,1184
2021-06-23,571,516,55,10.66,1184
2021-06-24,571,514,57,11.09,1184
2021-06-25,519,427,92,21.55,1184
2021-06-26,142,17,125,735.29,1184
2021-06-27,46,5,41,820.0,1184
2021-06-28,566,492,74,15.04,1184
2021-06-29,571,503,68,13.52,1184
2021-06-30,571,501,70,13.97,1184
2021-07-01,524,499,25,5.01,1184
2021-07-02,507,412,95,23.06,1184
2021-07-03,121,2,119,5950.0,1184
2021-07-04,46,2,44,2200.0,1184
2021-07-05,506,476,30,6.3,1184
2021-07-06,524,488,36,7.38,1184
2021-07-07,524,486,38,7.82,1184
2021-07-08,524,485,39,8.04,1184
2021-07-09,507,399,108,27.07,1184
2021-07-10,121,46,75,163.04,1184
2021-07-11,46,46,0,0.0,1184
2021-07-12,506,467,39,8.35,1184
2021-07-13,524,480,44,9.17,1184
2021-07-14,524,479,45,9.39,1184
2021-07-15,524,479,45,9.39,1184
2021-07-16,507,394,113,28.68,1184
2021-07-17,121,46,75,163.04,1184
2021-07-18,46,46,0,0.0,1184
2021-07-19,506,464,42,9.05,1184
2021-07-20,524,477,47,9.85,1184
2021-07-21,524,477,47,9.85,1184
2021-07-22,524,476,48,10.08,1184
2021-07-23,507,390,117,30.0,1184
2021-07-24,121,45,76,168.89,1184
2021-07-25,46,45,1,2.22,1184
2021-07-26,506,458,48,10.48,1184
2021-07-27,524,469,55,11.73,1184
2021-07-28,524,468,56,11.97,1184
2021-07-29,524,465,59,12.69,1184
2021-07-30,507,378,129,34.13,1184
2021-07-31,121,38,83,218.42,1184
2021-08-01,47,38,9,23.68,1184
2021-08-02,487,441,46,10.43,1184
2021-08-03,500,451,49,10.86,1184
2021-08-04,500,448,52,11.61,1184
2021-08-05,500,444,56,12.61,1184
2021-08-06,444,356,88,24.72,1184
2021-08-07,112,28,84,300.0,1184
2021-08-08,47,28,19,67.86,1184
2021-08-09,487,418,69,16.51,1184
2021-08-10,500,428,72,16.82,1184
2021-08-11,500,426,74,17.37,1184
2021-08-12,500,423,77,18.2,1184
2021-08-13,444,337,107,31.75,1184
2021-08-14,112,17,95,558.82,1184
2021-08-15,47,17,30,176.47,1184
2021-08-16,487,404,83,20.54,1184
2021-08-17,500,417,83,19.9,1184
2021-08-18,500,417,83,19.9,1184
2021-08-19,500,417,83,19.9,1184
2021-08-20,444,332,112,33.73,1184
2021-08-21,112,21,91,433.33,1184
2021-08-22,47,21,26,123.81,1184
2021-08-23,487,407,80,19.66,1184
2021-08-24,500,422,78,18.48,1184
2021-08-25,500,423,77,18.2,1184
2021-08-26,500,425,75,17.65,1184
2021-08-27,444,342,102,29.82,1184
2021-08-28,112,30,82,273.33,1184
2021-08-29,47,30,17,56.67,1184
2021-08-30,487,418,69,16.51,1184
2021-08-31,500,433,67,15.47,1184
2021-09-01,586,435,151,34.71,1184
2021-09-02,586,436,150,34.4,1184
2021-09-03,537,352,185,52.56,1184
2021-09-04,142,31,111,358.06,1184
2021-09-05,52,31,21,67.74,1184
2021-09-06,562,424,138,32.55,1184
2021-09-07,586,437,149,34.1,1184
2021-09-08,586,437,149,34.1,1184
2021-09-09,586,437,149,34.1,1184
2021-09-10,537,351,186,52.99,1184
2021-09-11,142,34,108,317.65,1184
2021-09-12,52,34,18,52.94,1184
2021-09-13,562,420,142,33.81,1184
2021-09-14,586,432,154,35.65,1184
2021-09-15,586,431,155,35.96,1184
2021-09-16,586,430,156,36.28,1184
2021-09-17,537,345,192,55.65,1184
2021-09-18,142,29,113,389.66,1184
2021-09-19,52,29,23,79.31,1184
2021-09-20,562,414,148,35.75,1184
2021-09-21,586,427,159,37.24,1184
2021-09-22,586,428,158,36.92,1184
2021-09-23,586,428,158,36.92,1184
2021-09-24,537,344,193,56.1,1184
2021-09-25,142,33,109,330.3,1184
2021-09-26,52,33,19,57.58,1184
2021-09-27,562,417,145,34.77,1184
2021-09-28,586,432,154,35.65,1184
2021-09-29,586,433,153,35.33,1184
2021-09-30,586,434,152,35.02,1184
2021-10-01,517,351,166,47.29,1184
2021-10-02,147,34,113,332.35,1184
2021-10-03,43,34,9,26.47,1184
2021-10-04,556,426,130,30.52,1184
2021-10-05,595,441,154,34.92,1184
2021-10-06,595,442,153,34.62,1184
2021-10-07,595,443,152,34.31,1184
2021-10-08,517,359,158,44.01,1184
2021-10-09,147,39,108,276.92,1184
2021-10-10,43,39,4,10.26,1184
2021-10-11,556,430,126,29.3,1184
2021-10-12,595,443,152,34.31,1184
2021-10-13,595,443,152,34.31,1184
2021-10-14,595,442,153,34.62,1184
2021-10-15,517,356,161,45.22,1184
2021-10-16,147,39,108,276.92,1184
2021-10-17,43,39,4,10.26,1184
2021-10-18,556,423,133,31.44,1184
2021-10-19,595,435,160,36.78,1184
2021-10-20,595,434,161,37.1,1184
2021-10-21,595,432,163,37.73,1184
2021-10-22,517,347,170,48.99,1184
2021-10-23,147,34,113,332.35,1184
2021-10-24,43,34,9,26.47,1184
2021-10-25,556,414,142,34.3,1184
2021-10-26,595,427,168,39.34,1184
2021-10-27,595,427,168,39.34,1184
2021-10-28,595,426,169,39.67,1184
2021-10-29,517,342,175,51.17,1184
2021-10-30,147,35,112,320.0,1184
2021-10-31,43,35,8,22.86,1184
2021-11-01,516,414,102,24.64,1184
2021-11-02,573,428,145,33.88,1184
2021-11-03,573,429,144,33.57,1184
2021-11-04,573,430,143,33.26,1184
2021-11-05,530,347,183,52.74,1184
2021-11-06,119,37,82,221.62,1184
2021-11-07,35,37,-2,-5.41,1184
2021-11-08,516,421,95,22.57,1184
2021-11-09,573,435,138,31.72,1184
2021-11-10,573,436,137,31.42,1184
2021-11-11,573,437,136,31.12,1184
2021-11-12,530,352,178,50.57,1184
2021-11-13,119,41,78,190.24,1184
2021-11-14,35,41,-6,-14.63,1184
2021-11-15,516,422,94,22.27,1184
2021-11-16,573,434,139,32.03,1184
2021-11-17,573,433,140,32.33,1184
2021-11-18,573,431,142,32.95,1184
2021-11-19,530,344,186,54.07,1184
2021-11-20,119,35,84,240.0,1184
2021-11-21,35,35,0,0.0,1184
2021-11-22,516,406,110,27.09,1184
2021-11-23,573,415,158,38.07,1184
2021-11-24,573,412,161,39.08,1184
2021-11-25,573,408,165,40.44,1184
2021-11-26,530,319,211,66.14,1184
2021-11-27,119,25,94,376.0,1184
2021-11-28,35,25,10,40.0,1184
2021-11-29,516,377,139,36.87,1184
2021-11-30,573,387,186,48.06,1184
2021-12-01,413,383,30,7.83,1184
2021-12-02,413,379,34,8.97,1184
2021-12-03,312,291,21,7.22,1184
2021-12-04,129,10,119,1190.0,1184
2021-12-05,22,10,12,120.0,1184
2021-12-06,435,353,82,23.23,1184
2021-12-07,413,363,50,13.77,1184
2021-12-08,413,361,52,14.4,1184
2021-12-09,413,359,54,15.04,1184
2021-12-10,312,273,39,14.29,1184
2021-12-11,129,5,124,2480.0,1184
2021-12-12,22,5,17,340.0,1184
2021-12-13,435,340,95,27.94,1184
2021-12-14,413,352,61,17.33,1184
2021-12-15,413,352,61,17.33,1184
2021-12-16,413,350,63,18.0,1184
2021-12-17,312,265,47,17.74,1184
2021-12-18,129,265,-136,-51.32,1184
2021-12-19,22,265,-243,-91.7,1184
2021-12-20,435,333,102,30.63,1184
2021-12-21,413,344,69,20.06,1184
2021-12-22,413,343,70,20.41,1184
2021-12-23,413,341,72,21.11,1184
2021-12-24,312,254,58,22.83,1184
2021-12-25,129,254,-125,-49.21,1184
2021-12-26,22,254,-232,-91.34,1184
2021-12-27,435,318,117,36.79,1184
2021-12-28,413,328,85,25.91,1184
2021-12-29,413,326,87,26.69,1184
2021-12-30,413,322,91,28.26,1184
2021-12-31,312,234,78,33.33,1184
2022-01-01,96,234,-138,-58.97,1184
2022-01-02,23,234,-211,-90.17,1184
2022-01-03,387,295,92,31.19,1184
2022-01-04,419,305,114,37.38,1184
2022-01-05,419,302,117,38.74,1184
2022-01-06,419,298,121,40.6,1184
2022-01-07,384,211,173,81.99,1184
2022-01-08,96,211,-115,-54.5,1184
2022-01-09,23,211,-188,-89.1,1184
2022-01-10,387,275,112,40.73,1184
2022-01-11,419,286,133,46.5,1184
2022-01-12,419,285,134,47.02,1184
2022-01-13,419,284,135,47.54,1184
2022-01-14,384,199,185,92.96,1184
2022-01-15,96,199,-103,-51.76,1184
2022-01-16,23,199,-176,-88.44,1184
2022-01-17,387,270,117,43.33,1184
2022-01-18,419,284,135,47.54,1184
2022-01-19,419,285,134,47.02,1184
2022-01-20,419,286,133,46.5,1184
2022-01-21,384,202,182,90.1,1184
2022-01-22,96,202,-106,-52.48,1184
2022-01-23,23,202,-179,-88.61,1184
2022-01-24,387,278,109,39.21,1184
2022-01-25,419,293,126,43.0,1184
2022-01-26,419,295,124,42.03,1184
2022-01-27,419,297,122,41.08,1184
2022-01-28,384,214,170,79.44,1184
2022-01-29,96,214,-118,-55.14,1184
2022-01-30,23,214,-191,-89.25,1184
2020-02-01,66,52,14,26.92,1218
2020-02-02,46,22,24,109.09,1218
2020-02-03,355,386,-31,-8.03,1218
2020-02-04,359,400,-41,-10.25,1218
2020-02-05,359,404,-45,-11.14,1218
2020-02-06,359,406,-47,-11.58,1218
2020-02-07,345,350,-5,-1.43,1218
2020-02-08,66,55,11,20.0,1218
2020-02-09,46,33,13,39.39,1218
2020-02-10,355,396,-41,-10.35,1218
2020-02-11,359,409,-50,-12.22,1218
2020-02-12,359,412,-53,-12.86,1218
2020-02-13,359,414,-55,-13.29,1218
2020-02-14,345,358,-13,-3.63,1218
2020-02-15,66,3,63,2100.0,1218
2020-02-16,46,30,16,53.33,1218
2020-02-17,355,406,-51,-12.56,1218
2020-02-18,359,420,-61,-14.52,1218
2020-02-19,359,425,-66,-15.53,1218
2020-02-20,359,429,-70,-16.32,1218
2020-02-21,345,375,-30,-8.0,1218
2020-02-22,66,23,43,186.96,1218
2020-02-23,46,44,2,4.55,1218
2020-02-24,355,430,-75,-17.44,1218
2020-02-25,359,446,-87,-19.51,1218
2020-02-26,359,453,-94,-20.75,1218
2020-02-27,359,459,-100,-21.79,1218
2020-02-28,345,406,-61,-15.02,1218
2020-02-29,66,55,11,20.0,1218
2020-03-01,39,5,34,680.0,1218
2020-03-02,320,463,-143,-30.89,1218
2020-03-03,327,479,-152,-31.73,1218
2020-03-04,327,484,-157,-32.44,1218
2020-03-05,327,489,-162,-33.13,1218
2020-03-06,294,435,-141,-32.41,1218
2020-03-07,68,81,-13,-16.05,1218
2020-03-08,39,29,10,34.48,1218
2020-03-09,320,485,-165,-34.02,1218
2020-03-10,327,498,-171,-34.34,1218
2020-03-11,327,501,-174,-34.73,1218
2020-03-12,327,504,-177,-35.12,1218
2020-03-13,294,446,-152,-34.08,1218
2020-03-14,68,90,-22,-24.44,1218
2020-03-15,39,36,3,8.33,1218
2020-03-16,320,490,-170,-34.69,1218
2020-03-17,327,502,-175,-34.86,1218
2020-03-18,327,504,-177,-35.12,1218
2020-03-19,327,506,-179,-35.38,1218
2020-03-20,294,448,-154,-34.38,1218
2020-03-21,68,93,-25,-26.88,1218
2020-03-22,39,40,-1,-2.5,1218
2020-03-23,320,495,-175,-35.35,1218
2020-03-24,327,510,-183,-35.88,1218
2020-03-25,327,515,-188,-36.5,1218
2020-03-26,327,520,-193,-37.12,1218
2020-03-27,294,466,-172,-36.91,1218
2020-03-28,68,115,-47,-40.87,1218
2020-03-29,39,66,-27,-40.91,1218
2020-03-30,320,525,-205,-39.05,1218
2020-03-31,327,543,-216,-39.78,1218
2020-04-01,300,552,-252,-45.65,1218
2020-04-02,300,561,-261,-46.52,1218
2020-04-03,238,510,-272,-53.33,1218
2020-04-04,42,161,-119,-73.91,1218
2020-04-05,24,114,-90,-78.95,1218
2020-04-06,299,575,-276,-48.0,1218
2020-04-07,300,594,-294,-49.49,1218
2020-04-08,300,602,-302,-50.17,1218
2020-04-09,300,609,-309,-50.74,1218
2020-04-10,238,557,-319,-57.27,1218
2020-04-11,42,205,-163,-79.51,1218
2020-04-12,24,154,-130,-84.42,1218
2020-04-13,299,610,-311,-50.98,1218
2020-04-14,300,623,-323,-51.85,1218
2020-04-15,300,625,-325,-52.0,1218
2020-04-16,300,625,-325,-52.0,1218
2020-04-17,238,565,-327,-57.88,1218
2020-04-18,42,206,-164,-79.61,1218
2020-04-19,24,146,-122,-83.56,1218
2020-04-20,299,594,-295,-49.66,1218
2020-04-21,300,599,-299,-49.92,1218
2020-04-22,300,592,-292,-49.32,1218
2020-04-23,300,585,-285,-48.72,1218
2020-04-24,238,517,-279,-53.97,1218
2020-04-25,42,150,-108,-72.0,1218
2020-04-26,24,85,-61,-71.76,1218
2020-04-27,299,527,-228,-43.26,1218
2020-04-28,300,527,-227,-43.07,1218
2020-04-29,300,517,-217,-41.97,1218
2020-04-30,300,506,-206,-40.71,1218
2020-05-01,329,437,-108,-24.71,1218
2020-05-02,78,69,9,13.04,1218
2020-05-03,38,3,35,1166.67,1218
2020-05-04,383,447,-64,-14.32,1218
2020-05-05,394,449,-55,-12.25,1218
2020-05-06,394,442,-48,-10.86,1218
2020-05-07,394,435,-41,-9.43,1218
2020-05-08,329,370,-41,-11.08,1218
2020-05-09,78,8,70,875.0,1218
2020-05-10,38,33,5,15.15,1218
2020-05-11,383,397,-14,-3.53,1218
2020-05-12,394,406,-12,-2.96,1218
2020-05-13,394,405,-11,-2.72,1218
2020-05-14,394,406,-12,-2.96,1218
2020-05-15,329,347,-18,-5.19,1218
2020-05-16,78,54,24,44.44,1218
2020-05-17,38,33,5,15.15,1218
2020-05-18,383,393,-10,-2.54,1218
2020-05-19,394,408,-14,-3.43,1218
2020-05-20,394,412,-18,-4.37,1218
2020-05-21,394,417,-23,-5.52,1218
2020-05-22,329,363,-34,-9.37,1218
2020-05-23,78,10,68,680.0,1218
2020-05-24,38,45,-7,-15.56,1218
2020-05-25,383,417,-34,-8.15,1218
2020-05-26,394,433,-39,-9.01,1218
2020-05-27,394,439,-45,-10.25,1218
2020-05-28,394,444,-50,-11.26,1218
2020-05-29,329,389,-60,-15.42,1218
2020-05-30,78,37,41,110.81,1218
2020-05-31,38,56,-18,-32.14,1218
2020-06-01,435,441,-6,-1.36,1218
2020-06-02,459,456,3,0.66,1218
2020-06-03,459,460,-1,-0.22,1218
2020-06-04,459,463,-4,-0.86,1218
2020-06-05,380,407,-27,-6.63,1218
2020-06-06,89,52,37,71.15,1218
2020-06-07,46,59,-13,-22.03,1218
2020-06-08,435,453,-18,-3.97,1218
2020-06-09,459,465,-6,-1.29,1218
2020-06-10,459,468,-9,-1.92,1218
2020-06-11,459,469,-10,-2.13,1218
2020-06-12,380,412,-32,-7.77,1218
2020-06-13,89,55,34,61.82,1218
2020-06-14,46,0,46,inf,1218
2020-06-15,435,454,-19,-4.19,1218
2020-06-16,459,465,-6,-1.29,1218
2020-06-17,459,467,-8,-1.71,1218
2020-06-18,459,468,-9,-1.92,1218
2020-06-19,380,409,-29,-7.09,1218
2020-06-20,89,52,37,71.15,1218
2020-06-21,46,58,-12,-20.69,1218
2020-06-22,435,449,-14,-3.12,1218
2020-06-23,459,460,-1,-0.22,1218
2020-06-24,459,461,-2,-0.43,1218
2020-06-25,459,461,-2,-0.43,1218
2020-06-26,380,402,-22,-5.47,1218
2020-06-27,89,45,44,97.78,1218
2020-06-28,46,59,-13,-22.03,1218
2020-06-29,435,441,-6,-1.36,1218
2020-06-30,459,451,8,1.77,1218
2020-07-01,442,452,-10,-2.21,1218
2020-07-02,442,451,-9,-2.0,1218
2020-07-03,373,392,-19,-4.85,1218
2020-07-04,92,34,58,170.59,1218
2020-07-05,40,54,-14,-25.93,1218
2020-07-06,414,430,-16,-3.72,1218
2020-07-07,442,440,2,0.45,1218
2020-07-08,442,441,1,0.23,1218
2020-07-09,442,441,1,0.23,1218
2020-07-10,373,382,-9,-2.36,1218
2020-07-11,92,24,68,283.33,1218
2020-07-12,40,53,-13,-24.53,1218
2020-07-13,414,421,-7,-1.66,1218
2020-07-14,442,433,9,2.08,1218
2020-07-15,442,434,8,1.84,1218
2020-07-16,442,435,7,1.61,1218
2020-07-17,373,377,-4,-1.06,1218
2020-07-18,92,21,71,338.1,1218
2020-07-19,40,47,-7,-14.89,1218
2020-07-20,414,420,-6,-1.43,1218
2020-07-21,442,432,10,2.31,1218
2020-07-22,442,434,8,1.84,1218
2020-07-23,442,436,6,1.38,1218
2020-07-24,373,378,-5,-1.32,1218
2020-07-25,92,23,69,300.0,1218
2020-07-26,40,48,-8,-16.67,1218
2020-07-27,414,422,-8,-1.9,1218
2020-07-28,442,434,8,1.84,1218
2020-07-29,442,436,6,1.38,1218
2020-07-30,442,438,4,0.91,1218
2020-07-31,373,380,-7,-1.84,1218
2020-08-01,100,23,77,334.78,1218
2020-08-02,57,55,2,3.64,1218
2020-08-03,457,421,36,8.55,1218
2020-08-04,474,433,41,9.47,1218
2020-08-05,474,434,40,9.22,1218
2020-08-06,474,434,40,9.22,1218
2020-08-07,386,376,10,2.66,1218
2020-08-08,100,18,82,455.56,1218
2020-08-09,57,47,10,21.28,1218
2020-08-10,457,415,42,10.12,1218
2020-08-11,474,426,48,11.27,1218
2020-08-12,474,427,47,11.01,1218
2020-08-13,474,428,46,10.75,1218
2020-08-14,386,369,17,4.61,1218
2020-08-15,100,12,88,733.33,1218
2020-08-16,57,50,7,14.0,1218
2020-08-17,457,410,47,11.46,1218
2020-08-18,474,422,52,12.32,1218
2020-08-19,474,424,50,11.79,1218
2020-08-20,474,425,49,11.53,1218
2020-08-21,386,368,18,4.89,1218
2020-08-22,100,12,88,733.33,1218
2020-08-23,57,50,7,14.0,1218
2020-08-24,457,413,44,10.65,1218
2020-08-25,474,426,48,11.27,1218
2020-08-26,474,429,45,10.49,1218
2020-08-27,474,432,42,9.72,1218
2020-08-28,386,376,10,2.66,1218
2020-08-29,100,21,79,376.19,1218
2020-08-30,57,57,0,0.0,1218
2020-08-31,457,423,34,8.04,1218
2020-09-01,408,436,-28,-6.42,1218
2020-09-02,408,439,-31,-7.06,1218
2020-09-03,408,442,-34,-7.69,1218
2020-09-04,342,385,-43,-11.17,1218
2020-09-05,95,29,66,227.59,1218
2020-09-06,51,60,-9,-15.0,1218
2020-09-07,389,429,-40,-9.32,1218
2020-09-08,408,442,-34,-7.69,1218
2020-09-09,408,444,-36,-8.11,1218
2020-09-10,408,445,-37,-8.31,1218
2020-09-11,342,387,-45,-11.63,1218
2020-09-12,95,31,64,206.45,1218
2020-09-13,51,57,-6,-10.53,1218
2020-09-14,389,429,-40,-9.32,1218
2020-09-15,408,440,-32,-7.27,1218
2020-09-16,408,442,-34,-7.69,1218
2020-09-17,408,443,-35,-7.9,1218
2020-09-18,342,385,-43,-11.17,1218
2020-09-19,95,28,67,239.29,1218
2020-09-20,51,61,-10,-16.39,1218
2020-09-21,389,427,-38,-8.9,1218
2020-09-22,408,439,-31,-7.06,1218
2020-09-23,408,441,-33,-7.48,1218
2020-09-24,408,443,-35,-7.9,1218
2020-09-25,342,386,-44,-11.4,1218
2020-09-26,95,31,64,206.45,1218
2020-09-27,51,65,-14,-21.54,1218
2020-09-28,389,432,-43,-9.95,1218
2020-09-29,408,445,-37,-8.31,1218
2020-09-30,408,449,-41,-9.13,1218
2020-10-01,421,452,-31,-6.86,1218
2020-10-02,363,396,-33,-8.33,1218
2020-10-03,81,41,40,97.56,1218
2020-10-04,45,71,-26,-36.62,1218
2020-10-05,412,443,-31,-7.0,1218
2020-10-06,421,457,-36,-7.88,1218
2020-10-07,421,460,-39,-8.48,1218
2020-10-08,421,463,-42,-9.07,1218
2020-10-09,363,406,-43,-10.59,1218
2020-10-10,81,51,30,58.82,1218
2020-10-11,45,75,-30,-40.0,1218
2020-10-12,412,451,-39,-8.65,1218
2020-10-13,421,464,-43,-9.27,1218
2020-10-14,421,466,-45,-9.66,1218
2020-10-15,421,467,-46,-9.85,1218
2020-10-16,363,409,-46,-11.25,1218
2020-10-17,81,52,29,55.77,1218
2020-10-18,45,80,-35,-43.75,1218
2020-10-19,412,449,-37,-8.24,1218
2020-10-20,421,460,-39,-8.48,1218
2020-10-21,421,461,-40,-8.68,1218
2020-10-22,421,462,-41,-8.87,1218
2020-10-23,363,403,-40,-9.93,1218
2020-10-24,81,46,35,76.09,1218
2020-10-25,45,79,-34,-43.04,1218
2020-10-26,412,443,-31,-7.0,1218
2020-10-27,421,455,-34,-7.47,1218
2020-10-28,421,456,-35,-7.68,1218
2020-10-29,421,458,-37,-8.08,1218
2020-10-30,363,400,-37,-9.25,1218
2020-10-31,81,44,37,84.09,1218
2020-11-01,35,81,-46,-56.79,1218
2020-11-02,424,444,-20,-4.5,1218
2020-11-03,415,457,-42,-9.19,1218
2020-11-04,415,460,-45,-9.78,1218
2020-11-05,415,462,-47,-10.17,1218
2020-11-06,375,406,-31,-7.64,1218
2020-11-07,71,51,20,39.22,1218
2020-11-08,35,85,-50,-58.82,1218
2020-11-09,424,452,-28,-6.19,1218
2020-11-10,415,465,-50,-10.75,1218
2020-11-11,415,468,-53,-11.32,1218
2020-11-12,415,470,-55,-11.7,1218
2020-11-13,375,413,-38,-9.2,1218
2020-11-14,71,57,14,24.56,1218
2020-11-15,35,2,33,1650.0,1218
2020-11-16,424,456,-32,-7.02,1218
2020-11-17,415,467,-52,-11.13,1218
2020-11-18,415,468,-53,-11.32,1218
2020-11-19,415,468,-53,-11.32,1218
2020-11-20,375,409,-34,-8.31,1218
2020-11-21,71,51,20,39.22,1218
2020-11-22,35,87,-52,-59.77,1218
2020-11-23,424,445,-21,-4.72,1218
2020-11-24,415,455,-40,-8.79,1218
2020-11-25,415,454,-39,-8.59,1218
2020-11-26,415,452,-37,-8.19,1218
2020-11-27,375,392,-17,-4.34,1218
2020-11-28,71,33,38,115.15,1218
2020-11-29,35,86,-51,-59.3,1218
2020-11-30,424,426,-2,-0.47,1218
2020-12-01,293,436,-143,-32.8,1218
2020-12-02,293,435,-142,-32.64,1218
2020-12-03,293,435,-142,-32.64,1218
2020-12-04,363,375,-12,-3.2,1218
2020-12-05,72,17,55,323.53,1218
2020-12-06,30,76,-46,-60.53,1218
2020-12-07,332,414,-82,-19.81,1218
2020-12-08,293,425,-132,-31.06,1218
2020-12-09,293,427,-134,-31.38,1218
2020-12-10,293,428,-135,-31.54,1218
2020-12-11,363,370,-7,-1.89,1218
2020-12-12,72,13,59,453.85,1218
2020-12-13,30,74,-44,-59.46,1218
2020-12-14,332,412,-80,-19.42,1218
2020-12-15,293,424,-131,-30.9,1218
2020-12-16,293,426,-133,-31.22,1218
2020-12-17,293,427,-134,-31.38,1218
2020-12-18,363,369,-6,-1.63,1218
2020-12-19,72,12,60,500.0,1218
2020-12-20,30,77,-47,-61.04,1218
2020-12-21,332,408,-76,-18.63,1218
2020-12-22,293,418,-125,-29.9,1218
2020-12-23,293,418,-125,-29.9,1218
2020-12-24,293,417,-124,-29.74,1218
2020-12-25,363,356,7,1.97,1218
2020-12-26,72,104,-32,-30.77,1218
2020-12-27,30,65,-35,-53.85,1218
2020-12-28,332,387,-55,-14.21,1218
2020-12-29,293,395,-102,-25.82,1218
2020-12-30,293,392,-99,-25.26,1218
2020-12-31,293,388,-95,-24.48,1218
2021-01-01,278,325,-47,-14.46,1218
2021-01-02,52,83,-31,-37.35,1218
2021-01-03,26,56,-30,-53.57,1218
2021-01-04,260,353,-93,-26.35,1218
2021-01-05,284,360,-76,-21.11,1218
2021-01-06,284,358,-74,-20.67,1218
2021-01-07,284,355,-71,-20.0,1218
2021-01-08,278,294,-16,-5.44,1218
2021-01-09,52,73,-21,-28.77,1218
2021-01-10,26,46,-20,-43.48,1218
2021-01-11,260,329,-69,-20.97,1218
2021-01-12,284,339,-55,-16.22,1218
2021-01-13,284,340,-56,-16.47,1218
2021-01-14,284,341,-57,-16.72,1218
2021-01-15,278,284,-6,-2.11,1218
2021-01-16,52,74,-22,-29.73,1218
2021-01-17,26,43,-17,-39.53,1218
2021-01-18,260,331,-71,-21.45,1218
2021-01-19,284,346,-62,-17.92,1218
2021-01-20,284,351,-67,-19.09,1218
2021-01-21,284,355,-71,-20.0,1218
2021-01-22,278,301,-23,-7.64,1218
2021-01-23,52,77,-25,-32.47,1218
2021-01-24,26,60,-34,-56.67,1218
2021-01-25,260,355,-95,-26.76,1218
2021-01-26,284,371,-87,-23.45,1218
2021-01-27,284,377,-93,-24.67,1218
2021-01-28,284,382,-98,-25.65,1218
2021-01-29,278,327,-49,-14.98,1218
2021-01-30,52,97,-45,-46.39,1218
2021-01-31,26,71,-45,-63.38,1218
2021-02-01,378,379,-1,-0.26,1218
2021-02-02,368,393,-25,-6.36,1218
2021-02-03,368,397,-29,-7.3,1218
2021-02-04,368,400,-32,-8.0,1218
2021-02-05,365,344,21,6.1,1218
2021-02-06,55,109,-54,-49.54,1218
2021-02-07,27,86,-59,-68.6,1218
2021-02-08,378,390,-12,-3.08,1218
2021-02-09,368,403,-35,-8.68,1218
2021-02-10,368,406,-38,-9.36,1218
2021-02-11,368,408,-40,-9.8,1218
2021-02-12,365,352,13,3.69,1218
2021-02-13,55,121,-66,-54.55,1218
2021-02-14,27,93,-66,-70.97,1218
2021-02-15,378,399,-21,-5.26,1218
2021-02-16,368,413,-45,-10.9,1218
2021-02-17,368,417,-49,-11.75,1218
2021-02-18,368,421,-53,-12.59,1218
2021-02-19,365,366,-1,-0.27,1218
2021-02-20,55,14,41,292.86,1218
2021-02-21,27,91,-64,-70.33,1218
2021-02-22,378,420,-42,-10.0,1218
2021-02-23,368,436,-68,-15.6,1218
2021-02-24,368,443,-75,-16.93,1218
2021-02-25,368,449,-81,-18.04,1218
2021-02-26,365,396,-31,-7.83,1218
2021-02-27,55,44,11,25.0,1218
2021-02-28,27,118,-91,-77.12,1218
2021-03-01,393,453,-60,-13.25,1218
2021-03-02,382,469,-87,-18.55,1218
2021-03-03,382,475,-93,-19.58,1218
2021-03-04,382,481,-99,-20.58,1218
2021-03-05,322,426,-104,-24.41,1218
2021-03-06,79,73,6,8.22,1218
2021-03-07,32,22,10,45.45,1218
2021-03-08,393,478,-85,-17.78,1218
2021-03-09,382,492,-110,-22.36,1218
2021-03-10,382,495,-113,-22.83,1218
2021-03-11,382,498,-116,-23.29,1218
2021-03-12,322,441,-119,-26.98,1218
2021-03-13,79,86,-7,-8.14,1218
2021-03-14,32,31,1,3.23,1218
2021-03-15,393,485,-92,-18.97,1218
2021-03-16,382,497,-115,-23.14,1218
2021-03-17,382,499,-117,-23.45,1218
2021-03-18,382,501,-119,-23.75,1218
2021-03-19,322,443,-121,-27.31,1218
2021-03-20,79,88,-9,-10.23,1218
2021-03-21,32,34,-2,-5.88,1218
2021-03-22,393,489,-96,-19.63,1218
2021-03-23,382,502,-120,-23.9,1218
2021-03-24,382,507,-125,-24.65,1218
2021-03-25,382,511,-129,-25.24,1218
2021-03-26,322,457,-135,-29.54,1218
2021-03-27,79,104,-25,-24.04,1218
2021-03-28,32,54,-22,-40.74,1218
2021-03-29,393,513,-120,-23.39,1218
2021-03-30,382,531,-149,-28.06,1218
2021-03-31,382,539,-157,-29.13,1218
2021-04-01,357,547,-190,-34.73,1218
2021-04-02,319,497,-178,-35.81,1218
2021-04-03,72,148,-76,-51.35,1218
2021-04-04,30,100,-70,-70.0,1218
2021-04-05,344,561,-217,-38.68,1218
2021-04-06,357,581,-224,-38.55,1218
2021-04-07,357,589,-232,-39.39,1218
2021-04-08,357,597,-240,-40.2,1218
2021-04-09,319,546,-227,-41.58,1218
2021-04-10,72,195,-123,-63.08,1218
2021-04-11,30,145,-115,-79.31,1218
2021-04-12,344,602,-258,-42.86,1218
2021-04-13,357,617,-260,-42.14,1218
2021-04-14,357,620,-263,-42.42,1218
2021-04-15,357,622,-265,-42.6,1218
2021-04-16,319,563,-244,-43.34,1218
2021-04-17,72,205,-133,-64.88,1218
2021-04-18,30,147,-117,-79.59,1218
2021-04-19,344,597,-253,-42.38,1218
2021-04-20,357,603,-246,-40.8,1218
2021-04-21,357,598,-241,-40.3,1218
2021-04-22,357,592,-235,-39.7,1218
2021-04-23,319,525,-206,-39.24,1218
2021-04-24,72,159,-87,-54.72,1218
2021-04-25,30,94,-64,-68.09,1218
2021-04-26,344,537,-193,-35.94,1218
2021-04-27,357,537,-180,-33.52,1218
2021-04-28,357,527,-170,-32.26,1218
2021-04-29,357,517,-160,-30.95,1218
2021-04-30,319,447,-128,-28.64,1218
2021-05-01,88,79,9,11.39,1218
2021-05-02,49,13,36,276.92,1218
2021-05-03,405,455,-50,-10.99,1218
2021-05-04,446,457,-11,-2.41,1218
2021-05-05,446,449,-3,-0.67,1218
2021-05-06,446,441,5,1.13,1218
2021-05-07,350,375,-25,-6.67,1218
2021-05-08,88,11,77,700.0,1218
2021-05-09,49,116,-67,-57.76,1218
2021-05-10,405,398,7,1.76,1218
2021-05-11,446,406,40,9.85,1218
2021-05-12,446,404,42,10.4,1218
2021-05-13,446,403,43,10.67,1218
2021-05-14,350,344,6,1.74,1218
2021-05-15,88,150,-62,-41.33,1218
2021-05-16,49,119,-70,-58.82,1218
2021-05-17,405,387,18,4.65,1218
2021-05-18,446,400,46,11.5,1218
2021-05-19,446,404,42,10.4,1218
2021-05-20,446,409,37,9.05,1218
2021-05-21,350,354,-4,-1.13,1218
2021-05-22,88,1,87,8700.0,1218
2021-05-23,49,134,-85,-63.43,1218
2021-05-24,405,408,-3,-0.74,1218
2021-05-25,446,423,23,5.44,1218
2021-05-26,446,429,17,3.96,1218
2021-05-27,446,435,11,2.53,1218
2021-05-28,350,381,-31,-8.14,1218
2021-05-29,88,28,60,214.29,1218
2021-05-30,49,148,-99,-66.89,1218
2021-05-31,405,433,-28,-6.47,1218
2021-06-01,430,448,-18,-4.02,1218
2021-06-02,430,453,-23,-5.08,1218
2021-06-03,430,456,-26,-5.7,1218
2021-06-04,370,400,-30,-7.5,1218
2021-06-05,89,46,43,93.48,1218
2021-06-06,50,155,-105,-67.74,1218
2021-06-07,459,447,12,2.68,1218
2021-06-08,430,460,-30,-6.52,1218
2021-06-09,430,463,-33,-7.13,1218
2021-06-10,430,465,-35,-7.53,1218
2021-06-11,370,407,-37,-9.09,1218
2021-06-12,89,51,38,74.51,1218
2021-06-13,50,158,-108,-68.35,1218
2021-06-14,459,450,9,2.0,1218
2021-06-15,430,461,-31,-6.72,1218
2021-06-16,430,463,-33,-7.13,1218
2021-06-17,430,464,-34,-7.33,1218
2021-06-18,370,405,-35,-8.64,1218
2021-06-19,89,49,40,81.63,1218
2021-06-20,50,165,-115,-69.7,1218
2021-06-21,459,446,13,2.91,1218
2021-06-22,430,457,-27,-5.91,1218
2021-06-23,430,458,-28,-6.11,1218
2021-06-24,430,458,-28,-6.11,1218
2021-06-25,370,399,-29,-7.27,1218
2021-06-26,89,42,47,111.9,1218
2021-06-27,50,162,-112,-69.14,1218
2021-06-28,459,438,21,4.79,1218
2021-06-29,430,449,-19,-4.23,1218
2021-06-30,430,449,-19,-4.23,1218
2021-07-01,408,449,-41,-9.13,1218
2021-07-02,349,390,-41,-10.51,1218
2021-07-03,80,32,48,150.0,1218
2021-07-04,51,161,-110,-68.32,1218
2021-07-05,382,427,-45,-10.54,1218
2021-07-06,408,438,-30,-6.85,1218
2021-07-07,408,438,-30,-6.85,1218
2021-07-08,408,438,-30,-6.85,1218
2021-07-09,349,379,-30,-7.92,1218
2021-07-10,80,21,59,280.95,1218
2021-07-11,51,159,-108,-67.92,1218
2021-07-12,382,418,-36,-8.61,1218
2021-07-13,408,429,-21,-4.9,1218
2021-07-14,408,430,-22,-5.12,1218
2021-07-15,408,431,-23,-5.34,1218
2021-07-16,349,373,-24,-6.43,1218
2021-07-17,80,16,64,400.0,1218
2021-07-18,51,154,-103,-66.88,1218
2021-07-19,382,415,-33,-7.95,1218
2021-07-20,408,427,-19,-4.45,1218
2021-07-21,408,429,-21,-4.9,1218
2021-07-22,408,431,-23,-5.34,1218
2021-07-23,349,373,-24,-6.43,1218
2021-07-24,80,18,62,344.44,1218
2021-07-25,51,163,-112,-68.71,1218
2021-07-26,382,417,-35,-8.39,1218
2021-07-27,408,430,-22,-5.12,1218
2021-07-28,408,432,-24,-5.56,1218
2021-07-29,408,433,-25,-5.77,1218
2021-07-30,349,376,-27,-7.18,1218
2021-07-31,80,19,61,321.05,1218
2021-08-01,56,168,-112,-66.67,1218
2021-08-02,356,418,-62,-14.83,1218
2021-08-03,370,429,-59,-13.75,1218
2021-08-04,370,430,-60,-13.95,1218
2021-08-05,370,431,-61,-14.15,1218
2021-08-06,298,372,-74,-19.89,1218
2021-08-07,80,15,65,433.33,1218
2021-08-08,56,172,-116,-67.44,1218
2021-08-09,356,412,-56,-13.59,1218
2021-08-10,370,423,-53,-12.53,1218
2021-08-11,370,424,-54,-12.74,1218
2021-08-12,370,424,-54,-12.74,1218
2021-08-13,298,365,-67,-18.36,1218
2021-08-14,80,8,72,900.0,1218
2021-08-15,56,175,-119,-68.0,1218
2021-08-16,356,406,-50,-12.32,1218
2021-08-17,370,418,-48,-11.48,1218
2021-08-18,370,419,-49,-11.69,1218
2021-08-19,370,421,-51,-12.11,1218
2021-08-20,298,363,-65,-17.91,1218
2021-08-21,80,7,73,1042.86,1218
2021-08-22,56,168,-112,-66.67,1218
2021-08-23,356,407,-51,-12.53,1218
2021-08-24,370,420,-50,-11.9,1218
2021-08-25,370,423,-53,-12.53,1218
2021-08-26,370,426,-56,-13.15,1218
2021-08-27,298,369,-71,-19.24,1218
2021-08-28,80,15,65,433.33,1218
2021-08-29,56,187,-131,-70.05,1218
2021-08-30,356,416,-60,-14.42,1218
2021-08-31,370,430,-60,-13.95,1218
2021-09-01,424,433,-9,-2.08,1218
2021-09-02,424,436,-12,-2.75,1218
2021-09-03,359,379,-20,-5.28,1218
2021-09-04,87,24,63,262.5,1218
2021-09-05,60,190,-130,-68.42,1218
2021-09-06,394,424,-30,-7.08,1218
2021-09-07,424,437,-13,-2.97,1218
2021-09-08,424,439,-15,-3.42,1218
2021-09-09,424,441,-17,-3.85,1218
2021-09-10,359,383,-24,-6.27,1218
2021-09-11,87,27,60,222.22,1218
2021-09-12,60,194,-134,-69.07,1218
2021-09-13,394,425,-31,-7.29,1218
2021-09-14,424,436,-12,-2.75,1218
2021-09-15,424,438,-14,-3.2,1218
2021-09-16,424,439,-15,-3.42,1218
2021-09-17,359,381,-22,-5.77,1218
2021-09-18,87,24,63,262.5,1218
2021-09-19,60,197,-137,-69.54,1218
2021-09-20,394,422,-28,-6.64,1218
2021-09-21,424,434,-10,-2.3,1218
2021-09-22,424,436,-12,-2.75,1218
2021-09-23,424,438,-14,-3.2,1218
2021-09-24,359,381,-22,-5.77,1218
2021-09-25,87,25,62,248.0,1218
2021-09-26,60,194,-134,-69.07,1218
2021-09-27,394,426,-32,-7.51,1218
2021-09-28,424,439,-15,-3.42,1218
2021-09-29,424,442,-18,-4.07,1218
2021-09-30,424,445,-21,-4.72,1218
2021-10-01,351,389,-38,-9.77,1218
2021-10-02,79,35,44,125.71,1218
2021-10-03,43,199,-156,-78.39,1218
2021-10-04,400,437,-37,-8.47,1218
2021-10-05,405,451,-46,-10.2,1218
2021-10-06,405,454,-49,-10.79,1218
2021-10-07,405,457,-52,-11.38,1218
2021-10-08,351,401,-50,-12.47,1218
2021-10-09,79,46,33,71.74,1218
2021-10-10,43,226,-183,-80.97,1218
2021-10-11,400,446,-46,-10.31,1218
2021-10-12,405,459,-54,-11.76,1218
2021-10-13,405,461,-56,-12.15,1218
2021-10-14,405,463,-58,-12.53,1218
2021-10-15,351,405,-54,-13.33,1218
2021-10-16,79,48,31,64.58,1218
2021-10-17,43,218,-175,-80.28,1218
2021-10-18,400,446,-46,-10.31,1218
2021-10-19,405,457,-52,-11.38,1218
2021-10-20,405,458,-53,-11.57,1218
2021-10-21,405,459,-54,-11.76,1218
2021-10-22,351,400,-49,-12.25,1218
2021-10-23,79,43,36,83.72,1218
2021-10-24,43,223,-180,-80.72,1218
2021-10-25,400,440,-40,-9.09,1218
2021-10-26,405,451,-46,-10.2,1218
2021-10-27,405,452,-47,-10.4,1218
2021-10-28,405,454,-49,-10.79,1218
2021-10-29,351,396,-45,-11.36,1218
2021-10-30,79,39,40,102.56,1218
2021-10-31,43,223,-180,-80.72,1218
2021-11-01,322,439,-117,-26.65,1218
2021-11-02,345,452,-107,-23.67,1218
2021-11-03,345,454,-109,-24.01,1218
2021-11-04,345,457,-112,-24.51,1218
2021-11-05,310,400,-90,-22.5,1218
2021-11-06,72,45,27,60.0,1218
2021-11-07,38,234,-196,-83.76,1218
2021-11-08,322,446,-124,-27.8,1218
2021-11-09,345,459,-114,-24.84,1218
2021-11-10,345,462,-117,-25.32,1218
2021-11-11,345,465,-120,-25.81,1218
2021-11-12,310,408,-98,-24.02,1218
2021-11-13,72,52,20,38.46,1218
2021-11-14,38,244,-206,-84.43,1218
2021-11-15,322,452,-130,-28.76,1218
2021-11-16,345,463,-118,-25.49,1218
2021-11-17,345,465,-120,-25.81,1218
2021-11-18,345,465,-120,-25.81,1218
2021-11-19,310,406,-96,-23.65,1218
2021-11-20,72,49,23,46.94,1218
2021-11-21,38,228,-190,-83.33,1218
2021-11-22,322,444,-122,-27.48,1218
2021-11-23,345,453,-108,-23.84,1218
2021-11-24,345,453,-108,-23.84,1218
2021-11-25,345,451,-106,-23.5,1218
2021-11-26,310,391,-81,-20.72,1218
2021-11-27,72,32,40,125.0,1218
2021-11-28,38,228,-190,-83.33,1218
2021-11-29,322,425,-103,-24.24,1218
2021-11-30,345,435,-90,-20.69,1218
2021-12-01,234,434,-200,-46.08,1218
2021-12-02,234,433,-199,-45.96,1218
2021-12-03,176,373,-197,-52.82,1218
2021-12-04,76,15,61,406.67,1218
2021-12-05,27,234,-207,-88.46,1218
2021-12-06,276,411,-135,-32.85,1218
2021-12-07,234,422,-188,-44.55,1218
2021-12-08,234,423,-189,-44.68,1218
2021-12-09,234,424,-190,-44.81,1218
2021-12-10,176,365,-189,-51.78,1218
2021-12-11,76,9,67,744.44,1218
2021-12-12,27,221,-194,-87.78,1218
2021-12-13,276,408,-132,-32.35,1218
2021-12-14,234,420,-186,-44.29,1218
2021-12-15,234,422,-188,-44.55,1218
2021-12-16,234,423,-189,-44.68,1218
2021-12-17,176,365,-189,-51.78,1218
2021-12-18,76,8,68,850.0,1218
2021-12-19,27,244,-217,-88.93,1218
2021-12-20,276,406,-130,-32.02,1218
2021-12-21,234,416,-182,-43.75,1218
2021-12-22,234,416,-182,-43.75,1218
2021-12-23,234,416,-182,-43.75,1218
2021-12-24,176,355,-179,-50.42,1218
2021-12-25,76,260,-184,-70.77,1218
2021-12-26,27,230,-203,-88.26,1218
2021-12-27,276,388,-112,-28.87,1218
2021-12-28,234,396,-162,-40.91,1218
2021-12-29,234,393,-159,-40.46,1218
2021-12-30,234,390,-156,-40.0,1218
2021-12-31,176,327,-151,-46.18,1218
2022-01-01,74,235,-161,-68.51,1218
2022-01-02,31,232,-201,-86.64,1218
2022-01-03,264,355,-91,-25.63,1218
2022-01-04,264,362,-98,-27.07,1218
2022-01-05,264,359,-95,-26.46,1218
2022-01-06,264,356,-92,-25.84,1218
2022-01-07,236,294,-58,-19.73,1218
2022-01-08,74,242,-168,-69.42,1218
2022-01-09,31,205,-174,-84.88,1218
2022-01-10,264,327,-63,-19.27,1218
2022-01-11,264,337,-73,-21.66,1218
2022-01-12,264,337,-73,-21.66,1218
2022-01-13,264,337,-73,-21.66,1218
2022-01-14,236,279,-43,-15.41,1218
2022-01-15,74,232,-158,-68.1,1218
2022-01-16,31,210,-179,-85.24,1218
2022-01-17,264,324,-60,-18.52,1218
2022-01-18,264,338,-74,-21.89,1218
2022-01-19,264,343,-79,-23.03,1218
2022-01-20,264,347,-83,-23.92,1218
2022-01-21,236,292,-56,-19.18,1218
2022-01-22,74,244,-170,-69.67,1218
2022-01-23,31,223,-192,-86.1,1218
2022-01-24,264,346,-82,-23.7,1218
2022-01-25,264,362,-98,-27.07,1218
2022-01-26,264,368,-104,-28.26,1218
2022-01-27,264,373,-109,-29.22,1218
2022-01-28,236,319,-83,-26.02,1218
2022-01-29,74,267,-193,-72.28,1218
2022-01-30,31,242,-211,-87.19,1218
2020-02-01,419,381,38,9.97,1221
2020-02-02,290,236,54,22.88,1221
2020-02-03,1250,1266,-16,-1.26,1221
2020-02-04,1262,1280,-18,-1.41,1221
2020-02-05,1262,1282,-20,-1.56,1221
2020-02-06,1262,1282,-20,-1.56,1221
2020-02-07,1194,1129,65,5.76,1221
2020-02-08,419,400,19,4.75,1221
2020-02-09,290,254,36,14.17,1221
2020-02-10,1250,1284,-34,-2.65,1221
2020-02-11,1262,1298,-36,-2.77,1221
2020-02-12,1262,1300,-38,-2.92,1221
2020-02-13,1262,1300,-38,-2.92,1221
2020-02-14,1194,1146,48,4.19,1221
2020-02-15,419,417,2,0.48,1221
2020-02-16,290,271,19,7.01,1221
2020-02-17,1250,1301,-51,-3.92,1221
2020-02-18,1262,1315,-53,-4.03,1221
2020-02-19,1262,1316,-54,-4.1,1221
2020-02-20,1262,1316,-54,-4.1,1221
2020-02-21,1194,1162,32,2.75,1221
2020-02-22,419,433,-14,-3.23,1221
2020-02-23,290,286,4,1.4,1221
2020-02-24,1250,1315,-65,-4.94,1221
2020-02-25,1262,1329,-67,-5.04,1221
2020-02-26,1262,1329,-67,-5.04,1221
2020-02-27,1262,1329,-67,-5.04,1221
2020-02-28,1194,1174,20,1.7,1221
2020-02-29,419,444,-25,-5.63,1221
2020-03-01,285,296,-11,-3.72,1221
2020-03-02,1125,1325,-200,-15.09,1221
2020-03-03,1063,1337,-274,-20.49,1221
2020-03-04,1063,1337,-274,-20.49,1221
2020-03-05,1063,1336,-273,-20.43,1221
2020-03-06,968,1180,-212,-17.97,1221
2020-03-07,386,449,-63,-14.03,1221
2020-03-08,285,301,-16,-5.32,1221
2020-03-09,1125,1329,-204,-15.35,1221
2020-03-10,1063,1341,-278,-20.73,1221
2020-03-11,1063,1341,-278,-20.73,1221
2020-03-12,1063,1340,-277,-20.67,1221
2020-03-13,968,1184,-216,-18.24,1221
2020-03-14,386,454,-68,-14.98,1221
2020-03-15,285,307,-22,-7.17,1221
2020-03-16,1125,1335,-210,-15.73,1221
2020-03-17,1063,1348,-285,-21.14,1221
2020-03-18,1063,1349,-286,-21.2,1221
2020-03-19,1063,1348,-285,-21.14,1221
2020-03-20,968,1194,-226,-18.93,1221
2020-03-21,386,465,-79,-16.99,1221
2020-03-22,285,319,-34,-10.66,1221
2020-03-23,1125,1348,-223,-16.54,1221
2020-03-24,1063,1362,-299,-21.95,1221
2020-03-25,1063,1364,-301,-22.07,1221
2020-03-26,1063,1365,-302,-22.12,1221
2020-03-27,968,1211,-243,-20.07,1221
2020-03-28,386,482,-96,-19.92,1221
2020-03-29,285,336,-51,-15.18,1221
2020-03-30,1125,1366,-241,-17.64,1221
2020-03-31,1063,1380,-317,-22.97,1221
2020-04-01,1084,1382,-298,-21.56,1221
2020-04-02,1084,1382,-298,-21.56,1221
2020-04-03,934,1228,-294,-23.94,1221
2020-04-04,348,499,-151,-30.26,1221
2020-04-05,251,352,-101,-28.69,1221
2020-04-06,1094,1381,-287,-20.78,1221
2020-04-07,1084,1394,-310,-22.24,1221
2020-04-08,1084,1394,-310,-22.24,1221
2020-04-09,1084,1393,-309,-22.18,1221
2020-04-10,934,1238,-304,-24.56,1221
2020-04-11,348,507,-159,-31.36,1221
2020-04-12,251,359,-108,-30.08,1221
2020-04-13,1094,1387,-293,-21.12,1221
2020-04-14,1084,1399,-315,-22.52,1221
2020-04-15,1084,1399,-315,-22.52,1221
2020-04-16,1084,1398,-314,-22.46,1221
2020-04-17,934,1242,-308,-24.8,1221
2020-04-18,348,512,-164,-32.03,1221
2020-04-19,251,364,-113,-31.04,1221
2020-04-20,1094,1393,-299,-21.46,1221
2020-04-21,1084,1405,-321,-22.85,1221
2020-04-22,1084,1406,-322,-22.9,1221
2020-04-23,1084,1406,-322,-22.9,1221
2020-04-24,934,1252,-318,-25.4,1221
2020-04-25,348,523,-175,-33.46,1221
2020-04-26,251,377,-126,-33.42,1221
2020-04-27,1094,1407,-313,-22.25,1221
2020-04-28,1084,1421,-337,-23.72,1221
2020-04-29,1084,1424,-340,-23.88,1221
2020-04-30,1084,1425,-341,-23.93,1221
2020-05-01,1161,1272,-111,-8.73,1221
2020-05-02,446,544,-98,-18.01,1221
2020-05-03,275,399,-124,-31.08,1221
2020-05-04,1258,1430,-172,-12.03,1221
2020-05-05,1290,1445,-155,-10.73,1221
2020-05-06,1290,1447,-157,-10.85,1221
2020-05-07,1290,1448,-158,-10.91,1221
2020-05-08,1161,1295,-134,-10.35,1221
2020-05-09,446,566,-120,-21.2,1221
2020-05-10,275,420,-145,-34.52,1221
2020-05-11,1258,1449,-191,-13.18,1221
2020-05-12,1290,1462,-172,-11.76,1221
2020-05-13,1290,1463,-173,-11.83,1221
2020-05-14,1290,1461,-171,-11.7,1221
2020-05-15,1161,1306,-145,-11.1,1221
2020-05-16,446,574,-128,-22.3,1221
2020-05-17,275,426,-151,-35.45,1221
2020-05-18,1258,1453,-195,-13.42,1221
2020-05-19,1290,1463,-173,-11.83,1221
2020-05-20,1290,1462,-172,-11.76,1221
2020-05-21,1290,1458,-168,-11.52,1221
2020-05-22,1161,1301,-140,-10.76,1221
2020-05-23,446,568,-122,-21.48,1221
2020-05-24,275,418,-143,-34.21,1221
2020-05-25,1258,1445,-187,-12.94,1221
2020-05-26,1290,1455,-165,-11.34,1221
2020-05-27,1290,1453,-163,-11.22,1221
2020-05-28,1290,1450,-160,-11.03,1221
2020-05-29,1161,1293,-132,-10.21,1221
2020-05-30,446,561,-115,-20.5,1221
2020-05-31,275,413,-138,-33.41,1221
2020-06-01,1359,1440,-81,-5.62,1221
2020-06-02,1346,1452,-106,-7.3,1221
2020-06-03,1346,1452,-106,-7.3,1221
2020-06-04,1346,1450,-104,-7.17,1221
2020-06-05,1200,1295,-95,-7.34,1221
2020-06-06,421,565,-144,-25.49,1221
2020-06-07,300,418,-118,-28.23,1221
2020-06-08,1359,1446,-87,-6.02,1221
2020-06-09,1346,1459,-113,-7.75,1221
2020-06-10,1346,1460,-114,-7.81,1221
2020-06-11,1346,1459,-113,-7.75,1221
2020-06-12,1200,1304,-104,-7.98,1221
2020-06-13,421,573,-152,-26.53,1221
2020-06-14,300,425,-125,-29.41,1221
2020-06-15,1359,1452,-93,-6.4,1221
2020-06-16,1346,1463,-117,-8.0,1221
2020-06-17,1346,1462,-116,-7.93,1221
2020-06-18,1346,1458,-112,-7.68,1221
2020-06-19,1200,1300,-100,-7.69,1221
2020-06-20,421,567,-146,-25.75,1221
2020-06-21,300,415,-115,-27.71,1221
2020-06-22,1359,1440,-81,-5.62,1221
2020-06-23,1346,1447,-101,-6.98,1221
2020-06-24,1346,1443,-97,-6.72,1221
2020-06-25,1346,1436,-90,-6.27,1221
2020-06-26,1200,1275,-75,-5.88,1221
2020-06-27,421,539,-118,-21.89,1221
2020-06-28,300,385,-85,-22.08,1221
2020-06-29,1359,1408,-49,-3.48,1221
2020-06-30,1346,1414,-68,-4.81,1221
2020-07-01,1320,1408,-88,-6.25,1221
2020-07-02,1320,1401,-81,-5.78,1221
2020-07-03,1178,1240,-62,-5.0,1221
2020-07-04,446,504,-58,-11.51,1221
2020-07-05,300,352,-52,-14.77,1221
2020-07-06,1333,1376,-43,-3.12,1221
2020-07-07,1320,1384,-64,-4.62,1221
2020-07-08,1320,1381,-61,-4.42,1221
2020-07-09,1320,1376,-56,-4.07,1221
2020-07-10,1178,1218,-40,-3.28,1221
2020-07-11,446,485,-39,-8.04,1221
2020-07-12,300,336,-36,-10.71,1221
2020-07-13,1333,1363,-30,-2.2,1221
2020-07-14,1320,1374,-54,-3.93,1221
2020-07-15,1320,1373,-53,-3.86,1221
2020-07-16,1320,1371,-51,-3.72,1221
2020-07-17,1178,1215,-37,-3.05,1221
2020-07-18,446,484,-38,-7.85,1221
2020-07-19,300,336,-36,-10.71,1221
2020-07-20,1333,1363,-30,-2.2,1221
2020-07-21,1320,1374,-54,-3.93,1221
2020-07-22,1320,1373,-53,-3.86,1221
2020-07-23,1320,1370,-50,-3.65,1221
2020-07-24,1178,1213,-35,-2.89,1221
2020-07-25,446,480,-34,-7.08,1221
2020-07-26,300,329,-29,-8.81,1221
2020-07-27,1333,1354,-21,-1.55,1221
2020-07-28,1320,1362,-42,-3.08,1221
2020-07-29,1320,1358,-38,-2.8,1221
2020-07-30,1320,1351,-31,-2.29,1221
2020-07-31,1178,1190,-12,-1.01,1221
2020-08-01,479,453,26,5.74,1221
2020-08-02,306,299,7,2.34,1221
2020-08-03,1499,1321,178,13.47,1221
2020-08-04,1562,1327,235,17.71,1221
2020-08-05,1562,1320,242,18.33,1221
2020-08-06,1562,1312,250,19.05,1221
2020-08-07,1406,1150,256,22.26,1221
2020-08-08,479,412,67,16.26,1221
2020-08-09,306,259,47,18.15,1221
2020-08-10,1499,1281,218,17.02,1221
2020-08-11,1562,1289,273,21.18,1221
2020-08-12,1562,1284,278,21.65,1221
2020-08-13,1562,1279,283,22.13,1221
2020-08-14,1406,1121,285,25.42,1221
2020-08-15,479,388,91,23.45,1221
2020-08-16,306,239,67,28.03,1221
2020-08-17,1499,1267,232,18.31,1221
2020-08-18,1562,1280,282,22.03,1221
2020-08-19,1562,1282,280,21.84,1221
2020-08-20,1562,1283,279,21.75,1221
2020-08-21,1406,1131,275,24.31,1221
2020-08-22,479,404,75,18.56,1221
2020-08-23,306,261,45,17.24,1221
2020-08-24,1499,1294,205,15.84,1221
2020-08-25,1562,1312,250,19.05,1221
2020-08-26,1562,1319,243,18.42,1221
2020-08-27,1562,1324,238,17.98,1221
2020-08-28,1406,1175,231,19.66,1221
2020-08-29,479,451,28,6.21,1221
2020-08-30,306,310,-4,-1.29,1221
2020-08-31,1499,1344,155,11.53,1221
2020-09-01,1287,1363,-76,-5.58,1221
2020-09-02,1287,1369,-82,-5.99,1221
2020-09-03,1287,1373,-86,-6.26,1221
2020-09-04,1143,1222,-79,-6.46,1221
2020-09-05,433,496,-63,-12.7,1221
2020-09-06,309,352,-43,-12.22,1221
2020-09-07,1224,1383,-159,-11.5,1221
2020-09-08,1287,1398,-111,-7.94,1221
2020-09-09,1287,1400,-113,-8.07,1221
2020-09-10,1287,1400,-113,-8.07,1221
2020-09-11,1143,1245,-102,-8.19,1221
2020-09-12,433,514,-81,-15.76,1221
2020-09-13,309,366,-57,-15.57,1221
2020-09-14,1224,1393,-169,-12.13,1221
2020-09-15,1287,1404,-117,-8.33,1221
2020-09-16,1287,1403,-116,-8.27,1221
2020-09-17,1287,1400,-113,-8.07,1221
2020-09-18,1143,1242,-99,-7.97,1221
2020-09-19,433,509,-76,-14.93,1221
2020-09-20,309,360,-51,-14.17,1221
2020-09-21,1224,1386,-162,-11.69,1221
2020-09-22,1287,1396,-109,-7.81,1221
2020-09-23,1287,1394,-107,-7.68,1221
2020-09-24,1287,1391,-104,-7.48,1221
2020-09-25,1143,1234,-91,-7.37,1221
2020-09-26,433,502,-69,-13.75,1221
2020-09-27,309,353,-44,-12.46,1221
2020-09-28,1224,1381,-157,-11.37,1221
2020-09-29,1287,1392,-105,-7.54,1221
2020-09-30,1287,1392,-105,-7.54,1221
2020-10-01,1231,1390,-159,-11.44,1221
2020-10-02,1145,1235,-90,-7.29,1221
2020-10-03,440,504,-64,-12.7,1221
2020-10-04,312,356,-44,-12.36,1221
2020-10-05,1270,1384,-114,-8.24,1221
2020-10-06,1231,1397,-166,-11.88,1221
2020-10-07,1231,1397,-166,-11.88,1221
2020-10-08,1231,1395,-164,-11.76,1221
2020-10-09,1145,1240,-95,-7.66,1221
2020-10-10,440,509,-69,-13.56,1221
2020-10-11,312,360,-48,-13.33,1221
2020-10-12,1270,1388,-118,-8.5,1221
2020-10-13,1231,1399,-168,-12.01,1221
2020-10-14,1231,1398,-167,-11.95,1221
2020-10-15,1231,1395,-164,-11.76,1221
2020-10-16,1145,1238,-93,-7.51,1221
2020-10-17,440,506,-66,-13.04,1221
2020-10-18,312,357,-45,-12.61,1221
2020-10-19,1270,1383,-113,-8.17,1221
2020-10-20,1231,1393,-162,-11.63,1221
2020-10-21,1231,1391,-160,-11.5,1221
2020-10-22,1231,1388,-157,-11.31,1221
2020-10-23,1145,1230,-85,-6.91,1221
2020-10-24,440,498,-58,-11.65,1221
2020-10-25,312,348,-36,-10.34,1221
2020-10-26,1270,1375,-105,-7.64,1221
2020-10-27,1231,1385,-154,-11.12,1221
2020-10-28,1231,1384,-153,-11.05,1221
2020-10-29,1231,1382,-151,-10.93,1221
2020-10-30,1145,1225,-80,-6.53,1221
2020-10-31,440,494,-54,-10.93,1221
2020-11-01,303,346,-43,-12.43,1221
2020-11-02,1307,1374,-67,-4.88,1221
2020-11-03,1282,1386,-104,-7.5,1221
2020-11-04,1282,1386,-104,-7.5,1221
2020-11-05,1282,1384,-102,-7.37,1221
2020-11-06,1166,1229,-63,-5.13,1221
2020-11-07,456,499,-43,-8.62,1221
2020-11-08,303,351,-48,-13.68,1221
2020-11-09,1307,1379,-72,-5.22,1221
2020-11-10,1282,1391,-109,-7.84,1221
2020-11-11,1282,1391,-109,-7.84,1221
2020-11-12,1282,1389,-107,-7.7,1221
2020-11-13,1166,1232,-66,-5.36,1221
2020-11-14,456,500,-44,-8.8,1221
2020-11-15,303,351,-48,-13.68,1221
2020-11-16,1307,1377,-70,-5.08,1221
2020-11-17,1282,1387,-105,-7.57,1221
2020-11-18,1282,1384,-102,-7.37,1221
2020-11-19,1282,1379,-97,-7.03,1221
2020-11-20,1166,1220,-54,-4.43,1221
2020-11-21,456,486,-30,-6.17,1221
2020-11-22,303,333,-30,-9.01,1221
2020-11-23,1307,1357,-50,-3.68,1221
2020-11-24,1282,1364,-82,-6.01,1221
2020-11-25,1282,1359,-77,-5.67,1221
2020-11-26,1282,1352,-70,-5.18,1221
2020-11-27,1166,1191,-25,-2.1,1221
2020-11-28,456,455,1,0.22,1221
2020-11-29,303,301,2,0.66,1221
2020-11-30,1307,1324,-17,-1.28,1221
2020-12-01,1036,1331,-295,-22.16,1221
2020-12-02,1036,1325,-289,-21.81,1221
2020-12-03,1036,1319,-283,-21.46,1221
2020-12-04,1154,1158,-4,-0.35,1221
2020-12-05,459,423,36,8.51,1221
2020-12-06,294,271,23,8.49,1221
2020-12-07,1087,1295,-208,-16.06,1221
2020-12-08,1036,1304,-268,-20.55,1221
2020-12-09,1036,1301,-265,-20.37,1221
2020-12-10,1036,1296,-260,-20.06,1221
2020-12-11,1154,1138,16,1.41,1221
2020-12-12,459,405,54,13.33,1221
2020-12-13,294,255,39,15.29,1221
2020-12-14,1087,1281,-194,-15.14,1221
2020-12-15,1036,1292,-256,-19.81,1221
2020-12-16,1036,1291,-255,-19.75,1221
2020-12-17,1036,1288,-252,-19.57,1221
2020-12-18,1154,1131,23,2.03,1221
2020-12-19,459,399,60,15.04,1221
2020-12-20,294,250,44,17.6,1221
2020-12-21,1087,1277,-190,-14.88,1221
2020-12-22,1036,1288,-252,-19.57,1221
2020-12-23,1036,1287,-251,-19.5,1221
2020-12-24,1036,1284,-248,-19.31,1221
2020-12-25,1154,1127,27,2.4,1221
2020-12-26,459,394,65,16.5,1221
2020-12-27,294,245,49,20.0,1221
2020-12-28,1087,1271,-184,-14.48,1221
2020-12-29,1036,1281,-245,-19.13,1221
2020-12-30,1036,1278,-242,-18.94,1221
2020-12-31,1036,1274,-238,-18.68,1221
2021-01-01,930,1116,-186,-16.67,1221
2021-01-02,396,383,13,3.39,1221
2021-01-03,282,232,50,21.55,1221
2021-01-04,995,1258,-263,-20.91,1221
2021-01-05,1010,1267,-257,-20.28,1221
2021-01-06,1010,1265,-255,-20.16,1221
2021-01-07,1010,1261,-251,-19.9,1221
2021-01-08,930,1103,-173,-15.68,1221
2021-01-09,396,370,26,7.03,1221
2021-01-10,282,220,62,28.18,1221
2021-01-11,995,1246,-251,-20.14,1221
2021-01-12,1010,1257,-247,-19.65,1221
2021-01-13,1010,1256,-246,-19.59,1221
2021-01-14,1010,1253,-243,-19.39,1221
2021-01-15,930,1097,-167,-15.22,1221
2021-01-16,396,366,30,8.2,1221
2021-01-17,282,218,64,29.36,1221
2021-01-18,995,1246,-251,-20.14,1221
2021-01-19,1010,1258,-248,-19.71,1221
2021-01-20,1010,1259,-249,-19.78,1221
2021-01-21,1010,1258,-248,-19.71,1221
2021-01-22,930,1104,-174,-15.76,1221
2021-01-23,396,374,22,5.88,1221
2021-01-24,282,228,54,23.68,1221
2021-01-25,995,1258,-263,-20.91,1221
2021-01-26,1010,1271,-261,-20.54,1221
2021-01-27,1010,1273,-263,-20.66,1221
2021-01-28,1010,1273,-263,-20.66,1221
2021-01-29,930,1120,-190,-16.96,1221
2021-01-30,396,391,5,1.28,1221
2021-01-31,282,245,37,15.1,1221
2021-02-01,1140,1275,-135,-10.59,1221
2021-02-02,1145,1290,-145,-11.24,1221
2021-02-03,1145,1292,-147,-11.38,1221
2021-02-04,1145,1292,-147,-11.38,1221
2021-02-05,1046,1139,-93,-8.17,1221
2021-02-06,414,410,4,0.98,1221
2021-02-07,272,264,8,3.03,1221
2021-02-08,1140,1294,-154,-11.9,1221
2021-02-09,1145,1308,-163,-12.46,1221
2021-02-10,1145,1310,-165,-12.6,1221
2021-02-11,1145,1310,-165,-12.6,1221
2021-02-12,1046,1156,-110,-9.52,1221
2021-02-13,414,427,-13,-3.04,1221
2021-02-14,272,281,-9,-3.2,1221
2021-02-15,1140,1311,-171,-13.04,1221
2021-02-16,1145,1325,-180,-13.58,1221
2021-02-17,1145,1327,-182,-13.72,1221
2021-02-18,1145,1327,-182,-13.72,1221
2021-02-19,1046,1173,-127,-10.83,1221
2021-02-20,414,443,-29,-6.55,1221
2021-02-21,272,297,-25,-8.42,1221
2021-02-22,1140,1326,-186,-14.03,1221
2021-02-23,1145,1340,-195,-14.55,1221
2021-02-24,1145,1341,-196,-14.62,1221
2021-02-25,1145,1340,-195,-14.55,1221
2021-02-26,1046,1185,-139,-11.73,1221
2021-02-27,414,455,-41,-9.01,1221
2021-02-28,272,308,-36,-11.69,1221
2021-03-01,1271,1337,-66,-4.94,1221
2021-03-02,1262,1349,-87,-6.45,1221
2021-03-03,1262,1349,-87,-6.45,1221
2021-03-04,1262,1348,-86,-6.38,1221
2021-03-05,1128,1192,-64,-5.37,1221
2021-03-06,447,461,-14,-3.04,1221
2021-03-07,295,314,-19,-6.05,1221
2021-03-08,1271,1342,-71,-5.29,1221
2021-03-09,1262,1354,-92,-6.79,1221
2021-03-10,1262,1354,-92,-6.79,1221
2021-03-11,1262,1352,-90,-6.66,1221
2021-03-12,1128,1197,-69,-5.76,1221
2021-03-13,447,466,-19,-4.08,1221
2021-03-14,295,318,-23,-7.23,1221
2021-03-15,1271,1347,-76,-5.64,1221
2021-03-16,1262,1359,-97,-7.14,1221
2021-03-17,1262,1360,-98,-7.21,1221
2021-03-18,1262,1359,-97,-7.14,1221
2021-03-19,1128,1205,-77,-6.39,1221
2021-03-20,447,475,-28,-5.89,1221
2021-03-21,295,329,-34,-10.33,1221
2021-03-22,1271,1359,-88,-6.48,1221
2021-03-23,1262,1372,-110,-8.02,1221
2021-03-24,1262,1374,-112,-8.15,1221
2021-03-25,1262,1374,-112,-8.15,1221
2021-03-26,1128,1221,-93,-7.62,1221
2021-03-27,447,492,-45,-9.15,1221
2021-03-28,295,346,-51,-14.74,1221
2021-03-29,1271,1376,-105,-7.63,1221
2021-03-30,1262,1390,-128,-9.21,1221
2021-03-31,1262,1392,-130,-9.34,1221
2021-04-01,1254,1392,-138,-9.91,1221
2021-04-02,1091,1239,-148,-11.95,1221
2021-04-03,446,509,-63,-12.38,1221
2021-04-04,272,363,-91,-25.07,1221
2021-04-05,1234,1392,-158,-11.35,1221
2021-04-06,1254,1405,-151,-10.75,1221
2021-04-07,1254,1406,-152,-10.81,1221
2021-04-08,1254,1405,-151,-10.75,1221
2021-04-09,1091,1250,-159,-12.72,1221
2021-04-10,446,519,-73,-14.07,1221
2021-04-11,272,372,-100,-26.88,1221
2021-04-12,1234,1400,-166,-11.86,1221
2021-04-13,1254,1412,-158,-11.19,1221
2021-04-14,1254,1412,-158,-11.19,1221
2021-04-15,1254,1410,-156,-11.06,1221
2021-04-16,1091,1255,-164,-13.07,1221
2021-04-17,446,524,-78,-14.89,1221
2021-04-18,272,376,-104,-27.66,1221
2021-04-19,1234,1404,-170,-12.11,1221
2021-04-20,1254,1417,-163,-11.5,1221
2021-04-21,1254,1418,-164,-11.57,1221
2021-04-22,1254,1417,-163,-11.5,1221
2021-04-23,1091,1262,-171,-13.55,1221
2021-04-24,446,533,-87,-16.32,1221
2021-04-25,272,387,-115,-29.72,1221
2021-04-26,1234,1417,-183,-12.91,1221
2021-04-27,1254,1431,-177,-12.37,1221
2021-04-28,1254,1433,-179,-12.49,1221
2021-04-29,1254,1434,-180,-12.55,1221
2021-04-30,1091,1281,-190,-14.83,1221
2021-05-01,492,553,-61,-11.03,1221
2021-05-02,288,408,-120,-29.41,1221
2021-05-03,1306,1439,-133,-9.24,1221
2021-05-04,1296,1454,-158,-10.87,1221
2021-05-05,1296,1456,-160,-10.99,1221
2021-05-06,1296,1458,-162,-11.11,1221
2021-05-07,1170,1305,-135,-10.34,1221
2021-05-08,492,576,-84,-14.58,1221
2021-05-09,288,430,-142,-33.02,1221
2021-05-10,1306,1460,-154,-10.55,1221
2021-05-11,1296,1473,-177,-12.02,1221
2021-05-12,1296,1474,-178,-12.08,1221
2021-05-13,1296,1473,-177,-12.02,1221
2021-05-14,1170,1318,-148,-11.23,1221
2021-05-15,492,587,-95,-16.18,1221
2021-05-16,288,439,-151,-34.4,1221
2021-05-17,1306,1466,-160,-10.91,1221
2021-05-18,1296,1477,-181,-12.25,1221
2021-05-19,1296,1476,-180,-12.2,1221
2021-05-20,1296,1473,-177,-12.02,1221
2021-05-21,1170,1316,-146,-11.09,1221
2021-05-22,492,583,-91,-15.61,1221
2021-05-23,288,433,-145,-33.49,1221
2021-05-24,1306,1459,-153,-10.49,1221
2021-05-25,1296,1469,-173,-11.78,1221
2021-05-26,1296,1468,-172,-11.72,1221
2021-05-27,1296,1464,-168,-11.48,1221
2021-05-28,1170,1307,-137,-10.48,1221
2021-05-29,492,575,-83,-14.43,1221
2021-05-30,288,426,-138,-32.39,1221
2021-05-31,1306,1453,-147,-10.12,1221
2021-06-01,1258,1465,-207,-14.13,1221
2021-06-02,1258,1464,-206,-14.07,1221
2021-06-03,1258,1463,-205,-14.01,1221
2021-06-04,1113,1307,-194,-14.84,1221
2021-06-05,470,577,-107,-18.54,1221
2021-06-06,313,429,-116,-27.04,1221
2021-06-07,1278,1458,-180,-12.35,1221
2021-06-08,1258,1471,-213,-14.48,1221
2021-06-09,1258,1471,-213,-14.48,1221
2021-06-10,1258,1470,-212,-14.42,1221
2021-06-11,1113,1315,-202,-15.36,1221
2021-06-12,470,585,-115,-19.66,1221
2021-06-13,313,437,-124,-28.38,1221
2021-06-14,1278,1465,-187,-12.76,1221
2021-06-15,1258,1477,-219,-14.83,1221
2021-06-16,1258,1476,-218,-14.77,1221
2021-06-17,1258,1473,-215,-14.6,1221
2021-06-18,1113,1316,-203,-15.43,1221
2021-06-19,470,582,-112,-19.24,1221
2021-06-20,313,432,-119,-27.55,1221
2021-06-21,1278,1457,-179,-12.29,1221
2021-06-22,1258,1465,-207,-14.13,1221
2021-06-23,1258,1461,-203,-13.89,1221
2021-06-24,1258,1455,-197,-13.54,1221
2021-06-25,1113,1294,-181,-13.99,1221
2021-06-26,470,558,-88,-15.77,1221
2021-06-27,313,405,-92,-22.72,1221
2021-06-28,1278,1427,-149,-10.44,1221
2021-06-29,1258,1433,-175,-12.21,1221
2021-06-30,1258,1428,-170,-11.9,1221
2021-07-01,1239,1420,-181,-12.75,1221
2021-07-02,1096,1259,-163,-12.95,1221
2021-07-03,421,523,-102,-19.5,1221
2021-07-04,304,370,-66,-17.84,1221
2021-07-05,1211,1393,-182,-13.07,1221
2021-07-06,1239,1401,-162,-11.56,1221
2021-07-07,1239,1397,-158,-11.31,1221
2021-07-08,1239,1392,-153,-10.99,1221
2021-07-09,1096,1234,-138,-11.18,1221
2021-07-10,421,500,-79,-15.8,1221
2021-07-11,304,350,-46,-13.14,1221
2021-07-12,1211,1377,-166,-12.06,1221
2021-07-13,1239,1387,-148,-10.67,1221
2021-07-14,1239,1386,-147,-10.61,1221
2021-07-15,1239,1384,-145,-10.48,1221
2021-07-16,1096,1228,-132,-10.75,1221
2021-07-17,421,497,-76,-15.29,1221
2021-07-18,304,348,-44,-12.64,1221
2021-07-19,1211,1376,-165,-11.99,1221
2021-07-20,1239,1388,-149,-10.73,1221
2021-07-21,1239,1387,-148,-10.67,1221
2021-07-22,1239,1384,-145,-10.48,1221
2021-07-23,1096,1228,-132,-10.75,1221
2021-07-24,421,495,-74,-14.95,1221
2021-07-25,304,345,-41,-11.88,1221
2021-07-26,1211,1370,-159,-11.61,1221
2021-07-27,1239,1379,-140,-10.15,1221
2021-07-28,1239,1375,-136,-9.89,1221
2021-07-29,1239,1369,-130,-9.5,1221
2021-07-30,1096,1209,-113,-9.35,1221
2021-07-31,421,473,-52,-10.99,1221
2021-08-01,306,319,-13,-4.08,1221
2021-08-02,1225,1341,-116,-8.65,1221
2021-08-03,1191,1347,-156,-11.58,1221
2021-08-04,1191,1340,-149,-11.12,1221
2021-08-05,1191,1332,-141,-10.59,1221
2021-08-06,1092,1170,-78,-6.67,1221
2021-08-07,438,433,5,1.15,1221
2021-08-08,306,278,28,10.07,1221
2021-08-09,1225,1301,-76,-5.84,1221
2021-08-10,1191,1307,-116,-8.88,1221
2021-08-11,1191,1302,-111,-8.53,1221
2021-08-12,1191,1296,-105,-8.1,1221
2021-08-13,1092,1137,-45,-3.96,1221
2021-08-14,438,403,35,8.68,1221
2021-08-15,306,253,53,20.95,1221
2021-08-16,1225,1280,-55,-4.3,1221
2021-08-17,1191,1292,-101,-7.82,1221
2021-08-18,1191,1292,-101,-7.82,1221
2021-08-19,1191,1292,-101,-7.82,1221
2021-08-20,1092,1139,-47,-4.13,1221
2021-08-21,438,411,27,6.57,1221
2021-08-22,306,267,39,14.61,1221
2021-08-23,1225,1300,-75,-5.77,1221
2021-08-24,1191,1317,-126,-9.57,1221
2021-08-25,1191,1323,-132,-9.98,1221
2021-08-26,1191,1328,-137,-10.32,1221
2021-08-27,1092,1179,-87,-7.38,1221
2021-08-28,438,455,-17,-3.74,1221
2021-08-29,306,314,-8,-2.55,1221
2021-08-30,1225,1348,-123,-9.12,1221
2021-08-31,1191,1367,-176,-12.87,1221
2021-09-01,1286,1373,-87,-6.34,1221
2021-09-02,1286,1378,-92,-6.68,1221
2021-09-03,1170,1228,-58,-4.72,1221
2021-09-04,462,502,-40,-7.97,1221
2021-09-05,312,359,-47,-13.09,1221
2021-09-06,1268,1391,-123,-8.84,1221
2021-09-07,1286,1407,-121,-8.6,1221
2021-09-08,1286,1409,-123,-8.73,1221
2021-09-09,1286,1410,-124,-8.79,1221
2021-09-10,1170,1256,-86,-6.85,1221
2021-09-11,462,526,-64,-12.17,1221
2021-09-12,312,379,-67,-17.68,1221
2021-09-13,1268,1407,-139,-9.88,1221
2021-09-14,1286,1418,-132,-9.31,1221
2021-09-15,1286,1417,-131,-9.24,1221
2021-09-16,1286,1414,-128,-9.05,1221
2021-09-17,1170,1257,-87,-6.92,1221
2021-09-18,462,524,-62,-11.83,1221
2021-09-19,312,374,-62,-16.58,1221
2021-09-20,1268,1401,-133,-9.49,1221
2021-09-21,1286,1411,-125,-8.86,1221
2021-09-22,1286,1409,-123,-8.73,1221
2021-09-23,1286,1405,-119,-8.47,1221
2021-09-24,1170,1248,-78,-6.25,1221
2021-09-25,462,516,-54,-10.47,1221
2021-09-26,312,367,-55,-14.99,1221
2021-09-27,1268,1394,-126,-9.04,1221
2021-09-28,1286,1405,-119,-8.47,1221
2021-09-29,1286,1405,-119,-8.47,1221
2021-09-30,1286,1403,-117,-8.34,1221
2021-10-01,1159,1247,-88,-7.06,1221
2021-10-02,457,516,-59,-11.43,1221
2021-10-03,297,368,-71,-19.29,1221
2021-10-04,1215,1396,-181,-12.97,1221
2021-10-05,1265,1409,-144,-10.22,1221
2021-10-06,1265,1409,-144,-10.22,1221
2021-10-07,1265,1407,-142,-10.09,1221
2021-10-08,1159,1252,-93,-7.43,1221
2021-10-09,457,521,-64,-12.28,1221
2021-10-10,297,373,-76,-20.38,1221
2021-10-11,1215,1401,-186,-13.28,1221
2021-10-12,1265,1412,-147,-10.41,1221
2021-10-13,1265,1412,-147,-10.41,1221
2021-10-14,1265,1409,-144,-10.22,1221
2021-10-15,1159,1252,-93,-7.43,1221
2021-10-16,457,520,-63,-12.12,1221
2021-10-17,297,371,-74,-19.95,1221
2021-10-18,1215,1397,-182,-13.03,1221
2021-10-19,1265,1408,-143,-10.16,1221
2021-10-20,1265,1406,-141,-10.03,1221
2021-10-21,1265,1402,-137,-9.77,1221
2021-10-22,1159,1245,-86,-6.91,1221
2021-10-23,457,512,-55,-10.74,1221
2021-10-24,297,363,-66,-18.18,1221
2021-10-25,1215,1389,-174,-12.53,1221
2021-10-26,1265,1399,-134,-9.58,1221
2021-10-27,1265,1398,-133,-9.51,1221
2021-10-28,1265,1395,-130,-9.32,1221
2021-10-29,1159,1239,-80,-6.46,1221
2021-10-30,457,507,-50,-9.86,1221
2021-10-31,297,359,-62,-17.27,1221
2021-11-01,1264,1386,-122,-8.8,1221
2021-11-02,1268,1398,-130,-9.3,1221
2021-11-03,1268,1398,-130,-9.3,1221
2021-11-04,1268,1397,-129,-9.23,1221
2021-11-05,1172,1241,-69,-5.56,1221
2021-11-06,452,511,-59,-11.55,1221
2021-11-07,300,363,-63,-17.36,1221
2021-11-08,1264,1391,-127,-9.13,1221
2021-11-09,1268,1403,-135,-9.62,1221
2021-11-10,1268,1403,-135,-9.62,1221
2021-11-11,1268,1402,-134,-9.56,1221
2021-11-12,1172,1246,-74,-5.94,1221
2021-11-13,452,514,-62,-12.06,1221
2021-11-14,300,365,-65,-17.81,1221
2021-11-15,1264,1392,-128,-9.2,1221
2021-11-16,1268,1402,-134,-9.56,1221
2021-11-17,1268,1400,-132,-9.43,1221
2021-11-18,1268,1396,-128,-9.17,1221
2021-11-19,1172,1237,-65,-5.25,1221
2021-11-20,452,503,-51,-10.14,1221
2021-11-21,300,351,-51,-14.53,1221
2021-11-22,1264,1375,-111,-8.07,1221
2021-11-23,1268,1382,-114,-8.25,1221
2021-11-24,1268,1378,-110,-7.98,1221
2021-11-25,1268,1371,-103,-7.51,1221
2021-11-26,1172,1210,-38,-3.14,1221
2021-11-27,452,474,-22,-4.64,1221
2021-11-28,300,320,-20,-6.25,1221
2021-11-29,1264,1343,-79,-5.88,1221
2021-11-30,1268,1350,-82,-6.07,1221
2021-12-01,1034,1344,-310,-23.07,1221
2021-12-02,1034,1337,-303,-22.66,1221
2021-12-03,848,1177,-329,-27.95,1221
2021-12-04,467,441,26,5.9,1221
2021-12-05,279,289,-10,-3.46,1221
2021-12-06,1138,1312,-174,-13.26,1221
2021-12-07,1034,1321,-287,-21.73,1221
2021-12-08,1034,1317,-283,-21.49,1221
2021-12-09,1034,1312,-278,-21.19,1221
2021-12-10,848,1154,-306,-26.52,1221
2021-12-11,467,420,47,11.19,1221
2021-12-12,279,270,9,3.33,1221
2021-12-13,1138,1296,-158,-12.19,1221
2021-12-14,1034,1306,-272,-20.83,1221
2021-12-15,1034,1305,-271,-20.77,1221
2021-12-16,1034,1302,-268,-20.58,1221
2021-12-17,848,1145,-297,-25.94,1221
2021-12-18,467,413,54,13.08,1221
2021-12-19,279,264,15,5.68,1221
2021-12-20,1138,1291,-153,-11.85,1221
2021-12-21,1034,1302,-268,-20.58,1221
2021-12-22,1034,1301,-267,-20.52,1221
2021-12-23,1034,1298,-264,-20.34,1221
2021-12-24,848,1141,-293,-25.68,1221
2021-12-25,467,409,58,14.18,1221
2021-12-26,279,259,20,7.72,1221
2021-12-27,1138,1286,-148,-11.51,1221
2021-12-28,1034,1296,-262,-20.22,1221
2021-12-29,1034,1294,-260,-20.09,1221
2021-12-30,1034,1290,-256,-19.84,1221
2021-12-31,848,1132,-284,-25.09,1221
2022-01-01,383,398,-15,-3.77,1221
2022-01-02,263,248,15,6.05,1221
2022-01-03,1046,1273,-227,-17.83,1221
2022-01-04,1034,1283,-249,-19.41,1221
2022-01-05,1034,1280,-246,-19.22,1221
2022-01-06,1034,1276,-242,-18.97,1221
2022-01-07,947,1118,-171,-15.3,1221
2022-01-08,383,385,-2,-0.52,1221
2022-01-09,263,235,28,11.91,1221
2022-01-10,1046,1261,-215,-17.05,1221
2022-01-11,1034,1271,-237,-18.65,1221
2022-01-12,1034,1270,-236,-18.58,1221
2022-01-13,1034,1267,-233,-18.39,1221
2022-01-14,947,1110,-163,-14.68,1221
2022-01-15,383,378,5,1.32,1221
2022-01-16,263,230,33,14.35,1221
2022-01-17,1046,1258,-212,-16.85,1221
2022-01-18,1034,1270,-236,-18.58,1221
2022-01-19,1034,1270,-236,-18.58,1221
2022-01-20,1034,1269,-235,-18.52,1221
2022-01-21,947,1115,-168,-15.07,1221
2022-01-22,383,385,-2,-0.52,1221
2022-01-23,263,238,25,10.5,1221
2022-01-24,1046,1268,-222,-17.51,1221
2022-01-25,1034,1281,-247,-19.28,1221
2022-01-26,1034,1283,-249,-19.41,1221
2022-01-27,1034,1283,-249,-19.41,1221
2022-01-28,947,1130,-183,-16.19,1221
2022-01-29,383,401,-18,-4.49,1221
2022-01-30,263,255,8,3.14,1221
2020-02-01,486,255,231,90.59,1622
2020-02-02,314,52,262,503.85,1622
2020-02-03,1536,1352,184,13.61,1622
2020-02-04,1485,1368,117,8.55,1622
2020-02-05,1485,1376,109,7.92,1622
2020-02-06,1485,1379,106,7.69,1622
2020-02-07,1350,1157,193,16.68,1622
2020-02-08,486,281,205,72.95,1622
2020-02-09,314,74,240,324.32,1622
2020-02-10,1536,1371,165,12.04,1622
2020-02-11,1485,1384,101,7.3,1622
2020-02-12,1485,1389,96,6.91,1622
2020-02-13,1485,1391,94,6.76,1622
2020-02-14,1350,1168,182,15.58,1622
2020-02-15,486,292,194,66.44,1622
2020-02-16,314,85,229,269.41,1622
2020-02-17,1536,1382,154,11.14,1622
2020-02-18,1485,1398,87,6.22,1622
2020-02-19,1485,1405,80,5.69,1622
2020-02-20,1485,1410,75,5.32,1622
2020-02-21,1350,1191,159,13.35,1622
2020-02-22,486,318,168,52.83,1622
2020-02-23,314,115,199,173.04,1622
2020-02-24,1536,1417,119,8.4,1622
2020-02-25,1485,1437,48,3.34,1622
2020-02-26,1485,1448,37,2.56,1622
2020-02-27,1485,1457,28,1.92,1622
2020-02-28,1350,1241,109,8.78,1622
2020-02-29,486,372,114,30.65,1622
2020-03-01,339,171,168,98.25,1622
2020-03-02,1419,1475,-56,-3.8,1622
2020-03-03,1425,1496,-71,-4.75,1622
2020-03-04,1425,1508,-83,-5.5,1622
2020-03-05,1425,1516,-91,-6.0,1622
2020-03-06,1256,1299,-43,-3.31,1622
2020-03-07,428,428,0,0.0,1622
2020-03-08,339,226,113,50.0,1622
2020-03-09,1419,1526,-107,-7.01,1622
2020-03-10,1425,1544,-119,-7.71,1622
2020-03-11,1425,1552,-127,-8.18,1622
2020-03-12,1425,1556,-131,-8.42,1622
2020-03-13,1256,1334,-78,-5.85,1622
2020-03-14,428,459,-31,-6.75,1622
2020-03-15,339,251,88,35.06,1622
2020-03-16,1419,1548,-129,-8.33,1622
2020-03-17,1425,1561,-136,-8.71,1622
2020-03-18,1425,1565,-140,-8.95,1622
2020-03-19,1425,1565,-140,-8.95,1622
2020-03-20,1256,1341,-85,-6.34,1622
2020-03-21,428,463,-35,-7.56,1622
2020-03-22,339,253,86,33.99,1622
2020-03-23,1419,1548,-129,-8.33,1622
2020-03-24,1425,1560,-135,-8.65,1622
2020-03-25,1425,1564,-139,-8.89,1622
2020-03-26,1425,1565,-140,-8.95,1622
2020-03-27,1256,1342,-86,-6.41,1622
2020-03-28,428,465,-37,-7.96,1622
2020-03-29,339,258,81,31.4,1622
2020-03-30,1419,1555,-136,-8.75,1622
2020-03-31,1425,1570,-145,-9.24,1622
2020-04-01,1374,1576,-202,-12.82,1622
2020-04-02,1374,1580,-206,-13.04,1622
2020-04-03,1120,1359,-239,-17.59,1622
2020-04-04,339,485,-146,-30.1,1622
2020-04-05,257,280,-23,-8.21,1622
2020-04-06,1344,1579,-235,-14.88,1622
2020-04-07,1374,1596,-222,-13.91,1622
2020-04-08,1374,1604,-230,-14.34,1622
2020-04-09,1374,1609,-235,-14.61,1622
2020-04-10,1120,1389,-269,-19.37,1622
2020-04-11,339,514,-175,-34.05,1622
2020-04-12,257,309,-52,-16.83,1622
2020-04-13,1344,1608,-264,-16.42,1622
2020-04-14,1374,1623,-249,-15.34,1622
2020-04-15,1374,1629,-255,-15.65,1622
2020-04-16,1374,1632,-258,-15.81,1622
2020-04-17,1120,1410,-290,-20.57,1622
2020-04-18,339,533,-194,-36.4,1622
2020-04-19,257,326,-69,-21.17,1622
2020-04-20,1344,1622,-278,-17.14,1622
2020-04-21,1374,1635,-261,-15.96,1622
2020-04-22,1374,1639,-265,-16.17,1622
2020-04-23,1374,1640,-266,-16.22,1622
2020-04-24,1120,1416,-296,-20.9,1622
2020-04-25,339,538,-199,-36.99,1622
2020-04-26,257,329,-72,-21.88,1622
2020-04-27,1344,1625,-281,-17.29,1622
2020-04-28,1374,1637,-263,-16.07,1622
2020-04-29,1374,1642,-268,-16.32,1622
2020-04-30,1374,1643,-269,-16.37,1622
2020-05-01,1377,1420,-43,-3.03,1622
2020-05-02,443,543,-100,-18.42,1622
2020-05-03,248,335,-87,-25.97,1622
2020-05-04,1529,1632,-103,-6.31,1622
2020-05-05,1535,1647,-112,-6.8,1622
2020-05-06,1535,1653,-118,-7.14,1622
2020-05-07,1535,1656,-121,-7.31,1622
2020-05-08,1377,1434,-57,-3.97,1622
2020-05-09,443,559,-116,-20.75,1622
2020-05-10,248,353,-105,-29.75,1622
2020-05-11,1529,1651,-122,-7.39,1622
2020-05-12,1535,1666,-131,-7.86,1622
2020-05-13,1535,1673,-138,-8.25,1622
2020-05-14,1535,1676,-141,-8.41,1622
2020-05-15,1377,1455,-78,-5.36,1622
2020-05-16,443,579,-136,-23.49,1622
2020-05-17,248,372,-124,-33.33,1622
2020-05-18,1529,1669,-140,-8.39,1622
2020-05-19,1535,1683,-148,-8.79,1622
2020-05-20,1535,1688,-153,-9.06,1622
2020-05-21,1535,1690,-155,-9.17,1622
2020-05-22,1377,1466,-89,-6.07,1622
2020-05-23,443,589,-146,-24.79,1622
2020-05-24,248,380,-132,-34.74,1622
2020-05-25,1529,1675,-146,-8.72,1622
2020-05-26,1535,1687,-152,-9.01,1622
2020-05-27,1535,1691,-156,-9.23,1622
2020-05-28,1535,1691,-156,-9.23,1622
2020-05-29,1377,1466,-89,-6.07,1622
2020-05-30,443,588,-145,-24.66,1622
2020-05-31,248,379,-131,-34.56,1622
2020-06-01,1624,1674,-50,-2.99,1622
2020-06-02,1643,1686,-43,-2.55,1622
2020-06-03,1643,1690,-47,-2.78,1622
2020-06-04,1643,1692,-49,-2.9,1622
2020-06-05,1206,1468,-262,-17.85,1622
2020-06-06,513,591,-78,-13.2,1622
2020-06-07,360,383,-23,-6.01,1622
2020-06-08,1624,1680,-56,-3.33,1622
2020-06-09,1643,1694,-51,-3.01,1622
2020-06-10,1643,1700,-57,-3.35,1622
2020-06-11,1643,1703,-60,-3.52,1622
2020-06-12,1206,1480,-274,-18.51,1622
2020-06-13,513,605,-92,-15.21,1622
2020-06-14,360,398,-38,-9.55,1622
2020-06-15,1624,1695,-71,-4.19,1622
2020-06-16,1643,1709,-66,-3.86,1622
2020-06-17,1643,1715,-72,-4.2,1622
2020-06-18,1643,1717,-74,-4.31,1622
2020-06-19,1206,1493,-287,-19.22,1622
2020-06-20,513,616,-103,-16.72,1622
2020-06-21,360,407,-47,-11.55,1622
2020-06-22,1624,1702,-78,-4.58,1622
2020-06-23,1643,1714,-71,-4.14,1622
2020-06-24,1643,1716,-73,-4.25,1622
2020-06-25,1643,1715,-72,-4.2,1622
2020-06-26,1206,1489,-283,-19.01,1622
2020-06-27,513,609,-96,-15.76,1622
2020-06-28,360,397,-37,-9.32,1622
2020-06-29,1624,1689,-65,-3.85,1622
2020-06-30,1643,1698,-55,-3.24,1622
2020-07-01,1499,1699,-200,-11.77,1622
2020-07-02,1499,1696,-197,-11.62,1622
2020-07-03,1245,1468,-223,-15.19,1622
2020-07-04,388,587,-199,-33.9,1622
2020-07-05,227,375,-148,-39.47,1622
2020-07-06,1491,1667,-176,-10.56,1622
2020-07-07,1499,1676,-177,-10.56,1622
2020-07-08,1499,1678,-179,-10.67,1622
2020-07-09,1499,1677,-178,-10.61,1622
2020-07-10,1245,1451,-206,-14.2,1622
2020-07-11,388,572,-184,-32.17,1622
2020-07-12,227,362,-135,-37.29,1622
2020-07-13,1491,1658,-167,-10.07,1622
2020-07-14,1499,1670,-171,-10.24,1622
2020-07-15,1499,1675,-176,-10.51,1622
2020-07-16,1499,1677,-178,-10.61,1622
2020-07-17,1245,1454,-209,-14.37,1622
2020-07-18,388,577,-189,-32.76,1622
2020-07-19,227,370,-143,-38.65,1622
2020-07-20,1491,1667,-176,-10.56,1622
2020-07-21,1499,1681,-182,-10.83,1622
2020-07-22,1499,1687,-188,-11.14,1622
2020-07-23,1499,1689,-190,-11.25,1622
2020-07-24,1245,1465,-220,-15.02,1622
2020-07-25,388,588,-200,-34.01,1622
2020-07-26,227,379,-152,-40.11,1622
2020-07-27,1491,1674,-183,-10.93,1622
2020-07-28,1499,1686,-187,-11.09,1622
2020-07-29,1499,1688,-189,-11.2,1622
2020-07-30,1499,1686,-187,-11.09,1622
2020-07-31,1245,1459,-214,-14.67,1622
2020-08-01,404,578,-174,-30.1,1622
2020-08-02,162,366,-204,-55.74,1622
2020-08-03,1414,1657,-243,-14.67,1622
2020-08-04,1264,1665,-401,-24.08,1622
2020-08-05,1264,1664,-400,-24.04,1622
2020-08-06,1264,1659,-395,-23.81,1622
2020-08-07,987,1430,-443,-30.98,1622
2020-08-08,404,547,-143,-26.14,1622
2020-08-09,162,333,-171,-51.35,1622
2020-08-10,1414,1624,-210,-12.93,1622
2020-08-11,1264,1632,-368,-22.55,1622
2020-08-12,1264,1633,-369,-22.6,1622
2020-08-13,1264,1631,-367,-22.5,1622
2020-08-14,987,1404,-417,-29.7,1622
2020-08-15,404,525,-121,-23.05,1622
2020-08-16,162,316,-154,-48.73,1622
2020-08-17,1414,1612,-198,-12.28,1622
2020-08-18,1264,1626,-362,-22.26,1622
2020-08-19,1264,1632,-368,-22.55,1622
2020-08-20,1264,1636,-372,-22.74,1622
2020-08-21,987,1416,-429,-30.3,1622
2020-08-22,404,544,-140,-25.74,1622
2020-08-23,162,341,-179,-52.49,1622
2020-08-24,1414,1643,-229,-13.94,1622
2020-08-25,1264,1663,-399,-23.99,1622
2020-08-26,1264,1675,-411,-24.54,1622
2020-08-27,1264,1684,-420,-24.94,1622
2020-08-28,987,1468,-481,-32.77,1622
2020-08-29,404,599,-195,-32.55,1622
2020-08-30,162,399,-237,-59.4,1622
2020-08-31,1414,1703,-289,-16.97,1622
2020-09-01,1424,1724,-300,-17.4,1622
2020-09-02,1424,1736,-312,-17.97,1622
2020-09-03,1424,1745,-321,-18.4,1622
2020-09-04,1300,1528,-228,-14.92,1622
2020-09-05,352,656,-304,-46.34,1622
2020-09-06,277,453,-176,-38.85,1622
2020-09-07,1366,1754,-388,-22.12,1622
2020-09-08,1424,1771,-347,-19.59,1622
2020-09-09,1424,1778,-354,-19.91,1622
2020-09-10,1424,1782,-358,-20.09,1622
2020-09-11,1300,1560,-260,-16.67,1622
2020-09-12,352,683,-331,-48.46,1622
2020-09-13,277,475,-198,-41.68,1622
2020-09-14,1366,1771,-405,-22.87,1622
2020-09-15,1424,1783,-359,-20.13,1622
2020-09-16,1424,1787,-363,-20.31,1622
2020-09-17,1424,1787,-363,-20.31,1622
2020-09-18,1300,1561,-261,-16.72,1622
2020-09-19,352,682,-330,-48.39,1622
2020-09-20,277,472,-195,-41.31,1622
2020-09-21,1366,1765,-399,-22.61,1622
2020-09-22,1424,1776,-352,-19.82,1622
2020-09-23,1424,1779,-355,-19.96,1622
2020-09-24,1424,1778,-354,-19.91,1622
2020-09-25,1300,1552,-252,-16.24,1622
2020-09-26,352,673,-321,-47.7,1622
2020-09-27,277,463,-186,-40.17,1622
2020-09-28,1366,1758,-392,-22.3,1622
2020-09-29,1424,1769,-345,-19.5,1622
2020-09-30,1424,1772,-348,-19.64,1622
2020-10-01,1416,1772,-356,-20.09,1622
2020-10-02,1241,1547,-306,-19.78,1622
2020-10-03,380,669,-289,-43.2,1622
2020-10-04,152,459,-307,-66.88,1622
2020-10-05,1373,1753,-380,-21.68,1622
2020-10-06,1416,1764,-348,-19.73,1622
2020-10-07,1416,1767,-351,-19.86,1622
2020-10-08,1416,1766,-350,-19.82,1622
2020-10-09,1241,1540,-299,-19.42,1622
2020-10-10,380,661,-281,-42.51,1622
2020-10-11,152,450,-298,-66.22,1622
2020-10-12,1373,1743,-370,-21.23,1622
2020-10-13,1416,1753,-337,-19.22,1622
2020-10-14,1416,1755,-339,-19.32,1622
2020-10-15,1416,1753,-337,-19.22,1622
2020-10-16,1241,1527,-286,-18.73,1622
2020-10-17,380,647,-267,-41.27,1622
2020-10-18,152,436,-284,-65.14,1622
2020-10-19,1373,1730,-357,-20.64,1622
2020-10-20,1416,1741,-325,-18.67,1622
2020-10-21,1416,1744,-328,-18.81,1622
2020-10-22,1416,1745,-329,-18.85,1622
2020-10-23,1241,1521,-280,-18.41,1622
2020-10-24,380,645,-265,-41.09,1622
2020-10-25,152,438,-286,-65.3,1622
2020-10-26,1373,1735,-362,-20.86,1622
2020-10-27,1416,1751,-335,-19.13,1622
2020-10-28,1416,1759,-343,-19.5,1622
2020-10-29,1416,1764,-348,-19.73,1622
2020-10-30,1241,1546,-305,-19.73,1622
2020-10-31,380,674,-294,-43.62,1622
2020-11-01,147,471,-324,-68.79,1622
2020-11-02,1368,1773,-405,-22.84,1622
2020-11-03,1385,1792,-407,-22.71,1622
2020-11-04,1385,1803,-418,-23.18,1622
2020-11-05,1385,1811,-426,-23.52,1622
2020-11-06,1201,1593,-392,-24.61,1622
2020-11-07,326,722,-396,-54.85,1622
2020-11-08,147,519,-372,-71.68,1622
2020-11-09,1368,1819,-451,-24.79,1622
2020-11-10,1385,1836,-451,-24.56,1622
2020-11-11,1385,1843,-458,-24.85,1622
2020-11-12,1385,1846,-461,-24.97,1622
2020-11-13,1201,1622,-421,-25.96,1622
2020-11-14,326,744,-418,-56.18,1622
2020-11-15,147,533,-386,-72.42,1622
2020-11-16,1368,1826,-458,-25.08,1622
2020-11-17,1385,1834,-449,-24.48,1622
2020-11-18,1385,1832,-447,-24.4,1622
2020-11-19,1385,1825,-440,-24.11,1622
2020-11-20,1201,1593,-392,-24.61,1622
2020-11-21,326,706,-380,-53.82,1622
2020-11-22,147,486,-339,-69.75,1622
2020-11-23,1368,1770,-402,-22.71,1622
2020-11-24,1385,1770,-385,-21.75,1622
2020-11-25,1385,1762,-377,-21.4,1622
2020-11-26,1385,1749,-364,-20.81,1622
2020-11-27,1201,1512,-311,-20.57,1622
2020-11-28,326,621,-295,-47.5,1622
2020-11-29,147,399,-252,-63.16,1622
2020-11-30,1368,1681,-313,-18.62,1622
2020-12-01,1046,1681,-635,-37.78,1622
2020-12-02,1046,1673,-627,-37.48,1622
2020-12-03,1046,1663,-617,-37.1,1622
2020-12-04,1157,1429,-272,-19.03,1622
2020-12-05,357,542,-185,-34.13,1622
2020-12-06,162,324,-162,-50.0,1622
2020-12-07,1076,1612,-536,-33.25,1622
2020-12-08,1046,1618,-572,-35.35,1622
2020-12-09,1046,1616,-570,-35.27,1622
2020-12-10,1046,1612,-566,-35.11,1622
2020-12-11,1157,1384,-227,-16.4,1622
2020-12-12,357,502,-145,-28.88,1622
2020-12-13,162,290,-128,-44.14,1622
2020-12-14,1076,1583,-507,-32.03,1622
2020-12-15,1046,1593,-547,-34.34,1622
2020-12-16,1046,1594,-548,-34.38,1622
2020-12-17,1046,1592,-546,-34.3,1622
2020-12-18,1157,1365,-208,-15.24,1622
2020-12-19,357,484,-127,-26.24,1622
2020-12-20,162,271,-109,-40.22,1622
2020-12-21,1076,1562,-486,-31.11,1622
2020-12-22,1046,1569,-523,-33.33,1622
2020-12-23,1046,1567,-521,-33.25,1622
2020-12-24,1046,1561,-515,-32.99,1622
2020-12-25,1157,1329,-172,-12.94,1622
2020-12-26,357,442,-85,-19.23,1622
2020-12-27,162,224,-62,-27.68,1622
2020-12-28,1076,1508,-432,-28.65,1622
2020-12-29,1046,1510,-464,-30.73,1622
2020-12-30,1046,1502,-456,-30.36,1622
2020-12-31,1046,1490,-444,-29.8,1622
2021-01-01,1041,1253,-212,-16.92,1622
2021-01-02,250,363,-113,-31.13,1622
2021-01-03,135,141,-6,-4.26,1622
2021-01-04,1002,1423,-421,-29.59,1622
2021-01-05,1056,1423,-367,-25.79,1622
2021-01-06,1056,1415,-359,-25.37,1622
2021-01-07,1056,1405,-349,-24.84,1622
2021-01-08,1041,1170,-129,-11.03,1622
2021-01-09,250,283,-33,-11.66,1622
2021-01-10,135,66,69,104.55,1622
2021-01-11,1002,1354,-352,-26.0,1622
2021-01-12,1056,1361,-305,-22.41,1622
2021-01-13,1056,1361,-305,-22.41,1622
2021-01-14,1056,1358,-302,-22.24,1622
2021-01-15,1041,1133,-92,-8.12,1622
2021-01-16,250,255,-5,-1.96,1622
2021-01-17,135,47,88,187.23,1622
2021-01-18,1002,1344,-342,-25.45,1622
2021-01-19,1056,1360,-304,-22.35,1622
2021-01-20,1056,1369,-313,-22.86,1622
2021-01-21,1056,1375,-319,-23.2,1622
2021-01-22,1041,1156,-115,-9.95,1622
2021-01-23,250,285,-35,-12.28,1622
2021-01-24,135,83,52,62.65,1622
2021-01-25,1002,1386,-384,-27.71,1622
2021-01-26,1056,1406,-350,-24.89,1622
2021-01-27,1056,1417,-361,-25.48,1622
2021-01-28,1056,1425,-369,-25.89,1622
2021-01-29,1041,1208,-167,-13.82,1622
2021-01-30,250,336,-86,-25.6,1622
2021-01-31,135,133,2,1.5,1622
2021-02-01,1271,1434,-163,-11.37,1622
2021-02-02,1247,1451,-204,-14.06,1622
2021-02-03,1247,1459,-212,-14.53,1622
2021-02-04,1247,1464,-217,-14.82,1622
2021-02-05,1114,1243,-129,-10.38,1622
2021-02-06,303,367,-64,-17.44,1622
2021-02-07,140,160,-20,-12.5,1622
2021-02-08,1271,1457,-186,-12.77,1622
2021-02-09,1247,1471,-224,-15.23,1622
2021-02-10,1247,1476,-229,-15.51,1622
2021-02-11,1247,1478,-231,-15.63,1622
2021-02-12,1114,1255,-141,-11.24,1622
2021-02-13,303,378,-75,-19.84,1622
2021-02-14,140,171,-31,-18.13,1622
2021-02-15,1271,1468,-197,-13.42,1622
2021-02-16,1247,1483,-236,-15.91,1622
2021-02-17,1247,1489,-242,-16.25,1622
2021-02-18,1247,1493,-246,-16.48,1622
2021-02-19,1114,1273,-159,-12.49,1622
2021-02-20,303,400,-97,-24.25,1622
2021-02-21,140,196,-56,-28.57,1622
2021-02-22,1271,1497,-226,-15.1,1622
2021-02-23,1247,1516,-269,-17.74,1622
2021-02-24,1247,1527,-280,-18.34,1622
2021-02-25,1247,1535,-288,-18.76,1622
2021-02-26,1114,1319,-205,-15.54,1622
2021-02-27,303,449,-146,-32.52,1622
2021-02-28,140,249,-109,-43.78,1622
2021-03-01,1383,1553,-170,-10.95,1622
2021-03-02,1443,1574,-131,-8.32,1622
2021-03-03,1443,1586,-143,-9.02,1622
2021-03-04,1443,1595,-152,-9.53,1622
2021-03-05,1275,1378,-103,-7.47,1622
2021-03-06,340,508,-168,-33.07,1622
2021-03-07,161,306,-145,-47.39,1622
2021-03-08,1383,1608,-225,-13.99,1622
2021-03-09,1443,1626,-183,-11.25,1622
2021-03-10,1443,1635,-192,-11.74,1622
2021-03-11,1443,1640,-197,-12.01,1622
2021-03-12,1275,1419,-144,-10.15,1622
2021-03-13,340,544,-204,-37.5,1622
2021-03-14,161,338,-177,-52.37,1622
2021-03-15,1383,1635,-252,-15.41,1622
2021-03-16,1443,1648,-205,-12.44,1622
2021-03-17,1443,1653,-210,-12.7,1622
2021-03-18,1443,1654,-211,-12.76,1622
2021-03-19,1275,1429,-154,-10.78,1622
2021-03-20,340,551,-211,-38.29,1622
2021-03-21,161,342,-181,-52.92,1622
2021-03-22,1383,1637,-254,-15.52,1622
2021-03-23,1443,1649,-206,-12.49,1622
2021-03-24,1443,1653,-210,-12.7,1622
2021-03-25,1443,1653,-210,-12.7,1622
2021-03-26,1275,1429,-154,-10.78,1622
2021-03-27,340,552,-212,-38.41,1622
2021-03-28,161,344,-183,-53.2,1622
2021-03-29,1383,1641,-258,-15.72,1622
2021-03-30,1443,1655,-212,-12.81,1622
2021-03-31,1443,1661,-218,-13.12,1622
2021-04-01,1459,1665,-206,-12.37,1622
2021-04-02,1161,1443,-282,-19.54,1622
2021-04-03,368,569,-201,-35.33,1622
2021-04-04,143,364,-221,-60.71,1622
2021-04-05,1415,1663,-248,-14.91,1622
2021-04-06,1459,1679,-220,-13.1,1622
2021-04-07,1459,1687,-228,-13.52,1622
2021-04-08,1459,1692,-233,-13.77,1622
2021-04-09,1161,1472,-311,-21.13,1622
2021-04-10,368,598,-230,-38.46,1622
2021-04-11,143,393,-250,-63.61,1622
2021-04-12,1415,1692,-277,-16.37,1622
2021-04-13,1459,1707,-248,-14.53,1622
2021-04-14,1459,1714,-255,-14.88,1622
2021-04-15,1459,1718,-259,-15.08,1622
2021-04-16,1161,1496,-335,-22.39,1622
2021-04-17,368,620,-252,-40.65,1622
2021-04-18,143,412,-269,-65.29,1622
2021-04-19,1415,1709,-294,-17.2,1622
2021-04-20,1459,1722,-263,-15.27,1622
2021-04-21,1459,1727,-268,-15.52,1622
2021-04-22,1459,1728,-269,-15.57,1622
2021-04-23,1161,1504,-343,-22.81,1622
2021-04-24,368,626,-258,-41.21,1622
2021-04-25,143,417,-274,-65.71,1622
2021-04-26,1415,1713,-298,-17.4,1622
2021-04-27,1459,1725,-266,-15.42,1622
2021-04-28,1459,1729,-270,-15.62,1622
2021-04-29,1459,1730,-271,-15.66,1622
2021-04-30,1161,1507,-346,-22.96,1622
2021-05-01,368,630,-262,-41.59,1622
2021-05-02,212,422,-210,-49.76,1622
2021-05-03,1447,1718,-271,-15.77,1622
2021-05-04,1416,1733,-317,-18.29,1622
2021-05-05,1416,1738,-322,-18.53,1622
2021-05-06,1416,1741,-325,-18.67,1622
2021-05-07,1144,1519,-375,-24.69,1622
2021-05-08,368,644,-276,-42.86,1622
2021-05-09,212,438,-226,-51.6,1622
2021-05-10,1447,1736,-289,-16.65,1622
2021-05-11,1416,1751,-335,-19.13,1622
2021-05-12,1416,1758,-342,-19.45,1622
2021-05-13,1416,1761,-345,-19.59,1622
2021-05-14,1144,1540,-396,-25.71,1622
2021-05-15,368,664,-296,-44.58,1622
2021-05-16,212,458,-246,-53.71,1622
2021-05-17,1447,1755,-308,-17.55,1622
2021-05-18,1416,1770,-354,-20.0,1622
2021-05-19,1416,1775,-359,-20.23,1622
2021-05-20,1416,1777,-361,-20.32,1622
2021-05-21,1144,1554,-410,-26.38,1622
2021-05-22,368,677,-309,-45.64,1622
2021-05-23,212,468,-256,-54.7,1622
2021-05-24,1447,1763,-316,-17.92,1622
2021-05-25,1416,1776,-360,-20.27,1622
2021-05-26,1416,1780,-364,-20.45,1622
2021-05-27,1416,1780,-364,-20.45,1622
2021-05-28,1144,1555,-411,-26.43,1622
2021-05-29,368,677,-309,-45.64,1622
2021-05-30,212,468,-256,-54.7,1622
2021-05-31,1447,1762,-315,-17.88,1622
2021-06-01,1450,1775,-325,-18.31,1622
2021-06-02,1450,1778,-328,-18.45,1622
2021-06-03,1450,1779,-329,-18.49,1622
2021-06-04,1180,1555,-375,-24.12,1622
2021-06-05,371,678,-307,-45.28,1622
2021-06-06,183,470,-287,-61.06,1622
2021-06-07,1433,1767,-334,-18.9,1622
2021-06-08,1450,1780,-330,-18.54,1622
2021-06-09,1450,1786,-336,-18.81,1622
2021-06-10,1450,1788,-338,-18.9,1622
2021-06-11,1180,1566,-386,-24.65,1622
2021-06-12,371,690,-319,-46.23,1622
2021-06-13,183,483,-300,-62.11,1622
2021-06-14,1433,1781,-348,-19.54,1622
2021-06-15,1450,1795,-345,-19.22,1622
2021-06-16,1450,1801,-351,-19.49,1622
2021-06-17,1450,1803,-353,-19.58,1622
2021-06-18,1180,1580,-400,-25.32,1622
2021-06-19,371,703,-332,-47.23,1622
2021-06-20,183,495,-312,-63.03,1622
2021-06-21,1433,1791,-358,-19.99,1622
2021-06-22,1450,1803,-353,-19.58,1622
2021-06-23,1450,1806,-356,-19.71,1622
2021-06-24,1450,1806,-356,-19.71,1622
2021-06-25,1180,1580,-400,-25.32,1622
2021-06-26,371,700,-329,-47.0,1622
2021-06-27,183,489,-306,-62.58,1622
2021-06-28,1433,1781,-348,-19.54,1622
2021-06-29,1450,1791,-341,-19.04,1622
2021-06-30,1450,1791,-341,-19.04,1622
2021-07-01,1279,1789,-510,-28.51,1622
2021-07-02,1062,1561,-499,-31.97,1622
2021-07-03,350,679,-329,-48.45,1622
2021-07-04,220,467,-247,-52.89,1622
2021-07-05,1322,1759,-437,-24.84,1622
2021-07-06,1279,1768,-489,-27.66,1622
2021-07-07,1279,1769,-490,-27.7,1622
2021-07-08,1279,1767,-488,-27.62,1622
2021-07-09,1062,1541,-479,-31.08,1622
2021-07-10,350,662,-312,-47.13,1622
2021-07-11,220,452,-232,-51.33,1622
2021-07-12,1322,1746,-424,-24.28,1622
2021-07-13,1279,1758,-479,-27.25,1622
2021-07-14,1279,1762,-483,-27.41,1622
2021-07-15,1279,1764,-485,-27.49,1622
2021-07-16,1062,1540,-478,-31.04,1622
2021-07-17,350,664,-314,-47.29,1622
2021-07-18,220,456,-236,-51.75,1622
2021-07-19,1322,1753,-431,-24.59,1622
2021-07-20,1279,1767,-488,-27.62,1622
2021-07-21,1279,1773,-494,-27.86,1622
2021-07-22,1279,1775,-496,-27.94,1622
2021-07-23,1062,1552,-490,-31.57,1622
2021-07-24,350,676,-326,-48.22,1622
2021-07-25,220,467,-247,-52.89,1622
2021-07-26,1322,1763,-441,-25.01,1622
2021-07-27,1279,1775,-496,-27.94,1622
2021-07-28,1279,1778,-499,-28.07,1622
2021-07-29,1279,1777,-498,-28.02,1622
2021-07-30,1062,1551,-489,-31.53,1622
2021-07-31,350,671,-321,-47.84,1622
2021-08-01,112,459,-347,-75.6,1622
2021-08-02,1036,1750,-714,-40.8,1622
2021-08-03,1037,1759,-722,-41.05,1622
2021-08-04,1037,1758,-721,-41.01,1622
2021-08-05,1037,1754,-717,-40.88,1622
2021-08-06,820,1525,-705,-46.23,1622
2021-08-07,238,642,-404,-62.93,1622
2021-08-08,112,428,-316,-73.83,1622
2021-08-09,1036,1718,-682,-39.7,1622
2021-08-10,1037,1726,-689,-39.92,1622
2021-08-11,1037,1726,-689,-39.92,1622
2021-08-12,1037,1723,-686,-39.81,1622
2021-08-13,820,1495,-675,-45.15,1622
2021-08-14,238,615,-377,-61.3,1622
2021-08-15,112,405,-293,-72.35,1622
2021-08-16,1036,1699,-663,-39.02,1622
2021-08-17,1037,1712,-675,-39.43,1622
2021-08-18,1037,1717,-680,-39.6,1622
2021-08-19,1037,1720,-683,-39.71,1622
2021-08-20,820,1499,-679,-45.3,1622
2021-08-21,238,625,-387,-61.92,1622
2021-08-22,112,422,-310,-73.46,1622
2021-08-23,1036,1723,-687,-39.87,1622
2021-08-24,1037,1742,-705,-40.47,1622
2021-08-25,1037,1753,-716,-40.84,1622
2021-08-26,1037,1762,-725,-41.15,1622
2021-08-27,820,1546,-726,-46.96,1622
2021-08-28,238,677,-439,-64.84,1622
2021-08-29,112,477,-365,-76.52,1622
2021-08-30,1036,1781,-745,-41.83,1622
2021-08-31,1037,1802,-765,-42.45,1622
2021-09-01,1717,1814,-97,-5.35,1622
2021-09-02,1717,1823,-106,-5.81,1622
2021-09-03,1532,1607,-75,-4.67,1622
2021-09-04,630,736,-106,-14.4,1622
2021-09-05,376,534,-158,-29.59,1622
2021-09-06,1716,1835,-119,-6.49,1622
2021-09-07,1717,1853,-136,-7.34,1622
2021-09-08,1717,1862,-145,-7.79,1622
2021-09-09,1717,1866,-149,-7.98,1622
2021-09-10,1532,1645,-113,-6.87,1622
2021-09-11,630,770,-140,-18.18,1622
2021-09-12,376,562,-186,-33.1,1622
2021-09-13,1716,1859,-143,-7.69,1622
2021-09-14,1717,1872,-155,-8.28,1622
2021-09-15,1717,1876,-159,-8.48,1622
2021-09-16,1717,1876,-159,-8.48,1622
2021-09-17,1532,1651,-119,-7.21,1622
2021-09-18,630,772,-142,-18.39,1622
2021-09-19,376,562,-186,-33.1,1622
2021-09-20,1716,1855,-139,-7.49,1622
2021-09-21,1717,1866,-149,-7.98,1622
2021-09-22,1717,1869,-152,-8.13,1622
2021-09-23,1717,1868,-151,-8.08,1622
2021-09-24,1532,1642,-110,-6.7,1622
2021-09-25,630,763,-133,-17.43,1622
2021-09-26,376,553,-177,-32.01,1622
2021-09-27,1716,1847,-131,-7.09,1622
2021-09-28,1717,1859,-142,-7.64,1622
2021-09-29,1717,1862,-145,-7.79,1622
2021-09-30,1717,1862,-145,-7.79,1622
2021-10-01,1571,1636,-65,-3.97,1622
2021-10-02,638,758,-120,-15.83,1622
2021-10-03,340,548,-208,-37.96,1622
2021-10-04,1649,1843,-194,-10.53,1622
2021-10-05,1711,1854,-143,-7.71,1622
2021-10-06,1711,1857,-146,-7.86,1622
2021-10-07,1711,1856,-145,-7.81,1622
2021-10-08,1571,1631,-60,-3.68,1622
2021-10-09,638,751,-113,-15.05,1622
2021-10-10,340,541,-201,-37.15,1622
2021-10-11,1649,1834,-185,-10.09,1622
2021-10-12,1711,1844,-133,-7.21,1622
2021-10-13,1711,1846,-135,-7.31,1622
2021-10-14,1711,1844,-133,-7.21,1622
2021-10-15,1571,1618,-47,-2.9,1622
2021-10-16,638,738,-100,-13.55,1622
2021-10-17,340,527,-187,-35.48,1622
2021-10-18,1649,1820,-171,-9.4,1622
2021-10-19,1711,1831,-120,-6.55,1622
2021-10-20,1711,1833,-122,-6.66,1622
2021-10-21,1711,1833,-122,-6.66,1622
2021-10-22,1571,1609,-38,-2.36,1622
2021-10-23,638,731,-93,-12.72,1622
2021-10-24,340,524,-184,-35.11,1622
2021-10-25,1649,1821,-172,-9.45,1622
2021-10-26,1711,1835,-124,-6.76,1622
2021-10-27,1711,1842,-131,-7.11,1622
2021-10-28,1711,1847,-136,-7.36,1622
2021-10-29,1571,1627,-56,-3.44,1622
2021-10-30,638,755,-117,-15.5,1622
2021-10-31,340,552,-212,-38.41,1622
2021-11-01,1656,1853,-197,-10.63,1622
2021-11-02,1757,1872,-115,-6.14,1622
2021-11-03,1757,1883,-126,-6.69,1622
2021-11-04,1757,1890,-133,-7.04,1622
2021-11-05,1498,1673,-175,-10.46,1622
2021-11-06,626,802,-176,-21.95,1622
2021-11-07,353,600,-247,-41.17,1622
2021-11-08,1656,1901,-245,-12.89,1622
2021-11-09,1757,1918,-161,-8.39,1622
2021-11-10,1757,1927,-170,-8.82,1622
2021-11-11,1757,1931,-174,-9.01,1622
2021-11-12,1498,1709,-211,-12.35,1622
2021-11-13,626,833,-207,-24.85,1622
2021-11-14,353,624,-271,-43.43,1622
2021-11-15,1656,1918,-262,-13.66,1622
2021-11-16,1757,1927,-170,-8.82,1622
2021-11-17,1757,1927,-170,-8.82,1622
2021-11-18,1757,1922,-165,-8.58,1622
2021-11-19,1498,1691,-193,-11.41,1622
2021-11-20,626,805,-179,-22.24,1622
2021-11-21,353,587,-234,-39.86,1622
2021-11-22,1656,1872,-216,-11.54,1622
2021-11-23,1757,1874,-117,-6.24,1622
2021-11-24,1757,1866,-109,-5.84,1622
2021-11-25,1757,1854,-97,-5.23,1622
2021-11-26,1498,1617,-119,-7.36,1622
2021-11-27,626,726,-100,-13.77,1622
2021-11-28,353,503,-150,-29.82,1622
2021-11-29,1656,1786,-130,-7.28,1622
2021-11-30,1757,1785,-28,-1.57,1622
2021-12-01,1357,1777,-420,-23.64,1622
2021-12-02,1357,1765,-408,-23.12,1622
2021-12-03,1146,1530,-384,-25.1,1622
2021-12-04,589,642,-53,-8.26,1622
2021-12-05,316,423,-107,-25.3,1622
2021-12-06,1508,1710,-202,-11.81,1622
2021-12-07,1357,1715,-358,-20.87,1622
2021-12-08,1357,1712,-355,-20.74,1622
2021-12-09,1357,1706,-349,-20.46,1622
2021-12-10,1146,1477,-331,-22.41,1622
2021-12-11,589,595,-6,-1.01,1622
2021-12-12,316,382,-66,-17.28,1622
2021-12-13,1508,1674,-166,-9.92,1622
2021-12-14,1357,1684,-327,-19.42,1622
2021-12-15,1357,1685,-328,-19.47,1622
2021-12-16,1357,1684,-327,-19.42,1622
2021-12-17,1146,1457,-311,-21.35,1622
2021-12-18,589,576,13,2.26,1622
2021-12-19,316,364,-48,-13.19,1622
2021-12-20,1508,1656,-148,-8.94,1622
2021-12-21,1357,1664,-307,-18.45,1622
2021-12-22,1357,1663,-306,-18.4,1622
2021-12-23,1357,1658,-301,-18.15,1622
2021-12-24,1146,1427,-281,-19.69,1622
2021-12-25,589,541,48,8.87,1622
2021-12-26,316,324,-8,-2.47,1622
2021-12-27,1508,1610,-102,-6.34,1622
2021-12-28,1357,1612,-255,-15.82,1622
2021-12-29,1357,1605,-248,-15.45,1622
2021-12-30,1357,1594,-237,-14.87,1622
2021-12-31,1146,1357,-211,-15.55,1622
2022-01-01,498,467,31,6.64,1622
2022-01-02,295,245,50,20.41,1622
2022-01-03,1326,1528,-202,-13.22,1622
2022-01-04,1355,1527,-172,-11.26,1622
2022-01-05,1355,1519,-164,-10.8,1622
2022-01-06,1355,1507,-152,-10.09,1622
2022-01-07,1244,1272,-28,-2.2,1622
2022-01-08,498,383,115,30.03,1622
2022-01-09,295,165,130,78.79,1622
2022-01-10,1326,1452,-126,-8.68,1622
2022-01-11,1355,1457,-102,-7.0,1622
2022-01-12,1355,1455,-100,-6.87,1622
2022-01-13,1355,1451,-96,-6.62,1622
2022-01-14,1244,1223,21,1.72,1622
2022-01-15,498,343,155,45.19,1622
2022-01-16,295,134,161,120.15,1622
2022-01-17,1326,1430,-104,-7.27,1622
2022-01-18,1355,1444,-89,-6.16,1622
2022-01-19,1355,1451,-96,-6.62,1622
2022-01-20,1355,1456,-101,-6.94,1622
2022-01-21,1244,1237,7,0.57,1622
2022-01-22,498,365,133,36.44,1622
2022-01-23,295,163,132,80.98,1622
2022-01-24,1326,1465,-139,-9.49,1622
2022-01-25,1355,1485,-130,-8.75,1622
2022-01-26,1355,1496,-141,-9.43,1622
2022-01-27,1355,1504,-149,-9.91,1622
2022-01-28,1244,1287,-43,-3.34,1622
2022-01-29,498,416,82,19.71,1622
2022-01-30,295,214,81,37.85,1622
2020-02-01,380,347,33,9.51,1626
2020-02-02,292,255,37,14.51,1626
2020-02-03,1114,1273,-159,-12.49,1626
2020-02-04,1107,1319,-212,-16.07,1626
2020-02-05,1107,1336,-229,-17.14,1626
2020-02-06,1107,1361,-254,-18.66,1626
2020-02-07,1004,1206,-202,-16.75,1626
2020-02-08,380,468,-88,-18.8,1626
2020-02-09,292,370,-78,-21.08,1626
2020-02-10,1114,1381,-267,-19.33,1626
2020-02-11,1107,1419,-312,-21.99,1626
2020-02-12,1107,1428,-321,-22.48,1626
2020-02-13,1107,1444,-337,-23.34,1626
2020-02-14,1004,1279,-275,-21.5,1626
2020-02-15,380,532,-152,-28.57,1626
2020-02-16,292,425,-133,-31.29,1626
2020-02-17,1114,1426,-312,-21.88,1626
2020-02-18,1107,1455,-348,-23.92,1626
2020-02-19,1107,1455,-348,-23.92,1626
2020-02-20,1107,1464,-357,-24.39,1626
2020-02-21,1004,1291,-287,-22.23,1626
2020-02-22,380,537,-157,-29.24,1626
2020-02-23,292,425,-133,-31.29,1626
2020-02-24,1114,1421,-307,-21.6,1626
2020-02-25,1107,1447,-340,-23.5,1626
2020-02-26,1107,1444,-337,-23.34,1626
2020-02-27,1107,1450,-343,-23.66,1626
2020-02-28,1004,1277,-273,-21.38,1626
2020-02-29,380,522,-142,-27.2,1626
2020-03-01,286,410,-124,-30.24,1626
2020-03-02,1018,1407,-389,-27.65,1626
2020-03-03,955,1434,-479,-33.4,1626
2020-03-04,955,1433,-478,-33.36,1626
2020-03-05,955,1442,-487,-33.77,1626
2020-03-06,857,1271,-414,-32.57,1626
2020-03-07,352,519,-167,-32.18,1626
2020-03-08,286,409,-123,-30.07,1626
2020-03-09,1018,1409,-391,-27.75,1626
2020-03-10,955,1438,-483,-33.59,1626
2020-03-11,955,1439,-484,-33.63,1626
2020-03-12,955,1449,-494,-34.09,1626
2020-03-13,857,1279,-422,-32.99,1626
2020-03-14,352,528,-176,-33.33,1626
2020-03-15,286,418,-132,-31.58,1626
2020-03-16,1018,1418,-400,-28.21,1626
2020-03-17,955,1447,-492,-34.0,1626
2020-03-18,955,1447,-492,-34.0,1626
2020-03-19,955,1456,-501,-34.41,1626
2020-03-20,857,1284,-427,-33.26,1626
2020-03-21,352,532,-180,-33.83,1626
2020-03-22,286,420,-134,-31.9,1626
2020-03-23,1018,1418,-400,-28.21,1626
2020-03-24,955,1444,-489,-33.86,1626
2020-03-25,955,1442,-487,-33.77,1626
2020-03-26,955,1449,-494,-34.09,1626
2020-03-27,857,1275,-418,-32.78,1626
2020-03-28,352,520,-168,-32.31,1626
2020-03-29,286,407,-121,-29.73,1626
2020-03-30,1018,1403,-385,-27.44,1626
2020-03-31,955,1428,-473,-33.12,1626
2020-04-01,953,1425,-472,-33.12,1626
2020-04-02,953,1431,-478,-33.4,1626
2020-04-03,815,1257,-442,-35.16,1626
2020-04-04,315,502,-187,-37.25,1626
2020-04-05,267,389,-122,-31.36,1626
2020-04-06,982,1385,-403,-29.1,1626
2020-04-07,953,1411,-458,-32.46,1626
2020-04-08,953,1409,-456,-32.36,1626
2020-04-09,953,1416,-463,-32.7,1626
2020-04-10,815,1244,-429,-34.49,1626
2020-04-11,315,490,-175,-35.71,1626
2020-04-12,267,378,-111,-29.37,1626
2020-04-13,982,1377,-395,-28.69,1626
2020-04-14,953,1404,-451,-32.12,1626
2020-04-15,953,1404,-451,-32.12,1626
2020-04-16,953,1412,-459,-32.51,1626
2020-04-17,815,1241,-426,-34.33,1626
2020-04-18,315,488,-173,-35.45,1626
2020-04-19,267,378,-111,-29.37,1626
2020-04-20,982,1377,-395,-28.69,1626
2020-04-21,953,1405,-452,-32.17,1626
2020-04-22,953,1405,-452,-32.17,1626
2020-04-23,953,1414,-461,-32.6,1626
2020-04-24,815,1243,-428,-34.43,1626
2020-04-25,315,490,-175,-35.71,1626
2020-04-26,267,380,-113,-29.74,1626
2020-04-27,982,1379,-397,-28.79,1626
2020-04-28,953,1406,-453,-32.22,1626
2020-04-29,953,1406,-453,-32.22,1626
2020-04-30,953,1415,-462,-32.65,1626
2020-05-01,1030,1243,-213,-17.14,1626
2020-05-02,485,490,-5,-1.02,1626
2020-05-03,298,379,-81,-21.37,1626
2020-05-04,1174,1378,-204,-14.8,1626
2020-05-05,1156,1405,-249,-17.72,1626
2020-05-06,1156,1405,-249,-17.72,1626
2020-05-07,1156,1413,-257,-18.19,1626
2020-05-08,1030,1241,-211,-17.0,1626
2020-05-09,485,488,-3,-0.61,1626
2020-05-10,298,377,-79,-20.95,1626
2020-05-11,1174,1376,-202,-14.68,1626
2020-05-12,1156,1403,-247,-17.61,1626
2020-05-13,1156,1402,-246,-17.55,1626
2020-05-14,1156,1411,-255,-18.07,1626
2020-05-15,1030,1239,-209,-16.87,1626
2020-05-16,485,486,-1,-0.21,1626
2020-05-17,298,374,-76,-20.32,1626
2020-05-18,1174,1372,-198,-14.43,1626
2020-05-19,1156,1399,-243,-17.37,1626
2020-05-20,1156,1398,-242,-17.31,1626
2020-05-21,1156,1406,-250,-17.78,1626
2020-05-22,1030,1234,-204,-16.53,1626
2020-05-23,485,480,5,1.04,1626
2020-05-24,298,368,-70,-19.02,1626
2020-05-25,1174,1365,-191,-13.99,1626
2020-05-26,1156,1392,-236,-16.95,1626
2020-05-27,1156,1390,-234,-16.83,1626
2020-05-28,1156,1397,-241,-17.25,1626
2020-05-29,1030,1224,-194,-15.85,1626
2020-05-30,485,469,16,3.41,1626
2020-05-31,298,356,-58,-16.29,1626
2020-06-01,1134,1353,-219,-16.19,1626
2020-06-02,1152,1379,-227,-16.46,1626
2020-06-03,1152,1377,-225,-16.34,1626
2020-06-04,1152,1383,-231,-16.7,1626
2020-06-05,1001,1210,-209,-17.27,1626
2020-06-06,399,455,-56,-12.31,1626
2020-06-07,301,342,-41,-11.99,1626
2020-06-08,1134,1339,-205,-15.31,1626
2020-06-09,1152,1365,-213,-15.6,1626
2020-06-10,1152,1363,-211,-15.48,1626
2020-06-11,1152,1370,-218,-15.91,1626
2020-06-12,1001,1197,-196,-16.37,1626
2020-06-13,399,442,-43,-9.73,1626
2020-06-14,301,330,-29,-8.79,1626
2020-06-15,1134,1327,-193,-14.54,1626
2020-06-16,1152,1353,-201,-14.86,1626
2020-06-17,1152,1351,-199,-14.73,1626
2020-06-18,1152,1358,-206,-15.17,1626
2020-06-19,1001,1186,-185,-15.6,1626
2020-06-20,399,432,-33,-7.64,1626
2020-06-21,301,319,-18,-5.64,1626
2020-06-22,1134,1316,-182,-13.83,1626
2020-06-23,1152,1342,-190,-14.16,1626
2020-06-24,1152,1340,-188,-14.03,1626
2020-06-25,1152,1347,-195,-14.48,1626
2020-06-26,1001,1174,-173,-14.74,1626
2020-06-27,399,419,-20,-4.77,1626
2020-06-28,301,306,-5,-1.63,1626
2020-06-29,1134,1303,-169,-12.97,1626
2020-06-30,1152,1328,-176,-13.25,1626
2020-07-01,1106,1326,-220,-16.59,1626
2020-07-02,1106,1332,-226,-16.97,1626
2020-07-03,995,1158,-163,-14.08,1626
2020-07-04,384,404,-20,-4.95,1626
2020-07-05,294,291,3,1.03,1626
2020-07-06,1079,1287,-208,-16.16,1626
2020-07-07,1106,1313,-207,-15.77,1626
2020-07-08,1106,1311,-205,-15.64,1626
2020-07-09,1106,1317,-211,-16.02,1626
2020-07-10,995,1144,-149,-13.02,1626
2020-07-11,384,390,-6,-1.54,1626
2020-07-12,294,278,16,5.76,1626
2020-07-13,1079,1275,-196,-15.37,1626
2020-07-14,1106,1302,-196,-15.05,1626
2020-07-15,1106,1301,-195,-14.99,1626
2020-07-16,1106,1308,-202,-15.44,1626
2020-07-17,995,1136,-141,-12.41,1626
2020-07-18,384,383,1,0.26,1626
2020-07-19,294,271,23,8.49,1626
2020-07-20,1079,1269,-190,-14.97,1626
2020-07-21,1106,1296,-190,-14.66,1626
2020-07-22,1106,1295,-189,-14.59,1626
2020-07-23,1106,1303,-197,-15.12,1626
2020-07-24,995,1131,-136,-12.02,1626
2020-07-25,384,377,7,1.86,1626
2020-07-26,294,265,29,10.94,1626
2020-07-27,1079,1262,-183,-14.5,1626
2020-07-28,1106,1288,-182,-14.13,1626
2020-07-29,1106,1285,-179,-13.93,1626
2020-07-30,1106,1292,-186,-14.4,1626
2020-07-31,995,1118,-123,-11.0,1626
2020-08-01,384,362,22,6.08,1626
2020-08-02,282,248,34,13.71,1626
2020-08-03,1056,1244,-188,-15.11,1626
2020-08-04,1046,1268,-222,-17.51,1626
2020-08-05,1046,1264,-218,-17.25,1626
2020-08-06,1046,1269,-223,-17.57,1626
2020-08-07,918,1094,-176,-16.09,1626
2020-08-08,384,338,46,13.61,1626
2020-08-09,282,224,58,25.89,1626
2020-08-10,1056,1219,-163,-13.37,1626
2020-08-11,1046,1244,-198,-15.92,1626
2020-08-12,1046,1241,-195,-15.71,1626
2020-08-13,1046,1247,-201,-16.12,1626
2020-08-14,918,1074,-156,-14.53,1626
2020-08-15,384,321,63,19.63,1626
2020-08-16,282,209,73,34.93,1626
2020-08-17,1056,1208,-152,-12.58,1626
2020-08-18,1046,1236,-190,-15.37,1626
2020-08-19,1046,1237,-191,-15.44,1626
2020-08-20,1046,1247,-201,-16.12,1626
2020-08-21,918,1079,-161,-14.92,1626
2020-08-22,384,329,55,16.72,1626
2020-08-23,282,222,60,27.03,1626
2020-08-24,1056,1226,-170,-13.87,1626
2020-08-25,1046,1258,-212,-16.85,1626
2020-08-26,1046,1263,-217,-17.18,1626
2020-08-27,1046,1278,-232,-18.15,1626
2020-08-28,918,1112,-194,-17.45,1626
2020-08-29,384,366,18,4.92,1626
2020-08-30,282,262,20,7.63,1626
2020-08-31,1056,1267,-211,-16.65,1626
2020-09-01,1156,1301,-145,-11.15,1626
2020-09-02,1156,1307,-151,-11.55,1626
2020-09-03,1156,1321,-165,-12.49,1626
2020-09-04,1043,1156,-113,-9.78,1626
2020-09-05,388,408,-20,-4.9,1626
2020-09-06,297,302,-5,-1.66,1626
2020-09-07,1099,1305,-206,-15.79,1626
2020-09-08,1156,1337,-181,-13.54,1626
2020-09-09,1156,1340,-184,-13.73,1626
2020-09-10,1156,1351,-195,-14.43,1626
2020-09-11,1043,1182,-139,-11.76,1626
2020-09-12,388,431,-43,-9.98,1626
2020-09-13,297,322,-25,-7.76,1626
2020-09-14,1099,1321,-222,-16.81,1626
2020-09-15,1156,1349,-193,-14.31,1626
2020-09-16,1156,1349,-193,-14.31,1626
2020-09-17,1156,1357,-201,-14.81,1626
2020-09-18,1043,1186,-143,-12.06,1626
2020-09-19,388,433,-45,-10.39,1626
2020-09-20,297,321,-24,-7.48,1626
2020-09-21,1099,1319,-220,-16.68,1626
2020-09-22,1156,1346,-190,-14.12,1626
2020-09-23,1156,1346,-190,-14.12,1626
2020-09-24,1156,1354,-198,-14.62,1626
2020-09-25,1043,1182,-139,-11.76,1626
2020-09-26,388,430,-42,-9.77,1626
2020-09-27,297,320,-23,-7.19,1626
2020-09-28,1099,1320,-221,-16.74,1626
2020-09-29,1156,1349,-193,-14.31,1626
2020-09-30,1156,1350,-194,-14.37,1626
2020-10-01,1144,1360,-216,-15.88,1626
2020-10-02,1035,1191,-156,-13.1,1626
2020-10-03,377,440,-63,-14.32,1626
2020-10-04,289,332,-43,-12.95,1626
2020-10-05,1244,1333,-89,-6.68,1626
2020-10-06,1144,1363,-219,-16.07,1626
2020-10-07,1144,1366,-222,-16.25,1626
2020-10-08,1144,1377,-233,-16.92,1626
2020-10-09,1035,1207,-172,-14.25,1626
2020-10-10,377,457,-80,-17.51,1626
2020-10-11,289,348,-59,-16.95,1626
2020-10-12,1244,1348,-104,-7.72,1626
2020-10-13,1144,1377,-233,-16.92,1626
2020-10-14,1144,1378,-234,-16.98,1626
2020-10-15,1144,1387,-243,-17.52,1626
2020-10-16,1035,1215,-180,-14.81,1626
2020-10-17,377,462,-85,-18.4,1626
2020-10-18,289,351,-62,-17.66,1626
2020-10-19,1244,1349,-105,-7.78,1626
2020-10-20,1144,1375,-231,-16.8,1626
2020-10-21,1144,1373,-229,-16.68,1626
2020-10-22,1144,1380,-236,-17.1,1626
2020-10-23,1035,1207,-172,-14.25,1626
2020-10-24,377,452,-75,-16.59,1626
2020-10-25,289,339,-50,-14.75,1626
2020-10-26,1244,1336,-92,-6.89,1626
2020-10-27,1144,1362,-218,-16.01,1626
2020-10-28,1144,1361,-217,-15.94,1626
2020-10-29,1144,1368,-224,-16.37,1626
2020-10-30,1035,1196,-161,-13.46,1626
2020-10-31,377,443,-66,-14.9,1626
2020-11-01,277,332,-55,-16.57,1626
2020-11-02,1136,1331,-195,-14.65,1626
2020-11-03,1124,1359,-235,-17.29,1626
2020-11-04,1124,1359,-235,-17.29,1626
2020-11-05,1124,1369,-245,-17.9,1626
2020-11-06,1019,1199,-180,-15.01,1626
2020-11-07,380,449,-69,-15.37,1626
2020-11-08,277,340,-63,-18.53,1626
2020-11-09,1136,1341,-205,-15.29,1626
2020-11-10,1124,1370,-246,-17.96,1626
2020-11-11,1124,1372,-248,-18.08,1626
2020-11-12,1124,1382,-258,-18.67,1626
2020-11-13,1019,1212,-193,-15.92,1626
2020-11-14,380,461,-81,-17.57,1626
2020-11-15,277,350,-73,-20.86,1626
2020-11-16,1136,1349,-213,-15.79,1626
2020-11-17,1124,1377,-253,-18.37,1626
2020-11-18,1124,1375,-251,-18.25,1626
2020-11-19,1124,1382,-258,-18.67,1626
2020-11-20,1019,1208,-189,-15.65,1626
2020-11-21,380,452,-72,-15.93,1626
2020-11-22,277,337,-60,-17.8,1626
2020-11-23,1136,1331,-195,-14.65,1626
2020-11-24,1124,1354,-230,-16.99,1626
2020-11-25,1124,1348,-224,-16.62,1626
2020-11-26,1124,1350,-226,-16.74,1626
2020-11-27,1019,1172,-153,-13.05,1626
2020-11-28,380,412,-32,-7.77,1626
2020-11-29,277,294,-17,-5.78,1626
2020-11-30,1136,1285,-149,-11.6,1626
2020-12-01,927,1305,-378,-28.97,1626
2020-12-02,927,1298,-371,-28.58,1626
2020-12-03,927,1299,-372,-28.64,1626
2020-12-04,1019,1121,-102,-9.1,1626
2020-12-05,387,362,25,6.91,1626
2020-12-06,274,245,29,11.84,1626
2020-12-07,953,1239,-286,-23.08,1626
2020-12-08,927,1262,-335,-26.55,1626
2020-12-09,927,1258,-331,-26.31,1626
2020-12-10,927,1264,-337,-26.66,1626
2020-12-11,1019,1090,-71,-6.51,1626
2020-12-12,387,335,52,15.52,1626
2020-12-13,274,223,51,22.87,1626
2020-12-14,953,1222,-269,-22.01,1626
2020-12-15,927,1249,-322,-25.78,1626
2020-12-16,927,1249,-322,-25.78,1626
2020-12-17,927,1259,-332,-26.37,1626
2020-12-18,1019,1088,-69,-6.34,1626
2020-12-19,387,336,51,15.18,1626
2020-12-20,274,226,48,21.24,1626
2020-12-21,953,1225,-272,-22.2,1626
2020-12-22,927,1253,-326,-26.02,1626
2020-12-23,927,1252,-325,-25.96,1626
2020-12-24,927,1260,-333,-26.43,1626
2020-12-25,1019,1087,-68,-6.26,1626
2020-12-26,387,332,55,16.57,1626
2020-12-27,274,217,57,26.27,1626
2020-12-28,953,1212,-259,-21.37,1626
2020-12-29,927,1234,-307,-24.88,1626
2020-12-30,927,1228,-301,-24.51,1626
2020-12-31,927,1230,-303,-24.63,1626
2021-01-01,844,1051,-207,-19.7,1626
2021-01-02,350,290,60,20.69,1626
2021-01-03,267,171,96,56.14,1626
2021-01-04,900,1160,-260,-22.41,1626
2021-01-05,950,1178,-228,-19.35,1626
2021-01-06,950,1169,-219,-18.73,1626
2021-01-07,950,1168,-218,-18.66,1626
2021-01-08,844,987,-143,-14.49,1626
2021-01-09,350,226,124,54.87,1626
2021-01-10,267,107,160,149.53,1626
2021-01-11,900,1099,-199,-18.11,1626
2021-01-12,950,1120,-170,-15.18,1626
2021-01-13,950,1115,-165,-14.8,1626
2021-01-14,950,1121,-171,-15.25,1626
2021-01-15,844,947,-103,-10.88,1626
2021-01-16,350,195,155,79.49,1626
2021-01-17,267,85,182,214.12,1626
2021-01-18,900,1087,-187,-17.2,1626
2021-01-19,950,1120,-170,-15.18,1626
2021-01-20,950,1127,-177,-15.71,1626
2021-01-21,950,1144,-194,-16.96,1626
2021-01-22,844,983,-139,-14.14,1626
2021-01-23,350,243,107,44.03,1626
2021-01-24,267,146,121,82.88,1626
2021-01-25,900,1160,-260,-22.41,1626
2021-01-26,950,1204,-254,-21.1,1626
2021-01-27,950,1221,-271,-22.19,1626
2021-01-28,950,1247,-297,-23.82,1626
2021-01-29,844,1095,-251,-22.92,1626
2021-01-30,350,361,-11,-3.05,1626
2021-01-31,267,270,-3,-1.11,1626
2021-02-01,1004,1288,-284,-22.05,1626
2021-02-02,1037,1334,-297,-22.26,1626
2021-02-03,1037,1353,-316,-23.36,1626
2021-02-04,1037,1379,-342,-24.8,1626
2021-02-05,917,1225,-308,-25.14,1626
2021-02-06,352,488,-136,-27.87,1626
2021-02-07,256,392,-136,-34.69,1626
2021-02-08,1004,1404,-400,-28.49,1626
2021-02-09,1037,1444,-407,-28.19,1626
2021-02-10,1037,1455,-418,-28.73,1626
2021-02-11,1037,1473,-436,-29.6,1626
2021-02-12,917,1310,-393,-30.0,1626
2021-02-13,352,564,-212,-37.59,1626
2021-02-14,256,458,-202,-44.1,1626
2021-02-15,1004,1461,-457,-31.28,1626
2021-02-16,1037,1492,-455,-30.5,1626
2021-02-17,1037,1493,-456,-30.54,1626
2021-02-18,1037,1503,-466,-31.0,1626
2021-02-19,917,1331,-414,-31.1,1626
2021-02-20,352,578,-226,-39.1,1626
2021-02-21,256,466,-210,-45.06,1626
2021-02-22,1004,1463,-459,-31.37,1626
2021-02-23,1037,1488,-451,-30.31,1626
2021-02-24,1037,1486,-449,-30.22,1626
2021-02-25,1037,1492,-455,-30.5,1626
2021-02-26,917,1318,-401,-30.42,1626
2021-02-27,352,563,-211,-37.48,1626
2021-02-28,256,450,-194,-43.11,1626
2021-03-01,1065,1448,-383,-26.45,1626
2021-03-02,1101,1474,-373,-25.31,1626
2021-03-03,1101,1473,-372,-25.25,1626
2021-03-04,1101,1481,-380,-25.66,1626
2021-03-05,957,1309,-352,-26.89,1626
2021-03-06,382,557,-175,-31.42,1626
2021-03-07,274,446,-172,-38.57,1626
2021-03-08,1065,1446,-381,-26.35,1626
2021-03-09,1101,1475,-374,-25.36,1626
2021-03-10,1101,1475,-374,-25.36,1626
2021-03-11,1101,1485,-384,-25.86,1626
2021-03-12,957,1316,-359,-27.28,1626
2021-03-13,382,565,-183,-32.39,1626
2021-03-14,274,455,-181,-39.78,1626
2021-03-15,1065,1455,-390,-26.8,1626
2021-03-16,1101,1484,-383,-25.81,1626
2021-03-17,1101,1485,-384,-25.86,1626
2021-03-18,1101,1494,-393,-26.31,1626
2021-03-19,957,1323,-366,-27.66,1626
2021-03-20,382,571,-189,-33.1,1626
2021-03-21,274,459,-185,-40.31,1626
2021-03-22,1065,1458,-393,-26.95,1626
2021-03-23,1101,1484,-383,-25.81,1626
2021-03-24,1101,1483,-382,-25.76,1626
2021-03-25,1101,1490,-389,-26.11,1626
2021-03-26,957,1316,-359,-27.28,1626
2021-03-27,382,562,-180,-32.03,1626
2021-03-28,274,449,-175,-38.98,1626
2021-03-29,1065,1445,-380,-26.3,1626
2021-03-30,1101,1470,-369,-25.1,1626
2021-03-31,1101,1467,-366,-24.95,1626
2021-04-01,1104,1473,-369,-25.05,1626
2021-04-02,979,1299,-320,-24.63,1626
2021-04-03,384,544,-160,-29.41,1626
2021-04-04,257,430,-173,-40.23,1626
2021-04-05,1089,1427,-338,-23.69,1626
2021-04-06,1104,1452,-348,-23.97,1626
2021-04-07,1104,1450,-346,-23.86,1626
2021-04-08,1104,1457,-353,-24.23,1626
2021-04-09,979,1284,-305,-23.75,1626
2021-04-10,384,530,-146,-27.55,1626
2021-04-11,257,418,-161,-38.52,1626
2021-04-12,1089,1416,-327,-23.09,1626
2021-04-13,1104,1443,-339,-23.49,1626
2021-04-14,1104,1442,-338,-23.44,1626
2021-04-15,1104,1451,-347,-23.91,1626
2021-04-16,979,1279,-300,-23.46,1626
2021-04-17,384,527,-143,-27.13,1626
2021-04-18,257,416,-159,-38.22,1626
2021-04-19,1089,1415,-326,-23.04,1626
2021-04-20,1104,1443,-339,-23.49,1626
2021-04-21,1104,1443,-339,-23.49,1626
2021-04-22,1104,1452,-348,-23.97,1626
2021-04-23,979,1281,-302,-23.58,1626
2021-04-24,384,529,-145,-27.41,1626
2021-04-25,257,418,-161,-38.52,1626
2021-04-26,1089,1417,-328,-23.15,1626
2021-04-27,1104,1445,-341,-23.6,1626
2021-04-28,1104,1445,-341,-23.6,1626
2021-04-29,1104,1453,-349,-24.02,1626
2021-04-30,979,1282,-303,-23.63,1626
2021-05-01,398,529,-131,-24.76,1626
2021-05-02,325,418,-93,-22.25,1626
2021-05-03,1158,1417,-259,-18.28,1626
2021-05-04,1148,1444,-296,-20.5,1626
2021-05-05,1148,1444,-296,-20.5,1626
2021-05-06,1148,1452,-304,-20.94,1626
2021-05-07,1066,1280,-214,-16.72,1626
2021-05-08,398,527,-129,-24.48,1626
2021-05-09,325,416,-91,-21.88,1626
2021-05-10,1158,1415,-257,-18.16,1626
2021-05-11,1148,1442,-294,-20.39,1626
2021-05-12,1148,1441,-293,-20.33,1626
2021-05-13,1148,1450,-302,-20.83,1626
2021-05-14,1066,1278,-212,-16.59,1626
2021-05-15,398,525,-127,-24.19,1626
2021-05-16,325,413,-88,-21.31,1626
2021-05-17,1158,1412,-254,-17.99,1626
2021-05-18,1148,1439,-291,-20.22,1626
2021-05-19,1148,1438,-290,-20.17,1626
2021-05-20,1148,1446,-298,-20.61,1626
2021-05-21,1066,1273,-207,-16.26,1626
2021-05-22,398,520,-122,-23.46,1626
2021-05-23,325,408,-83,-20.34,1626
2021-05-24,1158,1406,-248,-17.64,1626
2021-05-25,1148,1432,-284,-19.83,1626
2021-05-26,1148,1430,-282,-19.72,1626
2021-05-27,1148,1437,-289,-20.11,1626
2021-05-28,1066,1264,-198,-15.66,1626
2021-05-29,398,510,-112,-21.96,1626
2021-05-30,325,397,-72,-18.14,1626
2021-05-31,1158,1394,-236,-16.93,1626
2021-06-01,1084,1420,-336,-23.66,1626
2021-06-02,1084,1418,-334,-23.55,1626
2021-06-03,1084,1424,-340,-23.88,1626
2021-06-04,956,1251,-295,-23.58,1626
2021-06-05,368,496,-128,-25.81,1626
2021-06-06,263,383,-120,-31.33,1626
2021-06-07,1035,1380,-345,-25.0,1626
2021-06-08,1084,1406,-322,-22.9,1626
2021-06-09,1084,1404,-320,-22.79,1626
2021-06-10,1084,1410,-326,-23.12,1626
2021-06-11,956,1237,-281,-22.72,1626
2021-06-12,368,483,-115,-23.81,1626
2021-06-13,263,370,-107,-28.92,1626
2021-06-14,1035,1368,-333,-24.34,1626
2021-06-15,1084,1394,-310,-22.24,1626
2021-06-16,1084,1392,-308,-22.13,1626
2021-06-17,1084,1399,-315,-22.52,1626
2021-06-18,956,1226,-270,-22.02,1626
2021-06-19,368,472,-104,-22.03,1626
2021-06-20,263,360,-97,-26.94,1626
2021-06-21,1035,1357,-322,-23.73,1626
2021-06-22,1084,1383,-299,-21.62,1626
2021-06-23,1084,1381,-297,-21.51,1626
2021-06-24,1084,1388,-304,-21.9,1626
2021-06-25,956,1214,-258,-21.25,1626
2021-06-26,368,460,-92,-20.0,1626
2021-06-27,263,347,-84,-24.21,1626
2021-06-28,1035,1344,-309,-22.99,1626
2021-06-29,1084,1370,-286,-20.88,1626
2021-06-30,1084,1367,-283,-20.7,1626
2021-07-01,1064,1373,-309,-22.51,1626
2021-07-02,929,1200,-271,-22.58,1626
2021-07-03,369,445,-76,-17.08,1626
2021-07-04,266,332,-66,-19.88,1626
2021-07-05,968,1328,-360,-27.11,1626
2021-07-06,1064,1354,-290,-21.42,1626
2021-07-07,1064,1352,-288,-21.3,1626
2021-07-08,1064,1358,-294,-21.65,1626
2021-07-09,929,1185,-256,-21.6,1626
2021-07-10,369,431,-62,-14.39,1626
2021-07-11,266,318,-52,-16.35,1626
2021-07-12,968,1316,-348,-26.44,1626
2021-07-13,1064,1342,-278,-20.72,1626
2021-07-14,1064,1340,-276,-20.6,1626
2021-07-15,1064,1348,-284,-21.07,1626
2021-07-16,929,1176,-247,-21.0,1626
2021-07-17,369,422,-53,-12.56,1626
2021-07-18,266,311,-45,-14.47,1626
2021-07-19,968,1309,-341,-26.05,1626
2021-07-20,1064,1336,-272,-20.36,1626
2021-07-21,1064,1335,-271,-20.3,1626
2021-07-22,1064,1343,-279,-20.77,1626
2021-07-23,929,1170,-241,-20.6,1626
2021-07-24,369,417,-48,-11.51,1626
2021-07-25,266,305,-39,-12.79,1626
2021-07-26,968,1302,-334,-25.65,1626
2021-07-27,1064,1329,-265,-19.94,1626
2021-07-28,1064,1327,-263,-19.82,1626
2021-07-29,1064,1333,-269,-20.18,1626
2021-07-30,929,1159,-230,-19.84,1626
2021-07-31,369,404,-35,-8.66,1626
2021-08-01,395,291,104,35.74,1626
2021-08-02,1172,1287,-115,-8.94,1626
2021-08-03,1184,1311,-127,-9.69,1626
2021-08-04,1184,1307,-123,-9.41,1626
2021-08-05,1184,1312,-128,-9.76,1626
2021-08-06,1000,1137,-137,-12.05,1626
2021-08-07,425,381,44,11.55,1626
2021-08-08,395,267,128,47.94,1626
2021-08-09,1172,1262,-90,-7.13,1626
2021-08-10,1184,1286,-102,-7.93,1626
2021-08-11,1184,1283,-99,-7.72,1626
2021-08-12,1184,1289,-105,-8.15,1626
2021-08-13,1000,1115,-115,-10.31,1626
2021-08-14,425,361,64,17.73,1626
2021-08-15,395,248,147,59.27,1626
2021-08-16,1172,1246,-74,-5.94,1626
2021-08-17,1184,1274,-90,-7.06,1626
2021-08-18,1184,1274,-90,-7.06,1626
2021-08-19,1184,1284,-100,-7.79,1626
2021-08-20,1000,1114,-114,-10.23,1626
2021-08-21,425,364,61,16.76,1626
2021-08-22,395,256,139,54.3,1626
2021-08-23,1172,1259,-87,-6.91,1626
2021-08-24,1184,1291,-107,-8.29,1626
2021-08-25,1184,1295,-111,-8.57,1626
2021-08-26,1184,1309,-125,-9.55,1626
2021-08-27,1000,1143,-143,-12.51,1626
2021-08-28,425,397,28,7.05,1626
2021-08-29,395,292,103,35.27,1626
2021-08-30,1172,1297,-125,-9.64,1626
2021-08-31,1184,1331,-147,-11.04,1626
2021-09-01,1758,1338,420,31.39,1626
2021-09-02,1758,1352,406,30.03,1626
2021-09-03,1566,1187,379,31.93,1626
2021-09-04,680,440,240,54.55,1626
2021-09-05,440,335,105,31.34,1626
2021-09-06,1753,1338,415,31.02,1626
2021-09-07,1758,1371,387,28.23,1626
2021-09-08,1758,1374,384,27.95,1626
2021-09-09,1758,1386,372,26.84,1626
2021-09-10,1566,1218,348,28.57,1626
2021-09-11,680,468,212,45.3,1626
2021-09-12,440,359,81,22.56,1626
2021-09-13,1753,1359,394,28.99,1626
2021-09-14,1758,1387,371,26.75,1626
2021-09-15,1758,1388,370,26.66,1626
2021-09-16,1758,1396,362,25.93,1626
2021-09-17,1566,1225,341,27.84,1626
2021-09-18,680,472,208,44.07,1626
2021-09-19,440,360,80,22.22,1626
2021-09-20,1753,1359,394,28.99,1626
2021-09-21,1758,1386,372,26.84,1626
2021-09-22,1758,1385,373,26.93,1626
2021-09-23,1758,1393,365,26.2,1626
2021-09-24,1566,1221,345,28.26,1626
2021-09-25,680,469,211,44.99,1626
2021-09-26,440,358,82,22.91,1626
2021-09-27,1753,1357,396,29.18,1626
2021-09-28,1758,1386,372,26.84,1626
2021-09-29,1758,1386,372,26.84,1626
2021-09-30,1758,1396,362,25.93,1626
2021-10-01,1530,1227,303,24.69,1626
2021-10-02,668,476,192,40.34,1626
2021-10-03,442,368,74,20.11,1626
2021-10-04,1601,1369,232,16.95,1626
2021-10-05,1731,1399,332,23.73,1626
2021-10-06,1731,1401,330,23.55,1626
2021-10-07,1731,1412,319,22.59,1626
2021-10-08,1530,1243,287,23.09,1626
2021-10-09,668,493,175,35.5,1626
2021-10-10,442,384,58,15.1,1626
2021-10-11,1601,1385,216,15.6,1626
2021-10-12,1731,1414,317,22.42,1626
2021-10-13,1731,1415,316,22.33,1626
2021-10-14,1731,1425,306,21.47,1626
2021-10-15,1530,1254,276,22.01,1626
2021-10-16,668,501,167,33.33,1626
2021-10-17,442,390,52,13.33,1626
2021-10-18,1601,1388,213,15.35,1626
2021-10-19,1731,1415,316,22.33,1626
2021-10-20,1731,1414,317,22.42,1626
2021-10-21,1731,1421,310,21.82,1626
2021-10-22,1530,1247,283,22.69,1626
2021-10-23,668,493,175,35.5,1626
2021-10-24,442,380,62,16.32,1626
2021-10-25,1601,1377,224,16.27,1626
2021-10-26,1731,1403,328,23.38,1626
2021-10-27,1731,1401,330,23.55,1626
2021-10-28,1731,1408,323,22.94,1626
2021-10-29,1530,1235,295,23.89,1626
2021-10-30,668,482,186,38.59,1626
2021-10-31,442,370,72,19.46,1626
2021-11-01,1695,1369,326,23.81,1626
2021-11-02,1778,1397,381,27.27,1626
2021-11-03,1778,1397,381,27.27,1626
2021-11-04,1778,1406,372,26.46,1626
2021-11-05,1526,1236,290,23.46,1626
2021-11-06,672,485,187,38.56,1626
2021-11-07,441,376,65,17.29,1626
2021-11-08,1695,1377,318,23.09,1626
2021-11-09,1778,1406,372,26.46,1626
2021-11-10,1778,1408,370,26.28,1626
2021-11-11,1778,1418,360,25.39,1626
2021-11-12,1526,1249,277,22.18,1626
2021-11-13,672,498,174,34.94,1626
2021-11-14,441,388,53,13.66,1626
2021-11-15,1695,1388,307,22.12,1626
2021-11-16,1778,1416,362,25.56,1626
2021-11-17,1778,1415,363,25.65,1626
2021-11-18,1778,1423,355,24.95,1626
2021-11-19,1526,1250,276,22.08,1626
2021-11-20,672,495,177,35.76,1626
2021-11-21,441,381,60,15.75,1626
2021-11-22,1695,1376,319,23.18,1626
2021-11-23,1778,1399,379,27.09,1626
2021-11-24,1778,1393,385,27.64,1626
2021-11-25,1778,1396,382,27.36,1626
2021-11-26,1526,1219,307,25.18,1626
2021-11-27,672,459,213,46.41,1626
2021-11-28,441,341,100,29.33,1626
2021-11-29,1695,1333,362,27.16,1626
2021-11-30,1778,1353,425,31.41,1626
2021-12-01,1417,1345,72,5.35,1626
2021-12-02,1417,1346,71,5.27,1626
2021-12-03,1183,1168,15,1.28,1626
2021-12-04,641,409,232,56.72,1626
2021-12-05,407,291,116,39.86,1626
2021-12-06,1611,1284,327,25.47,1626
2021-12-07,1417,1307,110,8.42,1626
2021-12-08,1417,1302,115,8.83,1626
2021-12-09,1417,1306,111,8.5,1626
2021-12-10,1183,1131,52,4.6,1626
2021-12-11,641,376,265,70.48,1626
2021-12-12,407,263,144,54.75,1626
2021-12-13,1611,1261,350,27.76,1626
2021-12-14,1417,1288,129,10.02,1626
2021-12-15,1417,1288,129,10.02,1626
2021-12-16,1417,1296,121,9.34,1626
2021-12-17,1183,1126,57,5.06,1626
2021-12-18,641,374,267,71.39,1626
2021-12-19,407,264,143,54.17,1626
2021-12-20,1611,1263,348,27.55,1626
2021-12-21,1417,1291,126,9.76,1626
2021-12-22,1417,1291,126,9.76,1626
2021-12-23,1417,1299,118,9.08,1626
2021-12-24,1183,1127,56,4.97,1626
2021-12-25,641,373,268,71.85,1626
2021-12-26,407,260,147,56.54,1626
2021-12-27,1611,1256,355,28.26,1626
2021-12-28,1417,1279,138,10.79,1626
2021-12-29,1417,1274,143,11.22,1626
2021-12-30,1417,1277,140,10.96,1626
2021-12-31,1183,1099,84,7.64,1626
2022-01-01,556,339,217,64.01,1626
2022-01-02,386,220,166,75.45,1626
2022-01-03,1418,1210,208,17.19,1626
2022-01-04,1397,1229,168,13.67,1626
2022-01-05,1397,1219,178,14.6,1626
2022-01-06,1397,1218,179,14.7,1626
2022-01-07,1310,1037,273,26.33,1626
2022-01-08,556,275,281,102.18,1626
2022-01-09,386,156,230,147.44,1626
2022-01-10,1418,1146,272,23.73,1626
2022-01-11,1397,1167,230,19.71,1626
2022-01-12,1397,1160,237,20.43,1626
2022-01-13,1397,1164,233,20.02,1626
2022-01-14,1310,988,322,32.59,1626
2022-01-15,556,234,322,137.61,1626
2022-01-16,386,122,264,216.39,1626
2022-01-17,1418,1122,296,26.38,1626
2022-01-18,1397,1153,244,21.16,1626
2022-01-19,1397,1157,240,20.74,1626
2022-01-20,1397,1172,225,19.2,1626
2022-01-21,1310,1009,301,29.83,1626
2022-01-22,556,267,289,108.24,1626
2022-01-23,386,168,218,129.76,1626
2022-01-24,1418,1180,238,20.17,1626
2022-01-25,1397,1222,175,14.32,1626
2022-01-26,1397,1238,159,12.84,1626
2022-01-27,1397,1263,134,10.61,1626
2022-01-28,1310,1110,200,18.02,1626
2022-01-29,556,376,180,47.87,1626
2022-01-30,386,284,102,35.92,1626
2020-02-01,455,298,157,52.68,1182
2020-02-02,279,121,158,130.58,1182
2020-02-03,1447,1475,-28,-1.9,1182
2020-02-04,1503,1526,-23,-1.51,1182
2020-02-05,1503,1531,-28,-1.83,1182
2020-02-06,1503,1534,-31,-2.02,1182
2020-02-07,1348,1366,-18,-1.32,1182
2020-02-08,455,320,135,42.19,1182
2020-02-09,279,142,137,96.48,1182
2020-02-10,1447,1494,-47,-3.15,1182
2020-02-11,1503,1544,-41,-2.66,1182
2020-02-12,1503,1548,-45,-2.91,1182
2020-02-13,1503,1550,-47,-3.03,1182
2020-02-14,1348,1382,-34,-2.46,1182
2020-02-15,455,335,120,35.82,1182
2020-02-16,279,157,122,77.71,1182
2020-02-17,1447,1509,-62,-4.11,1182
2020-02-18,1503,1558,-55,-3.53,1182
2020-02-19,1503,1562,-59,-3.78,1182
2020-02-20,1503,1565,-62,-3.96,1182
2020-02-21,1348,1397,-49,-3.51,1182
2020-02-22,455,351,104,29.63,1182
2020-02-23,279,173,106,61.27,1182
2020-02-24,1447,1525,-78,-5.11,1182
2020-02-25,1503,1575,-72,-4.57,1182
2020-02-26,1503,1580,-77,-4.87,1182
2020-02-27,1503,1582,-79,-4.99,1182
2020-02-28,1348,1415,-67,-4.73,1182
2020-02-29,455,368,87,23.64,1182
2020-03-01,287,190,97,51.05,1182
2020-03-02,1379,1542,-163,-10.57,1182
2020-03-03,1424,1591,-167,-10.5,1182
2020-03-04,1424,1595,-171,-10.72,1182
2020-03-05,1424,1597,-173,-10.83,1182
2020-03-06,1259,1428,-169,-11.83,1182
2020-03-07,439,381,58,15.22,1182
2020-03-08,287,201,86,42.79,1182
2020-03-09,1379,1552,-173,-11.15,1182
2020-03-10,1424,1600,-176,-11.0,1182
2020-03-11,1424,1603,-179,-11.17,1182
2020-03-12,1424,1604,-180,-11.22,1182
2020-03-13,1259,1434,-175,-12.2,1182
2020-03-14,439,386,53,13.73,1182
2020-03-15,287,207,80,38.65,1182
2020-03-16,1379,1558,-179,-11.49,1182
2020-03-17,1424,1606,-182,-11.33,1182
2020-03-18,1424,1610,-186,-11.55,1182
2020-03-19,1424,1612,-188,-11.66,1182
2020-03-20,1259,1444,-185,-12.81,1182
2020-03-21,439,397,42,10.58,1182
2020-03-22,287,220,67,30.45,1182
2020-03-23,1379,1573,-194,-12.33,1182
2020-03-24,1424,1624,-200,-12.32,1182
2020-03-25,1424,1630,-206,-12.64,1182
2020-03-26,1424,1634,-210,-12.85,1182
2020-03-27,1259,1469,-210,-14.3,1182
2020-03-28,439,425,14,3.29,1182
2020-03-29,287,250,37,14.8,1182
2020-03-30,1379,1606,-227,-14.13,1182
2020-03-31,1424,1659,-235,-14.17,1182
2020-04-01,1337,1666,-329,-19.75,1182
2020-04-02,1337,1672,-335,-20.04,1182
2020-04-03,1148,1508,-360,-23.87,1182
2020-04-04,428,465,-37,-7.96,1182
2020-04-05,262,290,-28,-9.66,1182
2020-04-06,1279,1645,-366,-22.25,1182
2020-04-07,1337,1697,-360,-21.21,1182
2020-04-08,1337,1704,-367,-21.54,1182
2020-04-09,1337,1708,-371,-21.72,1182
2020-04-10,1148,1542,-394,-25.55,1182
2020-04-11,428,497,-69,-13.88,1182
2020-04-12,262,319,-57,-17.87,1182
2020-04-13,1279,1672,-393,-23.5,1182
2020-04-14,1337,1721,-384,-22.31,1182
2020-04-15,1337,1725,-388,-22.49,1182
2020-04-16,1337,1726,-389,-22.54,1182
2020-04-17,1148,1557,-409,-26.27,1182
2020-04-18,428,509,-81,-15.91,1182
2020-04-19,262,329,-67,-20.36,1182
2020-04-20,1279,1680,-401,-23.87,1182
2020-04-21,1337,1727,-390,-22.58,1182
2020-04-22,1337,1729,-392,-22.67,1182
2020-04-23,1337,1730,-393,-22.72,1182
2020-04-24,1148,1560,-412,-26.41,1182
2020-04-25,428,512,-84,-16.41,1182
2020-04-26,262,332,-70,-21.08,1182
2020-04-27,1279,1683,-404,-24.0,1182
2020-04-28,1337,1731,-394,-22.76,1182
2020-04-29,1337,1734,-397,-22.9,1182
2020-04-30,1337,1736,-399,-22.98,1182
2020-05-01,1352,1568,-216,-13.78,1182
2020-05-02,467,522,-55,-10.54,1182
2020-05-03,297,344,-47,-13.66,1182
2020-05-04,1470,1696,-226,-13.33,1182
2020-05-05,1577,1747,-170,-9.73,1182
2020-05-06,1577,1751,-174,-9.94,1182
2020-05-07,1577,1755,-178,-10.14,1182
2020-05-08,1352,1587,-235,-14.81,1182
2020-05-09,467,542,-75,-13.84,1182
2020-05-10,297,364,-67,-18.41,1182
2020-05-11,1470,1716,-246,-14.34,1182
2020-05-12,1577,1766,-189,-10.7,1182
2020-05-13,1577,1770,-193,-10.9,1182
2020-05-14,1577,1771,-194,-10.95,1182
2020-05-15,1352,1602,-250,-15.61,1182
2020-05-16,467,554,-87,-15.7,1182
2020-05-17,297,374,-77,-20.59,1182
2020-05-18,1470,1723,-253,-14.68,1182
2020-05-19,1577,1769,-192,-10.85,1182
2020-05-20,1577,1770,-193,-10.9,1182
2020-05-21,1577,1768,-191,-10.8,1182
2020-05-22,1352,1595,-243,-15.24,1182
2020-05-23,467,544,-77,-14.15,1182
2020-05-24,297,360,-63,-17.5,1182
2020-05-25,1470,1707,-237,-13.88,1182
2020-05-26,1577,1750,-173,-9.89,1182
2020-05-27,1577,1748,-171,-9.78,1182
2020-05-28,1577,1745,-168,-9.63,1182
2020-05-29,1352,1571,-219,-13.94,1182
2020-05-30,467,518,-51,-9.85,1182
2020-05-31,297,334,-37,-11.08,1182
2020-06-01,1516,1681,-165,-9.82,1182
2020-06-02,1582,1725,-143,-8.29,1182
2020-06-03,1582,1724,-142,-8.24,1182
2020-06-04,1582,1722,-140,-8.13,1182
2020-06-05,1367,1549,-182,-11.75,1182
2020-06-06,472,499,-27,-5.41,1182
2020-06-07,289,317,-28,-8.83,1182
2020-06-08,1516,1666,-150,-9.0,1182
2020-06-09,1582,1712,-130,-7.59,1182
2020-06-10,1582,1713,-131,-7.65,1182
2020-06-11,1582,1713,-131,-7.65,1182
2020-06-12,1367,1543,-176,-11.41,1182
2020-06-13,472,494,-22,-4.45,1182
2020-06-14,289,313,-24,-7.67,1182
2020-06-15,1516,1663,-147,-8.84,1182
2020-06-16,1582,1709,-127,-7.43,1182
2020-06-17,1582,1711,-129,-7.54,1182
2020-06-18,1582,1710,-128,-7.49,1182
2020-06-19,1367,1538,-171,-11.12,1182
2020-06-20,472,488,-16,-3.28,1182
2020-06-21,289,305,-16,-5.25,1182
2020-06-22,1516,1653,-137,-8.29,1182
2020-06-23,1582,1697,-115,-6.78,1182
2020-06-24,1582,1695,-113,-6.67,1182
2020-06-25,1582,1692,-110,-6.5,1182
2020-06-26,1367,1517,-150,-9.89,1182
2020-06-27,472,463,9,1.94,1182
2020-06-28,289,278,11,3.96,1182
2020-06-29,1516,1622,-106,-6.54,1182
2020-06-30,1582,1664,-82,-4.93,1182
2020-07-01,1562,1660,-98,-5.9,1182
2020-07-02,1562,1654,-92,-5.56,1182
2020-07-03,1391,1478,-87,-5.89,1182
2020-07-04,445,424,21,4.95,1182
2020-07-05,284,238,46,19.33,1182
2020-07-06,1493,1582,-89,-5.63,1182
2020-07-07,1562,1624,-62,-3.82,1182
2020-07-08,1562,1622,-60,-3.7,1182
2020-07-09,1562,1618,-56,-3.46,1182
2020-07-10,1391,1444,-53,-3.67,1182
2020-07-11,445,392,53,13.52,1182
2020-07-12,284,209,75,35.89,1182
2020-07-13,1493,1557,-64,-4.11,1182
2020-07-14,1562,1603,-41,-2.56,1182
2020-07-15,1562,1603,-41,-2.56,1182
2020-07-16,1562,1603,-41,-2.56,1182
2020-07-17,1391,1432,-41,-2.86,1182
2020-07-18,445,384,61,15.89,1182
2020-07-19,284,203,81,39.9,1182
2020-07-20,1493,1554,-61,-3.93,1182
2020-07-21,1562,1601,-39,-2.44,1182
2020-07-22,1562,1603,-41,-2.56,1182
2020-07-23,1562,1604,-42,-2.62,1182
2020-07-24,1391,1433,-42,-2.93,1182
2020-07-25,445,384,61,15.89,1182
2020-07-26,284,203,81,39.9,1182
2020-07-27,1493,1552,-59,-3.8,1182
2020-07-28,1562,1598,-36,-2.25,1182
2020-07-29,1562,1597,-35,-2.19,1182
2020-07-30,1562,1595,-33,-2.07,1182
2020-07-31,1391,1422,-31,-2.18,1182
2020-08-01,465,370,95,25.68,1182
2020-08-02,296,185,111,60.0,1182
2020-08-03,1448,1531,-83,-5.42,1182
2020-08-04,1494,1573,-79,-5.02,1182
2020-08-05,1494,1570,-76,-4.84,1182
2020-08-06,1494,1565,-71,-4.54,1182
2020-08-07,1344,1390,-46,-3.31,1182
2020-08-08,465,336,129,38.39,1182
2020-08-09,296,151,145,96.03,1182
2020-08-10,1448,1496,-48,-3.21,1182
2020-08-11,1494,1539,-45,-2.92,1182
2020-08-12,1494,1537,-43,-2.8,1182
2020-08-13,1494,1534,-40,-2.61,1182
2020-08-14,1344,1361,-17,-1.25,1182
2020-08-15,465,310,155,50.0,1182
2020-08-16,296,128,168,131.25,1182
2020-08-17,1448,1478,-30,-2.03,1182
2020-08-18,1494,1525,-31,-2.03,1182
2020-08-19,1494,1528,-34,-2.23,1182
2020-08-20,1494,1531,-37,-2.42,1182
2020-08-21,1344,1363,-19,-1.39,1182
2020-08-22,465,318,147,46.23,1182
2020-08-23,296,142,154,108.45,1182
2020-08-24,1448,1497,-49,-3.27,1182
2020-08-25,1494,1549,-55,-3.55,1182
2020-08-26,1494,1556,-62,-3.98,1182
2020-08-27,1494,1563,-69,-4.41,1182
2020-08-28,1344,1399,-55,-3.93,1182
2020-08-29,465,356,109,30.62,1182
2020-08-30,296,182,114,62.64,1182
2020-08-31,1448,1538,-90,-5.85,1182
2020-09-01,1578,1590,-12,-0.75,1182
2020-09-02,1578,1598,-20,-1.25,1182
2020-09-03,1578,1603,-25,-1.56,1182
2020-09-04,1358,1437,-79,-5.5,1182
2020-09-05,454,392,62,15.82,1182
2020-09-06,294,215,79,36.74,1182
2020-09-07,1477,1568,-91,-5.8,1182
2020-09-08,1578,1617,-39,-2.41,1182
2020-09-09,1578,1620,-42,-2.59,1182
2020-09-10,1578,1621,-43,-2.65,1182
2020-09-11,1358,1452,-94,-6.47,1182
2020-09-12,454,403,51,12.66,1182
2020-09-13,294,222,72,32.43,1182
2020-09-14,1477,1571,-94,-5.98,1182
2020-09-15,1578,1618,-40,-2.47,1182
2020-09-16,1578,1618,-40,-2.47,1182
2020-09-17,1578,1618,-40,-2.47,1182
2020-09-18,1358,1446,-88,-6.09,1182
2020-09-19,454,397,57,14.36,1182
2020-09-20,294,216,78,36.11,1182
2020-09-21,1477,1565,-88,-5.62,1182
2020-09-22,1578,1612,-34,-2.11,1182
2020-09-23,1578,1614,-36,-2.23,1182
2020-09-24,1578,1615,-37,-2.29,1182
2020-09-25,1358,1446,-88,-6.09,1182
2020-09-26,454,399,55,13.78,1182
2020-09-27,294,220,74,33.64,1182
2020-09-28,1477,1572,-95,-6.04,1182
2020-09-29,1578,1622,-44,-2.71,1182
2020-09-30,1578,1627,-49,-3.01,1182
2020-10-01,1611,1630,-19,-1.17,1182
2020-10-02,1426,1463,-37,-2.53,1182
2020-10-03,466,417,49,11.75,1182
2020-10-04,301,240,61,25.42,1182
2020-10-05,1560,1593,-33,-2.07,1182
2020-10-06,1611,1643,-32,-1.95,1182
2020-10-07,1611,1648,-37,-2.25,1182
2020-10-08,1611,1650,-39,-2.36,1182
2020-10-09,1426,1482,-56,-3.78,1182
2020-10-10,466,435,31,7.13,1182
2020-10-11,301,255,46,18.04,1182
2020-10-12,1560,1605,-45,-2.8,1182
2020-10-13,1611,1653,-42,-2.54,1182
2020-10-14,1611,1654,-43,-2.6,1182
2020-10-15,1611,1653,-42,-2.54,1182
2020-10-16,1426,1481,-55,-3.71,1182
2020-10-17,466,431,35,8.12,1182
2020-10-18,301,248,53,21.37,1182
2020-10-19,1560,1595,-35,-2.19,1182
2020-10-20,1611,1640,-29,-1.77,1182
2020-10-21,1611,1639,-28,-1.71,1182
2020-10-22,1611,1636,-25,-1.53,1182
2020-10-23,1426,1463,-37,-2.53,1182
2020-10-24,466,412,54,13.11,1182
2020-10-25,301,229,72,31.44,1182
2020-10-26,1560,1576,-16,-1.02,1182
2020-10-27,1611,1622,-11,-0.68,1182
2020-10-28,1611,1622,-11,-0.68,1182
2020-10-29,1611,1621,-10,-0.62,1182
2020-10-30,1426,1450,-24,-1.66,1182
2020-10-31,466,401,65,16.21,1182
2020-11-01,298,221,77,34.84,1182
2020-11-02,1468,1572,-104,-6.62,1182
2020-11-03,1495,1620,-125,-7.72,1182
2020-11-04,1495,1624,-129,-7.94,1182
2020-11-05,1495,1626,-131,-8.06,1182
2020-11-06,1351,1457,-106,-7.28,1182
2020-11-07,460,411,49,11.92,1182
2020-11-08,298,232,66,28.45,1182
2020-11-09,1468,1584,-116,-7.32,1182
2020-11-10,1495,1633,-138,-8.45,1182
2020-11-11,1495,1636,-141,-8.62,1182
2020-11-12,1495,1637,-142,-8.67,1182
2020-11-13,1351,1467,-116,-7.91,1182
2020-11-14,460,418,42,10.05,1182
2020-11-15,298,237,61,25.74,1182
2020-11-16,1468,1586,-118,-7.44,1182
2020-11-17,1495,1630,-135,-8.28,1182
2020-11-18,1495,1629,-134,-8.23,1182
2020-11-19,1495,1625,-130,-8.0,1182
2020-11-20,1351,1450,-99,-6.83,1182
2020-11-21,460,396,64,16.16,1182
2020-11-22,298,209,89,42.58,1182
2020-11-23,1468,1552,-84,-5.41,1182
2020-11-24,1495,1592,-97,-6.09,1182
2020-11-25,1495,1586,-91,-5.74,1182
2020-11-26,1495,1577,-82,-5.2,1182
2020-11-27,1351,1398,-47,-3.36,1182
2020-11-28,460,340,120,35.29,1182
2020-11-29,298,151,147,97.35,1182
2020-11-30,1468,1492,-24,-1.61,1182
2020-12-01,1234,1530,-296,-19.35,1182
2020-12-02,1234,1523,-289,-18.98,1182
2020-12-03,1234,1515,-281,-18.55,1182
2020-12-04,1415,1337,78,5.83,1182
2020-12-05,489,280,209,74.64,1182
2020-12-06,287,93,194,208.6,1182
2020-12-07,1270,1437,-167,-11.62,1182
2020-12-08,1234,1478,-244,-16.51,1182
2020-12-09,1234,1475,-241,-16.34,1182
2020-12-10,1234,1471,-237,-16.11,1182
2020-12-11,1415,1298,117,9.01,1182
2020-12-12,489,246,243,98.78,1182
2020-12-13,287,63,224,355.56,1182
2020-12-14,1270,1411,-141,-9.99,1182
2020-12-15,1234,1457,-223,-15.31,1182
2020-12-16,1234,1458,-224,-15.36,1182
2020-12-17,1234,1457,-223,-15.31,1182
2020-12-18,1415,1287,128,9.95,1182
2020-12-19,489,237,252,106.33,1182
2020-12-20,287,57,230,403.51,1182
2020-12-21,1270,1406,-136,-9.67,1182
2020-12-22,1234,1453,-219,-15.07,1182
2020-12-23,1234,1454,-220,-15.13,1182
2020-12-24,1234,1453,-219,-15.07,1182
2020-12-25,1415,1281,134,10.46,1182
2020-12-26,489,231,258,111.69,1182
2020-12-27,287,48,239,497.92,1182
2020-12-28,1270,1396,-126,-9.03,1182
2020-12-29,1234,1440,-206,-14.31,1182
2020-12-30,1234,1439,-205,-14.25,1182
2020-12-31,1234,1436,-202,-14.07,1182
2021-01-01,1170,1262,-92,-7.29,1182
2021-01-02,418,209,209,100.0,1182
2021-01-03,282,24,258,1075.0,1182
2021-01-04,1208,1370,-162,-11.82,1182
2021-01-05,1241,1413,-172,-12.17,1182
2021-01-06,1241,1411,-170,-12.05,1182
2021-01-07,1241,1408,-167,-11.86,1182
2021-01-08,1170,1234,-64,-5.19,1182
2021-01-09,418,182,236,129.67,1182
2021-01-10,282,71,211,297.18,1182
2021-01-11,1208,1347,-139,-10.32,1182
2021-01-12,1241,1392,-151,-10.85,1182
2021-01-13,1241,1392,-151,-10.85,1182
2021-01-14,1241,1392,-151,-10.85,1182
2021-01-15,1170,1222,-52,-4.26,1182
2021-01-16,418,173,245,141.62,1182
2021-01-17,282,69,213,308.7,1182
2021-01-18,1208,1346,-138,-10.25,1182
2021-01-19,1241,1395,-154,-11.04,1182
2021-01-20,1241,1399,-158,-11.29,1182
2021-01-21,1241,1403,-162,-11.55,1182
2021-01-22,1170,1236,-66,-5.34,1182
2021-01-23,418,191,227,118.85,1182
2021-01-24,282,15,267,1780.0,1182
2021-01-25,1208,1369,-161,-11.76,1182
2021-01-26,1241,1420,-179,-12.61,1182
2021-01-27,1241,1426,-185,-12.97,1182
2021-01-28,1241,1431,-190,-13.28,1182
2021-01-29,1170,1265,-95,-7.51,1182
2021-01-30,418,221,197,89.14,1182
2021-01-31,282,44,238,540.91,1182
2021-02-01,1304,1398,-94,-6.72,1182
2021-02-02,1341,1449,-108,-7.45,1182
2021-02-03,1341,1454,-113,-7.77,1182
2021-02-04,1341,1458,-117,-8.02,1182
2021-02-05,1226,1291,-65,-5.03,1182
2021-02-06,454,245,209,85.31,1182
2021-02-07,268,67,201,300.0,1182
2021-02-08,1304,1420,-116,-8.17,1182
2021-02-09,1341,1469,-128,-8.71,1182
2021-02-10,1341,1473,-132,-8.96,1182
2021-02-11,1341,1475,-134,-9.08,1182
2021-02-12,1226,1307,-81,-6.2,1182
2021-02-13,454,260,194,74.62,1182
2021-02-14,268,82,186,226.83,1182
2021-02-15,1304,1434,-130,-9.07,1182
2021-02-16,1341,1483,-142,-9.58,1182
2021-02-17,1341,1487,-146,-9.82,1182
2021-02-18,1341,1490,-149,-10.0,1182
2021-02-19,1226,1322,-96,-7.26,1182
2021-02-20,454,276,178,64.49,1182
2021-02-21,268,98,170,173.47,1182
2021-02-22,1304,1450,-146,-10.07,1182
2021-02-23,1341,1500,-159,-10.6,1182
2021-02-24,1341,1504,-163,-10.84,1182
2021-02-25,1341,1507,-166,-11.02,1182
2021-02-26,1226,1340,-114,-8.51,1182
2021-02-27,454,293,161,54.95,1182
2021-02-28,268,115,153,133.04,1182
2021-03-01,1452,1468,-16,-1.09,1182
2021-03-02,1494,1517,-23,-1.52,1182
2021-03-03,1494,1521,-27,-1.78,1182
2021-03-04,1494,1523,-29,-1.9,1182
2021-03-05,1314,1354,-40,-2.95,1182
2021-03-06,481,307,174,56.68,1182
2021-03-07,287,128,159,124.22,1182
2021-03-08,1452,1479,-27,-1.83,1182
2021-03-09,1494,1527,-33,-2.16,1182
2021-03-10,1494,1530,-36,-2.35,1182
2021-03-11,1494,1531,-37,-2.42,1182
2021-03-12,1314,1361,-47,-3.45,1182
2021-03-13,481,313,168,53.67,1182
2021-03-14,287,134,153,114.18,1182
2021-03-15,1452,1485,-33,-2.22,1182
2021-03-16,1494,1533,-39,-2.54,1182
2021-03-17,1494,1536,-42,-2.73,1182
2021-03-18,1494,1537,-43,-2.8,1182
2021-03-19,1314,1369,-55,-4.02,1182
2021-03-20,481,322,159,49.38,1182
2021-03-21,287,144,143,99.31,1182
2021-03-22,1452,1497,-45,-3.01,1182
2021-03-23,1494,1547,-53,-3.43,1182
2021-03-24,1494,1553,-59,-3.8,1182
2021-03-25,1494,1557,-63,-4.05,1182
2021-03-26,1314,1391,-77,-5.54,1182
2021-03-27,481,347,134,38.62,1182
2021-03-28,287,171,116,67.84,1182
2021-03-29,1452,1527,-75,-4.91,1182
2021-03-30,1494,1579,-85,-5.38,1182
2021-03-31,1494,1587,-93,-5.86,1182
2021-04-01,1509,1593,-84,-5.27,1182
2021-04-02,1330,1429,-99,-6.93,1182
2021-04-03,467,386,81,20.98,1182
2021-04-04,273,211,62,29.38,1182
2021-04-05,1501,1567,-66,-4.21,1182
2021-04-06,1509,1619,-110,-6.79,1182
2021-04-07,1509,1626,-117,-7.2,1182
2021-04-08,1509,1631,-122,-7.48,1182
2021-04-09,1330,1465,-135,-9.22,1182
2021-04-10,467,420,47,11.19,1182
2021-04-11,273,243,30,12.35,1182
2021-04-12,1501,1597,-96,-6.01,1182
2021-04-13,1509,1646,-137,-8.32,1182
2021-04-14,1509,1650,-141,-8.55,1182
2021-04-15,1509,1653,-144,-8.71,1182
2021-04-16,1330,1484,-154,-10.38,1182
2021-04-17,467,436,31,7.11,1182
2021-04-18,273,257,16,6.23,1182
2021-04-19,1501,1607,-106,-6.6,1182
2021-04-20,1509,1655,-146,-8.82,1182
2021-04-21,1509,1657,-148,-8.93,1182
2021-04-22,1509,1657,-148,-8.93,1182
2021-04-23,1330,1487,-157,-10.56,1182
2021-04-24,467,439,28,6.38,1182
2021-04-25,273,259,14,5.41,1182
2021-04-26,1501,1610,-109,-6.77,1182
2021-04-27,1509,1658,-149,-8.99,1182
2021-04-28,1509,1661,-152,-9.15,1182
2021-04-29,1509,1662,-153,-9.21,1182
2021-04-30,1330,1494,-164,-10.98,1182
2021-05-01,463,447,16,3.58,1182
2021-05-02,300,269,31,11.52,1182
2021-05-03,1542,1621,-79,-4.87,1182
2021-05-04,1567,1671,-104,-6.22,1182
2021-05-05,1567,1676,-109,-6.5,1182
2021-05-06,1567,1679,-112,-6.67,1182
2021-05-07,1372,1512,-140,-9.26,1182
2021-05-08,463,466,-3,-0.64,1182
2021-05-09,300,288,12,4.17,1182
2021-05-10,1542,1641,-99,-6.03,1182
2021-05-11,1567,1691,-124,-7.33,1182
2021-05-12,1567,1695,-128,-7.55,1182
2021-05-13,1567,1697,-130,-7.66,1182
2021-05-14,1372,1529,-157,-10.27,1182
2021-05-15,463,481,-18,-3.74,1182
2021-05-16,300,301,-1,-0.33,1182
2021-05-17,1542,1652,-110,-6.66,1182
2021-05-18,1567,1698,-131,-7.71,1182
2021-05-19,1567,1699,-132,-7.77,1182
2021-05-20,1567,1698,-131,-7.71,1182
2021-05-21,1372,1526,-154,-10.09,1182
2021-05-22,463,475,-12,-2.53,1182
2021-05-23,300,292,8,2.74,1182
2021-05-24,1542,1639,-97,-5.92,1182
2021-05-25,1567,1683,-116,-6.89,1182
2021-05-26,1567,1681,-114,-6.78,1182
2021-05-27,1567,1677,-110,-6.56,1182
2021-05-28,1372,1503,-131,-8.72,1182
2021-05-29,463,451,12,2.66,1182
2021-05-30,300,267,33,12.36,1182
2021-05-31,1542,1613,-71,-4.4,1182
2021-06-01,1632,1657,-25,-1.51,1182
2021-06-02,1632,1655,-23,-1.39,1182
2021-06-03,1632,1653,-21,-1.27,1182
2021-06-04,1440,1480,-40,-2.7,1182
2021-06-05,488,429,59,13.75,1182
2021-06-06,293,247,46,18.62,1182
2021-06-07,1623,1595,28,1.76,1182
2021-06-08,1632,1641,-9,-0.55,1182
2021-06-09,1632,1642,-10,-0.61,1182
2021-06-10,1632,1642,-10,-0.61,1182
2021-06-11,1440,1471,-31,-2.11,1182
2021-06-12,488,422,66,15.64,1182
2021-06-13,293,241,52,21.58,1182
2021-06-14,1623,1591,32,2.01,1182
2021-06-15,1632,1638,-6,-0.37,1182
2021-06-16,1632,1639,-7,-0.43,1182
2021-06-17,1632,1639,-7,-0.43,1182
2021-06-18,1440,1468,-28,-1.91,1182
2021-06-19,488,418,70,16.75,1182
2021-06-20,293,236,57,24.15,1182
2021-06-21,1623,1584,39,2.46,1182
2021-06-22,1632,1629,3,0.18,1182
2021-06-23,1632,1628,4,0.25,1182
2021-06-24,1632,1624,8,0.49,1182
2021-06-25,1440,1450,-10,-0.69,1182
2021-06-26,488,397,91,22.92,1182
2021-06-27,293,212,81,38.21,1182
2021-06-28,1623,1557,66,4.24,1182
2021-06-29,1632,1599,33,2.06,1182
2021-06-30,1632,1595,37,2.32,1182
2021-07-01,1522,1589,-67,-4.22,1182
2021-07-02,1350,1413,-63,-4.46,1182
2021-07-03,476,359,117,32.59,1182
2021-07-04,312,172,140,81.4,1182
2021-07-05,1420,1517,-97,-6.39,1182
2021-07-06,1522,1559,-37,-2.37,1182
2021-07-07,1522,1555,-33,-2.12,1182
2021-07-08,1522,1551,-29,-1.87,1182
2021-07-09,1350,1377,-27,-1.96,1182
2021-07-10,476,324,152,46.91,1182
2021-07-11,312,140,172,122.86,1182
2021-07-12,1420,1488,-68,-4.57,1182
2021-07-13,1522,1533,-11,-0.72,1182
2021-07-14,1522,1533,-11,-0.72,1182
2021-07-15,1522,1532,-10,-0.65,1182
2021-07-16,1350,1361,-11,-0.81,1182
2021-07-17,476,312,164,52.56,1182
2021-07-18,312,131,181,138.17,1182
2021-07-19,1420,1481,-61,-4.12,1182
2021-07-20,1522,1529,-7,-0.46,1182
2021-07-21,1522,1531,-9,-0.59,1182
2021-07-22,1522,1531,-9,-0.59,1182
2021-07-23,1350,1361,-11,-0.81,1182
2021-07-24,476,313,163,52.08,1182
2021-07-25,312,132,180,136.36,1182
2021-07-26,1420,1481,-61,-4.12,1182
2021-07-27,1522,1528,-6,-0.39,1182
2021-07-28,1522,1528,-6,-0.39,1182
2021-07-29,1522,1526,-4,-0.26,1182
2021-07-30,1350,1354,-4,-0.3,1182
2021-07-31,476,302,174,57.62,1182
2021-08-01,298,118,180,152.54,1182
2021-08-02,1406,1464,-58,-3.96,1182
2021-08-03,1426,1507,-81,-5.37,1182
2021-08-04,1426,1504,-78,-5.19,1182
2021-08-05,1426,1500,-74,-4.93,1182
2021-08-06,1260,1324,-64,-4.83,1182
2021-08-07,446,271,175,64.58,1182
2021-08-08,298,85,213,250.59,1182
2021-08-09,1406,1430,-24,-1.68,1182
2021-08-10,1426,1472,-46,-3.12,1182
2021-08-11,1426,1470,-44,-2.99,1182
2021-08-12,1426,1466,-40,-2.73,1182
2021-08-13,1260,1292,-32,-2.48,1182
2021-08-14,446,241,205,85.06,1182
2021-08-15,298,58,240,413.79,1182
2021-08-16,1406,1407,-1,-0.07,1182
2021-08-17,1426,1453,-27,-1.86,1182
2021-08-18,1426,1455,-29,-1.99,1182
2021-08-19,1426,1456,-30,-2.06,1182
2021-08-20,1260,1288,-28,-2.17,1182
2021-08-21,446,242,204,84.3,1182
2021-08-22,298,65,233,358.46,1182
2021-08-23,1406,1419,-13,-0.92,1182
2021-08-24,1426,1470,-44,-2.99,1182
2021-08-25,1426,1477,-51,-3.45,1182
2021-08-26,1426,1483,-57,-3.84,1182
2021-08-27,1260,1319,-59,-4.47,1182
2021-08-28,446,276,170,61.59,1182
2021-08-29,298,102,196,192.16,1182
2021-08-30,1406,1458,-52,-3.57,1182
2021-08-31,1426,1511,-85,-5.63,1182
2021-09-01,1634,1519,115,7.57,1182
2021-09-02,1634,1525,109,7.15,1182
2021-09-03,1461,1359,102,7.51,1182
2021-09-04,478,315,163,51.75,1182
2021-09-05,296,139,157,112.95,1182
2021-09-06,1534,1492,42,2.82,1182
2021-09-07,1634,1542,92,5.97,1182
2021-09-08,1634,1546,88,5.69,1182
2021-09-09,1634,1548,86,5.56,1182
2021-09-10,1461,1379,82,5.95,1182
2021-09-11,478,331,147,44.41,1182
2021-09-12,296,151,145,96.03,1182
2021-09-13,1534,1500,34,2.27,1182
2021-09-14,1634,1547,87,5.62,1182
2021-09-15,1634,1548,86,5.56,1182
2021-09-16,1634,1547,87,5.62,1182
2021-09-17,1461,1376,85,6.18,1182
2021-09-18,478,326,152,46.63,1182
2021-09-19,296,144,152,105.56,1182
2021-09-20,1534,1494,40,2.68,1182
2021-09-21,1634,1540,94,6.1,1182
2021-09-22,1634,1542,92,5.97,1182
2021-09-23,1634,1542,92,5.97,1182
2021-09-24,1461,1373,88,6.41,1182
2021-09-25,478,325,153,47.08,1182
2021-09-26,296,146,150,102.74,1182
2021-09-27,1534,1498,36,2.4,1182
2021-09-28,1634,1547,87,5.62,1182
2021-09-29,1634,1551,83,5.35,1182
2021-09-30,1634,1554,80,5.15,1182
2021-10-01,1496,1387,109,7.86,1182
2021-10-02,473,341,132,38.71,1182
2021-10-03,276,164,112,68.29,1182
2021-10-04,1530,1517,13,0.86,1182
2021-10-05,1648,1567,81,5.17,1182
2021-10-06,1648,1572,76,4.83,1182
2021-10-07,1648,1575,73,4.63,1182
2021-10-08,1496,1407,89,6.33,1182
2021-10-09,473,361,112,31.02,1182
2021-10-10,276,182,94,51.65,1182
2021-10-11,1530,1533,-3,-0.2,1182
2021-10-12,1648,1580,68,4.3,1182
2021-10-13,1648,1582,66,4.17,1182
2021-10-14,1648,1582,66,4.17,1182
2021-10-15,1496,1411,85,6.02,1182
2021-10-16,473,361,112,31.02,1182
2021-10-17,276,179,97,54.19,1182
2021-10-18,1530,1526,4,0.26,1182
2021-10-19,1648,1571,77,4.9,1182
2021-10-20,1648,1570,78,4.97,1182
2021-10-21,1648,1568,80,5.1,1182
2021-10-22,1496,1395,101,7.24,1182
2021-10-23,473,343,130,37.9,1182
2021-10-24,276,160,116,72.5,1182
2021-10-25,1530,1507,23,1.53,1182
2021-10-26,1648,1552,96,6.19,1182
2021-10-27,1648,1552,96,6.19,1182
2021-10-28,1648,1550,98,6.32,1182
2021-10-29,1496,1379,117,8.48,1182
2021-10-30,473,330,143,43.33,1182
2021-10-31,276,149,127,85.23,1182
2021-11-01,1472,1499,-27,-1.8,1182
2021-11-02,1600,1547,53,3.43,1182
2021-11-03,1600,1550,50,3.23,1182
2021-11-04,1600,1551,49,3.16,1182
2021-11-05,1483,1383,100,7.23,1182
2021-11-06,457,336,121,36.01,1182
2021-11-07,261,158,103,65.19,1182
2021-11-08,1472,1510,-38,-2.52,1182
2021-11-09,1600,1559,41,2.63,1182
2021-11-10,1600,1562,38,2.43,1182
2021-11-11,1600,1564,36,2.3,1182
2021-11-12,1483,1395,88,6.31,1182
2021-11-13,457,347,110,31.7,1182
2021-11-14,261,166,95,57.23,1182
2021-11-15,1472,1515,-43,-2.84,1182
2021-11-16,1600,1561,39,2.5,1182
2021-11-17,1600,1561,39,2.5,1182
2021-11-18,1600,1558,42,2.7,1182
2021-11-19,1483,1384,99,7.15,1182
2021-11-20,457,331,126,38.07,1182
2021-11-21,261,145,116,80.0,1182
2021-11-22,1472,1489,-17,-1.14,1182
2021-11-23,1600,1529,71,4.64,1182
2021-11-24,1600,1524,76,4.99,1182
2021-11-25,1600,1516,84,5.54,1182
2021-11-26,1483,1337,146,10.92,1182
2021-11-27,457,280,177,63.21,1182
2021-11-28,261,90,171,190.0,1182
2021-11-29,1472,1431,41,2.87,1182
2021-11-30,1600,1469,131,8.92,1182
2021-12-01,1302,1462,-160,-10.94,1182
2021-12-02,1302,1453,-151,-10.39,1182
2021-12-03,1067,1275,-208,-16.31,1182
2021-12-04,433,218,215,98.62,1182
2021-12-05,231,30,201,670.0,1182
2021-12-06,1335,1373,-38,-2.77,1182
2021-12-07,1302,1413,-111,-7.86,1182
2021-12-08,1302,1410,-108,-7.66,1182
2021-12-09,1302,1405,-103,-7.33,1182
2021-12-10,1067,1230,-163,-13.25,1182
2021-12-11,433,178,255,143.26,1182
2021-12-12,231,133,98,73.68,1182
2021-12-13,1335,1342,-7,-0.52,1182
2021-12-14,1302,1387,-85,-6.13,1182
2021-12-15,1302,1387,-85,-6.13,1182
2021-12-16,1302,1386,-84,-6.06,1182
2021-12-17,1067,1215,-148,-12.18,1182
2021-12-18,433,166,267,160.84,1182
2021-12-19,231,127,104,81.89,1182
2021-12-20,1335,1335,0,0.0,1182
2021-12-21,1302,1381,-79,-5.72,1182
2021-12-22,1302,1383,-81,-5.86,1182
2021-12-23,1302,1382,-80,-5.79,1182
2021-12-24,1067,1211,-144,-11.89,1182
2021-12-25,433,161,272,168.94,1182
2021-12-26,231,128,103,80.47,1182
2021-12-27,1335,1327,8,0.6,1182
2021-12-28,1302,1372,-70,-5.1,1182
2021-12-29,1302,1371,-69,-5.03,1182
2021-12-30,1302,1368,-66,-4.82,1182
2021-12-31,1067,1194,-127,-10.64,1182
2022-01-01,352,142,210,147.89,1182
2022-01-02,216,122,94,77.05,1182
2022-01-03,1074,1303,-229,-17.57,1182
2022-01-04,1180,1347,-167,-12.4,1182
2022-01-05,1180,1344,-164,-12.2,1182
2022-01-06,1180,1341,-161,-12.01,1182
2022-01-07,1086,1167,-81,-6.94,1182
2022-01-08,352,114,238,208.77,1182
2022-01-09,216,106,110,103.77,1182
2022-01-10,1074,1277,-203,-15.9,1182
2022-01-11,1180,1322,-142,-10.74,1182
2022-01-12,1180,1322,-142,-10.74,1182
2022-01-13,1180,1321,-141,-10.67,1182
2022-01-14,1086,1150,-64,-5.57,1182
2022-01-15,352,101,251,248.51,1182
2022-01-16,216,108,108,100.0,1182
2022-01-17,1074,1272,-198,-15.57,1182
2022-01-18,1180,1320,-140,-10.61,1182
2022-01-19,1180,1324,-144,-10.88,1182
2022-01-20,1180,1327,-147,-11.08,1182
2022-01-21,1086,1160,-74,-6.38,1182
2022-01-22,352,114,238,208.77,1182
2022-01-23,216,118,98,83.05,1182
2022-01-24,1074,1291,-217,-16.81,1182
2022-01-25,1180,1343,-163,-12.14,1182
2022-01-26,1180,1349,-169,-12.53,1182
2022-01-27,1180,1354,-174,-12.85,1182
2022-01-28,1086,1188,-102,-8.59,1182
2022-01-29,352,143,209,146.15,1182
2022-01-30,216,129,87,67.44,1182
2020-02-01,165,436,-271,-62.16,1611
2020-02-02,81,349,-268,-76.79,1611
2020-02-03,510,830,-320,-38.55,1611
2020-02-04,598,830,-232,-27.95,1611
2020-02-05,598,835,-237,-28.38,1611
2020-02-06,598,839,-241,-28.72,1611
2020-02-07,459,818,-359,-43.89,1611
2020-02-08,165,467,-302,-64.67,1611
2020-02-09,81,377,-296,-78.51,1611
2020-02-10,510,856,-346,-40.42,1611
2020-02-11,598,853,-255,-29.89,1611
2020-02-12,598,855,-257,-30.06,1611
2020-02-13,598,856,-258,-30.14,1611
2020-02-14,459,834,-375,-44.96,1611
2020-02-15,165,481,-316,-65.7,1611
2020-02-16,81,390,-309,-79.23,1611
2020-02-17,510,868,-358,-41.24,1611
2020-02-18,598,865,-267,-30.87,1611
2020-02-19,598,867,-269,-31.03,1611
2020-02-20,598,869,-271,-31.19,1611
2020-02-21,459,847,-388,-45.81,1611
2020-02-22,165,495,-330,-66.67,1611
2020-02-23,81,406,-325,-80.05,1611
2020-02-24,510,885,-375,-42.37,1611
2020-02-25,598,884,-286,-32.35,1611
2020-02-26,598,888,-290,-32.66,1611
2020-02-27,598,892,-294,-32.96,1611
2020-02-28,459,872,-413,-47.36,1611
2020-02-29,165,521,-356,-68.33,1611
2020-03-01,65,434,-369,-85.02,1611
2020-03-02,445,914,-469,-51.31,1611
2020-03-03,517,913,-396,-43.37,1611
2020-03-04,517,918,-401,-43.68,1611
2020-03-05,517,921,-404,-43.87,1611
2020-03-06,380,901,-521,-57.82,1611
2020-03-07,145,550,-405,-73.64,1611
2020-03-08,65,461,-396,-85.9,1611
2020-03-09,445,940,-495,-52.66,1611
2020-03-10,517,938,-421,-44.88,1611
2020-03-11,517,941,-424,-45.06,1611
2020-03-12,517,942,-425,-45.12,1611
2020-03-13,380,920,-540,-58.7,1611
2020-03-14,145,567,-422,-74.43,1611
2020-03-15,65,476,-411,-86.34,1611
2020-03-16,445,953,-508,-53.31,1611
2020-03-17,517,949,-432,-45.52,1611
2020-03-18,517,950,-433,-45.58,1611
2020-03-19,517,950,-433,-45.58,1611
2020-03-20,380,926,-546,-58.96,1611
2020-03-21,145,572,-427,-74.65,1611
2020-03-22,65,481,-416,-86.49,1611
2020-03-23,445,957,-512,-53.5,1611
2020-03-24,517,954,-437,-45.81,1611
2020-03-25,517,955,-438,-45.86,1611
2020-03-26,517,956,-439,-45.92,1611
2020-03-27,380,933,-553,-59.27,1611
2020-03-28,145,581,-436,-75.04,1611
2020-03-29,65,491,-426,-86.76,1611
2020-03-30,445,970,-525,-54.12,1611
2020-03-31,517,968,-451,-46.59,1611
2020-04-01,502,971,-469,-48.3,1611
2020-04-02,502,974,-472,-48.46,1611
2020-04-03,344,953,-609,-63.9,1611
2020-04-04,127,602,-475,-78.9,1611
2020-04-05,51,513,-462,-90.06,1611
2020-04-06,437,992,-555,-55.95,1611
2020-04-07,502,991,-489,-49.34,1611
2020-04-08,502,995,-493,-49.55,1611
2020-04-09,502,998,-496,-49.7,1611
2020-04-10,344,976,-632,-64.75,1611
2020-04-11,127,624,-497,-79.65,1611
2020-04-12,51,535,-484,-90.47,1611
2020-04-13,437,1013,-576,-56.86,1611
2020-04-14,502,1010,-508,-50.3,1611
2020-04-15,502,1011,-509,-50.35,1611
2020-04-16,502,1012,-510,-50.4,1611
2020-04-17,344,988,-644,-65.18,1611
2020-04-18,127,634,-507,-79.97,1611
2020-04-19,51,542,-491,-90.59,1611
2020-04-20,437,1018,-581,-57.07,1611
2020-04-21,502,1013,-511,-50.44,1611
2020-04-22,502,1013,-511,-50.44,1611
2020-04-23,502,1011,-509,-50.35,1611
2020-04-24,344,986,-642,-65.11,1611
2020-04-25,127,631,-504,-79.87,1611
2020-04-26,51,538,-487,-90.52,1611
2020-04-27,437,1013,-576,-56.86,1611
2020-04-28,502,1007,-505,-50.15,1611
2020-04-29,502,1007,-505,-50.15,1611
2020-04-30,502,1006,-504,-50.1,1611
2020-05-01,547,982,-435,-44.3,1611
2020-05-02,224,627,-403,-64.27,1611
2020-05-03,98,535,-437,-81.68,1611
2020-05-04,627,1012,-385,-38.04,1611
2020-05-05,592,1008,-416,-41.27,1611
2020-05-06,592,1009,-417,-41.33,1611
2020-05-07,592,1010,-418,-41.39,1611
2020-05-08,547,987,-440,-44.58,1611
2020-05-09,224,634,-410,-64.67,1611
2020-05-10,98,543,-445,-81.95,1611
2020-05-11,627,1021,-394,-38.59,1611
2020-05-12,592,1018,-426,-41.85,1611
2020-05-13,592,1020,-428,-41.96,1611
2020-05-14,592,1021,-429,-42.02,1611
2020-05-15,547,998,-451,-45.19,1611
2020-05-16,224,645,-421,-65.27,1611
2020-05-17,98,555,-457,-82.34,1611
2020-05-18,627,1032,-405,-39.24,1611
2020-05-19,592,1028,-436,-42.41,1611
2020-05-20,592,1029,-437,-42.47,1611
2020-05-21,592,1029,-437,-42.47,1611
2020-05-22,547,1005,-458,-45.57,1611
2020-05-23,224,651,-427,-65.59,1611
2020-05-24,98,559,-461,-82.47,1611
2020-05-25,627,1035,-408,-39.42,1611
2020-05-26,592,1030,-438,-42.52,1611
2020-05-27,592,1030,-438,-42.52,1611
2020-05-28,592,1030,-438,-42.52,1611
2020-05-29,547,1005,-458,-45.57,1611
2020-05-30,224,650,-426,-65.54,1611
2020-05-31,98,558,-460,-82.44,1611
2020-06-01,648,1034,-386,-37.33,1611
2020-06-02,600,1030,-430,-41.75,1611
2020-06-03,600,1031,-431,-41.8,1611
2020-06-04,600,1031,-431,-41.8,1611
2020-06-05,547,1007,-460,-45.68,1611
2020-06-06,228,654,-426,-65.14,1611
2020-06-07,100,563,-463,-82.24,1611
2020-06-08,648,1040,-392,-37.69,1611
2020-06-09,600,1037,-437,-42.14,1611
2020-06-10,600,1039,-439,-42.25,1611
2020-06-11,600,1040,-440,-42.31,1611
2020-06-12,547,1018,-471,-46.27,1611
2020-06-13,228,665,-437,-65.71,1611
2020-06-14,100,574,-474,-82.58,1611
2020-06-15,648,1052,-404,-38.4,1611
2020-06-16,600,1048,-448,-42.75,1611
2020-06-17,600,1050,-450,-42.86,1611
2020-06-18,600,1050,-450,-42.86,1611
2020-06-19,547,1026,-479,-46.69,1611
2020-06-20,228,672,-444,-66.07,1611
2020-06-21,100,580,-480,-82.76,1611
2020-06-22,648,1056,-408,-38.64,1611
2020-06-23,600,1050,-450,-42.86,1611
2020-06-24,600,1049,-449,-42.8,1611
2020-06-25,600,1047,-447,-42.69,1611
2020-06-26,547,1021,-474,-46.43,1611
2020-06-27,228,665,-437,-65.71,1611
2020-06-28,100,570,-470,-82.46,1611
2020-06-29,648,1044,-396,-37.93,1611
2020-06-30,600,1036,-436,-42.08,1611
2020-07-01,602,1034,-432,-41.78,1611
2020-07-02,602,1031,-429,-41.61,1611
2020-07-03,570,1004,-434,-43.23,1611
2020-07-04,239,648,-409,-63.12,1611
2020-07-05,101,553,-452,-81.74,1611
2020-07-06,629,1027,-398,-38.75,1611
2020-07-07,602,1021,-419,-41.04,1611
2020-07-08,602,1020,-418,-40.98,1611
2020-07-09,602,1019,-417,-40.92,1611
2020-07-10,570,994,-424,-42.66,1611
2020-07-11,239,639,-400,-62.6,1611
2020-07-12,101,547,-446,-81.54,1611
2020-07-13,629,1024,-395,-38.57,1611
2020-07-14,602,1020,-418,-40.98,1611
2020-07-15,602,1021,-419,-41.04,1611
2020-07-16,602,1022,-420,-41.1,1611
2020-07-17,570,1000,-430,-43.0,1611
2020-07-18,239,647,-408,-63.06,1611
2020-07-19,101,557,-456,-81.87,1611
2020-07-20,629,1035,-406,-39.23,1611
2020-07-21,602,1032,-430,-41.67,1611
2020-07-22,602,1034,-432,-41.78,1611
2020-07-23,602,1035,-433,-41.84,1611
2020-07-24,570,1011,-441,-43.62,1611
2020-07-25,239,658,-419,-63.68,1611
2020-07-26,101,566,-465,-82.16,1611
2020-07-27,629,1043,-414,-39.69,1611
2020-07-28,602,1037,-435,-41.95,1611
2020-07-29,602,1037,-435,-41.95,1611
2020-07-30,602,1036,-434,-41.89,1611
2020-07-31,570,1010,-440,-43.56,1611
2020-08-01,244,654,-410,-62.69,1611
2020-08-02,104,560,-456,-81.43,1611
2020-08-03,580,1034,-454,-43.91,1611
2020-08-04,582,1027,-445,-43.33,1611
2020-08-05,582,1025,-443,-43.22,1611
2020-08-06,582,1022,-440,-43.05,1611
2020-08-07,556,995,-439,-44.12,1611
2020-08-08,244,639,-395,-61.82,1611
2020-08-09,104,545,-441,-80.92,1611
2020-08-10,580,1019,-439,-43.08,1611
2020-08-11,582,1013,-431,-42.55,1611
2020-08-12,582,1013,-431,-42.55,1611
2020-08-13,582,1013,-431,-42.55,1611
2020-08-14,556,988,-432,-43.72,1611
2020-08-15,244,635,-391,-61.57,1611
2020-08-16,104,544,-440,-80.88,1611
2020-08-17,580,1022,-442,-43.25,1611
2020-08-18,582,1020,-438,-42.94,1611
2020-08-19,582,1023,-441,-43.11,1611
2020-08-20,582,1026,-444,-43.27,1611
2020-08-21,556,1005,-449,-44.68,1611
2020-08-22,244,655,-411,-62.75,1611
2020-08-23,104,567,-463,-81.66,1611
2020-08-24,580,1047,-467,-44.6,1611
2020-08-25,582,1046,-464,-44.36,1611
2020-08-26,582,1051,-469,-44.62,1611
2020-08-27,582,1054,-472,-44.78,1611
2020-08-28,556,1033,-477,-46.18,1611
2020-08-29,244,682,-438,-64.22,1611
2020-08-30,104,592,-488,-82.43,1611
2020-08-31,580,1070,-490,-45.79,1611
2020-09-01,607,1067,-460,-43.11,1611
2020-09-02,607,1069,-462,-43.22,1611
2020-09-03,607,1069,-462,-43.22,1611
2020-09-04,573,1044,-471,-45.11,1611
2020-09-05,250,689,-439,-63.72,1611
2020-09-06,108,596,-488,-81.88,1611
2020-09-07,616,1071,-455,-42.48,1611
2020-09-08,607,1065,-458,-43.0,1611
2020-09-09,607,1064,-457,-42.95,1611
2020-09-10,607,1062,-455,-42.84,1611
2020-09-11,573,1036,-463,-44.69,1611
2020-09-12,250,681,-431,-63.29,1611
2020-09-13,108,589,-481,-81.66,1611
2020-09-14,616,1065,-449,-42.16,1611
2020-09-15,607,1061,-454,-42.79,1611
2020-09-16,607,1064,-457,-42.95,1611
2020-09-17,607,1066,-459,-43.06,1611
2020-09-18,573,1046,-473,-45.22,1611
2020-09-19,250,697,-447,-64.13,1611
2020-09-20,108,612,-504,-82.35,1611
2020-09-21,616,1096,-480,-43.8,1611
2020-09-22,607,1100,-493,-44.82,1611
2020-09-23,607,1111,-504,-45.36,1611
2020-09-24,607,1123,-516,-45.95,1611
2020-09-25,573,1112,-539,-48.47,1611
2020-09-26,250,771,-521,-67.57,1611
2020-09-27,108,694,-586,-84.44,1611
2020-09-28,616,1186,-570,-48.06,1611
2020-09-29,607,1198,-591,-49.33,1611
2020-09-30,607,1215,-608,-50.04,1611
2020-10-01,616,1232,-616,-50.0,1611
2020-10-02,561,1224,-663,-54.17,1611
2020-10-03,224,886,-662,-74.72,1611
2020-10-04,97,810,-713,-88.02,1611
2020-10-05,649,1302,-653,-50.15,1611
2020-10-06,616,1312,-696,-53.05,1611
2020-10-07,616,1326,-710,-53.54,1611
2020-10-08,616,1338,-722,-53.96,1611
2020-10-09,561,1324,-763,-57.63,1611
2020-10-10,224,979,-755,-77.12,1611
2020-10-11,97,895,-798,-89.16,1611
2020-10-12,649,1378,-729,-52.9,1611
2020-10-13,616,1378,-762,-55.3,1611
2020-10-14,616,1381,-765,-55.39,1611
2020-10-15,616,1383,-767,-55.46,1611
2020-10-16,561,1358,-797,-58.69,1611
2020-10-17,224,1003,-779,-77.67,1611
2020-10-18,97,908,-811,-89.32,1611
2020-10-19,649,1381,-732,-53.01,1611
2020-10-20,616,1372,-756,-55.1,1611
2020-10-21,616,1368,-752,-54.97,1611
2020-10-22,616,1362,-746,-54.77,1611
2020-10-23,561,1332,-771,-57.88,1611
2020-10-24,224,971,-747,-76.93,1611
2020-10-25,97,874,-777,-88.9,1611
2020-10-26,649,1344,-695,-51.71,1611
2020-10-27,616,1334,-718,-53.82,1611
2020-10-28,616,1330,-714,-53.68,1611
2020-10-29,616,1326,-710,-53.54,1611
2020-10-30,561,1299,-738,-56.81,1611
2020-10-31,224,942,-718,-76.22,1611
2020-11-01,90,849,-759,-89.4,1611
2020-11-02,647,1324,-677,-51.13,1611
2020-11-03,624,1320,-696,-52.73,1611
2020-11-04,624,1322,-698,-52.8,1611
2020-11-05,624,1323,-699,-52.83,1611
2020-11-06,579,1301,-722,-55.5,1611
2020-11-07,219,950,-731,-76.95,1611
2020-11-08,90,861,-771,-89.55,1611
2020-11-09,647,1340,-693,-51.72,1611
2020-11-10,624,1338,-714,-53.36,1611
2020-11-11,624,1342,-718,-53.5,1611
2020-11-12,624,1344,-720,-53.57,1611
2020-11-13,579,1321,-742,-56.17,1611
2020-11-14,219,968,-749,-77.38,1611
2020-11-15,90,876,-786,-89.73,1611
2020-11-16,647,1351,-704,-52.11,1611
2020-11-17,624,1345,-721,-53.61,1611
2020-11-18,624,1342,-718,-53.5,1611
2020-11-19,624,1337,-713,-53.33,1611
2020-11-20,579,1307,-728,-55.7,1611
2020-11-21,219,945,-726,-76.83,1611
2020-11-22,90,845,-755,-89.35,1611
2020-11-23,647,1311,-664,-50.65,1611
2020-11-24,624,1295,-671,-51.81,1611
2020-11-25,624,1284,-660,-51.4,1611
2020-11-26,624,1271,-647,-50.9,1611
2020-11-27,579,1233,-654,-53.04,1611
2020-11-28,219,865,-646,-74.68,1611
2020-11-29,90,758,-668,-88.13,1611
2020-11-30,647,1220,-573,-46.97,1611
2020-12-01,504,1201,-697,-58.03,1611
2020-12-02,504,1187,-683,-57.54,1611
2020-12-03,504,1173,-669,-57.03,1611
2020-12-04,581,1135,-554,-48.81,1611
2020-12-05,222,769,-547,-71.13,1611
2020-12-06,91,665,-574,-86.32,1611
2020-12-07,562,1131,-569,-50.31,1611
2020-12-08,504,1117,-613,-54.88,1611
2020-12-09,504,1110,-606,-54.59,1611
2020-12-10,504,1103,-599,-54.31,1611
2020-12-11,581,1073,-492,-45.85,1611
2020-12-12,222,715,-493,-68.95,1611
2020-12-13,91,620,-529,-85.32,1611
2020-12-14,562,1094,-532,-48.63,1611
2020-12-15,504,1088,-584,-53.68,1611
2020-12-16,504,1089,-585,-53.72,1611
2020-12-17,504,1090,-586,-53.76,1611
2020-12-18,581,1067,-486,-45.55,1611
2020-12-19,222,715,-493,-68.95,1611
2020-12-20,91,626,-535,-85.46,1611
2020-12-21,562,1105,-543,-49.14,1611
2020-12-22,504,1103,-599,-54.31,1611
2020-12-23,504,1106,-602,-54.43,1611
2020-12-24,504,1109,-605,-54.55,1611
2020-12-25,581,1087,-506,-46.55,1611
2020-12-26,222,735,-513,-69.8,1611
2020-12-27,91,644,-553,-85.87,1611
2020-12-28,562,1121,-559,-49.87,1611
2020-12-29,504,1117,-613,-54.88,1611
2020-12-30,504,1117,-613,-54.88,1611
2020-12-31,504,1116,-612,-54.84,1611
2021-01-01,508,1090,-582,-53.39,1611
2021-01-02,209,734,-525,-71.53,1611
2021-01-03,87,640,-553,-86.41,1611
2021-01-04,560,1113,-553,-49.69,1611
2021-01-05,550,1105,-555,-50.23,1611
2021-01-06,550,1102,-552,-50.09,1611
2021-01-07,550,1099,-549,-49.95,1611
2021-01-08,508,1071,-563,-52.57,1611
2021-01-09,209,714,-505,-70.73,1611
2021-01-10,87,619,-532,-85.95,1611
2021-01-11,560,1092,-532,-48.72,1611
2021-01-12,550,1086,-536,-49.36,1611
2021-01-13,550,1085,-535,-49.31,1611
2021-01-14,550,1083,-533,-49.22,1611
2021-01-15,508,1059,-551,-52.03,1611
2021-01-16,209,705,-496,-70.35,1611
2021-01-17,87,614,-527,-85.83,1611
2021-01-18,560,1092,-532,-48.72,1611
2021-01-19,550,1090,-540,-49.54,1611
2021-01-20,550,1094,-544,-49.73,1611
2021-01-21,550,1098,-548,-49.91,1611
2021-01-22,508,1078,-570,-52.88,1611
2021-01-23,209,729,-520,-71.33,1611
2021-01-24,87,642,-555,-86.45,1611
2021-01-25,560,1124,-564,-50.18,1611
2021-01-26,550,1125,-575,-51.11,1611
2021-01-27,550,1132,-582,-51.41,1611
2021-01-28,550,1138,-588,-51.67,1611
2021-01-29,508,1120,-612,-54.64,1611
2021-01-30,209,771,-562,-72.89,1611
2021-01-31,87,685,-598,-87.3,1611
2021-02-01,508,1167,-659,-56.47,1611
2021-02-02,542,1167,-625,-53.56,1611
2021-02-03,542,1172,-630,-53.75,1611
2021-02-04,542,1176,-634,-53.91,1611
2021-02-05,459,1156,-697,-60.29,1611
2021-02-06,183,805,-622,-77.27,1611
2021-02-07,76,716,-640,-89.39,1611
2021-02-08,508,1195,-687,-57.49,1611
2021-02-09,542,1193,-651,-54.57,1611
2021-02-10,542,1195,-653,-54.64,1611
2021-02-11,542,1197,-655,-54.72,1611
2021-02-12,459,1174,-715,-60.9,1611
2021-02-13,183,822,-639,-77.74,1611
2021-02-14,76,731,-655,-89.6,1611
2021-02-15,508,1209,-701,-57.98,1611
2021-02-16,542,1205,-663,-55.02,1611
2021-02-17,542,1208,-666,-55.13,1611
2021-02-18,542,1209,-667,-55.17,1611
2021-02-19,459,1187,-728,-61.33,1611
2021-02-20,183,835,-652,-78.08,1611
2021-02-21,76,745,-669,-89.8,1611
2021-02-22,508,1224,-716,-58.5,1611
2021-02-23,542,1223,-681,-55.68,1611
2021-02-24,542,1226,-684,-55.79,1611
2021-02-25,542,1230,-688,-55.93,1611
2021-02-26,459,1209,-750,-62.03,1611
2021-02-27,183,859,-676,-78.7,1611
2021-02-28,76,771,-695,-90.14,1611
2021-03-01,521,1251,-730,-58.35,1611
2021-03-02,584,1251,-667,-53.32,1611
2021-03-03,584,1255,-671,-53.47,1611
2021-03-04,584,1259,-675,-53.61,1611
2021-03-05,452,1239,-787,-63.52,1611
2021-03-06,195,888,-693,-78.04,1611
2021-03-07,82,800,-718,-89.75,1611
2021-03-08,521,1279,-758,-59.27,1611
2021-03-09,584,1277,-693,-54.27,1611
2021-03-10,584,1280,-696,-54.37,1611
2021-03-11,584,1282,-698,-54.45,1611
2021-03-12,452,1260,-808,-64.13,1611
2021-03-13,195,908,-713,-78.52,1611
2021-03-14,82,817,-735,-89.96,1611
2021-03-15,521,1294,-773,-59.74,1611
2021-03-16,584,1290,-706,-54.73,1611
2021-03-17,584,1292,-708,-54.8,1611
2021-03-18,584,1292,-708,-54.8,1611
2021-03-19,452,1268,-816,-64.35,1611
2021-03-20,195,914,-719,-78.67,1611
2021-03-21,82,823,-741,-90.04,1611
2021-03-22,521,1299,-778,-59.89,1611
2021-03-23,584,1295,-711,-54.9,1611
2021-03-24,584,1296,-712,-54.94,1611
2021-03-25,584,1297,-713,-54.97,1611
2021-03-26,452,1274,-822,-64.52,1611
2021-03-27,195,921,-726,-78.83,1611
2021-03-28,82,831,-749,-90.13,1611
2021-03-29,521,1309,-788,-60.2,1611
2021-03-30,584,1307,-723,-55.32,1611
2021-03-31,584,1310,-726,-55.42,1611
2021-04-01,571,1313,-742,-56.51,1611
2021-04-02,451,1291,-840,-65.07,1611
2021-04-03,180,940,-760,-80.85,1611
2021-04-04,75,851,-776,-91.19,1611
2021-04-05,514,1331,-817,-61.38,1611
2021-04-06,571,1329,-758,-57.04,1611
2021-04-07,571,1333,-762,-57.16,1611
2021-04-08,571,1336,-765,-57.26,1611
2021-04-09,451,1315,-864,-65.7,1611
2021-04-10,180,964,-784,-81.33,1611
2021-04-11,75,874,-799,-91.42,1611
2021-04-12,514,1353,-839,-62.01,1611
2021-04-13,571,1350,-779,-57.7,1611
2021-04-14,571,1352,-781,-57.77,1611
2021-04-15,571,1353,-782,-57.8,1611
2021-04-16,451,1330,-879,-66.09,1611
2021-04-17,180,977,-797,-81.58,1611
2021-04-18,75,885,-810,-91.53,1611
2021-04-19,514,1361,-847,-62.23,1611
2021-04-20,571,1356,-785,-57.89,1611
2021-04-21,571,1356,-785,-57.89,1611
2021-04-22,571,1355,-784,-57.86,1611
2021-04-23,451,1330,-879,-66.09,1611
2021-04-24,180,975,-795,-81.54,1611
2021-04-25,75,882,-807,-91.5,1611
2021-04-26,514,1357,-843,-62.12,1611
2021-04-27,571,1351,-780,-57.74,1611
2021-04-28,571,1351,-780,-57.74,1611
2021-04-29,571,1350,-779,-57.7,1611
2021-04-30,451,1325,-874,-65.96,1611
2021-05-01,180,970,-790,-81.44,1611
2021-05-02,76,878,-802,-91.34,1611
2021-05-03,503,1354,-851,-62.85,1611
2021-05-04,568,1350,-782,-57.93,1611
2021-05-05,568,1351,-783,-57.96,1611
2021-05-06,568,1351,-783,-57.96,1611
2021-05-07,449,1328,-879,-66.19,1611
2021-05-08,180,975,-795,-81.54,1611
2021-05-09,76,884,-808,-91.4,1611
2021-05-10,503,1362,-859,-63.07,1611
2021-05-11,568,1359,-791,-58.2,1611
2021-05-12,568,1361,-793,-58.27,1611
2021-05-13,568,1362,-794,-58.3,1611
2021-05-14,449,1339,-890,-66.47,1611
2021-05-15,180,986,-806,-81.74,1611
2021-05-16,76,896,-820,-91.52,1611
2021-05-17,503,1373,-870,-63.36,1611
2021-05-18,568,1369,-801,-58.51,1611
2021-05-19,568,1371,-803,-58.57,1611
2021-05-20,568,1371,-803,-58.57,1611
2021-05-21,449,1347,-898,-66.67,1611
2021-05-22,180,993,-813,-81.87,1611
2021-05-23,76,901,-825,-91.56,1611
2021-05-24,503,1378,-875,-63.5,1611
2021-05-25,568,1373,-805,-58.63,1611
2021-05-26,568,1373,-805,-58.63,1611
2021-05-27,568,1372,-804,-58.6,1611
2021-05-28,449,1348,-899,-66.69,1611
2021-05-29,180,993,-813,-81.87,1611
2021-05-30,76,901,-825,-91.56,1611
2021-05-31,503,1377,-874,-63.47,1611
2021-06-01,581,1372,-791,-57.65,1611
2021-06-02,581,1373,-792,-57.68,1611
2021-06-03,581,1373,-792,-57.68,1611
2021-06-04,458,1349,-891,-66.05,1611
2021-06-05,183,996,-813,-81.63,1611
2021-06-06,83,904,-821,-90.82,1611
2021-06-07,519,1381,-862,-62.42,1611
2021-06-08,581,1378,-797,-57.84,1611
2021-06-09,581,1380,-799,-57.9,1611
2021-06-10,581,1381,-800,-57.93,1611
2021-06-11,458,1358,-900,-66.27,1611
2021-06-12,183,1006,-823,-81.81,1611
2021-06-13,83,915,-832,-90.93,1611
2021-06-14,519,1393,-874,-62.74,1611
2021-06-15,581,1389,-808,-58.17,1611
2021-06-16,581,1391,-810,-58.23,1611
2021-06-17,581,1392,-811,-58.26,1611
2021-06-18,458,1368,-910,-66.52,1611
2021-06-19,183,1015,-832,-81.97,1611
2021-06-20,83,923,-840,-91.01,1611
2021-06-21,519,1399,-880,-62.9,1611
2021-06-22,581,1394,-813,-58.32,1611
2021-06-23,581,1393,-812,-58.29,1611
2021-06-24,581,1392,-811,-58.26,1611
2021-06-25,458,1366,-908,-66.47,1611
2021-06-26,183,1010,-827,-81.88,1611
2021-06-27,83,916,-833,-90.94,1611
2021-06-28,519,1390,-871,-62.66,1611
2021-06-29,581,1382,-801,-57.96,1611
2021-06-30,581,1380,-799,-57.9,1611
2021-07-01,520,1377,-857,-62.24,1611
2021-07-02,422,1350,-928,-68.74,1611
2021-07-03,173,993,-820,-82.58,1611
2021-07-04,74,899,-825,-91.77,1611
2021-07-05,451,1373,-922,-67.15,1611
2021-07-06,520,1366,-846,-61.93,1611
2021-07-07,520,1364,-844,-61.88,1611
2021-07-08,520,1363,-843,-61.85,1611
2021-07-09,422,1337,-915,-68.44,1611
2021-07-10,173,982,-809,-82.38,1611
2021-07-11,74,890,-816,-91.69,1611
2021-07-12,451,1366,-915,-66.98,1611
2021-07-13,520,1361,-841,-61.79,1611
2021-07-14,520,1363,-843,-61.85,1611
2021-07-15,520,1363,-843,-61.85,1611
2021-07-16,422,1340,-918,-68.51,1611
2021-07-17,173,988,-815,-82.49,1611
2021-07-18,74,897,-823,-91.75,1611
2021-07-19,451,1375,-924,-67.2,1611
2021-07-20,520,1372,-852,-62.1,1611
2021-07-21,520,1374,-854,-62.15,1611
2021-07-22,520,1376,-856,-62.21,1611
2021-07-23,422,1353,-931,-68.81,1611
2021-07-24,173,1000,-827,-82.7,1611
2021-07-25,74,908,-834,-91.85,1611
2021-07-26,451,1385,-934,-67.44,1611
2021-07-27,520,1380,-860,-62.32,1611
2021-07-28,520,1381,-861,-62.35,1611
2021-07-29,520,1380,-860,-62.32,1611
2021-07-30,422,1354,-932,-68.83,1611
2021-07-31,173,999,-826,-82.68,1611
2021-08-01,74,905,-831,-91.82,1611
2021-08-02,436,1379,-943,-68.38,1611
2021-08-03,497,1372,-875,-63.78,1611
2021-08-04,497,1370,-873,-63.72,1611
2021-08-05,497,1368,-871,-63.67,1611
2021-08-06,406,1341,-935,-69.72,1611
2021-08-07,164,984,-820,-83.33,1611
2021-08-08,74,890,-816,-91.69,1611
2021-08-09,436,1364,-928,-68.04,1611
2021-08-10,497,1358,-861,-63.4,1611
2021-08-11,497,1357,-860,-63.38,1611
2021-08-12,497,1356,-859,-63.35,1611
2021-08-13,406,1331,-925,-69.5,1611
2021-08-14,164,977,-813,-83.21,1611
2021-08-15,74,885,-811,-91.64,1611
2021-08-16,436,1363,-927,-68.01,1611
2021-08-17,497,1360,-863,-63.46,1611
2021-08-18,497,1362,-865,-63.51,1611
2021-08-19,497,1365,-868,-63.59,1611
2021-08-20,406,1344,-938,-69.79,1611
2021-08-21,164,993,-829,-83.48,1611
2021-08-22,74,905,-831,-91.82,1611
2021-08-23,436,1385,-949,-68.52,1611
2021-08-24,497,1384,-887,-64.09,1611
2021-08-25,497,1388,-891,-64.19,1611
2021-08-26,497,1392,-895,-64.3,1611
2021-08-27,406,1371,-965,-70.39,1611
2021-08-28,164,1021,-857,-83.94,1611
2021-08-29,74,932,-858,-92.06,1611
2021-08-30,436,1410,-974,-69.08,1611
2021-08-31,497,1408,-911,-64.7,1611
2021-09-01,554,1410,-856,-60.71,1611
2021-09-02,554,1411,-857,-60.74,1611
2021-09-03,453,1387,-934,-67.34,1611
2021-09-04,180,1033,-853,-82.58,1611
2021-09-05,80,940,-860,-91.49,1611
2021-09-06,490,1415,-925,-65.37,1611
2021-09-07,554,1409,-855,-60.68,1611
2021-09-08,554,1408,-854,-60.65,1611
2021-09-09,554,1406,-852,-60.6,1611
2021-09-10,453,1381,-928,-67.2,1611
2021-09-11,180,1025,-845,-82.44,1611
2021-09-12,80,932,-852,-91.42,1611
2021-09-13,490,1407,-917,-65.17,1611
2021-09-14,554,1403,-849,-60.51,1611
2021-09-15,554,1404,-850,-60.54,1611
2021-09-16,554,1405,-851,-60.57,1611
2021-09-17,453,1384,-931,-67.27,1611
2021-09-18,180,1033,-853,-82.58,1611
2021-09-19,80,946,-866,-91.54,1611
2021-09-20,490,1429,-939,-65.71,1611
2021-09-21,554,1431,-877,-61.29,1611
2021-09-22,554,1441,-887,-61.55,1611
2021-09-23,554,1451,-897,-61.82,1611
2021-09-24,453,1438,-985,-68.5,1611
2021-09-25,180,1097,-917,-83.59,1611
2021-09-26,80,1018,-938,-92.14,1611
2021-09-27,490,1509,-1019,-67.53,1611
2021-09-28,554,1520,-966,-63.55,1611
2021-09-29,554,1537,-983,-63.96,1611
2021-09-30,554,1553,-999,-64.33,1611
2021-10-01,458,1546,-1088,-70.38,1611
2021-10-02,180,1208,-1028,-85.1,1611
2021-10-03,77,1133,-1056,-93.2,1611
2021-10-04,491,1625,-1134,-69.78,1611
2021-10-05,561,1636,-1075,-65.71,1611
2021-10-06,561,1651,-1090,-66.02,1611
2021-10-07,561,1665,-1104,-66.31,1611
2021-10-08,458,1653,-1195,-72.29,1611
2021-10-09,180,1310,-1130,-86.26,1611
2021-10-10,77,1228,-1151,-93.73,1611
2021-10-11,491,1712,-1221,-71.32,1611
2021-10-12,561,1714,-1153,-67.27,1611
2021-10-13,561,1720,-1159,-67.38,1611
2021-10-14,561,1723,-1162,-67.44,1611
2021-10-15,458,1701,-1243,-73.07,1611
2021-10-16,180,1347,-1167,-86.64,1611
2021-10-17,77,1254,-1177,-93.86,1611
2021-10-18,491,1728,-1237,-71.59,1611
2021-10-19,561,1720,-1159,-67.38,1611
2021-10-20,561,1716,-1155,-67.31,1611
2021-10-21,561,1711,-1150,-67.21,1611
2021-10-22,458,1681,-1223,-72.75,1611
2021-10-23,180,1321,-1141,-86.37,1611
2021-10-24,77,1223,-1146,-93.7,1611
2021-10-25,491,1694,-1203,-71.02,1611
2021-10-26,561,1683,-1122,-66.67,1611
2021-10-27,561,1679,-1118,-66.59,1611
2021-10-28,561,1674,-1113,-66.49,1611
2021-10-29,458,1645,-1187,-72.16,1611
2021-10-30,180,1288,-1108,-86.02,1611
2021-10-31,77,1193,-1116,-93.55,1611
2021-11-01,500,1668,-1168,-70.02,1611
2021-11-02,556,1662,-1106,-66.55,1611
2021-11-03,556,1663,-1107,-66.57,1611
2021-11-04,556,1664,-1108,-66.59,1611
2021-11-05,458,1641,-1183,-72.09,1611
2021-11-06,190,1289,-1099,-85.26,1611
2021-11-07,76,1199,-1123,-93.66,1611
2021-11-08,500,1679,-1179,-70.22,1611
2021-11-09,556,1677,-1121,-66.85,1611
2021-11-10,556,1681,-1125,-66.92,1611
2021-11-11,556,1683,-1127,-66.96,1611
2021-11-12,458,1662,-1204,-72.44,1611
2021-11-13,190,1309,-1119,-85.49,1611
2021-11-14,76,1219,-1143,-93.77,1611
2021-11-15,500,1695,-1195,-70.5,1611
2021-11-16,556,1690,-1134,-67.1,1611
2021-11-17,556,1688,-1132,-67.06,1611
2021-11-18,556,1685,-1129,-67.0,1611
2021-11-19,458,1656,-1198,-72.34,1611
2021-11-20,190,1297,-1107,-85.35,1611
2021-11-21,76,1198,-1122,-93.66,1611
2021-11-22,500,1665,-1165,-69.97,1611
2021-11-23,556,1651,-1095,-66.32,1611
2021-11-24,556,1641,-1085,-66.12,1611
2021-11-25,556,1629,-1073,-65.87,1611
2021-11-26,458,1592,-1134,-71.23,1611
2021-11-27,190,1225,-1035,-84.49,1611
2021-11-28,76,1119,-1043,-93.21,1611
2021-11-29,500,1580,-1080,-68.35,1611
2021-11-30,556,1561,-1005,-64.38,1611
2021-12-01,490,1547,-1057,-68.33,1611
2021-12-02,490,1533,-1043,-68.04,1611
2021-12-03,356,1495,-1139,-76.19,1611
2021-12-04,189,1127,-938,-83.23,1611
2021-12-05,76,1022,-946,-92.56,1611
2021-12-06,476,1487,-1011,-67.99,1611
2021-12-07,490,1472,-982,-66.71,1611
2021-12-08,490,1463,-973,-66.51,1611
2021-12-09,490,1454,-964,-66.3,1611
2021-12-10,356,1423,-1067,-74.98,1611
2021-12-11,189,1063,-874,-82.22,1611
2021-12-12,76,966,-890,-92.13,1611
2021-12-13,476,1439,-963,-66.92,1611
2021-12-14,490,1432,-942,-65.78,1611
2021-12-15,490,1432,-942,-65.78,1611
2021-12-16,490,1431,-941,-65.76,1611
2021-12-17,356,1408,-1052,-74.72,1611
2021-12-18,189,1055,-866,-82.09,1611
2021-12-19,76,965,-889,-92.12,1611
2021-12-20,476,1444,-968,-67.04,1611
2021-12-21,490,1442,-952,-66.02,1611
2021-12-22,490,1445,-955,-66.09,1611
2021-12-23,490,1448,-958,-66.16,1611
2021-12-24,356,1426,-1070,-75.04,1611
2021-12-25,189,1075,-886,-82.42,1611
2021-12-26,76,985,-909,-92.28,1611
2021-12-27,476,1463,-987,-67.46,1611
2021-12-28,490,1459,-969,-66.42,1611
2021-12-29,490,1460,-970,-66.44,1611
2021-12-30,490,1460,-970,-66.44,1611
2021-12-31,356,1435,-1079,-75.19,1611
2022-01-01,173,1079,-906,-83.97,1611
2022-01-02,82,985,-903,-91.68,1611
2022-01-03,439,1459,-1020,-69.91,1611
2022-01-04,515,1452,-937,-64.53,1611
2022-01-05,515,1449,-934,-64.46,1611
2022-01-06,515,1446,-931,-64.38,1611
2022-01-07,455,1418,-963,-67.91,1611
2022-01-08,173,1060,-887,-83.68,1611
2022-01-09,82,965,-883,-91.5,1611
2022-01-10,439,1438,-999,-69.47,1611
2022-01-11,515,1431,-916,-64.01,1611
2022-01-12,515,1429,-914,-63.96,1611
2022-01-13,515,1427,-912,-63.91,1611
2022-01-14,455,1402,-947,-67.55,1611
2022-01-15,173,1047,-874,-83.48,1611
2022-01-16,82,955,-873,-91.41,1611
2022-01-17,439,1432,-993,-69.34,1611
2022-01-18,515,1430,-915,-63.99,1611
2022-01-19,515,1433,-918,-64.06,1611
2022-01-20,515,1435,-920,-64.11,1611
2022-01-21,455,1415,-960,-67.84,1611
2022-01-22,173,1065,-892,-83.76,1611
2022-01-23,82,978,-896,-91.62,1611
2022-01-24,439,1459,-1020,-69.91,1611
2022-01-25,515,1460,-945,-64.73,1611
2022-01-26,515,1467,-952,-64.89,1611
2022-01-27,515,1473,-958,-65.04,1611
2022-01-28,455,1455,-1000,-68.73,1611
2022-01-29,173,1106,-933,-84.36,1611
2022-01-30,82,1020,-938,-91.96,1611
2020-02-01,682,481,201,41.79,1207
2020-02-02,327,95,232,244.21,1207
2020-02-03,2750,2639,111,4.21,1207
2020-02-04,2788,2632,156,5.93,1207
2020-02-05,2788,2641,147,5.57,1207
2020-02-06,2788,2649,139,5.25,1207
2020-02-07,2404,2255,149,6.61,1207
2020-02-08,682,525,157,29.9,1207
2020-02-09,327,135,192,142.22,1207
2020-02-10,2750,2674,76,2.84,1207
2020-02-11,2788,2663,125,4.69,1207
2020-02-12,2788,2669,119,4.46,1207
2020-02-13,2788,2675,113,4.22,1207
2020-02-14,2404,2281,123,5.39,1207
2020-02-15,682,551,131,23.77,1207
2020-02-16,327,161,166,103.11,1207
2020-02-17,2750,2703,47,1.74,1207
2020-02-18,2788,2695,93,3.45,1207
2020-02-19,2788,2705,83,3.07,1207
2020-02-20,2788,2716,72,2.65,1207
2020-02-21,2404,2327,77,3.31,1207
2020-02-22,682,603,79,13.1,1207
2020-02-23,327,220,107,48.64,1207
2020-02-24,2750,2769,-19,-0.69,1207
2020-02-25,2788,2767,21,0.76,1207
2020-02-26,2788,2783,5,0.18,1207
2020-02-27,2788,2800,-12,-0.43,1207
2020-02-28,2404,2416,-12,-0.5,1207
2020-02-29,682,696,-14,-2.01,1207
2020-03-01,277,317,-40,-12.62,1207
2020-03-02,2536,2868,-332,-11.58,1207
2020-03-03,2567,2868,-301,-10.5,1207
2020-03-04,2567,2885,-318,-11.02,1207
2020-03-05,2567,2901,-334,-11.51,1207
2020-03-06,2176,2515,-339,-13.48,1207
2020-03-07,638,793,-155,-19.55,1207
2020-03-08,277,409,-132,-32.27,1207
2020-03-09,2536,2956,-420,-14.21,1207
2020-03-10,2567,2950,-383,-12.98,1207
2020-03-11,2567,2960,-393,-13.28,1207
2020-03-12,2567,2969,-402,-13.54,1207
2020-03-13,2176,2577,-401,-15.56,1207
2020-03-14,638,846,-208,-24.59,1207
2020-03-15,277,455,-178,-39.12,1207
2020-03-16,2536,2994,-458,-15.3,1207
2020-03-17,2567,2981,-414,-13.89,1207
2020-03-18,2567,2985,-418,-14.0,1207
2020-03-19,2567,2987,-420,-14.06,1207
2020-03-20,2176,2589,-413,-15.95,1207
2020-03-21,638,854,-216,-25.29,1207
2020-03-22,277,459,-182,-39.65,1207
2020-03-23,2536,2994,-458,-15.3,1207
2020-03-24,2567,2978,-411,-13.8,1207
2020-03-25,2567,2981,-414,-13.89,1207
2020-03-26,2567,2983,-416,-13.95,1207
2020-03-27,2176,2584,-408,-15.79,1207
2020-03-28,638,850,-212,-24.94,1207
2020-03-29,277,457,-180,-39.39,1207
2020-03-30,2536,2994,-458,-15.3,1207
2020-03-31,2567,2981,-414,-13.89,1207
2020-04-01,2706,2986,-280,-9.38,1207
2020-04-02,2706,2991,-285,-9.53,1207
2020-04-03,2115,2596,-481,-18.53,1207
2020-04-04,552,864,-312,-36.11,1207
2020-04-05,186,474,-288,-60.76,1207
2020-04-06,2763,3014,-251,-8.33,1207
2020-04-07,2706,3003,-297,-9.89,1207
2020-04-08,2706,3010,-304,-10.1,1207
2020-04-09,2706,3016,-310,-10.28,1207
2020-04-10,2115,2622,-507,-19.34,1207
2020-04-11,552,891,-339,-38.05,1207
2020-04-12,186,500,-314,-62.8,1207
2020-04-13,2763,3040,-277,-9.11,1207
2020-04-14,2706,3028,-322,-10.63,1207
2020-04-15,2706,3034,-328,-10.81,1207
2020-04-16,2706,3039,-333,-10.96,1207
2020-04-17,2115,2643,-528,-19.98,1207
2020-04-18,552,910,-358,-39.34,1207
2020-04-19,186,518,-332,-64.09,1207
2020-04-20,2763,3056,-293,-9.59,1207
2020-04-21,2706,3042,-336,-11.05,1207
2020-04-22,2706,3046,-340,-11.16,1207
2020-04-23,2706,3050,-344,-11.28,1207
2020-04-24,2115,2653,-538,-20.28,1207
2020-04-25,552,920,-368,-40.0,1207
2020-04-26,186,528,-342,-64.77,1207
2020-04-27,2763,3066,-303,-9.88,1207
2020-04-28,2706,3053,-347,-11.37,1207
2020-04-29,2706,3058,-352,-11.51,1207
2020-04-30,2706,3063,-357,-11.66,1207
2020-05-01,2506,2668,-162,-6.07,1207
2020-05-02,666,936,-270,-28.85,1207
2020-05-03,286,545,-259,-47.52,1207
2020-05-04,2988,3085,-97,-3.14,1207
2020-05-05,3039,3074,-35,-1.14,1207
2020-05-06,3039,3081,-42,-1.36,1207
2020-05-07,3039,3087,-48,-1.55,1207
2020-05-08,2506,2693,-187,-6.94,1207
2020-05-09,666,963,-297,-30.84,1207
2020-05-10,286,572,-286,-50.0,1207
2020-05-11,2988,3112,-124,-3.98,1207
2020-05-12,3039,3100,-61,-1.97,1207
2020-05-13,3039,3106,-67,-2.16,1207
2020-05-14,3039,3112,-73,-2.35,1207
2020-05-15,2506,2716,-210,-7.73,1207
2020-05-16,666,983,-317,-32.25,1207
2020-05-17,286,590,-304,-51.53,1207
2020-05-18,2988,3127,-139,-4.45,1207
2020-05-19,3039,3112,-73,-2.35,1207
2020-05-20,3039,3115,-76,-2.44,1207
2020-05-21,3039,3117,-78,-2.5,1207
2020-05-22,2506,2718,-212,-7.8,1207
2020-05-23,666,982,-316,-32.18,1207
2020-05-24,286,587,-301,-51.28,1207
2020-05-25,2988,3122,-134,-4.29,1207
2020-05-26,3039,3105,-66,-2.13,1207
2020-05-27,3039,3107,-68,-2.19,1207
2020-05-28,3039,3108,-69,-2.22,1207
2020-05-29,2506,2709,-203,-7.49,1207
2020-05-30,666,974,-308,-31.62,1207
2020-05-31,286,579,-293,-50.6,1207
2020-06-01,3057,3115,-58,-1.86,1207
2020-06-02,3033,3101,-68,-2.19,1207
2020-06-03,3033,3105,-72,-2.32,1207
2020-06-04,3033,3109,-76,-2.44,1207
2020-06-05,2491,2713,-222,-8.18,1207
2020-06-06,718,981,-263,-26.81,1207
2020-06-07,334,589,-255,-43.29,1207
2020-06-08,3057,3128,-71,-2.27,1207
2020-06-09,3033,3116,-83,-2.66,1207
2020-06-10,3033,3122,-89,-2.85,1207
2020-06-11,3033,3127,-94,-3.01,1207
2020-06-12,2491,2732,-241,-8.82,1207
2020-06-13,718,999,-281,-28.13,1207
2020-06-14,334,607,-273,-44.98,1207
2020-06-15,3057,3144,-87,-2.77,1207
2020-06-16,3033,3129,-96,-3.07,1207
2020-06-17,3033,3131,-98,-3.13,1207
2020-06-18,3033,3131,-98,-3.13,1207
2020-06-19,2491,2730,-239,-8.75,1207
2020-06-20,718,991,-273,-27.55,1207
2020-06-21,334,591,-257,-43.49,1207
2020-06-22,3057,3120,-63,-2.02,1207
2020-06-23,3033,3097,-64,-2.07,1207
2020-06-24,3033,3090,-57,-1.84,1207
2020-06-25,3033,3081,-48,-1.56,1207
2020-06-26,2491,2671,-180,-6.74,1207
2020-06-27,718,923,-205,-22.21,1207
2020-06-28,334,515,-181,-35.15,1207
2020-06-29,3057,3037,20,0.66,1207
2020-06-30,3033,3007,26,0.86,1207
2020-07-01,3091,2995,96,3.21,1207
2020-07-02,3091,2982,109,3.66,1207
2020-07-03,2592,2569,23,0.9,1207
2020-07-04,767,819,-52,-6.35,1207
2020-07-05,362,411,-49,-11.92,1207
2020-07-06,3015,2934,81,2.76,1207
2020-07-07,3091,2907,184,6.33,1207
2020-07-08,3091,2898,193,6.66,1207
2020-07-09,3091,2891,200,6.92,1207
2020-07-10,2592,2484,108,4.35,1207
2020-07-11,767,742,25,3.37,1207
2020-07-12,362,342,20,5.85,1207
2020-07-13,3015,2875,140,4.87,1207
2020-07-14,3091,2857,234,8.19,1207
2020-07-15,3091,2859,232,8.11,1207
2020-07-16,3091,2862,229,8.0,1207
2020-07-17,2592,2465,127,5.15,1207
2020-07-18,767,733,34,4.64,1207
2020-07-19,362,342,20,5.85,1207
2020-07-20,3015,2883,132,4.58,1207
2020-07-21,3091,2873,218,7.59,1207
2020-07-22,3091,2881,210,7.29,1207
2020-07-23,3091,2888,203,7.03,1207
2020-07-24,2592,2495,97,3.89,1207
2020-07-25,767,766,1,0.13,1207
2020-07-26,362,376,-14,-3.72,1207
2020-07-27,3015,2916,99,3.4,1207
2020-07-28,3091,2904,187,6.44,1207
2020-07-29,3091,2909,182,6.26,1207
2020-07-30,3091,2913,178,6.11,1207
2020-07-31,2592,2515,77,3.06,1207
2020-08-01,757,780,-23,-2.95,1207
2020-08-02,362,384,-22,-5.73,1207
2020-08-03,2948,2918,30,1.03,1207
2020-08-04,3014,2899,115,3.97,1207
2020-08-05,3014,2898,116,4.0,1207
2020-08-06,3014,2896,118,4.07,1207
2020-08-07,2541,2492,49,1.97,1207
2020-08-08,757,752,5,0.66,1207
2020-08-09,362,352,10,2.84,1207
2020-08-10,2948,2883,65,2.25,1207
2020-08-11,3014,2863,151,5.27,1207
2020-08-12,3014,2861,153,5.35,1207
2020-08-13,3014,2860,154,5.38,1207
2020-08-14,2541,2458,83,3.38,1207
2020-08-15,757,721,36,4.99,1207
2020-08-16,362,326,36,11.04,1207
2020-08-17,2948,2862,86,3.0,1207
2020-08-18,3014,2849,165,5.79,1207
2020-08-19,3014,2855,159,5.57,1207
2020-08-20,3014,2861,153,5.35,1207
2020-08-21,2541,2468,73,2.96,1207
2020-08-22,757,740,17,2.3,1207
2020-08-23,362,354,8,2.26,1207
2020-08-24,2948,2899,49,1.69,1207
2020-08-25,3014,2894,120,4.15,1207
2020-08-26,3014,2907,107,3.68,1207
2020-08-27,3014,2921,93,3.18,1207
2020-08-28,2541,2534,7,0.28,1207
2020-08-29,757,811,-54,-6.66,1207
2020-08-30,362,428,-66,-15.42,1207
2020-08-31,2948,2976,-28,-0.94,1207
2020-09-01,3080,2972,108,3.63,1207
2020-09-02,3080,2986,94,3.15,1207
2020-09-03,3080,2998,82,2.74,1207
2020-09-04,2626,2609,17,0.65,1207
2020-09-05,740,882,-142,-16.1,1207
2020-09-06,376,494,-118,-23.89,1207
2020-09-07,2961,3037,-76,-2.5,1207
2020-09-08,3080,3026,54,1.78,1207
2020-09-09,3080,3033,47,1.55,1207
2020-09-10,3080,3038,42,1.38,1207
2020-09-11,2626,2641,-15,-0.57,1207
2020-09-12,740,907,-167,-18.41,1207
2020-09-13,376,512,-136,-26.56,1207
2020-09-14,2961,3048,-87,-2.85,1207
2020-09-15,3080,3031,49,1.62,1207
2020-09-16,3080,3032,48,1.58,1207
2020-09-17,3080,3032,48,1.58,1207
2020-09-18,2626,2632,-6,-0.23,1207
2020-09-19,740,895,-155,-17.32,1207
2020-09-20,376,498,-122,-24.5,1207
2020-09-21,2961,3032,-71,-2.34,1207
2020-09-22,3080,3015,65,2.16,1207
2020-09-23,3080,3017,63,2.09,1207
2020-09-24,3080,3018,62,2.05,1207
2020-09-25,2626,2620,6,0.23,1207
2020-09-26,740,886,-146,-16.48,1207
2020-09-27,376,492,-116,-23.58,1207
2020-09-28,2961,3029,-68,-2.24,1207
2020-09-29,3080,3016,64,2.12,1207
2020-09-30,3080,3022,58,1.92,1207
2020-10-01,2895,3027,-132,-4.36,1207
2020-10-02,2588,2631,-43,-1.63,1207
2020-10-03,783,899,-116,-12.9,1207
2020-10-04,335,508,-173,-34.06,1207
2020-10-05,2961,3047,-86,-2.82,1207
2020-10-06,2895,3035,-140,-4.61,1207
2020-10-07,2895,3040,-145,-4.77,1207
2020-10-08,2895,3044,-149,-4.89,1207
2020-10-09,2588,2647,-59,-2.23,1207
2020-10-10,783,914,-131,-14.33,1207
2020-10-11,335,520,-185,-35.58,1207
2020-10-12,2961,3056,-95,-3.11,1207
2020-10-13,2895,3040,-145,-4.77,1207
2020-10-14,2895,3041,-146,-4.8,1207
2020-10-15,2895,3042,-147,-4.83,1207
2020-10-16,2588,2641,-53,-2.01,1207
2020-10-17,783,904,-121,-13.38,1207
2020-10-18,335,506,-171,-33.79,1207
2020-10-19,2961,3040,-79,-2.6,1207
2020-10-20,2895,3021,-126,-4.17,1207
2020-10-21,2895,3021,-126,-4.17,1207
2020-10-22,2895,3021,-126,-4.17,1207
2020-10-23,2588,2620,-32,-1.22,1207
2020-10-24,783,883,-100,-11.33,1207
2020-10-25,335,487,-152,-31.21,1207
2020-10-26,2961,3023,-62,-2.05,1207
2020-10-27,2895,3008,-113,-3.76,1207
2020-10-28,2895,3011,-116,-3.85,1207
2020-10-29,2895,3015,-120,-3.98,1207
2020-10-30,2588,2619,-31,-1.18,1207
2020-10-31,783,887,-104,-11.72,1207
2020-11-01,304,496,-192,-38.71,1207
2020-11-02,3092,3037,55,1.81,1207
2020-11-03,3094,3027,67,2.21,1207
2020-11-04,3094,3035,59,1.94,1207
2020-11-05,3094,3043,51,1.68,1207
2020-11-06,2758,2650,108,4.08,1207
2020-11-07,772,920,-148,-16.09,1207
2020-11-08,304,531,-227,-42.75,1207
2020-11-09,3092,3072,20,0.65,1207
2020-11-10,3094,3061,33,1.08,1207
2020-11-11,3094,3067,27,0.88,1207
2020-11-12,3094,3071,23,0.75,1207
2020-11-13,2758,2674,84,3.14,1207
2020-11-14,772,939,-167,-17.78,1207
2020-11-15,304,542,-238,-43.91,1207
2020-11-16,3092,3076,16,0.52,1207
2020-11-17,3094,3056,38,1.24,1207
2020-11-18,3094,3053,41,1.34,1207
2020-11-19,3094,3048,46,1.51,1207
2020-11-20,2758,2641,117,4.43,1207
2020-11-21,772,896,-124,-13.84,1207
2020-11-22,304,491,-187,-38.09,1207
2020-11-23,3092,3015,77,2.55,1207
2020-11-24,3094,2987,107,3.58,1207
2020-11-25,3094,2976,118,3.97,1207
2020-11-26,3094,2965,129,4.35,1207
2020-11-27,2758,2552,206,8.07,1207
2020-11-28,772,803,-31,-3.86,1207
2020-11-29,304,395,-91,-23.04,1207
2020-11-30,3092,2918,174,5.96,1207
2020-12-01,2338,2890,-552,-19.1,1207
2020-12-02,2338,2880,-542,-18.82,1207
2020-12-03,2338,2871,-533,-18.56,1207
2020-12-04,2681,2463,218,8.85,1207
2020-12-05,802,719,83,11.54,1207
2020-12-06,296,316,-20,-6.33,1207
2020-12-07,2460,2845,-385,-13.53,1207
2020-12-08,2338,2824,-486,-17.21,1207
2020-12-09,2338,2822,-484,-17.15,1207
2020-12-10,2338,2820,-482,-17.09,1207
2020-12-11,2681,2419,262,10.83,1207
2020-12-12,802,681,121,17.77,1207
2020-12-13,296,285,11,3.86,1207
2020-12-14,2460,2819,-359,-12.74,1207
2020-12-15,2338,2803,-465,-16.59,1207
2020-12-16,2338,2804,-466,-16.62,1207
2020-12-17,2338,2804,-466,-16.62,1207
2020-12-18,2681,2403,278,11.57,1207
2020-12-19,802,665,137,20.6,1207
2020-12-20,296,266,30,11.28,1207
2020-12-21,2460,2797,-337,-12.05,1207
2020-12-22,2338,2776,-438,-15.78,1207
2020-12-23,2338,2771,-433,-15.63,1207
2020-12-24,2338,2764,-426,-15.41,1207
2020-12-25,2681,2356,325,13.79,1207
2020-12-26,802,610,192,31.48,1207
2020-12-27,296,202,94,46.53,1207
2020-12-28,2460,2725,-265,-9.72,1207
2020-12-29,2338,2695,-357,-13.25,1207
2020-12-30,2338,2682,-344,-12.83,1207
2020-12-31,2338,2668,-330,-12.37,1207
2021-01-01,2166,2253,-87,-3.86,1207
2021-01-02,567,501,66,13.17,1207
2021-01-03,249,89,160,179.78,1207
2021-01-04,2248,2609,-361,-13.84,1207
2021-01-05,2460,2578,-118,-4.58,1207
2021-01-06,2460,2565,-105,-4.09,1207
2021-01-07,2460,2553,-93,-3.64,1207
2021-01-08,2166,2141,25,1.17,1207
2021-01-09,567,395,172,43.54,1207
2021-01-10,249,100,149,149.0,1207
2021-01-11,2248,2518,-270,-10.72,1207
2021-01-12,2460,2497,-37,-1.48,1207
2021-01-13,2460,2495,-35,-1.4,1207
2021-01-14,2460,2495,-35,-1.4,1207
2021-01-15,2166,2096,70,3.34,1207
2021-01-16,567,363,204,56.2,1207
2021-01-17,249,87,162,186.21,1207
2021-01-18,2248,2512,-264,-10.51,1207
2021-01-19,2460,2504,-44,-1.76,1207
2021-01-20,2460,2515,-55,-2.19,1207
2021-01-21,2460,2526,-66,-2.61,1207
2021-01-22,2166,2138,28,1.31,1207
2021-01-23,567,414,153,36.96,1207
2021-01-24,249,31,218,703.23,1207
2021-01-25,2248,2579,-331,-12.83,1207
2021-01-26,2460,2576,-116,-4.5,1207
2021-01-27,2460,2591,-131,-5.06,1207
2021-01-28,2460,2605,-145,-5.57,1207
2021-01-29,2166,2217,-51,-2.3,1207
2021-01-30,567,493,74,15.01,1207
2021-01-31,249,109,140,128.44,1207
2021-02-01,2732,2654,78,2.94,1207
2021-02-02,2806,2647,159,6.01,1207
2021-02-03,2806,2657,149,5.61,1207
2021-02-04,2806,2666,140,5.25,1207
2021-02-05,2387,2274,113,4.97,1207
2021-02-06,626,544,82,15.07,1207
2021-02-07,267,154,113,73.38,1207
2021-02-08,2732,2695,37,1.37,1207
2021-02-09,2806,2683,123,4.58,1207
2021-02-10,2806,2690,116,4.31,1207
2021-02-11,2806,2696,110,4.08,1207
2021-02-12,2387,2301,86,3.74,1207
2021-02-13,626,570,56,9.82,1207
2021-02-14,267,180,87,48.33,1207
2021-02-15,2732,2721,11,0.4,1207
2021-02-16,2806,2712,94,3.47,1207
2021-02-17,2806,2721,85,3.12,1207
2021-02-18,2806,2731,75,2.75,1207
2021-02-19,2387,2340,47,2.01,1207
2021-02-20,626,615,11,1.79,1207
2021-02-21,267,231,36,15.58,1207
2021-02-22,2732,2778,-46,-1.66,1207
2021-02-23,2806,2775,31,1.12,1207
2021-02-24,2806,2791,15,0.54,1207
2021-02-25,2806,2807,-1,-0.04,1207
2021-02-26,2387,2423,-36,-1.49,1207
2021-02-27,626,703,-77,-10.95,1207
2021-02-28,267,323,-56,-17.34,1207
2021-03-01,2942,2874,68,2.37,1207
2021-03-02,2941,2874,67,2.33,1207
2021-03-03,2941,2892,49,1.69,1207
2021-03-04,2941,2909,32,1.1,1207
2021-03-05,2576,2524,52,2.06,1207
2021-03-06,822,802,20,2.49,1207
2021-03-07,299,420,-121,-28.81,1207
2021-03-08,2942,2968,-26,-0.88,1207
2021-03-09,2941,2963,-22,-0.74,1207
2021-03-10,2941,2975,-34,-1.14,1207
2021-03-11,2941,2986,-45,-1.51,1207
2021-03-12,2576,2594,-18,-0.69,1207
2021-03-13,822,865,-43,-4.97,1207
2021-03-14,299,476,-177,-37.18,1207
2021-03-15,2942,3016,-74,-2.45,1207
2021-03-16,2941,3003,-62,-2.06,1207
2021-03-17,2941,3008,-67,-2.23,1207
2021-03-18,2941,3012,-71,-2.36,1207
2021-03-19,2576,2614,-38,-1.45,1207
2021-03-20,822,879,-57,-6.48,1207
2021-03-21,299,484,-185,-38.22,1207
2021-03-22,2942,3020,-78,-2.58,1207
2021-03-23,2941,3004,-63,-2.1,1207
2021-03-24,2941,3006,-65,-2.16,1207
2021-03-25,2941,3008,-67,-2.23,1207
2021-03-26,2576,2609,-33,-1.26,1207
2021-03-27,822,875,-53,-6.06,1207
2021-03-28,299,480,-181,-37.71,1207
2021-03-29,2942,3017,-75,-2.49,1207
2021-03-30,2941,3004,-63,-2.1,1207
2021-03-31,2941,3008,-67,-2.23,1207
2021-04-01,3004,3013,-9,-0.3,1207
2021-04-02,2621,2617,4,0.15,1207
2021-04-03,697,885,-188,-21.24,1207
2021-04-04,278,494,-216,-43.72,1207
2021-04-05,2971,3034,-63,-2.08,1207
2021-04-06,3004,3022,-18,-0.6,1207
2021-04-07,3004,3029,-25,-0.83,1207
2021-04-08,3004,3036,-32,-1.05,1207
2021-04-09,2621,2642,-21,-0.79,1207
2021-04-10,697,911,-214,-23.49,1207
2021-04-11,278,520,-242,-46.54,1207
2021-04-12,2971,3060,-89,-2.91,1207
2021-04-13,3004,3049,-45,-1.48,1207
2021-04-14,3004,3055,-51,-1.67,1207
2021-04-15,3004,3060,-56,-1.83,1207
2021-04-16,2621,2665,-44,-1.65,1207
2021-04-17,697,932,-235,-25.21,1207
2021-04-18,278,540,-262,-48.52,1207
2021-04-19,2971,3078,-107,-3.48,1207
2021-04-20,3004,3065,-61,-1.99,1207
2021-04-21,3004,3069,-65,-2.12,1207
2021-04-22,3004,3073,-69,-2.25,1207
2021-04-23,2621,2676,-55,-2.06,1207
2021-04-24,697,943,-246,-26.09,1207
2021-04-25,278,550,-272,-49.45,1207
2021-04-26,2971,3088,-117,-3.79,1207
2021-04-27,3004,3075,-71,-2.31,1207
2021-04-28,3004,3080,-76,-2.47,1207
2021-04-29,3004,3085,-81,-2.63,1207
2021-04-30,2621,2689,-68,-2.53,1207
2021-05-01,782,957,-175,-18.29,1207
2021-05-02,358,566,-208,-36.75,1207
2021-05-03,3022,3105,-83,-2.67,1207
2021-05-04,3047,3094,-47,-1.52,1207
2021-05-05,3047,3101,-54,-1.74,1207
2021-05-06,3047,3107,-60,-1.93,1207
2021-05-07,2650,2713,-63,-2.32,1207
2021-05-08,782,982,-200,-20.37,1207
2021-05-09,358,592,-234,-39.53,1207
2021-05-10,3022,3132,-110,-3.51,1207
2021-05-11,3047,3121,-74,-2.37,1207
2021-05-12,3047,3127,-80,-2.56,1207
2021-05-13,3047,3133,-86,-2.74,1207
2021-05-14,2650,2737,-87,-3.18,1207
2021-05-15,782,1005,-223,-22.19,1207
2021-05-16,358,613,-255,-41.6,1207
2021-05-17,3022,3150,-128,-4.06,1207
2021-05-18,3047,3136,-89,-2.84,1207
2021-05-19,3047,3140,-93,-2.96,1207
2021-05-20,3047,3142,-95,-3.02,1207
2021-05-21,2650,2744,-94,-3.43,1207
2021-05-22,782,1008,-226,-22.42,1207
2021-05-23,358,613,-255,-41.6,1207
2021-05-24,3022,3148,-126,-4.0,1207
2021-05-25,3047,3132,-85,-2.71,1207
2021-05-26,3047,3133,-86,-2.74,1207
2021-05-27,3047,3134,-87,-2.78,1207
2021-05-28,2650,2735,-85,-3.11,1207
2021-05-29,782,999,-217,-21.72,1207
2021-05-30,358,604,-246,-40.73,1207
2021-05-31,3022,3140,-118,-3.76,1207
2021-06-01,3105,3125,-20,-0.64,1207
2021-06-02,3105,3129,-24,-0.77,1207
2021-06-03,3105,3132,-27,-0.86,1207
2021-06-04,2604,2735,-131,-4.79,1207
2021-06-05,761,1002,-241,-24.05,1207
2021-06-06,388,610,-222,-36.39,1207
2021-06-07,3069,3149,-80,-2.54,1207
2021-06-08,3105,3137,-32,-1.02,1207
2021-06-09,3105,3143,-38,-1.21,1207
2021-06-10,3105,3149,-44,-1.4,1207
2021-06-11,2604,2753,-149,-5.41,1207
2021-06-12,761,1021,-260,-25.47,1207
2021-06-13,388,629,-241,-38.31,1207
2021-06-14,3069,3167,-98,-3.09,1207
2021-06-15,3105,3154,-49,-1.55,1207
2021-06-16,3105,3157,-52,-1.65,1207
2021-06-17,3105,3159,-54,-1.71,1207
2021-06-18,2604,2759,-155,-5.62,1207
2021-06-19,761,1021,-260,-25.47,1207
2021-06-20,388,622,-234,-37.62,1207
2021-06-21,3069,3153,-84,-2.66,1207
2021-06-22,3105,3132,-27,-0.86,1207
2021-06-23,3105,3126,-21,-0.67,1207
2021-06-24,3105,3120,-15,-0.48,1207
2021-06-25,2604,2711,-107,-3.95,1207
2021-06-26,761,964,-203,-21.06,1207
2021-06-27,388,557,-169,-30.34,1207
2021-06-28,3069,3080,-11,-0.36,1207
2021-06-29,3105,3051,54,1.77,1207
2021-06-30,3105,3039,66,2.17,1207
2021-07-01,2635,3026,-391,-12.92,1207
2021-07-02,2252,2612,-360,-13.78,1207
2021-07-03,701,863,-162,-18.77,1207
2021-07-04,322,453,-131,-28.92,1207
2021-07-05,2574,2975,-401,-13.48,1207
2021-07-06,2635,2947,-312,-10.59,1207
2021-07-07,2635,2937,-302,-10.28,1207
2021-07-08,2635,2928,-293,-10.01,1207
2021-07-09,2252,2520,-268,-10.63,1207
2021-07-10,701,776,-75,-9.66,1207
2021-07-11,322,374,-52,-13.9,1207
2021-07-12,2574,2905,-331,-11.39,1207
2021-07-13,2635,2885,-250,-8.67,1207
2021-07-14,2635,2885,-250,-8.67,1207
2021-07-15,2635,2886,-251,-8.7,1207
2021-07-16,2252,2488,-236,-9.49,1207
2021-07-17,701,755,-54,-7.15,1207
2021-07-18,322,363,-41,-11.29,1207
2021-07-19,2574,2902,-328,-11.3,1207
2021-07-20,2635,2891,-256,-8.86,1207
2021-07-21,2635,2899,-264,-9.11,1207
2021-07-22,2635,2906,-271,-9.33,1207
2021-07-23,2252,2513,-261,-10.39,1207
2021-07-24,701,784,-83,-10.59,1207
2021-07-25,322,395,-73,-18.48,1207
2021-07-26,2574,2936,-362,-12.33,1207
2021-07-27,2635,2925,-290,-9.91,1207
2021-07-28,2635,2931,-296,-10.1,1207
2021-07-29,2635,2936,-301,-10.25,1207
2021-07-30,2252,2539,-287,-11.3,1207
2021-07-31,701,805,-104,-12.92,1207
2021-08-01,339,411,-72,-17.52,1207
2021-08-02,2352,2945,-593,-20.14,1207
2021-08-03,2403,2928,-525,-17.93,1207
2021-08-04,2403,2928,-525,-17.93,1207
2021-08-05,2403,2926,-523,-17.87,1207
2021-08-06,2139,2524,-385,-15.25,1207
2021-08-07,630,784,-154,-19.64,1207
2021-08-08,339,384,-45,-11.72,1207
2021-08-09,2352,2915,-563,-19.31,1207
2021-08-10,2403,2894,-491,-16.97,1207
2021-08-11,2403,2892,-489,-16.91,1207
2021-08-12,2403,2890,-487,-16.85,1207
2021-08-13,2139,2487,-348,-13.99,1207
2021-08-14,630,749,-119,-15.89,1207
2021-08-15,339,352,-13,-3.69,1207
2021-08-16,2352,2887,-535,-18.53,1207
2021-08-17,2403,2872,-469,-16.33,1207
2021-08-18,2403,2876,-473,-16.45,1207
2021-08-19,2403,2881,-478,-16.59,1207
2021-08-20,2139,2487,-348,-13.99,1207
2021-08-21,630,757,-127,-16.78,1207
2021-08-22,339,369,-30,-8.13,1207
2021-08-23,2352,2913,-561,-19.26,1207
2021-08-24,2403,2906,-503,-17.31,1207
2021-08-25,2403,2919,-516,-17.68,1207
2021-08-26,2403,2932,-529,-18.04,1207
2021-08-27,2139,2544,-405,-15.92,1207
2021-08-28,630,821,-191,-23.26,1207
2021-08-29,339,438,-99,-22.6,1207
2021-08-30,2352,2986,-634,-21.23,1207
2021-08-31,2403,2983,-580,-19.44,1207
2021-09-01,2930,2997,-67,-2.24,1207
2021-09-02,2930,3010,-80,-2.66,1207
2021-09-03,2599,2622,-23,-0.88,1207
2021-09-04,792,896,-104,-11.61,1207
2021-09-05,406,510,-104,-20.39,1207
2021-09-06,2978,3054,-76,-2.49,1207
2021-09-07,2930,3045,-115,-3.78,1207
2021-09-08,2930,3053,-123,-4.03,1207
2021-09-09,2930,3059,-129,-4.22,1207
2021-09-10,2599,2664,-65,-2.44,1207
2021-09-11,792,931,-139,-14.93,1207
2021-09-12,406,537,-131,-24.39,1207
2021-09-13,2978,3074,-96,-3.12,1207
2021-09-14,2930,3058,-128,-4.19,1207
2021-09-15,2930,3059,-129,-4.22,1207
2021-09-16,2930,3060,-130,-4.25,1207
2021-09-17,2599,2659,-60,-2.26,1207
2021-09-18,792,922,-130,-14.1,1207
2021-09-19,406,525,-119,-22.67,1207
2021-09-20,2978,3059,-81,-2.65,1207
2021-09-21,2930,3042,-112,-3.68,1207
2021-09-22,2930,3043,-113,-3.71,1207
2021-09-23,2930,3044,-114,-3.75,1207
2021-09-24,2599,2645,-46,-1.74,1207
2021-09-25,792,910,-118,-12.97,1207
2021-09-26,406,516,-110,-21.32,1207
2021-09-27,2978,3053,-75,-2.46,1207
2021-09-28,2930,3039,-109,-3.59,1207
2021-09-29,2930,3044,-114,-3.75,1207
2021-09-30,2930,3048,-118,-3.87,1207
2021-10-01,2649,2652,-3,-0.11,1207
2021-10-02,809,920,-111,-12.07,1207
2021-10-03,377,529,-152,-28.73,1207
2021-10-04,2893,3068,-175,-5.7,1207
2021-10-05,3035,3056,-21,-0.69,1207
2021-10-06,3035,3062,-27,-0.88,1207
2021-10-07,3035,3067,-32,-1.04,1207
2021-10-08,2649,2670,-21,-0.79,1207
2021-10-09,809,937,-128,-13.66,1207
2021-10-10,377,544,-167,-30.7,1207
2021-10-11,2893,3081,-188,-6.1,1207
2021-10-12,3035,3066,-31,-1.01,1207
2021-10-13,3035,3068,-33,-1.08,1207
2021-10-14,3035,3069,-34,-1.11,1207
2021-10-15,2649,2669,-20,-0.75,1207
2021-10-16,809,932,-123,-13.2,1207
2021-10-17,377,535,-158,-29.53,1207
2021-10-18,2893,3068,-175,-5.7,1207
2021-10-19,3035,3050,-15,-0.49,1207
2021-10-20,3035,3050,-15,-0.49,1207
2021-10-21,3035,3049,-14,-0.46,1207
2021-10-22,2649,2648,1,0.04,1207
2021-10-23,809,911,-102,-11.2,1207
2021-10-24,377,514,-137,-26.65,1207
2021-10-25,2893,3049,-156,-5.12,1207
2021-10-26,3035,3033,2,0.07,1207
2021-10-27,3035,3035,0,0.0,1207
2021-10-28,3035,3038,-3,-0.1,1207
2021-10-29,2649,2641,8,0.3,1207
2021-10-30,809,908,-99,-10.9,1207
2021-10-31,377,517,-140,-27.08,1207
2021-11-01,2989,3056,-67,-2.19,1207
2021-11-02,2978,3046,-68,-2.23,1207
2021-11-03,2978,3053,-75,-2.46,1207
2021-11-04,2978,3061,-83,-2.71,1207
2021-11-05,2636,2668,-32,-1.2,1207
2021-11-06,809,938,-129,-13.75,1207
2021-11-07,349,549,-200,-36.43,1207
2021-11-08,2989,3091,-102,-3.3,1207
2021-11-09,2978,3080,-102,-3.31,1207
2021-11-10,2978,3087,-109,-3.53,1207
2021-11-11,2978,3093,-115,-3.72,1207
2021-11-12,2636,2697,-61,-2.26,1207
2021-11-13,809,964,-155,-16.08,1207
2021-11-14,349,569,-220,-38.66,1207
2021-11-15,2989,3104,-115,-3.7,1207
2021-11-16,2978,3086,-108,-3.5,1207
2021-11-17,2978,3085,-107,-3.47,1207
2021-11-18,2978,3082,-104,-3.37,1207
2021-11-19,2636,2676,-40,-1.49,1207
2021-11-20,809,933,-124,-13.29,1207
2021-11-21,349,529,-180,-34.03,1207
2021-11-22,2989,3055,-66,-2.16,1207
2021-11-23,2978,3028,-50,-1.65,1207
2021-11-24,2978,3018,-40,-1.33,1207
2021-11-25,2978,3007,-29,-0.96,1207
2021-11-26,2636,2595,41,1.58,1207
2021-11-27,809,846,-37,-4.37,1207
2021-11-28,349,437,-88,-20.14,1207
2021-11-29,2989,2959,30,1.01,1207
2021-11-30,2978,2931,47,1.6,1207
2021-12-01,2456,2921,-465,-15.92,1207
2021-12-02,2456,2911,-455,-15.63,1207
2021-12-03,1901,2501,-600,-23.99,1207
2021-12-04,765,755,10,1.32,1207
2021-12-05,292,351,-59,-16.81,1207
2021-12-06,2683,2879,-196,-6.81,1207
2021-12-07,2456,2857,-401,-14.04,1207
2021-12-08,2456,2853,-397,-13.92,1207
2021-12-09,2456,2850,-394,-13.82,1207
2021-12-10,1901,2448,-547,-22.34,1207
2021-12-11,765,710,55,7.75,1207
2021-12-12,292,312,-20,-6.41,1207
2021-12-13,2683,2846,-163,-5.73,1207
2021-12-14,2456,2830,-374,-13.22,1207
2021-12-15,2456,2831,-375,-13.25,1207
2021-12-16,2456,2831,-375,-13.25,1207
2021-12-17,1901,2431,-530,-21.8,1207
2021-12-18,765,694,71,10.23,1207
2021-12-19,292,296,-4,-1.35,1207
2021-12-20,2683,2828,-145,-5.13,1207
2021-12-21,2456,2808,-352,-12.54,1207
2021-12-22,2456,2805,-349,-12.44,1207
2021-12-23,2456,2800,-344,-12.29,1207
2021-12-24,1901,2393,-492,-20.56,1207
2021-12-25,765,649,116,17.87,1207
2021-12-26,292,243,49,20.16,1207
2021-12-27,2683,2767,-84,-3.04,1207
2021-12-28,2456,2738,-282,-10.3,1207
2021-12-29,2456,2726,-270,-9.9,1207
2021-12-30,2456,2713,-257,-9.47,1207
2021-12-31,1901,2298,-397,-17.28,1207
2022-01-01,607,547,60,10.97,1207
2022-01-02,289,135,154,114.07,1207
2022-01-03,2512,2655,-143,-5.39,1207
2022-01-04,2563,2623,-60,-2.29,1207
2022-01-05,2563,2609,-46,-1.76,1207
2022-01-06,2563,2596,-33,-1.27,1207
2022-01-07,2226,2183,43,1.97,1207
2022-01-08,607,435,172,39.54,1207
2022-01-09,289,28,261,932.14,1207
2022-01-10,2512,2554,-42,-1.64,1207
2022-01-11,2563,2530,33,1.3,1207
2022-01-12,2563,2526,37,1.46,1207
2022-01-13,2563,2523,40,1.59,1207
2022-01-14,2226,2122,104,4.9,1207
2022-01-15,607,386,221,57.25,1207
2022-01-16,289,181,108,59.67,1207
2022-01-17,2512,2531,-19,-0.75,1207
2022-01-18,2563,2521,42,1.67,1207
2022-01-19,2563,2530,33,1.3,1207
2022-01-20,2563,2540,23,0.91,1207
2022-01-21,2226,2150,76,3.53,1207
2022-01-22,607,425,182,42.82,1207
2022-01-23,289,42,247,588.1,1207
2022-01-24,2512,2589,-77,-2.97,1207
2022-01-25,2563,2586,-23,-0.89,1207
2022-01-26,2563,2601,-38,-1.46,1207
2022-01-27,2563,2615,-52,-1.99,1207
2022-01-28,2226,2228,-2,-0.09,1207
2022-01-29,607,505,102,20.2,1207
2022-01-30,289,121,168,138.84,1207
2020-02-01,620,467,153,32.76,1208
2020-02-02,492,352,140,39.77,1208
2020-02-03,1325,1275,50,3.92,1208
2020-02-04,1334,1274,60,4.71,1208
2020-02-05,1334,1281,53,4.14,1208
2020-02-06,1334,1284,50,3.89,1208
2020-02-07,1260,1178,82,6.96,1208
2020-02-08,620,488,132,27.05,1208
2020-02-09,492,371,121,32.61,1208
2020-02-10,1325,1293,32,2.47,1208
2020-02-11,1334,1290,44,3.41,1208
2020-02-12,1334,1295,39,3.01,1208
2020-02-13,1334,1298,36,2.77,1208
2020-02-14,1260,1190,70,5.88,1208
2020-02-15,620,500,120,24.0,1208
2020-02-16,492,382,110,28.8,1208
2020-02-17,1325,1304,21,1.61,1208
2020-02-18,1334,1301,33,2.54,1208
2020-02-19,1334,1306,28,2.14,1208
2020-02-20,1334,1309,25,1.91,1208
2020-02-21,1260,1202,58,4.83,1208
2020-02-22,620,512,108,21.09,1208
2020-02-23,492,396,96,24.24,1208
2020-02-24,1325,1318,7,0.53,1208
2020-02-25,1334,1317,17,1.29,1208
2020-02-26,1334,1323,11,0.83,1208
2020-02-27,1334,1327,7,0.53,1208
2020-02-28,1260,1222,38,3.11,1208
2020-02-29,620,533,87,16.32,1208
2020-03-01,470,418,52,12.44,1208
2020-03-02,1123,1342,-219,-16.32,1208
2020-03-03,1139,1340,-201,-15.0,1208
2020-03-04,1139,1347,-208,-15.44,1208
2020-03-05,1139,1352,-213,-15.75,1208
2020-03-06,1047,1246,-199,-15.97,1208
2020-03-07,546,557,-11,-1.97,1208
2020-03-08,470,441,29,6.58,1208
2020-03-09,1123,1364,-241,-17.67,1208
2020-03-10,1139,1362,-223,-16.37,1208
2020-03-11,1139,1367,-228,-16.68,1208
2020-03-12,1139,1370,-231,-16.86,1208
2020-03-13,1047,1263,-216,-17.1,1208
2020-03-14,546,572,-26,-4.55,1208
2020-03-15,470,454,16,3.52,1208
2020-03-16,1123,1375,-252,-18.33,1208
2020-03-17,1139,1371,-232,-16.92,1208
2020-03-18,1139,1375,-236,-17.16,1208
2020-03-19,1139,1376,-237,-17.22,1208
2020-03-20,1047,1266,-219,-17.3,1208
2020-03-21,546,574,-28,-4.88,1208
2020-03-22,470,455,15,3.3,1208
2020-03-23,1123,1374,-251,-18.27,1208
2020-03-24,1139,1369,-230,-16.8,1208
2020-03-25,1139,1372,-233,-16.98,1208
2020-03-26,1139,1372,-233,-16.98,1208
2020-03-27,1047,1262,-215,-17.04,1208
2020-03-28,546,569,-23,-4.04,1208
2020-03-29,470,450,20,4.44,1208
2020-03-30,1123,1369,-246,-17.97,1208
2020-03-31,1139,1364,-225,-16.5,1208
2020-04-01,1032,1367,-335,-24.51,1208
2020-04-02,1032,1368,-336,-24.56,1208
2020-04-03,875,1258,-383,-30.45,1208
2020-04-04,504,566,-62,-10.95,1208
2020-04-05,453,447,6,1.34,1208
2020-04-06,1104,1367,-263,-19.24,1208
2020-04-07,1032,1362,-330,-24.23,1208
2020-04-08,1032,1366,-334,-24.45,1208
2020-04-09,1032,1367,-335,-24.51,1208
2020-04-10,875,1258,-383,-30.45,1208
2020-04-11,504,566,-62,-10.95,1208
2020-04-12,453,448,5,1.12,1208
2020-04-13,1104,1368,-264,-19.3,1208
2020-04-14,1032,1364,-332,-24.34,1208
2020-04-15,1032,1368,-336,-24.56,1208
2020-04-16,1032,1369,-337,-24.62,1208
2020-04-17,875,1260,-385,-30.56,1208
2020-04-18,504,569,-65,-11.42,1208
2020-04-19,453,451,2,0.44,1208
2020-04-20,1104,1371,-267,-19.47,1208
2020-04-21,1032,1367,-335,-24.51,1208
2020-04-22,1032,1372,-340,-24.78,1208
2020-04-23,1032,1374,-342,-24.89,1208
2020-04-24,875,1265,-390,-30.83,1208
2020-04-25,504,575,-71,-12.35,1208
2020-04-26,453,457,-4,-0.88,1208
2020-04-27,1104,1378,-274,-19.88,1208
2020-04-28,1032,1375,-343,-24.95,1208
2020-04-29,1032,1380,-348,-25.22,1208
2020-04-30,1032,1383,-351,-25.38,1208
2020-05-01,1119,1275,-156,-12.24,1208
2020-05-02,557,585,-28,-4.79,1208
2020-05-03,493,468,25,5.34,1208
2020-05-04,1272,1390,-118,-8.49,1208
2020-05-05,1244,1386,-142,-10.25,1208
2020-05-06,1244,1392,-148,-10.63,1208
2020-05-07,1244,1394,-150,-10.76,1208
2020-05-08,1119,1287,-168,-13.05,1208
2020-05-09,557,596,-39,-6.54,1208
2020-05-10,493,479,14,2.92,1208
2020-05-11,1272,1400,-128,-9.14,1208
2020-05-12,1244,1396,-152,-10.89,1208
2020-05-13,1244,1400,-156,-11.14,1208
2020-05-14,1244,1401,-157,-11.21,1208
2020-05-15,1119,1293,-174,-13.46,1208
2020-05-16,557,601,-44,-7.32,1208
2020-05-17,493,482,11,2.28,1208
2020-05-18,1272,1402,-130,-9.27,1208
2020-05-19,1244,1396,-152,-10.89,1208
2020-05-20,1244,1399,-155,-11.08,1208
2020-05-21,1244,1399,-155,-11.08,1208
2020-05-22,1119,1289,-170,-13.19,1208
2020-05-23,557,596,-39,-6.54,1208
2020-05-24,493,477,16,3.35,1208
2020-05-25,1272,1396,-124,-8.88,1208
2020-05-26,1244,1390,-146,-10.5,1208
2020-05-27,1244,1393,-149,-10.7,1208
2020-05-28,1244,1393,-149,-10.7,1208
2020-05-29,1119,1283,-164,-12.78,1208
2020-05-30,557,591,-34,-5.75,1208
2020-05-31,493,472,21,4.45,1208
2020-06-01,1371,1392,-21,-1.51,1208
2020-06-02,1378,1388,-10,-0.72,1208
2020-06-03,1378,1392,-14,-1.01,1208
2020-06-04,1378,1393,-15,-1.08,1208
2020-06-05,1240,1285,-45,-3.5,1208
2020-06-06,616,594,22,3.7,1208
2020-06-07,483,476,7,1.47,1208
2020-06-08,1371,1397,-26,-1.86,1208
2020-06-09,1378,1393,-15,-1.08,1208
2020-06-10,1378,1398,-20,-1.43,1208
2020-06-11,1378,1400,-22,-1.57,1208
2020-06-12,1240,1292,-52,-4.02,1208
2020-06-13,616,600,16,2.67,1208
2020-06-14,483,482,1,0.21,1208
2020-06-15,1371,1402,-31,-2.21,1208
2020-06-16,1378,1397,-19,-1.36,1208
2020-06-17,1378,1400,-22,-1.57,1208
2020-06-18,1378,1400,-22,-1.57,1208
2020-06-19,1240,1289,-49,-3.8,1208
2020-06-20,616,595,21,3.53,1208
2020-06-21,483,473,10,2.11,1208
2020-06-22,1371,1390,-19,-1.37,1208
2020-06-23,1378,1381,-3,-0.22,1208
2020-06-24,1378,1380,-2,-0.14,1208
2020-06-25,1378,1377,1,0.07,1208
2020-06-26,1240,1262,-22,-1.74,1208
2020-06-27,616,565,51,9.03,1208
2020-06-28,483,440,43,9.77,1208
2020-06-29,1371,1354,17,1.26,1208
2020-06-30,1378,1343,35,2.61,1208
2020-07-01,1315,1340,-25,-1.87,1208
2020-07-02,1315,1334,-19,-1.42,1208
2020-07-03,1220,1219,1,0.08,1208
2020-07-04,595,521,74,14.2,1208
2020-07-05,481,396,85,21.46,1208
2020-07-06,1334,1310,24,1.83,1208
2020-07-07,1315,1300,15,1.15,1208
2020-07-08,1315,1299,16,1.23,1208
2020-07-09,1315,1296,19,1.47,1208
2020-07-10,1220,1183,37,3.13,1208
2020-07-11,595,488,107,21.93,1208
2020-07-12,481,366,115,31.42,1208
2020-07-13,1334,1284,50,3.89,1208
2020-07-14,1315,1278,37,2.9,1208
2020-07-15,1315,1280,35,2.73,1208
2020-07-16,1315,1281,34,2.65,1208
2020-07-17,1220,1172,48,4.1,1208
2020-07-18,595,480,115,23.96,1208
2020-07-19,481,362,119,32.87,1208
2020-07-20,1334,1283,51,3.98,1208
2020-07-21,1315,1279,36,2.81,1208
2020-07-22,1315,1284,31,2.41,1208
2020-07-23,1315,1286,29,2.26,1208
2020-07-24,1220,1178,42,3.57,1208
2020-07-25,595,487,108,22.18,1208
2020-07-26,481,369,112,30.35,1208
2020-07-27,1334,1290,44,3.41,1208
2020-07-28,1315,1285,30,2.33,1208
2020-07-29,1315,1289,26,2.02,1208
2020-07-30,1315,1289,26,2.02,1208
2020-07-31,1220,1179,41,3.48,1208
2020-08-01,592,486,106,21.81,1208
2020-08-02,476,366,110,30.05,1208
2020-08-03,1262,1284,-22,-1.71,1208
2020-08-04,1262,1277,-15,-1.17,1208
2020-08-05,1262,1278,-16,-1.25,1208
2020-08-06,1262,1276,-14,-1.1,1208
2020-08-07,1171,1164,7,0.6,1208
2020-08-08,592,469,123,26.23,1208
2020-08-09,476,347,129,37.18,1208
2020-08-10,1262,1265,-3,-0.24,1208
2020-08-11,1262,1257,5,0.4,1208
2020-08-12,1262,1258,4,0.32,1208
2020-08-13,1262,1257,5,0.4,1208
2020-08-14,1171,1146,25,2.18,1208
2020-08-15,592,453,139,30.68,1208
2020-08-16,476,333,143,42.94,1208
2020-08-17,1262,1253,9,0.72,1208
2020-08-18,1262,1249,13,1.04,1208
2020-08-19,1262,1253,9,0.72,1208
2020-08-20,1262,1256,6,0.48,1208
2020-08-21,1171,1148,23,2.0,1208
2020-08-22,592,459,133,28.98,1208
2020-08-23,476,344,132,38.37,1208
2020-08-24,1262,1267,-5,-0.39,1208
2020-08-25,1262,1266,-4,-0.32,1208
2020-08-26,1262,1274,-12,-0.94,1208
2020-08-27,1262,1280,-18,-1.41,1208
2020-08-28,1171,1176,-5,-0.43,1208
2020-08-29,592,489,103,21.06,1208
2020-08-30,476,375,101,26.93,1208
2020-08-31,1262,1300,-38,-2.92,1208
2020-09-01,1348,1300,48,3.69,1208
2020-09-02,1348,1309,39,2.98,1208
2020-09-03,1348,1314,34,2.59,1208
2020-09-04,1227,1209,18,1.49,1208
2020-09-05,609,521,88,16.89,1208
2020-09-06,489,405,84,20.74,1208
2020-09-07,1372,1328,44,3.31,1208
2020-09-08,1348,1326,22,1.66,1208
2020-09-09,1348,1331,17,1.28,1208
2020-09-10,1348,1334,14,1.05,1208
2020-09-11,1227,1226,1,0.08,1208
2020-09-12,609,535,74,13.83,1208
2020-09-13,489,416,73,17.55,1208
2020-09-14,1372,1336,36,2.69,1208
2020-09-15,1348,1331,17,1.28,1208
2020-09-16,1348,1334,14,1.05,1208
2020-09-17,1348,1334,14,1.05,1208
2020-09-18,1227,1224,3,0.25,1208
2020-09-19,609,531,78,14.69,1208
2020-09-20,489,411,78,18.98,1208
2020-09-21,1372,1331,41,3.08,1208
2020-09-22,1348,1325,23,1.74,1208
2020-09-23,1348,1328,20,1.51,1208
2020-09-24,1348,1328,20,1.51,1208
2020-09-25,1227,1219,8,0.66,1208
2020-09-26,609,527,82,15.56,1208
2020-09-27,489,408,81,19.85,1208
2020-09-28,1372,1329,43,3.24,1208
2020-09-29,1348,1324,24,1.81,1208
2020-09-30,1348,1329,19,1.43,1208
2020-10-01,1348,1330,18,1.35,1208
2020-10-02,1265,1222,43,3.52,1208
2020-10-03,622,531,91,17.14,1208
2020-10-04,488,414,74,17.87,1208
2020-10-05,1373,1335,38,2.85,1208
2020-10-06,1348,1331,17,1.28,1208
2020-10-07,1348,1335,13,0.97,1208
2020-10-08,1348,1337,11,0.82,1208
2020-10-09,1265,1228,37,3.01,1208
2020-10-10,622,537,85,15.83,1208
2020-10-11,488,418,70,16.75,1208
2020-10-12,1373,1338,35,2.62,1208
2020-10-13,1348,1333,15,1.13,1208
2020-10-14,1348,1336,12,0.9,1208
2020-10-15,1348,1337,11,0.82,1208
2020-10-16,1265,1227,38,3.1,1208
2020-10-17,622,534,88,16.48,1208
2020-10-18,488,414,74,17.87,1208
2020-10-19,1373,1333,40,3.0,1208
2020-10-20,1348,1327,21,1.58,1208
2020-10-21,1348,1329,19,1.43,1208
2020-10-22,1348,1329,19,1.43,1208
2020-10-23,1265,1219,46,3.77,1208
2020-10-24,622,526,96,18.25,1208
2020-10-25,488,407,81,19.9,1208
2020-10-26,1373,1326,47,3.54,1208
2020-10-27,1348,1322,26,1.97,1208
2020-10-28,1348,1325,23,1.74,1208
2020-10-29,1348,1327,21,1.58,1208
2020-10-30,1265,1219,46,3.77,1208
2020-10-31,622,528,94,17.8,1208
2020-11-01,492,411,81,19.71,1208
2020-11-02,1360,1333,27,2.03,1208
2020-11-03,1352,1330,22,1.65,1208
2020-11-04,1352,1336,16,1.2,1208
2020-11-05,1352,1339,13,0.97,1208
2020-11-06,1247,1233,14,1.14,1208
2020-11-07,610,543,67,12.34,1208
2020-11-08,492,427,65,15.22,1208
2020-11-09,1360,1349,11,0.82,1208
2020-11-10,1352,1346,6,0.45,1208
2020-11-11,1352,1351,1,0.07,1208
2020-11-12,1352,1353,-1,-0.07,1208
2020-11-13,1247,1245,2,0.16,1208
2020-11-14,610,553,57,10.31,1208
2020-11-15,492,434,58,13.36,1208
2020-11-16,1360,1353,7,0.52,1208
2020-11-17,1352,1346,6,0.45,1208
2020-11-18,1352,1348,4,0.3,1208
2020-11-19,1352,1345,7,0.52,1208
2020-11-20,1247,1232,15,1.22,1208
2020-11-21,610,536,74,13.81,1208
2020-11-22,492,412,80,19.42,1208
2020-11-23,1360,1327,33,2.49,1208
2020-11-24,1352,1315,37,2.81,1208
2020-11-25,1352,1312,40,3.05,1208
2020-11-26,1352,1306,46,3.52,1208
2020-11-27,1247,1190,57,4.79,1208
2020-11-28,610,491,119,24.24,1208
2020-11-29,492,364,128,35.16,1208
2020-11-30,1360,1277,83,6.5,1208
2020-12-01,1120,1265,-145,-11.46,1208
2020-12-02,1120,1261,-141,-11.18,1208
2020-12-03,1120,1255,-135,-10.76,1208
2020-12-04,1230,1139,91,7.99,1208
2020-12-05,615,441,174,39.46,1208
2020-12-06,486,317,169,53.31,1208
2020-12-07,1187,1232,-45,-3.65,1208
2020-12-08,1120,1222,-102,-8.35,1208
2020-12-09,1120,1222,-102,-8.35,1208
2020-12-10,1120,1219,-99,-8.12,1208
2020-12-11,1230,1107,123,11.11,1208
2020-12-12,615,413,202,48.91,1208
2020-12-13,486,292,194,66.44,1208
2020-12-14,1187,1211,-24,-1.98,1208
2020-12-15,1120,1205,-85,-7.05,1208
2020-12-16,1120,1208,-88,-7.28,1208
2020-12-17,1120,1208,-88,-7.28,1208
2020-12-18,1230,1099,131,11.92,1208
2020-12-19,615,407,208,51.11,1208
2020-12-20,486,288,198,68.75,1208
2020-12-21,1187,1208,-21,-1.74,1208
2020-12-22,1120,1203,-83,-6.9,1208
2020-12-23,1120,1206,-86,-7.13,1208
2020-12-24,1120,1206,-86,-7.13,1208
2020-12-25,1230,1096,134,12.23,1208
2020-12-26,615,403,212,52.61,1208
2020-12-27,486,283,203,71.73,1208
2020-12-28,1187,1201,-14,-1.17,1208
2020-12-29,1120,1194,-74,-6.2,1208
2020-12-30,1120,1195,-75,-6.28,1208
2020-12-31,1120,1193,-73,-6.12,1208
2021-01-01,1087,1081,6,0.56,1208
2021-01-02,565,386,179,46.37,1208
2021-01-03,467,263,204,77.57,1208
2021-01-04,1120,1180,-60,-5.08,1208
2021-01-05,1150,1171,-21,-1.79,1208
2021-01-06,1150,1172,-22,-1.88,1208
2021-01-07,1150,1169,-19,-1.63,1208
2021-01-08,1087,1057,30,2.84,1208
2021-01-09,565,362,203,56.08,1208
2021-01-10,467,241,226,93.78,1208
2021-01-11,1120,1159,-39,-3.36,1208
2021-01-12,1150,1152,-2,-0.17,1208
2021-01-13,1150,1154,-4,-0.35,1208
2021-01-14,1150,1155,-5,-0.43,1208
2021-01-15,1087,1045,42,4.02,1208
2021-01-16,565,354,211,59.6,1208
2021-01-17,467,236,231,97.88,1208
2021-01-18,1120,1157,-37,-3.2,1208
2021-01-19,1150,1154,-4,-0.35,1208
2021-01-20,1150,1160,-10,-0.86,1208
2021-01-21,1150,1164,-14,-1.2,1208
2021-01-22,1087,1058,29,2.74,1208
2021-01-23,565,370,195,52.7,1208
2021-01-24,467,255,212,83.14,1208
2021-01-25,1120,1179,-59,-5.0,1208
2021-01-26,1150,1179,-29,-2.46,1208
2021-01-27,1150,1187,-37,-3.12,1208
2021-01-28,1150,1192,-42,-3.52,1208
2021-01-29,1087,1087,0,0.0,1208
2021-01-30,565,399,166,41.6,1208
2021-01-31,467,285,182,63.86,1208
2021-02-01,1360,1209,151,12.49,1208
2021-02-02,1286,1207,79,6.55,1208
2021-02-03,1286,1215,71,5.84,1208
2021-02-04,1286,1219,67,5.5,1208
2021-02-05,1206,1112,94,8.45,1208
2021-02-06,571,423,148,34.99,1208
2021-02-07,441,307,134,43.65,1208
2021-02-08,1360,1229,131,10.66,1208
2021-02-09,1286,1226,60,4.89,1208
2021-02-10,1286,1231,55,4.47,1208
2021-02-11,1286,1234,52,4.21,1208
2021-02-12,1206,1126,80,7.1,1208
2021-02-13,571,436,135,30.96,1208
2021-02-14,441,318,123,38.68,1208
2021-02-15,1360,1240,120,9.68,1208
2021-02-16,1286,1236,50,4.05,1208
2021-02-17,1286,1242,44,3.54,1208
2021-02-18,1286,1244,42,3.38,1208
2021-02-19,1206,1137,69,6.07,1208
2021-02-20,571,447,124,27.74,1208
2021-02-21,441,330,111,33.64,1208
2021-02-22,1360,1253,107,8.54,1208
2021-02-23,1286,1251,35,2.8,1208
2021-02-24,1286,1257,29,2.31,1208
2021-02-25,1286,1261,25,1.98,1208
2021-02-26,1206,1155,51,4.42,1208
2021-02-27,571,467,104,22.27,1208
2021-02-28,441,351,90,25.64,1208
2021-03-01,1373,1275,98,7.69,1208
2021-03-02,1372,1274,98,7.69,1208
2021-03-03,1372,1281,91,7.1,1208
2021-03-04,1372,1285,87,6.77,1208
2021-03-05,1226,1180,46,3.9,1208
2021-03-06,615,491,124,25.25,1208
2021-03-07,484,375,109,29.07,1208
2021-03-08,1373,1298,75,5.78,1208
2021-03-09,1372,1296,76,5.86,1208
2021-03-10,1372,1303,69,5.3,1208
2021-03-11,1372,1306,66,5.05,1208
2021-03-12,1226,1198,28,2.34,1208
2021-03-13,615,508,107,21.06,1208
2021-03-14,484,391,93,23.79,1208
2021-03-15,1373,1312,61,4.65,1208
2021-03-16,1372,1308,64,4.89,1208
2021-03-17,1372,1312,60,4.57,1208
2021-03-18,1372,1313,59,4.49,1208
2021-03-19,1226,1204,22,1.83,1208
2021-03-20,615,512,103,20.12,1208
2021-03-21,484,393,91,23.16,1208
2021-03-22,1373,1313,60,4.57,1208
2021-03-23,1372,1307,65,4.97,1208
2021-03-24,1372,1310,62,4.73,1208
2021-03-25,1372,1311,61,4.65,1208
2021-03-26,1226,1201,25,2.08,1208
2021-03-27,615,508,107,21.06,1208
2021-03-28,484,389,95,24.42,1208
2021-03-29,1373,1308,65,4.97,1208
2021-03-30,1372,1303,69,5.3,1208
2021-03-31,1372,1306,66,5.05,1208
2021-04-01,1344,1306,38,2.91,1208
2021-04-02,1217,1197,20,1.67,1208
2021-04-03,582,504,78,15.48,1208
2021-04-04,469,385,84,21.82,1208
2021-04-05,1378,1305,73,5.59,1208
2021-04-06,1344,1300,44,3.38,1208
2021-04-07,1344,1304,40,3.07,1208
2021-04-08,1344,1305,39,2.99,1208
2021-04-09,1217,1196,21,1.76,1208
2021-04-10,582,504,78,15.48,1208
2021-04-11,469,385,84,21.82,1208
2021-04-12,1378,1306,72,5.51,1208
2021-04-13,1344,1301,43,3.31,1208
2021-04-14,1344,1305,39,2.99,1208
2021-04-15,1344,1306,38,2.91,1208
2021-04-16,1217,1197,20,1.67,1208
2021-04-17,582,506,76,15.02,1208
2021-04-18,469,388,81,20.88,1208
2021-04-19,1378,1308,70,5.35,1208
2021-04-20,1344,1304,40,3.07,1208
2021-04-21,1344,1308,36,2.75,1208
2021-04-22,1344,1310,34,2.6,1208
2021-04-23,1217,1202,15,1.25,1208
2021-04-24,582,511,71,13.89,1208
2021-04-25,469,393,76,19.34,1208
2021-04-26,1378,1315,63,4.79,1208
2021-04-27,1344,1311,33,2.52,1208
2021-04-28,1344,1316,28,2.13,1208
2021-04-29,1344,1318,26,1.97,1208
2021-04-30,1217,1211,6,0.5,1208
2021-05-01,623,521,102,19.58,1208
2021-05-02,478,404,74,18.32,1208
2021-05-03,1423,1325,98,7.4,1208
2021-05-04,1442,1322,120,9.08,1208
2021-05-05,1442,1328,114,8.58,1208
2021-05-06,1442,1330,112,8.42,1208
2021-05-07,1288,1223,65,5.31,1208
2021-05-08,623,532,91,17.11,1208
2021-05-09,478,415,63,15.18,1208
2021-05-10,1423,1336,87,6.51,1208
2021-05-11,1442,1332,110,8.26,1208
2021-05-12,1442,1337,105,7.85,1208
2021-05-13,1442,1339,103,7.69,1208
2021-05-14,1288,1230,58,4.72,1208
2021-05-15,623,538,85,15.8,1208
2021-05-16,478,420,58,13.81,1208
2021-05-17,1423,1340,83,6.19,1208
2021-05-18,1442,1335,107,8.01,1208
2021-05-19,1442,1338,104,7.77,1208
2021-05-20,1442,1338,104,7.77,1208
2021-05-21,1288,1228,60,4.89,1208
2021-05-22,623,535,88,16.45,1208
2021-05-23,478,416,62,14.9,1208
2021-05-24,1423,1335,88,6.59,1208
2021-05-25,1442,1329,113,8.5,1208
2021-05-26,1442,1332,110,8.26,1208
2021-05-27,1442,1332,110,8.26,1208
2021-05-28,1288,1222,66,5.4,1208
2021-05-29,623,529,94,17.77,1208
2021-05-30,478,410,68,16.59,1208
2021-05-31,1423,1330,93,6.99,1208
2021-06-01,1447,1325,122,9.21,1208
2021-06-02,1447,1329,118,8.88,1208
2021-06-03,1447,1330,117,8.8,1208
2021-06-04,1309,1222,87,7.12,1208
2021-06-05,612,530,82,15.47,1208
2021-06-06,481,413,68,16.46,1208
2021-06-07,1420,1334,86,6.45,1208
2021-06-08,1447,1330,117,8.8,1208
2021-06-09,1447,1335,112,8.39,1208
2021-06-10,1447,1337,110,8.23,1208
2021-06-11,1309,1229,80,6.51,1208
2021-06-12,612,537,75,13.97,1208
2021-06-13,481,419,62,14.8,1208
2021-06-14,1420,1340,80,5.97,1208
2021-06-15,1447,1335,112,8.39,1208
2021-06-16,1447,1339,108,8.07,1208
2021-06-17,1447,1339,108,8.07,1208
2021-06-18,1309,1229,80,6.51,1208
2021-06-19,612,535,77,14.39,1208
2021-06-20,481,414,67,16.18,1208
2021-06-21,1420,1332,88,6.61,1208
2021-06-22,1447,1324,123,9.29,1208
2021-06-23,1447,1324,123,9.29,1208
2021-06-24,1447,1320,127,9.62,1208
2021-06-25,1309,1207,102,8.45,1208
2021-06-26,612,509,103,20.24,1208
2021-06-27,481,385,96,24.94,1208
2021-06-28,1420,1299,121,9.31,1208
2021-06-29,1447,1288,159,12.34,1208
2021-06-30,1447,1286,161,12.52,1208
2021-07-01,1377,1280,97,7.58,1208
2021-07-02,1248,1165,83,7.12,1208
2021-07-03,607,466,141,30.26,1208
2021-07-04,488,341,147,43.11,1208
2021-07-05,1375,1255,120,9.56,1208
2021-07-06,1377,1245,132,10.6,1208
2021-07-07,1377,1243,134,10.78,1208
2021-07-08,1377,1239,138,11.14,1208
2021-07-09,1248,1125,123,10.93,1208
2021-07-10,607,430,177,41.16,1208
2021-07-11,488,307,181,58.96,1208
2021-07-12,1375,1225,150,12.24,1208
2021-07-13,1377,1218,159,13.05,1208
2021-07-14,1377,1220,157,12.87,1208
2021-07-15,1377,1219,158,12.96,1208
2021-07-16,1248,1110,138,12.43,1208
2021-07-17,607,417,190,45.56,1208
2021-07-18,488,299,189,63.21,1208
2021-07-19,1375,1220,155,12.7,1208
2021-07-20,1377,1216,161,13.24,1208
2021-07-21,1377,1220,157,12.87,1208
2021-07-22,1377,1222,155,12.68,1208
2021-07-23,1248,1114,134,12.03,1208
2021-07-24,607,424,183,43.16,1208
2021-07-25,488,306,182,59.48,1208
2021-07-26,1375,1227,148,12.06,1208
2021-07-27,1377,1223,154,12.59,1208
2021-07-28,1377,1227,150,12.22,1208
2021-07-29,1377,1228,149,12.13,1208
2021-07-30,1248,1118,130,11.63,1208
2021-07-31,607,425,182,42.82,1208
2021-08-01,490,306,184,60.13,1208
2021-08-02,1314,1224,90,7.35,1208
2021-08-03,1290,1217,73,6.0,1208
2021-08-04,1290,1219,71,5.82,1208
2021-08-05,1290,1217,73,6.0,1208
2021-08-06,1187,1106,81,7.32,1208
2021-08-07,594,411,183,44.53,1208
2021-08-08,490,289,201,69.55,1208
2021-08-09,1314,1206,108,8.96,1208
2021-08-10,1290,1198,92,7.68,1208
2021-08-11,1290,1199,91,7.59,1208
2021-08-12,1290,1198,92,7.68,1208
2021-08-13,1187,1086,101,9.3,1208
2021-08-14,594,392,202,51.53,1208
2021-08-15,490,272,218,80.15,1208
2021-08-16,1314,1191,123,10.33,1208
2021-08-17,1290,1186,104,8.77,1208
2021-08-18,1290,1190,100,8.4,1208
2021-08-19,1290,1192,98,8.22,1208
2021-08-20,1187,1084,103,9.5,1208
2021-08-21,594,394,200,50.76,1208
2021-08-22,490,278,212,76.26,1208
2021-08-23,1314,1201,113,9.41,1208
2021-08-24,1290,1199,91,7.59,1208
2021-08-25,1290,1207,83,6.88,1208
2021-08-26,1290,1212,78,6.44,1208
2021-08-27,1187,1108,79,7.13,1208
2021-08-28,594,420,174,41.43,1208
2021-08-29,490,307,183,59.61,1208
2021-08-30,1314,1232,82,6.66,1208
2021-08-31,1290,1232,58,4.71,1208
2021-09-01,1394,1241,153,12.33,1208
2021-09-02,1394,1246,148,11.88,1208
2021-09-03,1287,1142,145,12.7,1208
2021-09-04,625,454,171,37.67,1208
2021-09-05,499,339,160,47.2,1208
2021-09-06,1377,1262,115,9.11,1208
2021-09-07,1394,1261,133,10.55,1208
2021-09-08,1394,1267,127,10.02,1208
2021-09-09,1394,1270,124,9.76,1208
2021-09-10,1287,1162,125,10.76,1208
2021-09-11,625,471,154,32.7,1208
2021-09-12,499,353,146,41.36,1208
2021-09-13,1377,1274,103,8.08,1208
2021-09-14,1394,1269,125,9.85,1208
2021-09-15,1394,1272,122,9.59,1208
2021-09-16,1394,1273,121,9.51,1208
2021-09-17,1287,1163,124,10.66,1208
2021-09-18,625,470,155,32.98,1208
2021-09-19,499,350,149,42.57,1208
2021-09-20,1377,1270,107,8.43,1208
2021-09-21,1394,1264,130,10.28,1208
2021-09-22,1394,1267,127,10.02,1208
2021-09-23,1394,1267,127,10.02,1208
2021-09-24,1287,1157,130,11.24,1208
2021-09-25,625,465,160,34.41,1208
2021-09-26,499,346,153,44.22,1208
2021-09-27,1377,1266,111,8.77,1208
2021-09-28,1394,1262,132,10.46,1208
2021-09-29,1394,1266,128,10.11,1208
2021-09-30,1394,1267,127,10.02,1208
2021-10-01,1287,1159,128,11.04,1208
2021-10-02,624,468,156,33.33,1208
2021-10-03,488,350,138,39.43,1208
2021-10-04,1392,1271,121,9.52,1208
2021-10-05,1396,1267,129,10.18,1208
2021-10-06,1396,1272,124,9.75,1208
2021-10-07,1396,1274,122,9.58,1208
2021-10-08,1287,1165,122,10.47,1208
2021-10-09,624,474,150,31.65,1208
2021-10-10,488,356,132,37.08,1208
2021-10-11,1392,1276,116,9.09,1208
2021-10-12,1396,1271,125,9.83,1208
2021-10-13,1396,1275,121,9.49,1208
2021-10-14,1396,1275,121,9.49,1208
2021-10-15,1287,1166,121,10.38,1208
2021-10-16,624,473,151,31.92,1208
2021-10-17,488,353,135,38.24,1208
2021-10-18,1392,1272,120,9.43,1208
2021-10-19,1396,1266,130,10.27,1208
2021-10-20,1396,1268,128,10.09,1208
2021-10-21,1396,1268,128,10.09,1208
2021-10-22,1287,1158,129,11.14,1208
2021-10-23,624,465,159,34.19,1208
2021-10-24,488,345,143,41.45,1208
2021-10-25,1392,1265,127,10.04,1208
2021-10-26,1396,1259,137,10.88,1208
2021-10-27,1396,1263,133,10.53,1208
2021-10-28,1396,1264,132,10.44,1208
2021-10-29,1287,1155,132,11.43,1208
2021-10-30,624,464,160,34.48,1208
2021-10-31,488,347,141,40.63,1208
2021-11-01,1407,1268,139,10.96,1208
2021-11-02,1376,1265,111,8.77,1208
2021-11-03,1376,1271,105,8.26,1208
2021-11-04,1376,1274,102,8.01,1208
2021-11-05,1284,1167,117,10.03,1208
2021-11-06,648,478,170,35.56,1208
2021-11-07,491,361,130,36.01,1208
2021-11-08,1407,1284,123,9.58,1208
2021-11-09,1376,1281,95,7.42,1208
2021-11-10,1376,1287,89,6.92,1208
2021-11-11,1376,1290,86,6.67,1208
2021-11-12,1284,1182,102,8.63,1208
2021-11-13,648,491,157,31.98,1208
2021-11-14,491,372,119,31.99,1208
2021-11-15,1407,1292,115,8.9,1208
2021-11-16,1376,1286,90,7.0,1208
2021-11-17,1376,1288,88,6.83,1208
2021-11-18,1376,1287,89,6.92,1208
2021-11-19,1284,1175,109,9.28,1208
2021-11-20,648,479,169,35.28,1208
2021-11-21,491,356,135,37.92,1208
2021-11-22,1407,1271,136,10.7,1208
2021-11-23,1376,1261,115,9.12,1208
2021-11-24,1376,1259,117,9.29,1208
2021-11-25,1376,1253,123,9.82,1208
2021-11-26,1284,1137,147,12.93,1208
2021-11-27,648,438,210,47.95,1208
2021-11-28,491,312,179,57.37,1208
2021-11-29,1407,1224,183,14.95,1208
2021-11-30,1376,1212,164,13.53,1208
2021-12-01,1217,1208,9,0.75,1208
2021-12-02,1217,1201,16,1.33,1208
2021-12-03,1009,1085,-76,-7.0,1208
2021-12-04,621,387,234,60.47,1208
2021-12-05,486,262,224,85.5,1208
2021-12-06,1329,1176,153,13.01,1208
2021-12-07,1217,1166,51,4.37,1208
2021-12-08,1217,1165,52,4.46,1208
2021-12-09,1217,1161,56,4.82,1208
2021-12-10,1009,1049,-40,-3.81,1208
2021-12-11,621,354,267,75.42,1208
2021-12-12,486,232,254,109.48,1208
2021-12-13,1329,1150,179,15.57,1208
2021-12-14,1217,1144,73,6.38,1208
2021-12-15,1217,1147,70,6.1,1208
2021-12-16,1217,1147,70,6.1,1208
2021-12-17,1009,1037,-28,-2.7,1208
2021-12-18,621,345,276,80.0,1208
2021-12-19,486,226,260,115.04,1208
2021-12-20,1329,1146,183,15.97,1208
2021-12-21,1217,1141,76,6.66,1208
2021-12-22,1217,1144,73,6.38,1208
2021-12-23,1217,1145,72,6.29,1208
2021-12-24,1009,1035,-26,-2.51,1208
2021-12-25,621,342,279,81.58,1208
2021-12-26,486,222,264,118.92,1208
2021-12-27,1329,1141,188,16.48,1208
2021-12-28,1217,1134,83,7.32,1208
2021-12-29,1217,1136,81,7.13,1208
2021-12-30,1217,1134,83,7.32,1208
2021-12-31,1009,1022,-13,-1.27,1208
2022-01-01,604,327,277,84.71,1208
2022-01-02,475,205,270,131.71,1208
2022-01-03,1229,1122,107,9.54,1208
2022-01-04,1214,1114,100,8.98,1208
2022-01-05,1214,1114,100,8.98,1208
2022-01-06,1214,1111,103,9.27,1208
2022-01-07,1142,999,143,14.31,1208
2022-01-08,604,304,300,98.68,1208
2022-01-09,475,182,293,160.99,1208
2022-01-10,1229,1099,130,11.83,1208
2022-01-11,1214,1092,122,11.17,1208
2022-01-12,1214,1094,120,10.97,1208
2022-01-13,1214,1093,121,11.07,1208
2022-01-14,1142,983,159,16.17,1208
2022-01-15,604,291,313,107.56,1208
2022-01-16,475,172,303,176.16,1208
2022-01-17,1229,1093,136,12.44,1208
2022-01-18,1214,1090,124,11.38,1208
2022-01-19,1214,1095,119,10.87,1208
2022-01-20,1214,1098,116,10.56,1208
2022-01-21,1142,992,150,15.12,1208
2022-01-22,604,303,301,99.34,1208
2022-01-23,475,188,287,152.66,1208
2022-01-24,1229,1112,117,10.52,1208
2022-01-25,1214,1111,103,9.27,1208
2022-01-26,1214,1119,95,8.49,1208
2022-01-27,1214,1124,90,8.01,1208
2022-01-28,1142,1020,122,11.96,1208
2022-01-29,604,332,272,81.93,1208
2022-01-30,475,217,258,118.89,1208
2020-02-01,437,545,-108,-19.82,1612
2020-02-02,323,450,-127,-28.22,1612
2020-02-03,785,977,-192,-19.65,1612
2020-02-04,853,984,-131,-13.31,1612
2020-02-05,853,987,-134,-13.58,1612
2020-02-06,853,990,-137,-13.84,1612
2020-02-07,824,941,-117,-12.43,1612
2020-02-08,437,569,-132,-23.2,1612
2020-02-09,323,472,-149,-31.57,1612
2020-02-10,785,997,-212,-21.26,1612
2020-02-11,853,1002,-149,-14.87,1612
2020-02-12,853,1003,-150,-14.96,1612
2020-02-13,853,1006,-153,-15.21,1612
2020-02-14,824,956,-132,-13.81,1612
2020-02-15,437,582,-145,-24.91,1612
2020-02-16,323,484,-161,-33.26,1612
2020-02-17,785,1009,-224,-22.2,1612
2020-02-18,853,1014,-161,-15.88,1612
2020-02-19,853,1016,-163,-16.04,1612
2020-02-20,853,1018,-165,-16.21,1612
2020-02-21,824,969,-145,-14.96,1612
2020-02-22,437,596,-159,-26.68,1612
2020-02-23,323,499,-176,-35.27,1612
2020-02-24,785,1025,-240,-23.41,1612
2020-02-25,853,1031,-178,-17.26,1612
2020-02-26,853,1034,-181,-17.5,1612
2020-02-27,853,1038,-185,-17.82,1612
2020-02-28,824,990,-166,-16.77,1612
2020-02-29,437,618,-181,-29.29,1612
2020-03-01,293,522,-229,-43.87,1612
2020-03-02,734,1049,-315,-30.03,1612
2020-03-03,706,1056,-350,-33.14,1612
2020-03-04,706,1059,-353,-33.33,1612
2020-03-05,706,1063,-357,-33.58,1612
2020-03-06,684,1015,-331,-32.61,1612
2020-03-07,379,643,-264,-41.06,1612
2020-03-08,293,547,-254,-46.44,1612
2020-03-09,734,1073,-339,-31.59,1612
2020-03-10,706,1079,-373,-34.57,1612
2020-03-11,706,1081,-375,-34.69,1612
2020-03-12,706,1083,-377,-34.81,1612
2020-03-13,684,1034,-350,-33.85,1612
2020-03-14,379,660,-281,-42.58,1612
2020-03-15,293,562,-269,-47.86,1612
2020-03-16,734,1087,-353,-32.47,1612
2020-03-17,706,1091,-385,-35.29,1612
2020-03-18,706,1091,-385,-35.29,1612
2020-03-19,706,1092,-386,-35.35,1612
2020-03-20,684,1041,-357,-34.29,1612
2020-03-21,379,665,-286,-43.01,1612
2020-03-22,293,566,-273,-48.23,1612
2020-03-23,734,1090,-356,-32.66,1612
2020-03-24,706,1093,-387,-35.41,1612
2020-03-25,706,1093,-387,-35.41,1612
2020-03-26,706,1094,-388,-35.47,1612
2020-03-27,684,1043,-359,-34.42,1612
2020-03-28,379,668,-289,-43.26,1612
2020-03-29,293,569,-276,-48.51,1612
2020-03-30,734,1093,-359,-32.85,1612
2020-03-31,706,1097,-391,-35.64,1612
2020-04-01,654,1098,-444,-40.44,1612
2020-04-02,654,1100,-446,-40.55,1612
2020-04-03,580,1050,-470,-44.76,1612
2020-04-04,364,676,-312,-46.15,1612
2020-04-05,248,578,-330,-57.09,1612
2020-04-06,634,1103,-469,-42.52,1612
2020-04-07,654,1108,-454,-40.97,1612
2020-04-08,654,1109,-455,-41.03,1612
2020-04-09,654,1111,-457,-41.13,1612
2020-04-10,580,1062,-482,-45.39,1612
2020-04-11,364,688,-324,-47.09,1612
2020-04-12,248,590,-342,-57.97,1612
2020-04-13,634,1115,-481,-43.14,1612
2020-04-14,654,1120,-466,-41.61,1612
2020-04-15,654,1120,-466,-41.61,1612
2020-04-16,654,1122,-468,-41.71,1612
2020-04-17,580,1071,-491,-45.85,1612
2020-04-18,364,696,-332,-47.7,1612
2020-04-19,248,598,-350,-58.53,1612
2020-04-20,634,1121,-487,-43.44,1612
2020-04-21,654,1125,-471,-41.87,1612
2020-04-22,654,1124,-470,-41.81,1612
2020-04-23,654,1125,-471,-41.87,1612
2020-04-24,580,1073,-493,-45.95,1612
2020-04-25,364,698,-334,-47.85,1612
2020-04-26,248,598,-350,-58.53,1612
2020-04-27,634,1121,-487,-43.44,1612
2020-04-28,654,1125,-471,-41.87,1612
2020-04-29,654,1124,-470,-41.81,1612
2020-04-30,654,1124,-470,-41.81,1612
2020-05-01,713,1073,-360,-33.55,1612
2020-05-02,414,698,-284,-40.69,1612
2020-05-03,288,599,-311,-51.92,1612
2020-05-04,768,1123,-355,-31.61,1612
2020-05-05,780,1127,-347,-30.79,1612
2020-05-06,780,1128,-348,-30.85,1612
2020-05-07,780,1129,-349,-30.91,1612
2020-05-08,713,1079,-366,-33.92,1612
2020-05-09,414,705,-291,-41.28,1612
2020-05-10,288,607,-319,-52.55,1612
2020-05-11,768,1132,-364,-32.16,1612
2020-05-12,780,1137,-357,-31.4,1612
2020-05-13,780,1138,-358,-31.46,1612
2020-05-14,780,1141,-361,-31.64,1612
2020-05-15,713,1091,-378,-34.65,1612
2020-05-16,414,717,-303,-42.26,1612
2020-05-17,288,619,-331,-53.47,1612
2020-05-18,768,1144,-376,-32.87,1612
2020-05-19,780,1148,-368,-32.06,1612
2020-05-20,780,1149,-369,-32.11,1612
2020-05-21,780,1150,-370,-32.17,1612
2020-05-22,713,1099,-386,-35.12,1612
2020-05-23,414,724,-310,-42.82,1612
2020-05-24,288,625,-337,-53.92,1612
2020-05-25,768,1148,-380,-33.1,1612
2020-05-26,780,1151,-371,-32.23,1612
2020-05-27,780,1150,-370,-32.17,1612
2020-05-28,780,1149,-369,-32.11,1612
2020-05-29,713,1097,-384,-35.0,1612
2020-05-30,414,721,-307,-42.58,1612
2020-05-31,288,621,-333,-53.62,1612
2020-06-01,874,1143,-269,-23.53,1612
2020-06-02,897,1145,-248,-21.66,1612
2020-06-03,897,1144,-247,-21.59,1612
2020-06-04,897,1143,-246,-21.52,1612
2020-06-05,794,1091,-297,-27.22,1612
2020-06-06,397,715,-318,-44.48,1612
2020-06-07,282,615,-333,-54.15,1612
2020-06-08,874,1138,-264,-23.2,1612
2020-06-09,897,1142,-245,-21.45,1612
2020-06-10,897,1141,-244,-21.38,1612
2020-06-11,897,1142,-245,-21.45,1612
2020-06-12,794,1092,-298,-27.29,1612
2020-06-13,397,717,-320,-44.63,1612
2020-06-14,282,619,-337,-54.44,1612
2020-06-15,874,1144,-270,-23.6,1612
2020-06-16,897,1149,-252,-21.93,1612
2020-06-17,897,1150,-253,-22.0,1612
2020-06-18,897,1153,-256,-22.2,1612
2020-06-19,794,1104,-310,-28.08,1612
2020-06-20,397,730,-333,-45.62,1612
2020-06-21,282,634,-352,-55.52,1612
2020-06-22,874,1159,-285,-24.59,1612
2020-06-23,897,1165,-268,-23.0,1612
2020-06-24,897,1167,-270,-23.14,1612
2020-06-25,897,1170,-273,-23.33,1612
2020-06-26,794,1121,-327,-29.17,1612
2020-06-27,397,748,-351,-46.93,1612
2020-06-28,282,651,-369,-56.68,1612
2020-06-29,874,1177,-303,-25.74,1612
2020-06-30,897,1182,-285,-24.11,1612
2020-07-01,900,1183,-283,-23.92,1612
2020-07-02,900,1186,-286,-24.11,1612
2020-07-03,772,1136,-364,-32.04,1612
2020-07-04,390,762,-372,-48.82,1612
2020-07-05,304,664,-360,-54.22,1612
2020-07-06,896,1189,-293,-24.64,1612
2020-07-07,900,1194,-294,-24.62,1612
2020-07-08,900,1194,-294,-24.62,1612
2020-07-09,900,1196,-296,-24.75,1612
2020-07-10,772,1145,-373,-32.58,1612
2020-07-11,390,771,-381,-49.42,1612
2020-07-12,304,673,-369,-54.83,1612
2020-07-13,896,1197,-301,-25.15,1612
2020-07-14,900,1201,-301,-25.06,1612
2020-07-15,900,1202,-302,-25.12,1612
2020-07-16,900,1203,-303,-25.19,1612
2020-07-17,772,1152,-380,-32.99,1612
2020-07-18,390,778,-388,-49.87,1612
2020-07-19,304,679,-375,-55.23,1612
2020-07-20,896,1203,-307,-25.52,1612
2020-07-21,900,1207,-307,-25.43,1612
2020-07-22,900,1207,-307,-25.43,1612
2020-07-23,900,1207,-307,-25.43,1612
2020-07-24,772,1156,-384,-33.22,1612
2020-07-25,390,780,-390,-50.0,1612
2020-07-26,304,681,-377,-55.36,1612
2020-07-27,896,1204,-308,-25.58,1612
2020-07-28,900,1207,-307,-25.43,1612
2020-07-29,900,1205,-305,-25.31,1612
2020-07-30,900,1204,-304,-25.25,1612
2020-07-31,772,1152,-380,-32.99,1612
2020-08-01,394,775,-381,-49.16,1612
2020-08-02,290,674,-384,-56.97,1612
2020-08-03,805,1196,-391,-32.69,1612
2020-08-04,832,1197,-365,-30.49,1612
2020-08-05,832,1195,-363,-30.38,1612
2020-08-06,832,1193,-361,-30.26,1612
2020-08-07,770,1140,-370,-32.46,1612
2020-08-08,394,763,-369,-48.36,1612
2020-08-09,290,662,-372,-56.19,1612
2020-08-10,805,1184,-379,-32.01,1612
2020-08-11,832,1186,-354,-29.85,1612
2020-08-12,832,1185,-353,-29.79,1612
2020-08-13,832,1185,-353,-29.79,1612
2020-08-14,770,1134,-364,-32.1,1612
2020-08-15,394,759,-365,-48.09,1612
2020-08-16,290,661,-371,-56.13,1612
2020-08-17,805,1186,-381,-32.12,1612
2020-08-18,832,1192,-360,-30.2,1612
2020-08-19,832,1194,-362,-30.32,1612
2020-08-20,832,1198,-366,-30.55,1612
2020-08-21,770,1151,-381,-33.1,1612
2020-08-22,394,780,-386,-49.49,1612
2020-08-23,290,686,-396,-57.73,1612
2020-08-24,805,1215,-410,-33.74,1612
2020-08-25,832,1225,-393,-32.08,1612
2020-08-26,832,1231,-399,-32.41,1612
2020-08-27,832,1238,-406,-32.79,1612
2020-08-28,770,1194,-424,-35.51,1612
2020-08-29,394,826,-432,-52.3,1612
2020-08-30,290,735,-445,-60.54,1612
2020-08-31,805,1266,-461,-36.41,1612
2020-09-01,903,1277,-374,-29.29,1612
2020-09-02,903,1284,-381,-29.67,1612
2020-09-03,903,1292,-389,-30.11,1612
2020-09-04,806,1248,-442,-35.42,1612
2020-09-05,426,879,-453,-51.54,1612
2020-09-06,302,787,-485,-61.63,1612
2020-09-07,876,1316,-440,-33.43,1612
2020-09-08,903,1325,-422,-31.85,1612
2020-09-09,903,1330,-427,-32.11,1612
2020-09-10,903,1335,-432,-32.36,1612
2020-09-11,806,1287,-481,-37.37,1612
2020-09-12,426,915,-489,-53.44,1612
2020-09-13,302,819,-517,-63.13,1612
2020-09-14,876,1345,-469,-34.87,1612
2020-09-15,903,1351,-448,-33.16,1612
2020-09-16,903,1351,-448,-33.16,1612
2020-09-17,903,1353,-450,-33.26,1612
2020-09-18,806,1302,-496,-38.1,1612
2020-09-19,426,927,-501,-54.05,1612
2020-09-20,302,828,-526,-63.53,1612
2020-09-21,876,1352,-476,-35.21,1612
2020-09-22,903,1355,-452,-33.36,1612
2020-09-23,903,1354,-451,-33.31,1612
2020-09-24,903,1354,-451,-33.31,1612
2020-09-25,806,1303,-497,-38.14,1612
2020-09-26,426,927,-501,-54.05,1612
2020-09-27,302,828,-526,-63.53,1612
2020-09-28,876,1351,-475,-35.16,1612
2020-09-29,903,1355,-452,-33.36,1612
2020-09-30,903,1355,-452,-33.36,1612
2020-10-01,880,1356,-476,-35.1,1612
2020-10-02,767,1305,-538,-41.23,1612
2020-10-03,411,931,-520,-55.85,1612
2020-10-04,300,832,-532,-63.94,1612
2020-10-05,942,1357,-415,-30.58,1612
2020-10-06,880,1362,-482,-35.39,1612
2020-10-07,880,1363,-483,-35.44,1612
2020-10-08,880,1365,-485,-35.53,1612
2020-10-09,767,1315,-548,-41.67,1612
2020-10-10,411,941,-530,-56.32,1612
2020-10-11,300,844,-544,-64.45,1612
2020-10-12,942,1369,-427,-31.19,1612
2020-10-13,880,1374,-494,-35.95,1612
2020-10-14,880,1375,-495,-36.0,1612
2020-10-15,880,1377,-497,-36.09,1612
2020-10-16,767,1327,-560,-42.2,1612
2020-10-17,411,953,-542,-56.87,1612
2020-10-18,300,855,-555,-64.91,1612
2020-10-19,942,1380,-438,-31.74,1612
2020-10-20,880,1385,-505,-36.46,1612
2020-10-21,880,1385,-505,-36.46,1612
2020-10-22,880,1386,-506,-36.51,1612
2020-10-23,767,1336,-569,-42.59,1612
2020-10-24,411,962,-551,-57.28,1612
2020-10-25,300,863,-563,-65.24,1612
2020-10-26,942,1388,-446,-32.13,1612
2020-10-27,880,1392,-512,-36.78,1612
2020-10-28,880,1393,-513,-36.83,1612
2020-10-29,880,1394,-514,-36.87,1612
2020-10-30,767,1344,-577,-42.93,1612
2020-10-31,411,970,-559,-57.63,1612
2020-11-01,298,872,-574,-65.83,1612
2020-11-02,905,1397,-492,-35.22,1612
2020-11-03,876,1402,-526,-37.52,1612
2020-11-04,876,1404,-528,-37.61,1612
2020-11-05,876,1406,-530,-37.7,1612
2020-11-06,848,1357,-509,-37.51,1612
2020-11-07,422,983,-561,-57.07,1612
2020-11-08,298,886,-588,-66.37,1612
2020-11-09,905,1411,-506,-35.86,1612
2020-11-10,876,1416,-540,-38.14,1612
2020-11-11,876,1417,-541,-38.18,1612
2020-11-12,876,1419,-543,-38.27,1612
2020-11-13,848,1370,-522,-38.1,1612
2020-11-14,422,995,-573,-57.59,1612
2020-11-15,298,897,-599,-66.78,1612
2020-11-16,905,1421,-516,-36.31,1612
2020-11-17,876,1425,-549,-38.53,1612
2020-11-18,876,1425,-549,-38.53,1612
2020-11-19,876,1425,-549,-38.53,1612
2020-11-20,848,1374,-526,-38.28,1612
2020-11-21,422,997,-575,-57.67,1612
2020-11-22,298,897,-599,-66.78,1612
2020-11-23,905,1419,-514,-36.22,1612
2020-11-24,876,1421,-545,-38.35,1612
2020-11-25,876,1419,-543,-38.27,1612
2020-11-26,876,1417,-541,-38.18,1612
2020-11-27,848,1364,-516,-37.83,1612
2020-11-28,422,986,-564,-57.2,1612
2020-11-29,298,885,-587,-66.33,1612
2020-11-30,905,1406,-501,-35.63,1612
2020-12-01,742,1407,-665,-47.26,1612
2020-12-02,742,1405,-663,-47.19,1612
2020-12-03,742,1403,-661,-47.11,1612
2020-12-04,838,1350,-512,-37.93,1612
2020-12-05,422,973,-551,-56.63,1612
2020-12-06,291,872,-581,-66.63,1612
2020-12-07,788,1394,-606,-43.47,1612
2020-12-08,742,1397,-655,-46.89,1612
2020-12-09,742,1395,-653,-46.81,1612
2020-12-10,742,1395,-653,-46.81,1612
2020-12-11,838,1344,-506,-37.65,1612
2020-12-12,422,968,-546,-56.4,1612
2020-12-13,291,869,-578,-66.51,1612
2020-12-14,788,1393,-605,-43.43,1612
2020-12-15,742,1397,-655,-46.89,1612
2020-12-16,742,1397,-655,-46.89,1612
2020-12-17,742,1398,-656,-46.92,1612
2020-12-18,838,1348,-510,-37.83,1612
2020-12-19,422,973,-551,-56.63,1612
2020-12-20,291,874,-583,-66.7,1612
2020-12-21,788,1398,-610,-43.63,1612
2020-12-22,742,1402,-660,-47.08,1612
2020-12-23,742,1401,-659,-47.04,1612
2020-12-24,742,1402,-660,-47.08,1612
2020-12-25,838,1350,-512,-37.93,1612
2020-12-26,422,974,-552,-56.67,1612
2020-12-27,291,874,-583,-66.7,1612
2020-12-28,788,1396,-608,-43.55,1612
2020-12-29,742,1398,-656,-46.92,1612
2020-12-30,742,1396,-654,-46.85,1612
2020-12-31,742,1394,-652,-46.77,1612
2021-01-01,718,1341,-623,-46.46,1612
2021-01-02,380,963,-583,-60.54,1612
2021-01-03,277,861,-584,-67.83,1612
2021-01-04,738,1382,-644,-46.6,1612
2021-01-05,779,1383,-604,-43.67,1612
2021-01-06,779,1380,-601,-43.55,1612
2021-01-07,779,1379,-600,-43.51,1612
2021-01-08,718,1325,-607,-45.81,1612
2021-01-09,380,948,-568,-59.92,1612
2021-01-10,277,847,-570,-67.3,1612
2021-01-11,738,1369,-631,-46.09,1612
2021-01-12,779,1372,-593,-43.22,1612
2021-01-13,779,1371,-592,-43.18,1612
2021-01-14,779,1372,-593,-43.22,1612
2021-01-15,718,1321,-603,-45.65,1612
2021-01-16,380,947,-567,-59.87,1612
2021-01-17,277,849,-572,-67.37,1612
2021-01-18,738,1374,-636,-46.29,1612
2021-01-19,779,1380,-601,-43.55,1612
2021-01-20,779,1382,-603,-43.63,1612
2021-01-21,779,1386,-607,-43.8,1612
2021-01-22,718,1338,-620,-46.34,1612
2021-01-23,380,967,-587,-60.7,1612
2021-01-24,277,872,-595,-68.23,1612
2021-01-25,738,1399,-661,-47.25,1612
2021-01-26,779,1407,-628,-44.63,1612
2021-01-27,779,1411,-632,-44.79,1612
2021-01-28,779,1416,-637,-44.99,1612
2021-01-29,718,1369,-651,-47.55,1612
2021-01-30,380,998,-618,-61.92,1612
2021-01-31,277,903,-626,-69.32,1612
2021-02-01,852,1431,-579,-40.46,1612
2021-02-02,849,1438,-589,-40.96,1612
2021-02-03,849,1441,-592,-41.08,1612
2021-02-04,849,1445,-596,-41.25,1612
2021-02-05,812,1396,-584,-41.83,1612
2021-02-06,426,1024,-598,-58.4,1612
2021-02-07,293,927,-634,-68.39,1612
2021-02-08,852,1453,-601,-41.36,1612
2021-02-09,849,1458,-609,-41.77,1612
2021-02-10,849,1460,-611,-41.85,1612
2021-02-11,849,1462,-613,-41.93,1612
2021-02-12,812,1412,-600,-42.49,1612
2021-02-13,426,1038,-612,-58.96,1612
2021-02-14,293,941,-648,-68.86,1612
2021-02-15,852,1466,-614,-41.88,1612
2021-02-16,849,1471,-622,-42.28,1612
2021-02-17,849,1472,-623,-42.32,1612
2021-02-18,849,1474,-625,-42.4,1612
2021-02-19,812,1425,-613,-43.02,1612
2021-02-20,426,1051,-625,-59.47,1612
2021-02-21,293,954,-661,-69.29,1612
2021-02-22,852,1480,-628,-42.43,1612
2021-02-23,849,1486,-637,-42.87,1612
2021-02-24,849,1488,-639,-42.94,1612
2021-02-25,849,1492,-643,-43.1,1612
2021-02-26,812,1444,-632,-43.77,1612
2021-02-27,426,1072,-646,-60.26,1612
2021-02-28,293,976,-683,-69.98,1612
2021-03-01,975,1503,-528,-35.13,1612
2021-03-02,982,1510,-528,-34.97,1612
2021-03-03,982,1513,-531,-35.1,1612
2021-03-04,982,1517,-535,-35.27,1612
2021-03-05,843,1469,-626,-42.61,1612
2021-03-06,463,1097,-634,-57.79,1612
2021-03-07,314,1001,-687,-68.63,1612
2021-03-08,975,1528,-553,-36.19,1612
2021-03-09,982,1534,-552,-35.98,1612
2021-03-10,982,1536,-554,-36.07,1612
2021-03-11,982,1539,-557,-36.19,1612
2021-03-12,843,1490,-647,-43.42,1612
2021-03-13,463,1116,-653,-58.51,1612
2021-03-14,314,1019,-705,-69.19,1612
2021-03-15,975,1544,-569,-36.85,1612
2021-03-16,982,1548,-566,-36.56,1612
2021-03-17,982,1548,-566,-36.56,1612
2021-03-18,982,1550,-568,-36.65,1612
2021-03-19,843,1499,-656,-43.76,1612
2021-03-20,463,1124,-661,-58.81,1612
2021-03-21,314,1025,-711,-69.37,1612
2021-03-22,975,1548,-573,-37.02,1612
2021-03-23,982,1552,-570,-36.73,1612
2021-03-24,982,1551,-569,-36.69,1612
2021-03-25,982,1552,-570,-36.73,1612
2021-03-26,843,1501,-658,-43.84,1612
2021-03-27,463,1126,-663,-58.88,1612
2021-03-28,314,1027,-713,-69.43,1612
2021-03-29,975,1551,-576,-37.14,1612
2021-03-30,982,1555,-573,-36.85,1612
2021-03-31,982,1555,-573,-36.85,1612
2021-04-01,949,1557,-608,-39.05,1612
2021-04-02,856,1506,-650,-43.16,1612
2021-04-03,455,1132,-677,-59.81,1612
2021-04-04,293,1034,-741,-71.66,1612
2021-04-05,945,1559,-614,-39.38,1612
2021-04-06,949,1564,-615,-39.32,1612
2021-04-07,949,1565,-616,-39.36,1612
2021-04-08,949,1568,-619,-39.48,1612
2021-04-09,856,1518,-662,-43.61,1612
2021-04-10,455,1144,-689,-60.23,1612
2021-04-11,293,1047,-754,-72.02,1612
2021-04-12,945,1572,-627,-39.89,1612
2021-04-13,949,1577,-628,-39.82,1612
2021-04-14,949,1577,-628,-39.82,1612
2021-04-15,949,1579,-630,-39.9,1612
2021-04-16,856,1529,-673,-44.02,1612
2021-04-17,455,1154,-699,-60.57,1612
2021-04-18,293,1055,-762,-72.23,1612
2021-04-19,945,1579,-634,-40.15,1612
2021-04-20,949,1583,-634,-40.05,1612
2021-04-21,949,1583,-634,-40.05,1612
2021-04-22,949,1583,-634,-40.05,1612
2021-04-23,856,1532,-676,-44.13,1612
2021-04-24,455,1156,-701,-60.64,1612
2021-04-25,293,1057,-764,-72.28,1612
2021-04-26,945,1580,-635,-40.19,1612
2021-04-27,949,1583,-634,-40.05,1612
2021-04-28,949,1582,-633,-40.01,1612
2021-04-29,949,1583,-634,-40.05,1612
2021-04-30,856,1531,-675,-44.09,1612
2021-05-01,462,1156,-694,-60.03,1612
2021-05-02,293,1057,-764,-72.28,1612
2021-05-03,1004,1581,-577,-36.5,1612
2021-05-04,990,1585,-595,-37.54,1612
2021-05-05,990,1585,-595,-37.54,1612
2021-05-06,990,1586,-596,-37.58,1612
2021-05-07,854,1536,-682,-44.4,1612
2021-05-08,462,1162,-700,-60.24,1612
2021-05-09,293,1064,-771,-72.46,1612
2021-05-10,1004,1589,-585,-36.82,1612
2021-05-11,990,1594,-604,-37.89,1612
2021-05-12,990,1595,-605,-37.93,1612
2021-05-13,990,1597,-607,-38.01,1612
2021-05-14,854,1547,-693,-44.8,1612
2021-05-15,462,1173,-711,-60.61,1612
2021-05-16,293,1076,-783,-72.77,1612
2021-05-17,1004,1601,-597,-37.29,1612
2021-05-18,990,1605,-615,-38.32,1612
2021-05-19,990,1606,-616,-38.36,1612
2021-05-20,990,1607,-617,-38.39,1612
2021-05-21,854,1557,-703,-45.15,1612
2021-05-22,462,1182,-720,-60.91,1612
2021-05-23,293,1083,-790,-72.95,1612
2021-05-24,1004,1606,-602,-37.48,1612
2021-05-25,990,1610,-620,-38.51,1612
2021-05-26,990,1609,-619,-38.47,1612
2021-05-27,990,1609,-619,-38.47,1612
2021-05-28,854,1557,-703,-45.15,1612
2021-05-29,462,1180,-718,-60.85,1612
2021-05-30,293,1080,-787,-72.87,1612
2021-05-31,1004,1603,-599,-37.37,1612
2021-06-01,993,1605,-612,-38.13,1612
2021-06-02,993,1603,-610,-38.05,1612
2021-06-03,993,1603,-610,-38.05,1612
2021-06-04,872,1551,-679,-43.78,1612
2021-06-05,443,1174,-731,-62.27,1612
2021-06-06,310,1074,-764,-71.14,1612
2021-06-07,976,1597,-621,-38.89,1612
2021-06-08,993,1600,-607,-37.94,1612
2021-06-09,993,1599,-606,-37.9,1612
2021-06-10,993,1600,-607,-37.94,1612
2021-06-11,872,1549,-677,-43.71,1612
2021-06-12,443,1174,-731,-62.27,1612
2021-06-13,310,1076,-766,-71.19,1612
2021-06-14,976,1601,-625,-39.04,1612
2021-06-15,993,1605,-612,-38.13,1612
2021-06-16,993,1606,-613,-38.17,1612
2021-06-17,993,1609,-616,-38.28,1612
2021-06-18,872,1559,-687,-44.07,1612
2021-06-19,443,1186,-743,-62.65,1612
2021-06-20,310,1089,-779,-71.53,1612
2021-06-21,976,1615,-639,-39.57,1612
2021-06-22,993,1621,-628,-38.74,1612
2021-06-23,993,1623,-630,-38.82,1612
2021-06-24,993,1626,-633,-38.93,1612
2021-06-25,872,1577,-705,-44.71,1612
2021-06-26,443,1204,-761,-63.21,1612
2021-06-27,310,1107,-797,-72.0,1612
2021-06-28,976,1632,-656,-40.2,1612
2021-06-29,993,1638,-645,-39.38,1612
2021-06-30,993,1639,-646,-39.41,1612
2021-07-01,887,1642,-755,-45.98,1612
2021-07-02,885,1592,-707,-44.41,1612
2021-07-03,387,1218,-831,-68.23,1612
2021-07-04,301,1121,-820,-73.15,1612
2021-07-05,904,1646,-742,-45.08,1612
2021-07-06,887,1650,-763,-46.24,1612
2021-07-07,887,1651,-764,-46.27,1612
2021-07-08,887,1653,-766,-46.34,1612
2021-07-09,885,1603,-718,-44.79,1612
2021-07-10,387,1228,-841,-68.49,1612
2021-07-11,301,1130,-829,-73.36,1612
2021-07-12,904,1654,-750,-45.34,1612
2021-07-13,887,1659,-772,-46.53,1612
2021-07-14,887,1659,-772,-46.53,1612
2021-07-15,887,1660,-773,-46.57,1612
2021-07-16,885,1610,-725,-45.03,1612
2021-07-17,387,1235,-848,-68.66,1612
2021-07-18,301,1137,-836,-73.53,1612
2021-07-19,904,1661,-757,-45.57,1612
2021-07-20,887,1665,-778,-46.73,1612
2021-07-21,887,1665,-778,-46.73,1612
2021-07-22,887,1665,-778,-46.73,1612
2021-07-23,885,1614,-729,-45.17,1612
2021-07-24,387,1239,-852,-68.77,1612
2021-07-25,301,1140,-839,-73.6,1612
2021-07-26,904,1663,-759,-45.64,1612
2021-07-27,887,1666,-779,-46.76,1612
2021-07-28,887,1664,-777,-46.69,1612
2021-07-29,887,1664,-777,-46.69,1612
2021-07-30,885,1612,-727,-45.1,1612
2021-07-31,387,1235,-848,-68.66,1612
2021-08-01,298,1134,-836,-73.72,1612
2021-08-02,825,1656,-831,-50.18,1612
2021-08-03,880,1658,-778,-46.92,1612
2021-08-04,880,1655,-775,-46.83,1612
2021-08-05,880,1654,-774,-46.8,1612
2021-08-06,817,1601,-784,-48.97,1612
2021-08-07,410,1223,-813,-66.48,1612
2021-08-08,298,1122,-824,-73.44,1612
2021-08-09,825,1644,-819,-49.82,1612
2021-08-10,880,1646,-766,-46.54,1612
2021-08-11,880,1644,-764,-46.47,1612
2021-08-12,880,1644,-764,-46.47,1612
2021-08-13,817,1592,-775,-48.68,1612
2021-08-14,410,1217,-807,-66.31,1612
2021-08-15,298,1118,-820,-73.35,1612
2021-08-16,825,1642,-817,-49.76,1612
2021-08-17,880,1647,-767,-46.57,1612
2021-08-18,880,1649,-769,-46.63,1612
2021-08-19,880,1652,-772,-46.73,1612
2021-08-20,817,1604,-787,-49.06,1612
2021-08-21,410,1233,-823,-66.75,1612
2021-08-22,298,1138,-840,-73.81,1612
2021-08-23,825,1666,-841,-50.48,1612
2021-08-24,880,1676,-796,-47.49,1612
2021-08-25,880,1681,-801,-47.65,1612
2021-08-26,880,1688,-808,-47.87,1612
2021-08-27,817,1644,-827,-50.3,1612
2021-08-28,410,1276,-866,-67.87,1612
2021-08-29,298,1184,-886,-74.83,1612
2021-08-30,825,1715,-890,-51.9,1612
2021-08-31,880,1726,-846,-49.02,1612
2021-09-01,971,1733,-762,-43.97,1612
2021-09-02,971,1741,-770,-44.23,1612
2021-09-03,923,1697,-774,-45.61,1612
2021-09-04,439,1329,-890,-66.97,1612
2021-09-05,326,1237,-911,-73.65,1612
2021-09-06,960,1767,-807,-45.67,1612
2021-09-07,971,1777,-806,-45.36,1612
2021-09-08,971,1782,-811,-45.51,1612
2021-09-09,971,1787,-816,-45.66,1612
2021-09-10,923,1741,-818,-46.98,1612
2021-09-11,439,1369,-930,-67.93,1612
2021-09-12,326,1274,-948,-74.41,1612
2021-09-13,960,1800,-840,-46.67,1612
2021-09-14,971,1806,-835,-46.23,1612
2021-09-15,971,1808,-837,-46.29,1612
2021-09-16,971,1810,-839,-46.35,1612
2021-09-17,923,1760,-837,-47.56,1612
2021-09-18,439,1385,-946,-68.3,1612
2021-09-19,326,1287,-961,-74.67,1612
2021-09-20,960,1810,-850,-46.96,1612
2021-09-21,971,1814,-843,-46.47,1612
2021-09-22,971,1813,-842,-46.44,1612
2021-09-23,971,1813,-842,-46.44,1612
2021-09-24,923,1762,-839,-47.62,1612
2021-09-25,439,1386,-947,-68.33,1612
2021-09-26,326,1286,-960,-74.65,1612
2021-09-27,960,1810,-850,-46.96,1612
2021-09-28,971,1813,-842,-46.44,1612
2021-09-29,971,1813,-842,-46.44,1612
2021-09-30,971,1813,-842,-46.44,1612
2021-10-01,956,1763,-807,-45.77,1612
2021-10-02,485,1388,-903,-65.06,1612
2021-10-03,325,1290,-965,-74.81,1612
2021-10-04,964,1814,-850,-46.86,1612
2021-10-05,989,1819,-830,-45.63,1612
2021-10-06,989,1819,-830,-45.63,1612
2021-10-07,989,1821,-832,-45.69,1612
2021-10-08,956,1771,-815,-46.02,1612
2021-10-09,485,1398,-913,-65.31,1612
2021-10-10,325,1300,-975,-75.0,1612
2021-10-11,964,1825,-861,-47.18,1612
2021-10-12,989,1830,-841,-45.96,1612
2021-10-13,989,1831,-842,-45.99,1612
2021-10-14,989,1834,-845,-46.07,1612
2021-10-15,956,1784,-828,-46.41,1612
2021-10-16,485,1410,-925,-65.6,1612
2021-10-17,325,1312,-987,-75.23,1612
2021-10-18,964,1837,-873,-47.52,1612
2021-10-19,989,1841,-852,-46.28,1612
2021-10-20,989,1842,-853,-46.31,1612
2021-10-21,989,1844,-855,-46.37,1612
2021-10-22,956,1793,-837,-46.68,1612
2021-10-23,485,1419,-934,-65.82,1612
2021-10-24,325,1321,-996,-75.4,1612
2021-10-25,964,1845,-881,-47.75,1612
2021-10-26,989,1849,-860,-46.51,1612
2021-10-27,989,1850,-861,-46.54,1612
2021-10-28,989,1851,-862,-46.57,1612
2021-10-29,956,1801,-845,-46.92,1612
2021-10-30,485,1427,-942,-66.01,1612
2021-10-31,325,1329,-1004,-75.55,1612
2021-11-01,965,1854,-889,-47.95,1612
2021-11-02,1003,1859,-856,-46.05,1612
2021-11-03,1003,1860,-857,-46.08,1612
2021-11-04,1003,1862,-859,-46.13,1612
2021-11-05,884,1813,-929,-51.24,1612
2021-11-06,485,1439,-954,-66.3,1612
2021-11-07,320,1342,-1022,-76.15,1612
2021-11-08,965,1867,-902,-48.31,1612
2021-11-09,1003,1872,-869,-46.42,1612
2021-11-10,1003,1874,-871,-46.48,1612
2021-11-11,1003,1876,-873,-46.54,1612
2021-11-12,884,1826,-942,-51.59,1612
2021-11-13,485,1452,-967,-66.6,1612
2021-11-14,320,1354,-1034,-76.37,1612
2021-11-15,965,1879,-914,-48.64,1612
2021-11-16,1003,1883,-880,-46.73,1612
2021-11-17,1003,1883,-880,-46.73,1612
2021-11-18,1003,1884,-881,-46.76,1612
2021-11-19,884,1832,-948,-51.75,1612
2021-11-20,485,1457,-972,-66.71,1612
2021-11-21,320,1357,-1037,-76.42,1612
2021-11-22,965,1879,-914,-48.64,1612
2021-11-23,1003,1881,-878,-46.68,1612
2021-11-24,1003,1879,-876,-46.62,1612
2021-11-25,1003,1878,-875,-46.59,1612
2021-11-26,884,1825,-941,-51.56,1612
2021-11-27,485,1447,-962,-66.48,1612
2021-11-28,320,1346,-1026,-76.23,1612
2021-11-29,965,1867,-902,-48.31,1612
2021-11-30,1003,1868,-865,-46.31,1612
2021-12-01,796,1866,-1070,-57.34,1612
2021-12-02,796,1864,-1068,-57.3,1612
2021-12-03,711,1811,-1100,-60.74,1612
2021-12-04,446,1433,-987,-68.88,1612
2021-12-05,290,1332,-1042,-78.23,1612
2021-12-06,860,1854,-994,-53.61,1612
2021-12-07,796,1856,-1060,-57.11,1612
2021-12-08,796,1855,-1059,-57.09,1612
2021-12-09,796,1854,-1058,-57.07,1612
2021-12-10,711,1803,-1092,-60.57,1612
2021-12-11,446,1427,-981,-68.75,1612
2021-12-12,290,1328,-1038,-78.16,1612
2021-12-13,860,1851,-991,-53.54,1612
2021-12-14,796,1855,-1059,-57.09,1612
2021-12-15,796,1855,-1059,-57.09,1612
2021-12-16,796,1856,-1060,-57.11,1612
2021-12-17,711,1805,-1094,-60.61,1612
2021-12-18,446,1431,-985,-68.83,1612
2021-12-19,290,1332,-1042,-78.23,1612
2021-12-20,860,1856,-996,-53.66,1612
2021-12-21,796,1860,-1064,-57.2,1612
2021-12-22,796,1860,-1064,-57.2,1612
2021-12-23,796,1860,-1064,-57.2,1612
2021-12-24,711,1809,-1098,-60.7,1612
2021-12-25,446,1433,-987,-68.88,1612
2021-12-26,290,1333,-1043,-78.24,1612
2021-12-27,860,1856,-996,-53.66,1612
2021-12-28,796,1858,-1062,-57.16,1612
2021-12-29,796,1856,-1060,-57.11,1612
2021-12-30,796,1855,-1059,-57.09,1612
2021-12-31,711,1802,-1091,-60.54,1612
2022-01-01,409,1424,-1015,-71.28,1612
2022-01-02,282,1323,-1041,-78.68,1612
2022-01-03,804,1844,-1040,-56.4,1612
2022-01-04,836,1845,-1009,-54.69,1612
2022-01-05,836,1842,-1006,-54.61,1612
2022-01-06,836,1840,-1004,-54.57,1612
2022-01-07,772,1786,-1014,-56.77,1612
2022-01-08,409,1409,-1000,-70.97,1612
2022-01-09,282,1308,-1026,-78.44,1612
2022-01-10,804,1829,-1025,-56.04,1612
2022-01-11,836,1832,-996,-54.37,1612
2022-01-12,836,1830,-994,-54.32,1612
2022-01-13,836,1830,-994,-54.32,1612
2022-01-14,772,1779,-1007,-56.6,1612
2022-01-15,409,1404,-995,-70.87,1612
2022-01-16,282,1306,-1024,-78.41,1612
2022-01-17,804,1830,-1026,-56.07,1612
2022-01-18,836,1836,-1000,-54.47,1612
2022-01-19,836,1837,-1001,-54.49,1612
2022-01-20,836,1841,-1005,-54.59,1612
2022-01-21,772,1792,-1020,-56.92,1612
2022-01-22,409,1420,-1011,-71.2,1612
2022-01-23,282,1325,-1043,-78.72,1612
2022-01-24,804,1853,-1049,-56.61,1612
2022-01-25,836,1860,-1024,-55.05,1612
2022-01-26,836,1864,-1028,-55.15,1612
2022-01-27,836,1869,-1033,-55.27,1612
2022-01-28,772,1822,-1050,-57.63,1612
2022-01-29,409,1451,-1042,-71.81,1612
2022-01-30,282,1356,-1074,-79.2,1612
2020-02-01,794,529,265,50.09,1191
2020-02-02,450,146,304,208.22,1191
2020-02-03,1910,1839,71,3.86,1191
2020-02-04,1892,1866,26,1.39,1191
2020-02-05,1892,1871,21,1.12,1191
2020-02-06,1892,1874,18,0.96,1191
2020-02-07,1691,1648,43,2.61,1191
2020-02-08,794,551,243,44.1,1191
2020-02-09,450,164,286,174.39,1191
2020-02-10,1910,1854,56,3.02,1191
2020-02-11,1892,1879,13,0.69,1191
2020-02-12,1892,1883,9,0.48,1191
2020-02-13,1892,1885,7,0.37,1191
2020-02-14,1691,1660,31,1.87,1191
2020-02-15,794,565,229,40.53,1191
2020-02-16,450,181,269,148.62,1191
2020-02-17,1910,1874,36,1.92,1191
2020-02-18,1892,1904,-12,-0.63,1191
2020-02-19,1892,1913,-21,-1.1,1191
2020-02-20,1892,1922,-30,-1.56,1191
2020-02-21,1691,1702,-11,-0.65,1191
2020-02-22,794,614,180,29.32,1191
2020-02-23,450,237,213,89.87,1191
2020-02-24,1910,1937,-27,-1.39,1191
2020-02-25,1892,1974,-82,-4.15,1191
2020-02-26,1892,1989,-97,-4.88,1191
2020-02-27,1892,2003,-111,-5.54,1191
2020-02-28,1691,1788,-97,-5.43,1191
2020-02-29,794,703,91,12.94,1191
2020-03-01,314,329,-15,-4.56,1191
2020-03-02,1659,2030,-371,-18.28,1191
2020-03-03,1643,2067,-424,-20.51,1191
2020-03-04,1643,2081,-438,-21.05,1191
2020-03-05,1643,2093,-450,-21.5,1191
2020-03-06,1464,1875,-411,-21.92,1191
2020-03-07,594,786,-192,-24.43,1191
2020-03-08,314,406,-92,-22.66,1191
2020-03-09,1659,2102,-443,-21.08,1191
2020-03-10,1643,2133,-490,-22.97,1191
2020-03-11,1643,2140,-497,-23.22,1191
2020-03-12,1643,2145,-502,-23.4,1191
2020-03-13,1464,1920,-456,-23.75,1191
2020-03-14,594,825,-231,-28.0,1191
2020-03-15,314,439,-125,-28.47,1191
2020-03-16,1659,2129,-470,-22.08,1191
2020-03-17,1643,2154,-511,-23.72,1191
2020-03-18,1643,2158,-515,-23.86,1191
2020-03-19,1643,2159,-516,-23.9,1191
2020-03-20,1464,1932,-468,-24.22,1191
2020-03-21,594,836,-242,-28.95,1191
2020-03-22,314,450,-136,-30.22,1191
2020-03-23,1659,2140,-481,-22.48,1191
2020-03-24,1643,2167,-524,-24.18,1191
2020-03-25,1643,2173,-530,-24.39,1191
2020-03-26,1643,2179,-536,-24.6,1191
2020-03-27,1464,1956,-492,-25.15,1191
2020-03-28,594,864,-270,-31.25,1191
2020-03-29,314,483,-169,-34.99,1191
2020-03-30,1659,2179,-520,-23.86,1191
2020-03-31,1643,2212,-569,-25.72,1191
2020-04-01,1726,2223,-497,-22.36,1191
2020-04-02,1726,2234,-508,-22.74,1191
2020-04-03,1405,2015,-610,-30.27,1191
2020-04-04,510,928,-418,-45.04,1191
2020-04-05,189,550,-361,-65.64,1191
2020-04-06,1808,2248,-440,-19.57,1191
2020-04-07,1726,2282,-556,-24.36,1191
2020-04-08,1726,2294,-568,-24.76,1191
2020-04-09,1726,2303,-577,-25.05,1191
2020-04-10,1405,2083,-678,-32.55,1191
2020-04-11,510,993,-483,-48.64,1191
2020-04-12,189,611,-422,-69.07,1191
2020-04-13,1808,2305,-497,-21.56,1191
2020-04-14,1726,2333,-607,-26.02,1191
2020-04-15,1726,2339,-613,-26.21,1191
2020-04-16,1726,2342,-616,-26.3,1191
2020-04-17,1405,2115,-710,-33.57,1191
2020-04-18,510,1017,-507,-49.85,1191
2020-04-19,189,628,-439,-69.9,1191
2020-04-20,1808,2315,-507,-21.9,1191
2020-04-21,1726,2337,-611,-26.14,1191
2020-04-22,1726,2337,-611,-26.14,1191
2020-04-23,1726,2334,-608,-26.05,1191
2020-04-24,1405,2103,-698,-33.19,1191
2020-04-25,510,1001,-491,-49.05,1191
2020-04-26,189,610,-421,-69.02,1191
2020-04-27,1808,2295,-487,-21.22,1191
2020-04-28,1726,2315,-589,-25.44,1191
2020-04-29,1726,2315,-589,-25.44,1191
2020-04-30,1726,2313,-587,-25.38,1191
2020-05-01,1896,2083,-187,-8.98,1191
2020-05-02,768,984,-216,-21.95,1191
2020-05-03,343,595,-252,-42.35,1191
2020-05-04,2097,2283,-186,-8.15,1191
2020-05-05,2106,2308,-202,-8.75,1191
2020-05-06,2106,2311,-205,-8.87,1191
2020-05-07,2106,2313,-207,-8.95,1191
2020-05-08,1896,2087,-191,-9.15,1191
2020-05-09,768,992,-224,-22.58,1191
2020-05-10,343,606,-263,-43.4,1191
2020-05-11,2097,2298,-201,-8.75,1191
2020-05-12,2106,2324,-218,-9.38,1191
2020-05-13,2106,2329,-223,-9.57,1191
2020-05-14,2106,2333,-227,-9.73,1191
2020-05-15,1896,2107,-211,-10.01,1191
2020-05-16,768,1012,-244,-24.11,1191
2020-05-17,343,625,-282,-45.12,1191
2020-05-18,2097,2315,-218,-9.42,1191
2020-05-19,2106,2340,-234,-10.0,1191
2020-05-20,2106,2343,-237,-10.12,1191
2020-05-21,2106,2344,-238,-10.15,1191
2020-05-22,1896,2115,-219,-10.35,1191
2020-05-23,768,1016,-248,-24.41,1191
2020-05-24,343,626,-283,-45.21,1191
2020-05-25,2097,2313,-216,-9.34,1191
2020-05-26,2106,2334,-228,-9.77,1191
2020-05-27,2106,2334,-228,-9.77,1191
2020-05-28,2106,2333,-227,-9.73,1191
2020-05-29,1896,2102,-206,-9.8,1191
2020-05-30,768,1002,-234,-23.35,1191
2020-05-31,343,612,-269,-43.95,1191
2020-06-01,2221,2298,-77,-3.35,1191
2020-06-02,2210,2321,-111,-4.78,1191
2020-06-03,2210,2322,-112,-4.82,1191
2020-06-04,2210,2322,-112,-4.82,1191
2020-06-05,1894,2094,-200,-9.55,1191
2020-06-06,827,996,-169,-16.97,1191
2020-06-07,428,609,-181,-29.72,1191
2020-06-08,2221,2298,-77,-3.35,1191
2020-06-09,2210,2324,-114,-4.91,1191
2020-06-10,2210,2328,-118,-5.07,1191
2020-06-11,2210,2330,-120,-5.15,1191
2020-06-12,1894,2104,-210,-9.98,1191
2020-06-13,827,1008,-181,-17.96,1191
2020-06-14,428,621,-193,-31.08,1191
2020-06-15,2221,2311,-90,-3.89,1191
2020-06-16,2210,2336,-126,-5.39,1191
2020-06-17,2210,2338,-128,-5.47,1191
2020-06-18,2210,2338,-128,-5.47,1191
2020-06-19,1894,2109,-215,-10.19,1191
2020-06-20,827,1008,-181,-17.96,1191
2020-06-21,428,617,-189,-30.63,1191
2020-06-22,2221,2300,-79,-3.43,1191
2020-06-23,2210,2319,-109,-4.7,1191
2020-06-24,2210,2314,-104,-4.49,1191
2020-06-25,2210,2307,-97,-4.2,1191
2020-06-26,1894,2070,-176,-8.5,1191
2020-06-27,827,962,-135,-14.03,1191
2020-06-28,428,564,-136,-24.11,1191
2020-06-29,2221,2241,-20,-0.89,1191
2020-06-30,2210,2253,-43,-1.91,1191
2020-07-01,2180,2243,-63,-2.81,1191
2020-07-02,2180,2231,-51,-2.29,1191
2020-07-03,1934,1990,-56,-2.81,1191
2020-07-04,838,880,-42,-4.77,1191
2020-07-05,448,480,-32,-6.67,1191
2020-07-06,2176,2157,19,0.88,1191
2020-07-07,2180,2170,10,0.46,1191
2020-07-08,2180,2163,17,0.79,1191
2020-07-09,2180,2155,25,1.16,1191
2020-07-10,1934,1919,15,0.78,1191
2020-07-11,838,815,23,2.82,1191
2020-07-12,448,421,27,6.41,1191
2020-07-13,2176,2106,70,3.32,1191
2020-07-14,2180,2127,53,2.49,1191
2020-07-15,2180,2128,52,2.44,1191
2020-07-16,2180,2128,52,2.44,1191
2020-07-17,1934,1901,33,1.74,1191
2020-07-18,838,804,34,4.23,1191
2020-07-19,448,418,30,7.18,1191
2020-07-20,2176,2110,66,3.13,1191
2020-07-21,2180,2137,43,2.01,1191
2020-07-22,2180,2143,37,1.73,1191
2020-07-23,2180,2147,33,1.54,1191
2020-07-24,1934,1922,12,0.62,1191
2020-07-25,838,827,11,1.33,1191
2020-07-26,448,442,6,1.36,1191
2020-07-27,2176,2132,44,2.06,1191
2020-07-28,2180,2157,23,1.07,1191
2020-07-29,2180,2159,21,0.97,1191
2020-07-30,2180,2159,21,0.97,1191
2020-07-31,1934,1929,5,0.26,1191
2020-08-01,835,829,6,0.72,1191
2020-08-02,476,437,39,8.92,1191
2020-08-03,2069,2120,-51,-2.41,1191
2020-08-04,2031,2139,-108,-5.05,1191
2020-08-05,2031,2134,-103,-4.83,1191
2020-08-06,2031,2128,-97,-4.56,1191
2020-08-07,1852,1893,-41,-2.17,1191
2020-08-08,835,787,48,6.1,1191
2020-08-09,476,392,84,21.43,1191
2020-08-10,2069,2073,-4,-0.19,1191
2020-08-11,2031,2090,-59,-2.82,1191
2020-08-12,2031,2085,-54,-2.59,1191
2020-08-13,2031,2081,-50,-2.4,1191
2020-08-14,1852,1848,4,0.22,1191
2020-08-15,835,747,88,11.78,1191
2020-08-16,476,356,120,33.71,1191
2020-08-17,2069,2044,25,1.22,1191
2020-08-18,2031,2069,-38,-1.84,1191
2020-08-19,2031,2073,-42,-2.03,1191
2020-08-20,2031,2078,-47,-2.26,1191
2020-08-21,1852,1855,-3,-0.16,1191
2020-08-22,835,764,71,9.29,1191
2020-08-23,476,384,92,23.96,1191
2020-08-24,2069,2082,-13,-0.62,1191
2020-08-25,2031,2117,-86,-4.06,1191
2020-08-26,2031,2130,-99,-4.65,1191
2020-08-27,2031,2143,-112,-5.23,1191
2020-08-28,1852,1928,-76,-3.94,1191
2020-08-29,835,843,-8,-0.95,1191
2020-08-30,476,468,8,1.71,1191
2020-08-31,2069,2169,-100,-4.61,1191
2020-09-01,2166,2206,-40,-1.81,1191
2020-09-02,2166,2220,-54,-2.43,1191
2020-09-03,2166,2232,-66,-2.96,1191
2020-09-04,1918,2014,-96,-4.77,1191
2020-09-05,886,925,-39,-4.22,1191
2020-09-06,512,546,-34,-6.23,1191
2020-09-07,2102,2241,-139,-6.2,1191
2020-09-08,2166,2271,-105,-4.62,1191
2020-09-09,2166,2277,-111,-4.87,1191
2020-09-10,2166,2281,-115,-5.04,1191
2020-09-11,1918,2055,-137,-6.67,1191
2020-09-12,886,958,-72,-7.52,1191
2020-09-13,512,570,-58,-10.18,1191
2020-09-14,2102,2257,-155,-6.87,1191
2020-09-15,2166,2279,-113,-4.96,1191
2020-09-16,2166,2279,-113,-4.96,1191
2020-09-17,2166,2277,-111,-4.87,1191
2020-09-18,1918,2045,-127,-6.21,1191
2020-09-19,886,944,-58,-6.14,1191
2020-09-20,512,552,-40,-7.25,1191
2020-09-21,2102,2237,-135,-6.03,1191
2020-09-22,2166,2258,-92,-4.07,1191
2020-09-23,2166,2258,-92,-4.07,1191
2020-09-24,2166,2257,-91,-4.03,1191
2020-09-25,1918,2027,-109,-5.38,1191
2020-09-26,886,928,-42,-4.53,1191
2020-09-27,512,540,-28,-5.19,1191
2020-09-28,2102,2229,-127,-5.7,1191
2020-09-29,2166,2254,-88,-3.9,1191
2020-09-30,2166,2257,-91,-4.03,1191
2020-10-01,2129,2260,-131,-5.8,1191
2020-10-02,1880,2034,-154,-7.57,1191
2020-10-03,865,938,-73,-7.78,1191
2020-10-04,423,553,-130,-23.51,1191
2020-10-05,2154,2244,-90,-4.01,1191
2020-10-06,2129,2270,-141,-6.21,1191
2020-10-07,2129,2274,-145,-6.38,1191
2020-10-08,2129,2277,-148,-6.5,1191
2020-10-09,1880,2050,-170,-8.29,1191
2020-10-10,865,953,-88,-9.23,1191
2020-10-11,423,565,-142,-25.13,1191
2020-10-12,2154,2252,-98,-4.35,1191
2020-10-13,2129,2275,-146,-6.42,1191
2020-10-14,2129,2275,-146,-6.42,1191
2020-10-15,2129,2273,-144,-6.34,1191
2020-10-16,1880,2042,-162,-7.93,1191
2020-10-17,865,940,-75,-7.98,1191
2020-10-18,423,547,-124,-22.67,1191
2020-10-19,2154,2230,-76,-3.41,1191
2020-10-20,2129,2249,-120,-5.34,1191
2020-10-21,2129,2246,-117,-5.21,1191
2020-10-22,2129,2241,-112,-5.0,1191
2020-10-23,1880,2007,-127,-6.33,1191
2020-10-24,865,904,-39,-4.31,1191
2020-10-25,423,510,-87,-17.06,1191
2020-10-26,2154,2194,-40,-1.82,1191
2020-10-27,2129,2214,-85,-3.84,1191
2020-10-28,2129,2212,-83,-3.75,1191
2020-10-29,2129,2210,-81,-3.67,1191
2020-10-30,1880,1979,-99,-5.0,1191
2020-10-31,865,879,-14,-1.59,1191
2020-11-01,357,490,-133,-27.14,1191
2020-11-02,2033,2177,-144,-6.61,1191
2020-11-03,2047,2201,-154,-7.0,1191
2020-11-04,2047,2203,-156,-7.08,1191
2020-11-05,2047,2205,-158,-7.17,1191
2020-11-06,1801,1977,-176,-8.9,1191
2020-11-07,745,880,-135,-15.34,1191
2020-11-08,357,493,-136,-27.59,1191
2020-11-09,2033,2182,-149,-6.83,1191
2020-11-10,2047,2207,-160,-7.25,1191
2020-11-11,2047,2209,-162,-7.33,1191
2020-11-12,2047,2209,-162,-7.33,1191
2020-11-13,1801,1979,-178,-8.99,1191
2020-11-14,745,879,-134,-15.24,1191
2020-11-15,357,488,-131,-26.84,1191
2020-11-16,2033,2172,-139,-6.4,1191
2020-11-17,2047,2191,-144,-6.57,1191
2020-11-18,2047,2187,-140,-6.4,1191
2020-11-19,2047,2181,-134,-6.14,1191
2020-11-20,1801,1944,-143,-7.36,1191
2020-11-21,745,837,-92,-10.99,1191
2020-11-22,357,439,-82,-18.68,1191
2020-11-23,2033,2117,-84,-3.97,1191
2020-11-24,2047,2130,-83,-3.9,1191
2020-11-25,2047,2121,-74,-3.49,1191
2020-11-26,2047,2111,-64,-3.03,1191
2020-11-27,1801,1871,-70,-3.74,1191
2020-11-28,745,761,-16,-2.1,1191
2020-11-29,357,362,-5,-1.38,1191
2020-11-30,2033,2039,-6,-0.29,1191
2020-12-01,1667,2052,-385,-18.76,1191
2020-12-02,1667,2045,-378,-18.48,1191
2020-12-03,1667,2037,-370,-18.16,1191
2020-12-04,1955,1800,155,8.61,1191
2020-12-05,833,695,138,19.86,1191
2020-12-06,354,300,54,18.0,1191
2020-12-07,1715,1983,-268,-13.51,1191
2020-12-08,1667,2002,-335,-16.73,1191
2020-12-09,1667,2000,-333,-16.65,1191
2020-12-10,1667,1998,-331,-16.57,1191
2020-12-11,1955,1767,188,10.64,1191
2020-12-12,833,666,167,25.08,1191
2020-12-13,354,276,78,28.26,1191
2020-12-14,1715,1962,-247,-12.59,1191
2020-12-15,1667,1984,-317,-15.98,1191
2020-12-16,1667,1983,-316,-15.94,1191
2020-12-17,1667,1981,-314,-15.85,1191
2020-12-18,1955,1749,206,11.78,1191
2020-12-19,833,646,187,28.95,1191
2020-12-20,354,252,102,40.48,1191
2020-12-21,1715,1934,-219,-11.32,1191
2020-12-22,1667,1950,-283,-14.51,1191
2020-12-23,1667,1943,-276,-14.2,1191
2020-12-24,1667,1933,-266,-13.76,1191
2020-12-25,1955,1693,262,15.48,1191
2020-12-26,833,582,251,43.13,1191
2020-12-27,354,180,174,96.67,1191
2020-12-28,1715,1854,-139,-7.5,1191
2020-12-29,1667,1862,-195,-10.47,1191
2020-12-30,1667,1847,-180,-9.75,1191
2020-12-31,1667,1831,-164,-8.96,1191
2021-01-01,1393,1585,-192,-12.11,1191
2021-01-02,559,470,89,18.94,1191
2021-01-03,278,64,214,334.38,1191
2021-01-04,1464,1736,-272,-15.67,1191
2021-01-05,1601,1744,-143,-8.2,1191
2021-01-06,1601,1730,-129,-7.46,1191
2021-01-07,1601,1717,-116,-6.76,1191
2021-01-08,1393,1476,-83,-5.62,1191
2021-01-09,559,366,193,52.73,1191
2021-01-10,278,51,227,445.1,1191
2021-01-11,1464,1648,-184,-11.17,1191
2021-01-12,1601,1665,-64,-3.84,1191
2021-01-13,1601,1663,-62,-3.73,1191
2021-01-14,1601,1661,-60,-3.61,1191
2021-01-15,1393,1431,-38,-2.66,1191
2021-01-16,559,334,225,67.37,1191
2021-01-17,278,44,234,531.82,1191
2021-01-18,1464,1640,-176,-10.73,1191
2021-01-19,1601,1669,-68,-4.07,1191
2021-01-20,1601,1677,-76,-4.53,1191
2021-01-21,1601,1685,-84,-4.99,1191
2021-01-22,1393,1465,-72,-4.91,1191
2021-01-23,559,375,184,49.07,1191
2021-01-24,278,71,207,291.55,1191
2021-01-25,1464,1693,-229,-13.53,1191
2021-01-26,1601,1725,-124,-7.19,1191
2021-01-27,1601,1736,-135,-7.78,1191
2021-01-28,1601,1745,-144,-8.25,1191
2021-01-29,1393,1524,-131,-8.6,1191
2021-01-30,559,432,127,29.4,1191
2021-01-31,278,50,228,456.0,1191
2021-02-01,1746,1744,2,0.11,1191
2021-02-02,1794,1772,22,1.24,1191
2021-02-03,1794,1778,16,0.9,1191
2021-02-04,1794,1782,12,0.67,1191
2021-02-05,1563,1556,7,0.45,1191
2021-02-06,704,460,244,53.04,1191
2021-02-07,334,73,261,357.53,1191
2021-02-08,1746,1763,-17,-0.96,1191
2021-02-09,1794,1788,6,0.34,1191
2021-02-10,1794,1791,3,0.17,1191
2021-02-11,1794,1794,0,0.0,1191
2021-02-12,1563,1567,-4,-0.26,1191
2021-02-13,704,471,233,49.47,1191
2021-02-14,334,86,248,288.37,1191
2021-02-15,1746,1779,-33,-1.85,1191
2021-02-16,1794,1807,-13,-0.72,1191
2021-02-17,1794,1815,-21,-1.16,1191
2021-02-18,1794,1823,-29,-1.59,1191
2021-02-19,1563,1602,-39,-2.43,1191
2021-02-20,704,513,191,37.23,1191
2021-02-21,334,134,200,149.25,1191
2021-02-22,1746,1833,-87,-4.75,1191
2021-02-23,1794,1869,-75,-4.01,1191
2021-02-24,1794,1883,-89,-4.73,1191
2021-02-25,1794,1897,-103,-5.43,1191
2021-02-26,1563,1682,-119,-7.07,1191
2021-02-27,704,597,107,17.92,1191
2021-02-28,334,222,112,50.45,1191
2021-03-01,2041,1924,117,6.08,1191
2021-03-02,2055,1961,94,4.79,1191
2021-03-03,2055,1976,79,4.0,1191
2021-03-04,2055,1989,66,3.32,1191
2021-03-05,1820,1772,48,2.71,1191
2021-03-06,970,685,285,41.61,1191
2021-03-07,374,306,68,22.22,1191
2021-03-08,2041,2003,38,1.9,1191
2021-03-09,2055,2035,20,0.98,1191
2021-03-10,2055,2044,11,0.54,1191
2021-03-11,2055,2050,5,0.24,1191
2021-03-12,1820,1826,-6,-0.33,1191
2021-03-13,970,732,238,32.51,1191
2021-03-14,374,347,27,7.78,1191
2021-03-15,2041,2038,3,0.15,1191
2021-03-16,2055,2063,-8,-0.39,1191
2021-03-17,2055,2067,-12,-0.58,1191
2021-03-18,2055,2069,-14,-0.68,1191
2021-03-19,1820,1841,-21,-1.14,1191
2021-03-20,970,745,225,30.2,1191
2021-03-21,374,358,16,4.47,1191
2021-03-22,2041,2048,-7,-0.34,1191
2021-03-23,2055,2074,-19,-0.92,1191
2021-03-24,2055,2079,-24,-1.15,1191
2021-03-25,2055,2084,-29,-1.39,1191
2021-03-26,1820,1860,-40,-2.15,1191
2021-03-27,970,767,203,26.47,1191
2021-03-28,374,385,-11,-2.86,1191
2021-03-29,2041,2080,-39,-1.88,1191
2021-03-30,2055,2112,-57,-2.7,1191
2021-03-31,2055,2122,-67,-3.16,1191
2021-04-01,2056,2132,-76,-3.56,1191
2021-04-02,1853,1914,-61,-3.19,1191
2021-04-03,761,825,-64,-7.76,1191
2021-04-04,319,447,-128,-28.64,1191
2021-04-05,2046,2146,-100,-4.66,1191
2021-04-06,2056,2180,-124,-5.69,1191
2021-04-07,2056,2192,-136,-6.2,1191
2021-04-08,2056,2203,-147,-6.67,1191
2021-04-09,1853,1983,-130,-6.56,1191
2021-04-10,761,894,-133,-14.88,1191
2021-04-11,319,513,-194,-37.82,1191
2021-04-12,2046,2208,-162,-7.34,1191
2021-04-13,2056,2238,-182,-8.13,1191
2021-04-14,2056,2245,-189,-8.42,1191
2021-04-15,2056,2249,-193,-8.58,1191
2021-04-16,1853,2024,-171,-8.45,1191
2021-04-17,761,927,-166,-17.91,1191
2021-04-18,319,540,-221,-40.93,1191
2021-04-19,2046,2228,-182,-8.17,1191
2021-04-20,2056,2250,-194,-8.62,1191
2021-04-21,2056,2250,-194,-8.62,1191
2021-04-22,2056,2249,-193,-8.58,1191
2021-04-23,1853,2018,-165,-8.18,1191
2021-04-24,761,916,-155,-16.92,1191
2021-04-25,319,525,-206,-39.24,1191
2021-04-26,2046,2209,-163,-7.38,1191
2021-04-27,2056,2230,-174,-7.8,1191
2021-04-28,2056,2229,-173,-7.76,1191
2021-04-29,2056,2227,-171,-7.68,1191
2021-04-30,1853,1996,-143,-7.16,1191
2021-05-01,852,896,-44,-4.91,1191
2021-05-02,458,506,-48,-9.49,1191
2021-05-03,2086,2194,-108,-4.92,1191
2021-05-04,2172,2218,-46,-2.07,1191
2021-05-05,2172,2220,-48,-2.16,1191
2021-05-06,2172,2222,-50,-2.25,1191
2021-05-07,1886,1995,-109,-5.46,1191
2021-05-08,852,899,-47,-5.23,1191
2021-05-09,458,513,-55,-10.72,1191
2021-05-10,2086,2204,-118,-5.35,1191
2021-05-11,2172,2231,-59,-2.64,1191
2021-05-12,2172,2236,-64,-2.86,1191
2021-05-13,2172,2240,-68,-3.04,1191
2021-05-14,1886,2015,-129,-6.4,1191
2021-05-15,852,919,-67,-7.29,1191
2021-05-16,458,534,-76,-14.23,1191
2021-05-17,2086,2224,-138,-6.21,1191
2021-05-18,2172,2249,-77,-3.42,1191
2021-05-19,2172,2253,-81,-3.6,1191
2021-05-20,2172,2254,-82,-3.64,1191
2021-05-21,1886,2026,-140,-6.91,1191
2021-05-22,852,927,-75,-8.09,1191
2021-05-23,458,538,-80,-14.87,1191
2021-05-24,2086,2225,-139,-6.25,1191
2021-05-25,2172,2248,-76,-3.38,1191
2021-05-26,2172,2248,-76,-3.38,1191
2021-05-27,2172,2246,-74,-3.29,1191
2021-05-28,1886,2016,-130,-6.45,1191
2021-05-29,852,915,-63,-6.89,1191
2021-05-30,458,525,-67,-12.76,1191
2021-05-31,2086,2211,-125,-5.65,1191
2021-06-01,2220,2233,-13,-0.58,1191
2021-06-02,2220,2234,-14,-0.63,1191
2021-06-03,2220,2234,-14,-0.63,1191
2021-06-04,1916,2005,-89,-4.44,1191
2021-06-05,885,906,-21,-2.32,1191
2021-06-06,506,519,-13,-2.5,1191
2021-06-07,2246,2208,38,1.72,1191
2021-06-08,2220,2233,-13,-0.58,1191
2021-06-09,2220,2236,-16,-0.72,1191
2021-06-10,2220,2239,-19,-0.85,1191
2021-06-11,1916,2012,-96,-4.77,1191
2021-06-12,885,916,-31,-3.38,1191
2021-06-13,506,530,-24,-4.53,1191
2021-06-14,2246,2220,26,1.17,1191
2021-06-15,2220,2245,-25,-1.11,1191
2021-06-16,2220,2248,-28,-1.25,1191
2021-06-17,2220,2250,-30,-1.33,1191
2021-06-18,1916,2021,-105,-5.2,1191
2021-06-19,885,922,-37,-4.01,1191
2021-06-20,506,531,-25,-4.71,1191
2021-06-21,2246,2217,29,1.31,1191
2021-06-22,2220,2236,-16,-0.72,1191
2021-06-23,2220,2233,-13,-0.58,1191
2021-06-24,2220,2227,-7,-0.31,1191
2021-06-25,1916,1992,-76,-3.82,1191
2021-06-26,885,885,0,0.0,1191
2021-06-27,506,487,19,3.9,1191
2021-06-28,2246,2165,81,3.74,1191
2021-06-29,2220,2178,42,1.93,1191
2021-06-30,2220,2169,51,2.35,1191
2021-07-01,2095,2157,-62,-2.87,1191
2021-07-02,1868,1917,-49,-2.56,1191
2021-07-03,915,806,109,13.52,1191
2021-07-04,490,406,84,20.69,1191
2021-07-05,2074,2082,-8,-0.38,1191
2021-07-06,2095,2094,1,0.05,1191
2021-07-07,2095,2086,9,0.43,1191
2021-07-08,2095,2077,18,0.87,1191
2021-07-09,1868,1839,29,1.58,1191
2021-07-10,915,733,182,24.83,1191
2021-07-11,490,339,151,44.54,1191
2021-07-12,2074,2021,53,2.62,1191
2021-07-13,2095,2041,54,2.65,1191
2021-07-14,2095,2040,55,2.7,1191
2021-07-15,2095,2039,56,2.75,1191
2021-07-16,1868,1810,58,3.2,1191
2021-07-17,915,713,202,28.33,1191
2021-07-18,490,326,164,50.31,1191
2021-07-19,2074,2017,57,2.83,1191
2021-07-20,2095,2044,51,2.5,1191
2021-07-21,2095,2049,46,2.24,1191
2021-07-22,2095,2053,42,2.05,1191
2021-07-23,1868,1829,39,2.13,1191
2021-07-24,915,734,181,24.66,1191
2021-07-25,490,349,141,40.4,1191
2021-07-26,2074,2040,34,1.67,1191
2021-07-27,2095,2066,29,1.4,1191
2021-07-28,2095,2070,25,1.21,1191
2021-07-29,2095,2071,24,1.16,1191
2021-07-30,1868,1842,26,1.41,1191
2021-07-31,915,742,173,23.32,1191
2021-08-01,526,352,174,49.43,1191
2021-08-02,1967,2037,-70,-3.44,1191
2021-08-03,1973,2056,-83,-4.04,1191
2021-08-04,1973,2053,-80,-3.9,1191
2021-08-05,1973,2047,-74,-3.62,1191
2021-08-06,1751,1812,-61,-3.37,1191
2021-08-07,880,707,173,24.47,1191
2021-08-08,526,312,214,68.59,1191
2021-08-09,1967,1992,-25,-1.26,1191
2021-08-10,1973,2009,-36,-1.79,1191
2021-08-11,1973,2004,-31,-1.55,1191
2021-08-12,1973,1998,-25,-1.25,1191
2021-08-13,1751,1764,-13,-0.74,1191
2021-08-14,880,662,218,32.93,1191
2021-08-15,526,270,256,94.81,1191
2021-08-16,1967,1956,11,0.56,1191
2021-08-17,1973,1979,-6,-0.3,1191
2021-08-18,1973,1981,-8,-0.4,1191
2021-08-19,1973,1984,-11,-0.55,1191
2021-08-20,1751,1759,-8,-0.45,1191
2021-08-21,880,666,214,32.13,1191
2021-08-22,526,285,241,84.56,1191
2021-08-23,1967,1981,-14,-0.71,1191
2021-08-24,1973,2014,-41,-2.04,1191
2021-08-25,1973,2027,-54,-2.66,1191
2021-08-26,1973,2039,-66,-3.24,1191
2021-08-27,1751,1823,-72,-3.95,1191
2021-08-28,880,737,143,19.4,1191
2021-08-29,526,362,164,45.3,1191
2021-08-30,1967,2064,-97,-4.7,1191
2021-08-31,1973,2101,-128,-6.09,1191
2021-09-01,2253,2115,138,6.52,1191
2021-09-02,2253,2128,125,5.87,1191
2021-09-03,2019,1912,107,5.6,1191
2021-09-04,1003,824,179,21.72,1191
2021-09-05,633,446,187,41.93,1191
2021-09-06,2264,2143,121,5.65,1191
2021-09-07,2253,2174,79,3.63,1191
2021-09-08,2253,2182,71,3.25,1191
2021-09-09,2253,2188,65,2.97,1191
2021-09-10,2019,1963,56,2.85,1191
2021-09-11,1003,867,136,15.69,1191
2021-09-12,633,480,153,31.87,1191
2021-09-13,2264,2169,95,4.38,1191
2021-09-14,2253,2192,61,2.78,1191
2021-09-15,2253,2192,61,2.78,1191
2021-09-16,2253,2191,62,2.83,1191
2021-09-17,2019,1960,59,3.01,1191
2021-09-18,1003,858,145,16.9,1191
2021-09-19,633,467,166,35.55,1191
2021-09-20,2264,2152,112,5.2,1191
2021-09-21,2253,2173,80,3.68,1191
2021-09-22,2253,2172,81,3.73,1191
2021-09-23,2253,2170,83,3.82,1191
2021-09-24,2019,1940,79,4.07,1191
2021-09-25,1003,840,163,19.4,1191
2021-09-26,633,451,182,40.35,1191
2021-09-27,2264,2139,125,5.84,1191
2021-09-28,2253,2163,90,4.16,1191
2021-09-29,2253,2166,87,4.02,1191
2021-09-30,2253,2168,85,3.92,1191
2021-10-01,2155,1942,213,10.97,1191
2021-10-02,1102,846,256,30.26,1191
2021-10-03,578,460,118,25.65,1191
2021-10-04,2220,2151,69,3.21,1191
2021-10-05,2282,2178,104,4.78,1191
2021-10-06,2282,2182,100,4.58,1191
2021-10-07,2282,2185,97,4.44,1191
2021-10-08,2155,1959,196,10.01,1191
2021-10-09,1102,862,240,27.84,1191
2021-10-10,578,475,103,21.68,1191
2021-10-11,2220,2164,56,2.59,1191
2021-10-12,2282,2187,95,4.34,1191
2021-10-13,2282,2188,94,4.3,1191
2021-10-14,2282,2187,95,4.34,1191
2021-10-15,2155,1956,199,10.17,1191
2021-10-16,1102,855,247,28.89,1191
2021-10-17,578,463,115,24.84,1191
2021-10-18,2220,2147,73,3.4,1191
2021-10-19,2282,2166,116,5.36,1191
2021-10-20,2282,2163,119,5.5,1191
2021-10-21,2282,2159,123,5.7,1191
2021-10-22,2155,1925,230,11.95,1191
2021-10-23,1102,821,281,34.23,1191
2021-10-24,578,427,151,35.36,1191
2021-10-25,2220,2111,109,5.16,1191
2021-10-26,2282,2130,152,7.14,1191
2021-10-27,2282,2127,155,7.29,1191
2021-10-28,2282,2124,158,7.44,1191
2021-10-29,2155,1893,262,13.84,1191
2021-10-30,1102,792,310,39.14,1191
2021-10-31,578,402,176,43.78,1191
2021-11-01,2066,2089,-23,-1.1,1191
2021-11-02,2159,2112,47,2.23,1191
2021-11-03,2159,2114,45,2.13,1191
2021-11-04,2159,2115,44,2.08,1191
2021-11-05,1896,1887,9,0.48,1191
2021-11-06,911,790,121,15.32,1191
2021-11-07,432,403,29,7.2,1191
2021-11-08,2066,2092,-26,-1.24,1191
2021-11-09,2159,2117,42,1.98,1191
2021-11-10,2159,2119,40,1.89,1191
2021-11-11,2159,2120,39,1.84,1191
2021-11-12,1896,1891,5,0.26,1191
2021-11-13,911,792,119,15.03,1191
2021-11-14,432,402,30,7.46,1191
2021-11-15,2066,2088,-22,-1.05,1191
2021-11-16,2159,2108,51,2.42,1191
2021-11-17,2159,2105,54,2.57,1191
2021-11-18,2159,2100,59,2.81,1191
2021-11-19,1896,1865,31,1.66,1191
2021-11-20,911,759,152,20.03,1191
2021-11-21,432,362,70,19.34,1191
2021-11-22,2066,2041,25,1.22,1191
2021-11-23,2159,2055,104,5.06,1191
2021-11-24,2159,2046,113,5.52,1191
2021-11-25,2159,2036,123,6.04,1191
2021-11-26,1896,1796,100,5.57,1191
2021-11-27,911,686,225,32.8,1191
2021-11-28,432,286,146,51.05,1191
2021-11-29,2066,1963,103,5.25,1191
2021-11-30,2159,1976,183,9.26,1191
2021-12-01,1680,1968,-288,-14.63,1191
2021-12-02,1680,1959,-279,-14.24,1191
2021-12-03,1294,1721,-427,-24.81,1191
2021-12-04,780,615,165,26.83,1191
2021-12-05,342,219,123,56.16,1191
2021-12-06,1921,1901,20,1.05,1191
2021-12-07,1680,1919,-239,-12.45,1191
2021-12-08,1680,1916,-236,-12.32,1191
2021-12-09,1680,1913,-233,-12.18,1191
2021-12-10,1294,1681,-387,-23.02,1191
2021-12-11,780,580,200,34.48,1191
2021-12-12,342,189,153,80.95,1191
2021-12-13,1921,1875,46,2.45,1191
2021-12-14,1680,1897,-217,-11.44,1191
2021-12-15,1680,1897,-217,-11.44,1191
2021-12-16,1680,1895,-215,-11.35,1191
2021-12-17,1294,1664,-370,-22.24,1191
2021-12-18,780,562,218,38.79,1191
2021-12-19,342,170,172,101.18,1191
2021-12-20,1921,1853,68,3.67,1191
2021-12-21,1680,1870,-190,-10.16,1191
2021-12-22,1680,1865,-185,-9.92,1191
2021-12-23,1680,1857,-177,-9.53,1191
2021-12-24,1294,1618,-324,-20.02,1191
2021-12-25,780,509,271,53.24,1191
2021-12-26,342,108,234,216.67,1191
2021-12-27,1921,1783,138,7.74,1191
2021-12-28,1680,1792,-112,-6.25,1191
2021-12-29,1680,1778,-98,-5.51,1191
2021-12-30,1680,1763,-83,-4.71,1191
2021-12-31,1294,1517,-223,-14.7,1191
2022-01-01,654,402,252,62.69,1191
2022-01-02,315,85,230,270.59,1191
2022-01-03,1648,1668,-20,-1.2,1191
2022-01-04,1745,1675,70,4.18,1191
2022-01-05,1745,1660,85,5.12,1191
2022-01-06,1745,1645,100,6.08,1191
2022-01-07,1434,1403,31,2.21,1191
2022-01-08,654,291,363,124.74,1191
2022-01-09,315,40,275,687.5,1191
2022-01-10,1648,1569,79,5.04,1191
2022-01-11,1745,1584,161,10.16,1191
2022-01-12,1745,1580,165,10.44,1191
2022-01-13,1745,1575,170,10.79,1191
2022-01-14,1434,1344,90,6.7,1191
2022-01-15,654,244,410,168.03,1191
2022-01-16,315,17,298,1752.94,1191
2022-01-17,1648,1546,102,6.6,1191
2022-01-18,1745,1574,171,10.86,1191
2022-01-19,1745,1580,165,10.44,1191
2022-01-20,1745,1587,158,9.96,1191
2022-01-21,1434,1366,68,4.98,1191
2022-01-22,654,275,379,137.82,1191
2022-01-23,315,35,280,800.0,1191
2022-01-24,1648,1592,56,3.52,1191
2022-01-25,1745,1625,120,7.38,1191
2022-01-26,1745,1636,109,6.66,1191
2022-01-27,1745,1645,100,6.08,1191
2022-01-28,1434,1425,9,0.63,1191
2022-01-29,654,334,320,95.81,1191
2022-01-30,315,66,249,377.27,1191
2020-02-01,176,111,65,58.56,1209
2020-02-02,114,49,65,132.65,1209
2020-02-03,529,516,13,2.52,1209
2020-02-04,577,537,40,7.45,1209
2020-02-05,577,536,41,7.65,1209
2020-02-06,577,536,41,7.65,1209
2020-02-07,542,487,55,11.29,1209
2020-02-08,176,109,67,61.47,1209
2020-02-09,114,47,67,142.55,1209
2020-02-10,529,514,15,2.92,1209
2020-02-11,577,535,42,7.85,1209
2020-02-12,577,535,42,7.85,1209
2020-02-13,577,535,42,7.85,1209
2020-02-14,542,486,56,11.52,1209
2020-02-15,176,109,67,61.47,1209
2020-02-16,114,48,66,137.5,1209
2020-02-17,529,516,13,2.52,1209
2020-02-18,577,537,40,7.45,1209
2020-02-19,577,538,39,7.25,1209
2020-02-20,577,539,38,7.05,1209
2020-02-21,542,491,51,10.39,1209
2020-02-22,176,115,61,53.04,1209
2020-02-23,114,55,59,107.27,1209
2020-02-24,529,523,6,1.15,1209
2020-02-25,577,545,32,5.87,1209
2020-02-26,577,546,31,5.68,1209
2020-02-27,577,548,29,5.29,1209
2020-02-28,542,500,42,8.4,1209
2020-02-29,176,124,52,41.94,1209
2020-03-01,122,64,58,90.62,1209
2020-03-02,454,532,-78,-14.66,1209
2020-03-03,475,553,-78,-14.1,1209
2020-03-04,475,554,-79,-14.26,1209
2020-03-05,475,555,-80,-14.41,1209
2020-03-06,468,507,-39,-7.69,1209
2020-03-07,166,130,36,27.69,1209
2020-03-08,122,69,53,76.81,1209
2020-03-09,454,536,-82,-15.3,1209
2020-03-10,475,557,-82,-14.72,1209
2020-03-11,475,558,-83,-14.87,1209
2020-03-12,475,558,-83,-14.87,1209
2020-03-13,468,509,-41,-8.06,1209
2020-03-14,166,132,34,25.76,1209
2020-03-15,122,70,52,74.29,1209
2020-03-16,454,538,-84,-15.61,1209
2020-03-17,475,558,-83,-14.87,1209
2020-03-18,475,559,-84,-15.03,1209
2020-03-19,475,560,-85,-15.18,1209
2020-03-20,468,511,-43,-8.41,1209
2020-03-21,166,134,32,23.88,1209
2020-03-22,122,73,49,67.12,1209
2020-03-23,454,541,-87,-16.08,1209
2020-03-24,475,563,-88,-15.63,1209
2020-03-25,475,564,-89,-15.78,1209
2020-03-26,475,566,-91,-16.08,1209
2020-03-27,468,518,-50,-9.65,1209
2020-03-28,166,142,24,16.9,1209
2020-03-29,122,82,40,48.78,1209
2020-03-30,454,550,-96,-17.45,1209
2020-03-31,475,572,-97,-16.96,1209
2020-04-01,415,574,-159,-27.7,1209
2020-04-02,415,576,-161,-27.95,1209
2020-04-03,370,529,-159,-30.06,1209
2020-04-04,152,152,0,0.0,1209
2020-04-05,106,92,14,15.22,1209
2020-04-06,375,560,-185,-33.04,1209
2020-04-07,415,582,-167,-28.69,1209
2020-04-08,415,583,-168,-28.82,1209
2020-04-09,415,584,-169,-28.94,1209
2020-04-10,370,536,-166,-30.97,1209
2020-04-11,152,160,-8,-5.0,1209
2020-04-12,106,98,8,8.16,1209
2020-04-13,375,566,-191,-33.75,1209
2020-04-14,415,587,-172,-29.3,1209
2020-04-15,415,587,-172,-29.3,1209
2020-04-16,415,588,-173,-29.42,1209
2020-04-17,370,540,-170,-31.48,1209
2020-04-18,152,162,-10,-6.17,1209
2020-04-19,106,101,5,4.95,1209
2020-04-20,375,568,-193,-33.98,1209
2020-04-21,415,590,-175,-29.66,1209
2020-04-22,415,590,-175,-29.66,1209
2020-04-23,415,591,-176,-29.78,1209
2020-04-24,370,543,-173,-31.86,1209
2020-04-25,152,166,-14,-8.43,1209
2020-04-26,106,106,0,0.0,1209
2020-04-27,375,574,-199,-34.67,1209
2020-04-28,415,596,-181,-30.37,1209
2020-04-29,415,598,-183,-30.6,1209
2020-04-30,415,600,-185,-30.83,1209
2020-05-01,538,553,-15,-2.71,1209
2020-05-02,197,177,20,11.3,1209
2020-05-03,134,117,17,14.53,1209
2020-05-04,550,586,-36,-6.14,1209
2020-05-05,573,609,-36,-5.91,1209
2020-05-06,573,611,-38,-6.22,1209
2020-05-07,573,613,-40,-6.53,1209
2020-05-08,538,566,-28,-4.95,1209
2020-05-09,197,190,7,3.68,1209
2020-05-10,134,130,4,3.08,1209
2020-05-11,550,598,-48,-8.03,1209
2020-05-12,573,620,-47,-7.58,1209
2020-05-13,573,621,-48,-7.73,1209
2020-05-14,573,622,-49,-7.88,1209
2020-05-15,538,574,-36,-6.27,1209
2020-05-16,197,196,1,0.51,1209
2020-05-17,134,135,-1,-0.74,1209
2020-05-18,550,601,-51,-8.49,1209
2020-05-19,573,622,-49,-7.88,1209
2020-05-20,573,621,-48,-7.73,1209
2020-05-21,573,620,-47,-7.58,1209
2020-05-22,538,571,-33,-5.78,1209
2020-05-23,197,192,5,2.6,1209
2020-05-24,134,129,5,3.88,1209
2020-05-25,550,595,-45,-7.56,1209
2020-05-26,573,614,-41,-6.68,1209
2020-05-27,573,613,-40,-6.53,1209
2020-05-28,573,612,-39,-6.37,1209
2020-05-29,538,562,-24,-4.27,1209
2020-05-30,197,183,14,7.65,1209
2020-05-31,134,120,14,11.67,1209
2020-06-01,601,586,15,2.56,1209
2020-06-02,612,606,6,0.99,1209
2020-06-03,612,606,6,0.99,1209
2020-06-04,612,605,7,1.16,1209
2020-06-05,558,556,2,0.36,1209
2020-06-06,165,178,-13,-7.3,1209
2020-06-07,119,117,2,1.71,1209
2020-06-08,601,584,17,2.91,1209
2020-06-09,612,605,7,1.16,1209
2020-06-10,612,605,7,1.16,1209
2020-06-11,612,605,7,1.16,1209
2020-06-12,558,557,1,0.18,1209
2020-06-13,165,179,-14,-7.82,1209
2020-06-14,119,118,1,0.85,1209
2020-06-15,601,585,16,2.74,1209
2020-06-16,612,605,7,1.16,1209
2020-06-17,612,605,7,1.16,1209
2020-06-18,612,604,8,1.32,1209
2020-06-19,558,555,3,0.54,1209
2020-06-20,165,176,-11,-6.25,1209
2020-06-21,119,113,6,5.31,1209
2020-06-22,601,579,22,3.8,1209
2020-06-23,612,597,15,2.51,1209
2020-06-24,612,596,16,2.68,1209
2020-06-25,612,594,18,3.03,1209
2020-06-26,558,542,16,2.95,1209
2020-06-27,165,162,3,1.85,1209
2020-06-28,119,98,21,21.43,1209
2020-06-29,601,562,39,6.94,1209
2020-06-30,612,580,32,5.52,1209
2020-07-01,529,577,-48,-8.32,1209
2020-07-02,529,574,-45,-7.84,1209
2020-07-03,486,523,-37,-7.07,1209
2020-07-04,166,142,24,16.9,1209
2020-07-05,113,78,35,44.87,1209
2020-07-06,514,542,-28,-5.17,1209
2020-07-07,529,561,-32,-5.7,1209
2020-07-08,529,559,-30,-5.37,1209
2020-07-09,529,557,-28,-5.03,1209
2020-07-10,486,507,-21,-4.14,1209
2020-07-11,166,128,38,29.69,1209
2020-07-12,113,65,48,73.85,1209
2020-07-13,514,531,-17,-3.2,1209
2020-07-14,529,551,-22,-3.99,1209
2020-07-15,529,551,-22,-3.99,1209
2020-07-16,529,551,-22,-3.99,1209
2020-07-17,486,502,-16,-3.19,1209
2020-07-18,166,125,41,32.8,1209
2020-07-19,113,63,50,79.37,1209
2020-07-20,514,530,-16,-3.02,1209
2020-07-21,529,551,-22,-3.99,1209
2020-07-22,529,551,-22,-3.99,1209
2020-07-23,529,552,-23,-4.17,1209
2020-07-24,486,503,-17,-3.38,1209
2020-07-25,166,125,41,32.8,1209
2020-07-26,113,63,50,79.37,1209
2020-07-27,514,529,-15,-2.84,1209
2020-07-28,529,549,-20,-3.64,1209
2020-07-29,529,548,-19,-3.47,1209
2020-07-30,529,547,-18,-3.29,1209
2020-07-31,486,497,-11,-2.21,1209
2020-08-01,157,117,40,34.19,1209
2020-08-02,130,54,76,140.74,1209
2020-08-03,566,518,48,9.27,1209
2020-08-04,563,537,26,4.84,1209
2020-08-05,563,534,29,5.43,1209
2020-08-06,563,532,31,5.83,1209
2020-08-07,514,481,33,6.86,1209
2020-08-08,157,101,56,55.45,1209
2020-08-09,130,37,93,251.35,1209
2020-08-10,566,502,64,12.75,1209
2020-08-11,563,520,43,8.27,1209
2020-08-12,563,519,44,8.48,1209
2020-08-13,563,517,46,8.9,1209
2020-08-14,514,468,46,9.83,1209
2020-08-15,157,89,68,76.4,1209
2020-08-16,130,27,103,381.48,1209
2020-08-17,566,494,72,14.57,1209
2020-08-18,563,514,49,9.53,1209
2020-08-19,563,515,48,9.32,1209
2020-08-20,563,516,47,9.11,1209
2020-08-21,514,469,45,9.59,1209
2020-08-22,157,93,64,68.82,1209
2020-08-23,130,33,97,293.94,1209
2020-08-24,566,503,63,12.52,1209
2020-08-25,563,526,37,7.03,1209
2020-08-26,563,529,34,6.43,1209
2020-08-27,563,532,31,5.83,1209
2020-08-28,514,487,27,5.54,1209
2020-08-29,157,112,45,40.18,1209
2020-08-30,130,54,76,140.74,1209
2020-08-31,566,524,42,8.02,1209
2020-09-01,623,548,75,13.69,1209
2020-09-02,623,551,72,13.07,1209
2020-09-03,623,554,69,12.45,1209
2020-09-04,545,508,37,7.28,1209
2020-09-05,197,133,64,48.12,1209
2020-09-06,125,73,52,71.23,1209
2020-09-07,617,543,74,13.63,1209
2020-09-08,623,565,58,10.27,1209
2020-09-09,623,566,57,10.07,1209
2020-09-10,623,568,55,9.68,1209
2020-09-11,545,520,25,4.81,1209
2020-09-12,197,143,54,37.76,1209
2020-09-13,125,82,43,52.44,1209
2020-09-14,617,549,68,12.39,1209
2020-09-15,623,570,53,9.3,1209
2020-09-16,623,570,53,9.3,1209
2020-09-17,623,570,53,9.3,1209
2020-09-18,545,520,25,4.81,1209
2020-09-19,197,142,55,38.73,1209
2020-09-20,125,80,45,56.25,1209
2020-09-21,617,546,71,13.0,1209
2020-09-22,623,566,57,10.07,1209
2020-09-23,623,566,57,10.07,1209
2020-09-24,623,565,58,10.27,1209
2020-09-25,545,516,29,5.62,1209
2020-09-26,197,138,59,42.75,1209
2020-09-27,125,75,50,66.67,1209
2020-09-28,617,542,75,13.84,1209
2020-09-29,623,562,61,10.85,1209
2020-09-30,623,562,61,10.85,1209
2020-10-01,625,562,63,11.21,1209
2020-10-02,564,513,51,9.94,1209
2020-10-03,211,135,76,56.3,1209
2020-10-04,137,73,64,87.67,1209
2020-10-05,610,539,71,13.17,1209
2020-10-06,625,560,65,11.61,1209
2020-10-07,625,560,65,11.61,1209
2020-10-08,625,559,66,11.81,1209
2020-10-09,564,510,54,10.59,1209
2020-10-10,211,132,79,59.85,1209
2020-10-11,137,70,67,95.71,1209
2020-10-12,610,537,73,13.59,1209
2020-10-13,625,557,68,12.21,1209
2020-10-14,625,557,68,12.21,1209
2020-10-15,625,557,68,12.21,1209
2020-10-16,564,508,56,11.02,1209
2020-10-17,211,130,81,62.31,1209
2020-10-18,137,68,69,101.47,1209
2020-10-19,610,535,75,14.02,1209
2020-10-20,625,555,70,12.61,1209
2020-10-21,625,555,70,12.61,1209
2020-10-22,625,555,70,12.61,1209
2020-10-23,564,507,57,11.24,1209
2020-10-24,211,129,82,63.57,1209
2020-10-25,137,68,69,101.47,1209
2020-10-26,610,536,74,13.81,1209
2020-10-27,625,557,68,12.21,1209
2020-10-28,625,558,67,12.01,1209
2020-10-29,625,559,66,11.81,1209
2020-10-30,564,512,52,10.16,1209
2020-10-31,211,135,76,56.3,1209
2020-11-01,141,75,66,88.0,1209
2020-11-02,601,543,58,10.68,1209
2020-11-03,598,565,33,5.84,1209
2020-11-04,598,567,31,5.47,1209
2020-11-05,598,568,30,5.28,1209
2020-11-06,542,521,21,4.03,1209
2020-11-07,212,145,67,46.21,1209
2020-11-08,141,84,57,67.86,1209
2020-11-09,601,553,48,8.68,1209
2020-11-10,598,574,24,4.18,1209
2020-11-11,598,575,23,4.0,1209
2020-11-12,598,576,22,3.82,1209
2020-11-13,542,528,14,2.65,1209
2020-11-14,212,150,62,41.33,1209
2020-11-15,141,88,53,60.23,1209
2020-11-16,601,555,46,8.29,1209
2020-11-17,598,575,23,4.0,1209
2020-11-18,598,574,24,4.18,1209
2020-11-19,598,573,25,4.36,1209
2020-11-20,542,524,18,3.44,1209
2020-11-21,212,145,67,46.21,1209
2020-11-22,141,81,60,74.07,1209
2020-11-23,601,547,54,9.87,1209
2020-11-24,598,565,33,5.84,1209
2020-11-25,598,564,34,6.03,1209
2020-11-26,598,562,36,6.41,1209
2020-11-27,542,512,30,5.86,1209
2020-11-28,212,132,80,60.61,1209
2020-11-29,141,69,72,104.35,1209
2020-11-30,601,534,67,12.55,1209
2020-12-01,528,553,-25,-4.52,1209
2020-12-02,528,551,-23,-4.17,1209
2020-12-03,528,550,-22,-4.0,1209
2020-12-04,563,500,63,12.6,1209
2020-12-05,249,122,127,104.1,1209
2020-12-06,151,59,92,155.93,1209
2020-12-07,520,525,-5,-0.95,1209
2020-12-08,528,545,-17,-3.12,1209
2020-12-09,528,545,-17,-3.12,1209
2020-12-10,528,545,-17,-3.12,1209
2020-12-11,563,496,67,13.51,1209
2020-12-12,249,118,131,111.02,1209
2020-12-13,151,56,95,169.64,1209
2020-12-14,520,523,-3,-0.57,1209
2020-12-15,528,543,-15,-2.76,1209
2020-12-16,528,543,-15,-2.76,1209
2020-12-17,528,543,-15,-2.76,1209
2020-12-18,563,494,69,13.97,1209
2020-12-19,249,115,134,116.52,1209
2020-12-20,151,53,98,184.91,1209
2020-12-21,520,519,1,0.19,1209
2020-12-22,528,539,-11,-2.04,1209
2020-12-23,528,538,-10,-1.86,1209
2020-12-24,528,536,-8,-1.49,1209
2020-12-25,563,486,77,15.84,1209
2020-12-26,249,107,142,132.71,1209
2020-12-27,151,43,108,251.16,1209
2020-12-28,520,509,11,2.16,1209
2020-12-29,528,527,1,0.19,1209
2020-12-30,528,525,3,0.57,1209
2020-12-31,528,523,5,0.96,1209
2021-01-01,442,472,-30,-6.36,1209
2021-01-02,222,93,129,138.71,1209
2021-01-03,153,29,124,427.59,1209
2021-01-04,451,494,-43,-8.7,1209
2021-01-05,489,513,-24,-4.68,1209
2021-01-06,489,511,-22,-4.31,1209
2021-01-07,489,509,-20,-3.93,1209
2021-01-08,442,459,-17,-3.7,1209
2021-01-09,222,80,142,177.5,1209
2021-01-10,153,17,136,800.0,1209
2021-01-11,451,484,-33,-6.82,1209
2021-01-12,489,503,-14,-2.78,1209
2021-01-13,489,503,-14,-2.78,1209
2021-01-14,489,503,-14,-2.78,1209
2021-01-15,442,454,-12,-2.64,1209
2021-01-16,222,76,146,192.11,1209
2021-01-17,153,15,138,920.0,1209
2021-01-18,451,482,-31,-6.43,1209
2021-01-19,489,503,-14,-2.78,1209
2021-01-20,489,504,-15,-2.98,1209
2021-01-21,489,504,-15,-2.98,1209
2021-01-22,442,456,-14,-3.07,1209
2021-01-23,222,79,143,181.01,1209
2021-01-24,153,18,135,750.0,1209
2021-01-25,451,485,-34,-7.01,1209
2021-01-26,489,506,-17,-3.36,1209
2021-01-27,489,506,-17,-3.36,1209
2021-01-28,489,507,-18,-3.55,1209
2021-01-29,442,458,-16,-3.49,1209
2021-01-30,222,81,141,174.07,1209
2021-01-31,153,19,134,705.26,1209
2021-02-01,511,486,25,5.14,1209
2021-02-02,511,506,5,0.99,1209
2021-02-03,511,506,5,0.99,1209
2021-02-04,511,506,5,0.99,1209
2021-02-05,486,457,29,6.35,1209
2021-02-06,204,79,125,158.23,1209
2021-02-07,146,17,129,758.82,1209
2021-02-08,511,484,27,5.58,1209
2021-02-09,511,504,7,1.39,1209
2021-02-10,511,504,7,1.39,1209
2021-02-11,511,504,7,1.39,1209
2021-02-12,486,455,31,6.81,1209
2021-02-13,204,78,126,161.54,1209
2021-02-14,146,16,130,812.5,1209
2021-02-15,511,484,27,5.58,1209
2021-02-16,511,505,6,1.19,1209
2021-02-17,511,506,5,0.99,1209
2021-02-18,511,507,4,0.79,1209
2021-02-19,486,459,27,5.88,1209
2021-02-20,204,83,121,145.78,1209
2021-02-21,146,22,124,563.64,1209
2021-02-22,511,490,21,4.29,1209
2021-02-23,511,512,-1,-0.2,1209
2021-02-24,511,514,-3,-0.58,1209
2021-02-25,511,515,-4,-0.78,1209
2021-02-26,486,468,18,3.85,1209
2021-02-27,204,92,112,121.74,1209
2021-02-28,146,31,115,370.97,1209
2021-03-01,558,499,59,11.82,1209
2021-03-02,573,521,52,9.98,1209
2021-03-03,573,522,51,9.77,1209
2021-03-04,573,523,50,9.56,1209
2021-03-05,526,476,50,10.5,1209
2021-03-06,222,99,123,124.24,1209
2021-03-07,143,37,106,286.49,1209
2021-03-08,558,505,53,10.5,1209
2021-03-09,573,526,47,8.94,1209
2021-03-10,573,526,47,8.94,1209
2021-03-11,573,527,46,8.73,1209
2021-03-12,526,478,48,10.04,1209
2021-03-13,222,101,121,119.8,1209
2021-03-14,143,39,104,266.67,1209
2021-03-15,558,507,51,10.06,1209
2021-03-16,573,527,46,8.73,1209
2021-03-17,573,528,45,8.52,1209
2021-03-18,573,528,45,8.52,1209
2021-03-19,526,480,46,9.58,1209
2021-03-20,222,103,119,115.53,1209
2021-03-21,143,42,101,240.48,1209
2021-03-22,558,509,49,9.63,1209
2021-03-23,573,531,42,7.91,1209
2021-03-24,573,532,41,7.71,1209
2021-03-25,573,533,40,7.5,1209
2021-03-26,526,486,40,8.23,1209
2021-03-27,222,109,113,103.67,1209
2021-03-28,143,49,94,191.84,1209
2021-03-29,558,518,40,7.72,1209
2021-03-30,573,540,33,6.11,1209
2021-03-31,573,541,32,5.91,1209
2021-04-01,588,543,45,8.29,1209
2021-04-02,546,496,50,10.08,1209
2021-04-03,215,120,95,79.17,1209
2021-04-04,144,59,85,144.07,1209
2021-04-05,580,528,52,9.85,1209
2021-04-06,588,550,38,6.91,1209
2021-04-07,588,551,37,6.72,1209
2021-04-08,588,552,36,6.52,1209
2021-04-09,546,505,41,8.12,1209
2021-04-10,215,128,87,67.97,1209
2021-04-11,144,67,77,114.93,1209
2021-04-12,580,534,46,8.61,1209
2021-04-13,588,556,32,5.76,1209
2021-04-14,588,556,32,5.76,1209
2021-04-15,588,557,31,5.57,1209
2021-04-16,546,508,38,7.48,1209
2021-04-17,215,131,84,64.12,1209
2021-04-18,144,70,74,105.71,1209
2021-04-19,580,537,43,8.01,1209
2021-04-20,588,558,30,5.38,1209
2021-04-21,588,559,29,5.19,1209
2021-04-22,588,559,29,5.19,1209
2021-04-23,546,511,35,6.85,1209
2021-04-24,215,134,81,60.45,1209
2021-04-25,144,74,70,94.59,1209
2021-04-26,580,542,38,7.01,1209
2021-04-27,588,564,24,4.26,1209
2021-04-28,588,565,23,4.07,1209
2021-04-29,588,567,21,3.7,1209
2021-04-30,546,520,26,5.0,1209
2021-05-01,240,144,96,66.67,1209
2021-05-02,147,84,63,75.0,1209
2021-05-03,612,553,59,10.67,1209
2021-05-04,638,575,63,10.96,1209
2021-05-05,638,577,61,10.57,1209
2021-05-06,638,580,58,10.0,1209
2021-05-07,565,533,32,6.0,1209
2021-05-08,240,157,83,52.87,1209
2021-05-09,147,97,50,51.55,1209
2021-05-10,612,566,46,8.13,1209
2021-05-11,638,588,50,8.5,1209
2021-05-12,638,589,49,8.32,1209
2021-05-13,638,590,48,8.14,1209
2021-05-14,565,542,23,4.24,1209
2021-05-15,240,165,75,45.45,1209
2021-05-16,147,104,43,41.35,1209
2021-05-17,612,571,41,7.18,1209
2021-05-18,638,591,47,7.95,1209
2021-05-19,638,591,47,7.95,1209
2021-05-20,638,591,47,7.95,1209
2021-05-21,565,541,24,4.44,1209
2021-05-22,240,162,78,48.15,1209
2021-05-23,147,100,47,47.0,1209
2021-05-24,612,565,47,8.32,1209
2021-05-25,638,585,53,9.06,1209
2021-05-26,638,584,54,9.25,1209
2021-05-27,638,582,56,9.62,1209
2021-05-28,565,532,33,6.2,1209
2021-05-29,240,154,86,55.84,1209
2021-05-30,147,91,56,61.54,1209
2021-05-31,612,557,55,9.87,1209
2021-06-01,643,576,67,11.63,1209
2021-06-02,643,576,67,11.63,1209
2021-06-03,643,575,68,11.83,1209
2021-06-04,552,526,26,4.94,1209
2021-06-05,184,148,36,24.32,1209
2021-06-06,116,86,30,34.88,1209
2021-06-07,570,553,17,3.07,1209
2021-06-08,643,574,69,12.02,1209
2021-06-09,643,574,69,12.02,1209
2021-06-10,643,574,69,12.02,1209
2021-06-11,552,526,26,4.94,1209
2021-06-12,184,148,36,24.32,1209
2021-06-13,116,87,29,33.33,1209
2021-06-14,570,554,16,2.89,1209
2021-06-15,643,574,69,12.02,1209
2021-06-16,643,574,69,12.02,1209
2021-06-17,643,574,69,12.02,1209
2021-06-18,552,525,27,5.14,1209
2021-06-19,184,147,37,25.17,1209
2021-06-20,116,84,32,38.1,1209
2021-06-21,570,550,20,3.64,1209
2021-06-22,643,569,74,13.01,1209
2021-06-23,643,567,76,13.4,1209
2021-06-24,643,565,78,13.81,1209
2021-06-25,552,515,37,7.18,1209
2021-06-26,184,135,49,36.3,1209
2021-06-27,116,70,46,65.71,1209
2021-06-28,570,535,35,6.54,1209
2021-06-29,643,552,91,16.49,1209
2021-06-30,643,550,93,16.91,1209
2021-07-01,683,547,136,24.86,1209
2021-07-02,640,495,145,29.29,1209
2021-07-03,227,115,112,97.39,1209
2021-07-04,160,50,110,220.0,1209
2021-07-05,666,515,151,29.32,1209
2021-07-06,683,533,150,28.14,1209
2021-07-07,683,531,152,28.63,1209
2021-07-08,683,529,154,29.11,1209
2021-07-09,640,478,162,33.89,1209
2021-07-10,227,99,128,129.29,1209
2021-07-11,160,36,124,344.44,1209
2021-07-12,666,502,164,32.67,1209
2021-07-13,683,521,162,31.09,1209
2021-07-14,683,521,162,31.09,1209
2021-07-15,683,521,162,31.09,1209
2021-07-16,640,472,168,35.59,1209
2021-07-17,227,94,133,141.49,1209
2021-07-18,160,32,128,400.0,1209
2021-07-19,666,499,167,33.47,1209
2021-07-20,683,520,163,31.35,1209
2021-07-21,683,520,163,31.35,1209
2021-07-22,683,521,162,31.09,1209
2021-07-23,640,472,168,35.59,1209
2021-07-24,227,94,133,141.49,1209
2021-07-25,160,32,128,400.0,1209
2021-07-26,666,499,167,33.47,1209
2021-07-27,683,519,164,31.6,1209
2021-07-28,683,518,165,31.85,1209
2021-07-29,683,518,165,31.85,1209
2021-07-30,640,468,172,36.75,1209
2021-07-31,227,89,138,155.06,1209
2021-08-01,163,25,138,552.0,1209
2021-08-02,653,490,163,33.27,1209
2021-08-03,661,509,152,29.86,1209
2021-08-04,661,507,154,30.37,1209
2021-08-05,661,504,157,31.15,1209
2021-08-06,568,453,115,25.39,1209
2021-08-07,222,73,149,204.11,1209
2021-08-08,163,9,154,1711.11,1209
2021-08-09,653,474,179,37.76,1209
2021-08-10,661,492,169,34.35,1209
2021-08-11,661,490,171,34.9,1209
2021-08-12,661,489,172,35.17,1209
2021-08-13,568,438,130,29.68,1209
2021-08-14,222,59,163,276.27,1209
2021-08-15,163,168,-5,-2.98,1209
2021-08-16,653,463,190,41.04,1209
2021-08-17,661,483,178,36.85,1209
2021-08-18,661,484,177,36.57,1209
2021-08-19,661,484,177,36.57,1209
2021-08-20,568,437,131,29.98,1209
2021-08-21,222,60,162,270.0,1209
2021-08-22,163,0,163,inf,1209
2021-08-23,653,469,184,39.23,1209
2021-08-24,661,492,169,34.35,1209
2021-08-25,661,495,166,33.54,1209
2021-08-26,661,498,163,32.73,1209
2021-08-27,568,452,116,25.66,1209
2021-08-28,222,77,145,188.31,1209
2021-08-29,163,19,144,757.89,1209
2021-08-30,653,489,164,33.54,1209
2021-08-31,661,513,148,28.85,1209
2021-09-01,658,516,142,27.52,1209
2021-09-02,658,520,138,26.54,1209
2021-09-03,609,474,135,28.48,1209
2021-09-04,231,99,132,133.33,1209
2021-09-05,169,40,129,322.5,1209
2021-09-06,626,509,117,22.99,1209
2021-09-07,658,532,126,23.68,1209
2021-09-08,658,534,124,23.22,1209
2021-09-09,658,535,123,22.99,1209
2021-09-10,609,488,121,24.8,1209
2021-09-11,231,111,120,108.11,1209
2021-09-12,169,50,119,238.0,1209
2021-09-13,626,518,108,20.85,1209
2021-09-14,658,539,119,22.08,1209
2021-09-15,658,539,119,22.08,1209
2021-09-16,658,539,119,22.08,1209
2021-09-17,609,490,119,24.29,1209
2021-09-18,231,112,119,106.25,1209
2021-09-19,169,50,119,238.0,1209
2021-09-20,626,516,110,21.32,1209
2021-09-21,658,536,122,22.76,1209
2021-09-22,658,536,122,22.76,1209
2021-09-23,658,535,123,22.99,1209
2021-09-24,609,486,123,25.31,1209
2021-09-25,231,108,123,113.89,1209
2021-09-26,169,45,124,275.56,1209
2021-09-27,626,512,114,22.27,1209
2021-09-28,658,532,126,23.68,1209
2021-09-29,658,531,127,23.92,1209
2021-09-30,658,531,127,23.92,1209
2021-10-01,601,482,119,24.69,1209
2021-10-02,239,104,135,129.81,1209
2021-10-03,160,42,118,280.95,1209
2021-10-04,618,509,109,21.41,1209
2021-10-05,643,529,114,21.55,1209
2021-10-06,643,529,114,21.55,1209
2021-10-07,643,529,114,21.55,1209
2021-10-08,601,480,121,25.21,1209
2021-10-09,239,102,137,134.31,1209
2021-10-10,160,40,120,300.0,1209
2021-10-11,618,507,111,21.89,1209
2021-10-12,643,527,116,22.01,1209
2021-10-13,643,527,116,22.01,1209
2021-10-14,643,526,117,22.24,1209
2021-10-15,601,477,124,26.0,1209
2021-10-16,239,99,140,141.41,1209
2021-10-17,160,37,123,332.43,1209
2021-10-18,618,504,114,22.62,1209
2021-10-19,643,524,119,22.71,1209
2021-10-20,643,524,119,22.71,1209
2021-10-21,643,524,119,22.71,1209
2021-10-22,601,476,125,26.26,1209
2021-10-23,239,98,141,143.88,1209
2021-10-24,160,37,123,332.43,1209
2021-10-25,618,504,114,22.62,1209
2021-10-26,643,525,118,22.48,1209
2021-10-27,643,526,117,22.24,1209
2021-10-28,643,527,116,22.01,1209
2021-10-29,601,479,122,25.47,1209
2021-10-30,239,103,136,132.04,1209
2021-10-31,160,42,118,280.95,1209
2021-11-01,625,511,114,22.31,1209
2021-11-02,641,533,108,20.26,1209
2021-11-03,641,534,107,20.04,1209
2021-11-04,641,536,105,19.59,1209
2021-11-05,593,489,104,21.27,1209
2021-11-06,251,112,139,124.11,1209
2021-11-07,171,52,119,228.85,1209
2021-11-08,625,520,105,20.19,1209
2021-11-09,641,542,99,18.27,1209
2021-11-10,641,543,98,18.05,1209
2021-11-11,641,544,97,17.83,1209
2021-11-12,593,496,97,19.56,1209
2021-11-13,251,119,132,110.92,1209
2021-11-14,171,57,114,200.0,1209
2021-11-15,625,524,101,19.27,1209
2021-11-16,641,545,96,17.61,1209
2021-11-17,641,544,97,17.83,1209
2021-11-18,641,544,97,17.83,1209
2021-11-19,593,494,99,20.04,1209
2021-11-20,251,115,136,118.26,1209
2021-11-21,171,52,119,228.85,1209
2021-11-22,625,518,107,20.66,1209
2021-11-23,641,537,104,19.37,1209
2021-11-24,641,535,106,19.81,1209
2021-11-25,641,534,107,20.04,1209
2021-11-26,593,483,110,22.77,1209
2021-11-27,251,103,148,143.69,1209
2021-11-28,171,40,131,327.5,1209
2021-11-29,625,505,120,23.76,1209
2021-11-30,641,524,117,22.33,1209
2021-12-01,539,522,17,3.26,1209
2021-12-02,539,521,18,3.45,1209
2021-12-03,457,471,-14,-2.97,1209
2021-12-04,239,92,147,159.78,1209
2021-12-05,155,29,126,434.48,1209
2021-12-06,551,496,55,11.09,1209
2021-12-07,539,515,24,4.66,1209
2021-12-08,539,515,24,4.66,1209
2021-12-09,539,514,25,4.86,1209
2021-12-10,457,465,-8,-1.72,1209
2021-12-11,239,87,152,174.71,1209
2021-12-12,155,25,130,520.0,1209
2021-12-13,551,492,59,11.99,1209
2021-12-14,539,513,26,5.07,1209
2021-12-15,539,512,27,5.27,1209
2021-12-16,539,512,27,5.27,1209
2021-12-17,457,463,-6,-1.3,1209
2021-12-18,239,85,154,181.18,1209
2021-12-19,155,23,132,573.91,1209
2021-12-20,551,489,62,12.68,1209
2021-12-21,539,509,30,5.89,1209
2021-12-22,539,508,31,6.1,1209
2021-12-23,539,507,32,6.31,1209
2021-12-24,457,457,0,0.0,1209
2021-12-25,239,78,161,206.41,1209
2021-12-26,155,15,140,933.33,1209
2021-12-27,551,480,71,14.79,1209
2021-12-28,539,499,40,8.02,1209
2021-12-29,539,497,42,8.45,1209
2021-12-30,539,495,44,8.89,1209
2021-12-31,457,444,13,2.93,1209
2022-01-01,226,64,162,253.12,1209
2022-01-02,157,1,156,15600.0,1209
2022-01-03,493,466,27,5.79,1209
2022-01-04,499,484,15,3.1,1209
2022-01-05,499,482,17,3.53,1209
2022-01-06,499,481,18,3.74,1209
2022-01-07,478,430,48,11.16,1209
2022-01-08,226,51,175,343.14,1209
2022-01-09,157,253,-96,-37.94,1209
2022-01-10,493,454,39,8.59,1209
2022-01-11,499,474,25,5.27,1209
2022-01-12,499,473,26,5.5,1209
2022-01-13,499,473,26,5.5,1209
2022-01-14,478,423,55,13.0,1209
2022-01-15,226,46,180,391.3,1209
2022-01-16,157,255,-98,-38.43,1209
2022-01-17,493,451,42,9.31,1209
2022-01-18,499,472,27,5.72,1209
2022-01-19,499,472,27,5.72,1209
2022-01-20,499,473,26,5.5,1209
2022-01-21,478,425,53,12.47,1209
2022-01-22,226,47,179,380.85,1209
2022-01-23,157,260,-103,-39.62,1209
2022-01-24,493,454,39,8.59,1209
2022-01-25,499,475,24,5.05,1209
2022-01-26,499,475,24,5.05,1209
2022-01-27,499,476,23,4.83,1209
2022-01-28,478,427,51,11.94,1209
2022-01-29,226,50,176,352.0,1209
2022-01-30,157,266,-109,-40.98,1209
2020-02-01,259,277,-18,-6.5,1613
2020-02-02,226,233,-7,-3.0,1613
2020-02-03,438,512,-74,-14.45,1613
2020-02-04,506,521,-15,-2.88,1613
2020-02-05,506,520,-14,-2.69,1613
2020-02-06,506,520,-14,-2.69,1613
2020-02-07,480,493,-13,-2.64,1613
2020-02-08,259,273,-14,-5.13,1613
2020-02-09,226,228,-2,-0.88,1613
2020-02-10,438,507,-69,-13.61,1613
2020-02-11,506,516,-10,-1.94,1613
2020-02-12,506,515,-9,-1.75,1613
2020-02-13,506,515,-9,-1.75,1613
2020-02-14,480,489,-9,-1.84,1613
2020-02-15,259,270,-11,-4.07,1613
2020-02-16,226,226,0,0.0,1613
2020-02-17,438,506,-68,-13.44,1613
2020-02-18,506,516,-10,-1.94,1613
2020-02-19,506,517,-11,-2.13,1613
2020-02-20,506,518,-12,-2.32,1613
2020-02-21,480,493,-13,-2.64,1613
2020-02-22,259,275,-16,-5.82,1613
2020-02-23,226,232,-6,-2.59,1613
2020-02-24,438,514,-76,-14.79,1613
2020-02-25,506,525,-19,-3.62,1613
2020-02-26,506,526,-20,-3.8,1613
2020-02-27,506,528,-22,-4.17,1613
2020-02-28,480,503,-23,-4.57,1613
2020-02-29,259,286,-27,-9.44,1613
2020-03-01,229,244,-15,-6.15,1613
2020-03-02,430,525,-95,-18.1,1613
2020-03-03,431,536,-105,-19.59,1613
2020-03-04,431,537,-106,-19.74,1613
2020-03-05,431,539,-108,-20.04,1613
2020-03-06,425,513,-88,-17.15,1613
2020-03-07,253,295,-42,-14.24,1613
2020-03-08,229,252,-23,-9.13,1613
2020-03-09,430,532,-102,-19.17,1613
2020-03-10,431,542,-111,-20.48,1613
2020-03-11,431,542,-111,-20.48,1613
2020-03-12,431,542,-111,-20.48,1613
2020-03-13,425,516,-91,-17.64,1613
2020-03-14,253,296,-43,-14.53,1613
2020-03-15,229,252,-23,-9.13,1613
2020-03-16,430,532,-102,-19.17,1613
2020-03-17,431,541,-110,-20.33,1613
2020-03-18,431,540,-109,-20.19,1613
2020-03-19,431,539,-108,-20.04,1613
2020-03-20,425,513,-88,-17.15,1613
2020-03-21,253,293,-40,-13.65,1613
2020-03-22,229,249,-20,-8.03,1613
2020-03-23,430,528,-98,-18.56,1613
2020-03-24,431,537,-106,-19.74,1613
2020-03-25,431,536,-105,-19.59,1613
2020-03-26,431,537,-106,-19.74,1613
2020-03-27,425,510,-85,-16.67,1613
2020-03-28,253,291,-38,-13.06,1613
2020-03-29,229,247,-18,-7.29,1613
2020-03-30,430,527,-97,-18.41,1613
2020-03-31,431,537,-106,-19.74,1613
2020-04-01,412,537,-125,-23.28,1613
2020-04-02,412,538,-126,-23.42,1613
2020-04-03,382,512,-130,-25.39,1613
2020-04-04,248,293,-45,-15.36,1613
2020-04-05,220,249,-29,-11.65,1613
2020-04-06,413,529,-116,-21.93,1613
2020-04-07,412,539,-127,-23.56,1613
2020-04-08,412,539,-127,-23.56,1613
2020-04-09,412,540,-128,-23.7,1613
2020-04-10,382,513,-131,-25.54,1613
2020-04-11,248,294,-46,-15.65,1613
2020-04-12,220,250,-30,-12.0,1613
2020-04-13,413,530,-117,-22.08,1613
2020-04-14,412,539,-127,-23.56,1613
2020-04-15,412,538,-126,-23.42,1613
2020-04-16,412,538,-126,-23.42,1613
2020-04-17,382,511,-129,-25.24,1613
2020-04-18,248,291,-43,-14.78,1613
2020-04-19,220,246,-26,-10.57,1613
2020-04-20,413,525,-112,-21.33,1613
2020-04-21,412,533,-121,-22.7,1613
2020-04-22,412,532,-120,-22.56,1613
2020-04-23,412,531,-119,-22.41,1613
2020-04-24,382,504,-122,-24.21,1613
2020-04-25,248,284,-36,-12.68,1613
2020-04-26,220,239,-19,-7.95,1613
2020-04-27,413,518,-105,-20.27,1613
2020-04-28,412,526,-114,-21.67,1613
2020-04-29,412,525,-113,-21.52,1613
2020-04-30,412,524,-112,-21.37,1613
2020-05-01,422,497,-75,-15.09,1613
2020-05-02,241,277,-36,-13.0,1613
2020-05-03,216,233,-17,-7.3,1613
2020-05-04,447,512,-65,-12.7,1613
2020-05-05,461,521,-60,-11.52,1613
2020-05-06,461,520,-59,-11.35,1613
2020-05-07,461,520,-59,-11.35,1613
2020-05-08,422,493,-71,-14.4,1613
2020-05-09,241,273,-32,-11.72,1613
2020-05-10,216,229,-13,-5.68,1613
2020-05-11,447,509,-62,-12.18,1613
2020-05-12,461,518,-57,-11.0,1613
2020-05-13,461,517,-56,-10.83,1613
2020-05-14,461,517,-56,-10.83,1613
2020-05-15,422,490,-68,-13.88,1613
2020-05-16,241,271,-30,-11.07,1613
2020-05-17,216,226,-10,-4.42,1613
2020-05-18,447,506,-59,-11.66,1613
2020-05-19,461,515,-54,-10.49,1613
2020-05-20,461,514,-53,-10.31,1613
2020-05-21,461,514,-53,-10.31,1613
2020-05-22,422,487,-65,-13.35,1613
2020-05-23,241,267,-26,-9.74,1613
2020-05-24,216,223,-7,-3.14,1613
2020-05-25,447,502,-55,-10.96,1613
2020-05-26,461,511,-50,-9.78,1613
2020-05-27,461,511,-50,-9.78,1613
2020-05-28,461,511,-50,-9.78,1613
2020-05-29,422,484,-62,-12.81,1613
2020-05-30,241,265,-24,-9.06,1613
2020-05-31,216,221,-5,-2.26,1613
2020-06-01,462,500,-38,-7.6,1613
2020-06-02,476,510,-34,-6.67,1613
2020-06-03,476,509,-33,-6.48,1613
2020-06-04,476,510,-34,-6.67,1613
2020-06-05,417,484,-67,-13.84,1613
2020-06-06,245,265,-20,-7.55,1613
2020-06-07,205,221,-16,-7.24,1613
2020-06-08,462,501,-39,-7.78,1613
2020-06-09,476,511,-35,-6.85,1613
2020-06-10,476,510,-34,-6.67,1613
2020-06-11,476,511,-35,-6.85,1613
2020-06-12,417,484,-67,-13.84,1613
2020-06-13,245,265,-20,-7.55,1613
2020-06-14,205,221,-16,-7.24,1613
2020-06-15,462,500,-38,-7.6,1613
2020-06-16,476,509,-33,-6.48,1613
2020-06-17,476,508,-32,-6.3,1613
2020-06-18,476,508,-32,-6.3,1613
2020-06-19,417,481,-64,-13.31,1613
2020-06-20,245,260,-15,-5.77,1613
2020-06-21,205,215,-10,-4.65,1613
2020-06-22,462,493,-31,-6.29,1613
2020-06-23,476,501,-25,-4.99,1613
2020-06-24,476,499,-23,-4.61,1613
2020-06-25,476,498,-22,-4.42,1613
2020-06-26,417,470,-53,-11.28,1613
2020-06-27,245,249,-4,-1.61,1613
2020-06-28,205,203,2,0.99,1613
2020-06-29,462,480,-18,-3.75,1613
2020-06-30,476,488,-12,-2.46,1613
2020-07-01,413,486,-73,-15.02,1613
2020-07-02,413,484,-71,-14.67,1613
2020-07-03,396,456,-60,-13.16,1613
2020-07-04,231,235,-4,-1.7,1613
2020-07-05,228,190,38,20.0,1613
2020-07-06,412,468,-56,-11.97,1613
2020-07-07,413,476,-63,-13.24,1613
2020-07-08,413,475,-62,-13.05,1613
2020-07-09,413,474,-61,-12.87,1613
2020-07-10,396,447,-51,-11.41,1613
2020-07-11,231,227,4,1.76,1613
2020-07-12,228,183,45,24.59,1613
2020-07-13,412,462,-50,-10.82,1613
2020-07-14,413,471,-58,-12.31,1613
2020-07-15,413,470,-57,-12.13,1613
2020-07-16,413,471,-58,-12.31,1613
2020-07-17,396,444,-48,-10.81,1613
2020-07-18,231,225,6,2.67,1613
2020-07-19,228,180,48,26.67,1613
2020-07-20,412,460,-48,-10.43,1613
2020-07-21,413,469,-56,-11.94,1613
2020-07-22,413,468,-55,-11.75,1613
2020-07-23,413,468,-55,-11.75,1613
2020-07-24,396,440,-44,-10.0,1613
2020-07-25,231,220,11,5.0,1613
2020-07-26,228,175,53,30.29,1613
2020-07-27,412,453,-41,-9.05,1613
2020-07-28,413,461,-48,-10.41,1613
2020-07-29,413,459,-46,-10.02,1613
2020-07-30,413,457,-44,-9.63,1613
2020-07-31,396,429,-33,-7.69,1613
2020-08-01,187,207,-20,-9.66,1613
2020-08-02,185,161,24,14.91,1613
2020-08-03,317,438,-121,-27.63,1613
2020-08-04,330,445,-115,-25.84,1613
2020-08-05,330,443,-113,-25.51,1613
2020-08-06,330,441,-111,-25.17,1613
2020-08-07,320,412,-92,-22.33,1613
2020-08-08,187,191,-4,-2.09,1613
2020-08-09,185,145,40,27.59,1613
2020-08-10,317,423,-106,-25.06,1613
2020-08-11,330,431,-101,-23.43,1613
2020-08-12,330,429,-99,-23.08,1613
2020-08-13,330,429,-99,-23.08,1613
2020-08-14,320,402,-82,-20.4,1613
2020-08-15,187,182,5,2.75,1613
2020-08-16,185,139,46,33.09,1613
2020-08-17,317,419,-102,-24.34,1613
2020-08-18,330,429,-99,-23.08,1613
2020-08-19,330,430,-100,-23.26,1613
2020-08-20,330,432,-102,-23.61,1613
2020-08-21,320,407,-87,-21.38,1613
2020-08-22,187,190,-3,-1.58,1613
2020-08-23,185,148,37,25.0,1613
2020-08-24,317,431,-114,-26.45,1613
2020-08-25,330,443,-113,-25.51,1613
2020-08-26,330,445,-115,-25.84,1613
2020-08-27,330,448,-118,-26.34,1613
2020-08-28,320,425,-105,-24.71,1613
2020-08-29,187,208,-21,-10.1,1613
2020-08-30,185,167,18,10.78,1613
2020-08-31,317,450,-133,-29.56,1613
2020-09-01,319,462,-143,-30.95,1613
2020-09-02,319,464,-145,-31.25,1613
2020-09-03,319,467,-148,-31.69,1613
2020-09-04,265,442,-177,-40.05,1613
2020-09-05,147,225,-78,-34.67,1613
2020-09-06,110,183,-73,-39.89,1613
2020-09-07,280,464,-184,-39.66,1613
2020-09-08,319,475,-156,-32.84,1613
2020-09-09,319,476,-157,-32.98,1613
2020-09-10,319,478,-159,-33.26,1613
2020-09-11,265,452,-187,-41.37,1613
2020-09-12,147,234,-87,-37.18,1613
2020-09-13,110,191,-81,-42.41,1613
2020-09-14,280,471,-191,-40.55,1613
2020-09-15,319,481,-162,-33.68,1613
2020-09-16,319,481,-162,-33.68,1613
2020-09-17,319,482,-163,-33.82,1613
2020-09-18,265,457,-192,-42.01,1613
2020-09-19,147,238,-91,-38.24,1613
2020-09-20,110,195,-85,-43.59,1613
2020-09-21,280,476,-196,-41.18,1613
2020-09-22,319,486,-167,-34.36,1613
2020-09-23,319,487,-168,-34.5,1613
2020-09-24,319,488,-169,-34.63,1613
2020-09-25,265,463,-198,-42.76,1613
2020-09-26,147,245,-98,-40.0,1613
2020-09-27,110,203,-93,-45.81,1613
2020-09-28,280,484,-204,-42.15,1613
2020-09-29,319,495,-176,-35.56,1613
2020-09-30,319,496,-177,-35.69,1613
2020-10-01,328,499,-171,-34.27,1613
2020-10-02,257,474,-217,-45.78,1613
2020-10-03,149,256,-107,-41.8,1613
2020-10-04,123,214,-91,-42.52,1613
2020-10-05,323,495,-172,-34.75,1613
2020-10-06,328,506,-178,-35.18,1613
2020-10-07,328,507,-179,-35.31,1613
2020-10-08,328,509,-181,-35.56,1613
2020-10-09,257,484,-227,-46.9,1613
2020-10-10,149,266,-117,-43.98,1613
2020-10-11,123,223,-100,-44.84,1613
2020-10-12,323,503,-180,-35.79,1613
2020-10-13,328,514,-186,-36.19,1613
2020-10-14,328,514,-186,-36.19,1613
2020-10-15,328,515,-187,-36.31,1613
2020-10-16,257,489,-232,-47.44,1613
2020-10-17,149,270,-121,-44.81,1613
2020-10-18,123,227,-104,-45.81,1613
2020-10-19,323,507,-184,-36.29,1613
2020-10-20,328,517,-189,-36.56,1613
2020-10-21,328,517,-189,-36.56,1613
2020-10-22,328,518,-190,-36.68,1613
2020-10-23,257,492,-235,-47.76,1613
2020-10-24,149,274,-125,-45.62,1613
2020-10-25,123,231,-108,-46.75,1613
2020-10-26,323,512,-189,-36.91,1613
2020-10-27,328,523,-195,-37.28,1613
2020-10-28,328,524,-196,-37.4,1613
2020-10-29,328,526,-198,-37.64,1613
2020-10-30,257,502,-245,-48.8,1613
2020-10-31,149,284,-135,-47.54,1613
2020-11-01,152,243,-91,-37.45,1613
2020-11-02,365,525,-160,-30.48,1613
2020-11-03,372,536,-164,-30.6,1613
2020-11-04,372,538,-166,-30.86,1613
2020-11-05,372,541,-169,-31.24,1613
2020-11-06,382,517,-135,-26.11,1613
2020-11-07,183,300,-117,-39.0,1613
2020-11-08,152,258,-106,-41.09,1613
2020-11-09,365,540,-175,-32.41,1613
2020-11-10,372,551,-179,-32.49,1613
2020-11-11,372,552,-180,-32.61,1613
2020-11-12,372,554,-182,-32.85,1613
2020-11-13,382,529,-147,-27.79,1613
2020-11-14,183,311,-128,-41.16,1613
2020-11-15,152,268,-116,-43.28,1613
2020-11-16,365,548,-183,-33.39,1613
2020-11-17,372,557,-185,-33.21,1613
2020-11-18,372,557,-185,-33.21,1613
2020-11-19,372,557,-185,-33.21,1613
2020-11-20,382,530,-148,-27.92,1613
2020-11-21,183,310,-127,-40.97,1613
2020-11-22,152,265,-113,-42.64,1613
2020-11-23,365,543,-178,-32.78,1613
2020-11-24,372,552,-180,-32.61,1613
2020-11-25,372,550,-178,-32.36,1613
2020-11-26,372,548,-176,-32.12,1613
2020-11-27,382,520,-138,-26.54,1613
2020-11-28,183,300,-117,-39.0,1613
2020-11-29,152,254,-102,-40.16,1613
2020-11-30,365,533,-168,-31.52,1613
2020-12-01,338,541,-203,-37.52,1613
2020-12-02,338,539,-201,-37.29,1613
2020-12-03,338,538,-200,-37.17,1613
2020-12-04,370,511,-141,-27.59,1613
2020-12-05,193,291,-98,-33.68,1613
2020-12-06,153,246,-93,-37.8,1613
2020-12-07,335,526,-191,-36.31,1613
2020-12-08,338,535,-197,-36.82,1613
2020-12-09,338,534,-196,-36.7,1613
2020-12-10,338,535,-197,-36.82,1613
2020-12-11,370,508,-138,-27.17,1613
2020-12-12,193,290,-97,-33.45,1613
2020-12-13,153,246,-93,-37.8,1613
2020-12-14,335,526,-191,-36.31,1613
2020-12-15,338,536,-198,-36.94,1613
2020-12-16,338,536,-198,-36.94,1613
2020-12-17,338,537,-199,-37.06,1613
2020-12-18,370,511,-141,-27.59,1613
2020-12-19,193,292,-99,-33.9,1613
2020-12-20,153,248,-95,-38.31,1613
2020-12-21,335,528,-193,-36.55,1613
2020-12-22,338,538,-200,-37.17,1613
2020-12-23,338,537,-199,-37.06,1613
2020-12-24,338,537,-199,-37.06,1613
2020-12-25,370,510,-140,-27.45,1613
2020-12-26,193,290,-97,-33.45,1613
2020-12-27,153,246,-93,-37.8,1613
2020-12-28,335,524,-189,-36.07,1613
2020-12-29,338,533,-195,-36.59,1613
2020-12-30,338,531,-193,-36.35,1613
2020-12-31,338,531,-193,-36.35,1613
2021-01-01,341,503,-162,-32.21,1613
2021-01-02,176,283,-107,-37.81,1613
2021-01-03,175,238,-63,-26.47,1613
2021-01-04,316,516,-200,-38.76,1613
2021-01-05,353,525,-172,-32.76,1613
2021-01-06,353,523,-170,-32.5,1613
2021-01-07,353,523,-170,-32.5,1613
2021-01-08,341,496,-155,-31.25,1613
2021-01-09,176,276,-100,-36.23,1613
2021-01-10,175,232,-57,-24.57,1613
2021-01-11,316,511,-195,-38.16,1613
2021-01-12,353,521,-168,-32.25,1613
2021-01-13,353,520,-167,-32.12,1613
2021-01-14,353,521,-168,-32.25,1613
2021-01-15,341,495,-154,-31.11,1613
2021-01-16,176,276,-100,-36.23,1613
2021-01-17,175,233,-58,-24.89,1613
2021-01-18,316,514,-198,-38.52,1613
2021-01-19,353,524,-171,-32.63,1613
2021-01-20,353,524,-171,-32.63,1613
2021-01-21,353,525,-172,-32.76,1613
2021-01-22,341,500,-159,-31.8,1613
2021-01-23,176,281,-105,-37.37,1613
2021-01-24,175,238,-63,-26.47,1613
2021-01-25,316,518,-202,-39.0,1613
2021-01-26,353,528,-175,-33.14,1613
2021-01-27,353,528,-175,-33.14,1613
2021-01-28,353,529,-176,-33.27,1613
2021-01-29,341,502,-161,-32.07,1613
2021-01-30,176,283,-107,-37.81,1613
2021-01-31,175,239,-64,-26.78,1613
2021-02-01,381,518,-137,-26.45,1613
2021-02-02,356,527,-171,-32.45,1613
2021-02-03,356,526,-170,-32.32,1613
2021-02-04,356,526,-170,-32.32,1613
2021-02-05,340,499,-159,-31.86,1613
2021-02-06,177,279,-102,-36.56,1613
2021-02-07,150,235,-85,-36.17,1613
2021-02-08,381,514,-133,-25.88,1613
2021-02-09,356,523,-167,-31.93,1613
2021-02-10,356,522,-166,-31.8,1613
2021-02-11,356,521,-165,-31.67,1613
2021-02-12,340,495,-155,-31.31,1613
2021-02-13,177,275,-98,-35.64,1613
2021-02-14,150,232,-82,-35.34,1613
2021-02-15,381,511,-130,-25.44,1613
2021-02-16,356,521,-165,-31.67,1613
2021-02-17,356,521,-165,-31.67,1613
2021-02-18,356,522,-166,-31.8,1613
2021-02-19,340,497,-157,-31.59,1613
2021-02-20,177,279,-102,-36.56,1613
2021-02-21,150,236,-86,-36.44,1613
2021-02-22,381,517,-136,-26.31,1613
2021-02-23,356,528,-172,-32.58,1613
2021-02-24,356,529,-173,-32.7,1613
2021-02-25,356,532,-176,-33.08,1613
2021-02-26,340,507,-167,-32.94,1613
2021-02-27,177,289,-112,-38.75,1613
2021-02-28,150,247,-97,-39.27,1613
2021-03-01,380,529,-149,-28.17,1613
2021-03-02,390,540,-150,-27.78,1613
2021-03-03,390,541,-151,-27.91,1613
2021-03-04,390,543,-153,-28.18,1613
2021-03-05,335,518,-183,-35.33,1613
2021-03-06,194,299,-105,-35.12,1613
2021-03-07,156,257,-101,-39.3,1613
2021-03-08,380,537,-157,-29.24,1613
2021-03-09,390,547,-157,-28.7,1613
2021-03-10,390,547,-157,-28.7,1613
2021-03-11,390,548,-158,-28.83,1613
2021-03-12,335,522,-187,-35.82,1613
2021-03-13,194,302,-108,-35.76,1613
2021-03-14,156,258,-102,-39.53,1613
2021-03-15,380,538,-158,-29.37,1613
2021-03-16,390,547,-157,-28.7,1613
2021-03-17,390,546,-156,-28.57,1613
2021-03-18,390,546,-156,-28.57,1613
2021-03-19,335,519,-184,-35.45,1613
2021-03-20,194,299,-105,-35.12,1613
2021-03-21,156,255,-99,-38.82,1613
2021-03-22,380,534,-154,-28.84,1613
2021-03-23,390,543,-153,-28.18,1613
2021-03-24,390,542,-152,-28.04,1613
2021-03-25,390,542,-152,-28.04,1613
2021-03-26,335,516,-181,-35.08,1613
2021-03-27,194,297,-103,-34.68,1613
2021-03-28,156,253,-97,-38.34,1613
2021-03-29,380,533,-153,-28.71,1613
2021-03-30,390,542,-152,-28.04,1613
2021-03-31,390,542,-152,-28.04,1613
2021-04-01,421,543,-122,-22.47,1613
2021-04-02,396,517,-121,-23.4,1613
2021-04-03,209,298,-89,-29.87,1613
2021-04-04,166,254,-88,-34.65,1613
2021-04-05,431,535,-104,-19.44,1613
2021-04-06,421,544,-123,-22.61,1613
2021-04-07,421,544,-123,-22.61,1613
2021-04-08,421,545,-124,-22.75,1613
2021-04-09,396,519,-123,-23.7,1613
2021-04-10,209,300,-91,-30.33,1613
2021-04-11,166,256,-90,-35.16,1613
2021-04-12,431,536,-105,-19.59,1613
2021-04-13,421,545,-124,-22.75,1613
2021-04-14,421,544,-123,-22.61,1613
2021-04-15,421,544,-123,-22.61,1613
2021-04-16,396,517,-121,-23.4,1613
2021-04-17,209,297,-88,-29.63,1613
2021-04-18,166,253,-87,-34.39,1613
2021-04-19,431,532,-101,-18.98,1613
2021-04-20,421,540,-119,-22.04,1613
2021-04-21,421,539,-118,-21.89,1613
2021-04-22,421,538,-117,-21.75,1613
2021-04-23,396,511,-115,-22.5,1613
2021-04-24,209,291,-82,-28.18,1613
2021-04-25,166,246,-80,-32.52,1613
2021-04-26,431,524,-93,-17.75,1613
2021-04-27,421,533,-112,-21.01,1613
2021-04-28,421,531,-110,-20.72,1613
2021-04-29,421,531,-110,-20.72,1613
2021-04-30,396,504,-108,-21.43,1613
2021-05-01,223,284,-61,-21.48,1613
2021-05-02,165,239,-74,-30.96,1613
2021-05-03,422,518,-96,-18.53,1613
2021-05-04,431,527,-96,-18.22,1613
2021-05-05,431,526,-95,-18.06,1613
2021-05-06,431,526,-95,-18.06,1613
2021-05-07,408,499,-91,-18.24,1613
2021-05-08,223,280,-57,-20.36,1613
2021-05-09,165,235,-70,-29.79,1613
2021-05-10,422,515,-93,-18.06,1613
2021-05-11,431,524,-93,-17.75,1613
2021-05-12,431,523,-92,-17.59,1613
2021-05-13,431,523,-92,-17.59,1613
2021-05-14,408,496,-88,-17.74,1613
2021-05-15,223,277,-54,-19.49,1613
2021-05-16,165,233,-68,-29.18,1613
2021-05-17,422,512,-90,-17.58,1613
2021-05-18,431,521,-90,-17.27,1613
2021-05-19,431,520,-89,-17.12,1613
2021-05-20,431,520,-89,-17.12,1613
2021-05-21,408,493,-85,-17.24,1613
2021-05-22,223,273,-50,-18.32,1613
2021-05-23,165,229,-64,-27.95,1613
2021-05-24,422,508,-86,-16.93,1613
2021-05-25,431,517,-86,-16.63,1613
2021-05-26,431,517,-86,-16.63,1613
2021-05-27,431,517,-86,-16.63,1613
2021-05-28,408,490,-82,-16.73,1613
2021-05-29,223,271,-48,-17.71,1613
2021-05-30,165,227,-62,-27.31,1613
2021-05-31,422,506,-84,-16.6,1613
2021-06-01,433,516,-83,-16.09,1613
2021-06-02,433,515,-82,-15.92,1613
2021-06-03,433,516,-83,-16.09,1613
2021-06-04,404,489,-85,-17.38,1613
2021-06-05,222,270,-48,-17.78,1613
2021-06-06,185,226,-41,-18.14,1613
2021-06-07,444,506,-62,-12.25,1613
2021-06-08,433,516,-83,-16.09,1613
2021-06-09,433,516,-83,-16.09,1613
2021-06-10,433,516,-83,-16.09,1613
2021-06-11,404,490,-86,-17.55,1613
2021-06-12,222,271,-49,-18.08,1613
2021-06-13,185,227,-42,-18.5,1613
2021-06-14,444,506,-62,-12.25,1613
2021-06-15,433,516,-83,-16.09,1613
2021-06-16,433,515,-82,-15.92,1613
2021-06-17,433,514,-81,-15.76,1613
2021-06-18,404,487,-83,-17.04,1613
2021-06-19,222,267,-45,-16.85,1613
2021-06-20,185,222,-37,-16.67,1613
2021-06-21,444,501,-57,-11.38,1613
2021-06-22,433,509,-76,-14.93,1613
2021-06-23,433,507,-74,-14.6,1613
2021-06-24,433,506,-73,-14.43,1613
2021-06-25,404,478,-74,-15.48,1613
2021-06-26,222,257,-35,-13.62,1613
2021-06-27,185,211,-26,-12.32,1613
2021-06-28,444,489,-45,-9.2,1613
2021-06-29,433,496,-63,-12.7,1613
2021-06-30,433,494,-61,-12.35,1613
2021-07-01,402,492,-90,-18.29,1613
2021-07-02,385,464,-79,-17.03,1613
2021-07-03,218,243,-25,-10.29,1613
2021-07-04,199,197,2,1.02,1613
2021-07-05,394,475,-81,-17.05,1613
2021-07-06,402,483,-81,-16.77,1613
2021-07-07,402,482,-80,-16.6,1613
2021-07-08,402,481,-79,-16.42,1613
2021-07-09,385,454,-69,-15.2,1613
2021-07-10,218,234,-16,-6.84,1613
2021-07-11,199,189,10,5.29,1613
2021-07-12,394,468,-74,-15.81,1613
2021-07-13,402,477,-75,-15.72,1613
2021-07-14,402,476,-74,-15.55,1613
2021-07-15,402,477,-75,-15.72,1613
2021-07-16,385,450,-65,-14.44,1613
2021-07-17,218,231,-13,-5.63,1613
2021-07-18,199,186,13,6.99,1613
2021-07-19,394,466,-72,-15.45,1613
2021-07-20,402,475,-73,-15.37,1613
2021-07-21,402,474,-72,-15.19,1613
2021-07-22,402,474,-72,-15.19,1613
2021-07-23,385,447,-62,-13.87,1613
2021-07-24,218,227,-9,-3.96,1613
2021-07-25,199,182,17,9.34,1613
2021-07-26,394,461,-67,-14.53,1613
2021-07-27,402,469,-67,-14.29,1613
2021-07-28,402,467,-65,-13.92,1613
2021-07-29,402,465,-63,-13.55,1613
2021-07-30,385,437,-52,-11.9,1613
2021-07-31,218,216,2,0.93,1613
2021-08-01,222,170,52,30.59,1613
2021-08-02,375,447,-72,-16.11,1613
2021-08-03,389,454,-65,-14.32,1613
2021-08-04,389,451,-62,-13.75,1613
2021-08-05,389,449,-60,-13.36,1613
2021-08-06,364,420,-56,-13.33,1613
2021-08-07,224,199,25,12.56,1613
2021-08-08,222,153,69,45.1,1613
2021-08-09,375,431,-56,-12.99,1613
2021-08-10,389,438,-49,-11.19,1613
2021-08-11,389,436,-47,-10.78,1613
2021-08-12,389,436,-47,-10.78,1613
2021-08-13,364,408,-44,-10.78,1613
2021-08-14,224,188,36,19.15,1613
2021-08-15,222,144,78,54.17,1613
2021-08-16,375,424,-49,-11.56,1613
2021-08-17,389,434,-45,-10.37,1613
2021-08-18,389,434,-45,-10.37,1613
2021-08-19,389,436,-47,-10.78,1613
2021-08-20,364,411,-47,-11.44,1613
2021-08-21,224,193,31,16.06,1613
2021-08-22,222,151,71,47.02,1613
2021-08-23,375,433,-58,-13.39,1613
2021-08-24,389,445,-56,-12.58,1613
2021-08-25,389,447,-58,-12.98,1613
2021-08-26,389,450,-61,-13.56,1613
2021-08-27,364,427,-63,-14.75,1613
2021-08-28,224,210,14,6.67,1613
2021-08-29,222,170,52,30.59,1613
2021-08-30,375,452,-77,-17.04,1613
2021-08-31,389,464,-75,-16.16,1613
2021-09-01,475,466,9,1.93,1613
2021-09-02,475,469,6,1.28,1613
2021-09-03,450,445,5,1.12,1613
2021-09-04,240,228,12,5.26,1613
2021-09-05,241,187,54,28.88,1613
2021-09-06,484,468,16,3.42,1613
2021-09-07,475,479,-4,-0.84,1613
2021-09-08,475,480,-5,-1.04,1613
2021-09-09,475,482,-7,-1.45,1613
2021-09-10,450,457,-7,-1.53,1613
2021-09-11,240,238,2,0.84,1613
2021-09-12,241,195,46,23.59,1613
2021-09-13,484,476,8,1.68,1613
2021-09-14,475,486,-11,-2.26,1613
2021-09-15,475,486,-11,-2.26,1613
2021-09-16,475,487,-12,-2.46,1613
2021-09-17,450,461,-11,-2.39,1613
2021-09-18,240,243,-3,-1.23,1613
2021-09-19,241,200,41,20.5,1613
2021-09-20,484,480,4,0.83,1613
2021-09-21,475,490,-15,-3.06,1613
2021-09-22,475,491,-16,-3.26,1613
2021-09-23,475,492,-17,-3.46,1613
2021-09-24,450,467,-17,-3.64,1613
2021-09-25,240,249,-9,-3.61,1613
2021-09-26,241,207,34,16.43,1613
2021-09-27,484,488,-4,-0.82,1613
2021-09-28,475,499,-24,-4.81,1613
2021-09-29,475,500,-25,-5.0,1613
2021-09-30,475,502,-27,-5.38,1613
2021-10-01,521,477,44,9.22,1613
2021-10-02,291,260,31,11.92,1613
2021-10-03,264,218,46,21.1,1613
2021-10-04,504,499,5,1.0,1613
2021-10-05,531,510,21,4.12,1613
2021-10-06,531,511,20,3.91,1613
2021-10-07,531,513,18,3.51,1613
2021-10-08,521,488,33,6.76,1613
2021-10-09,291,270,21,7.78,1613
2021-10-10,264,227,37,16.3,1613
2021-10-11,504,508,-4,-0.79,1613
2021-10-12,531,518,13,2.51,1613
2021-10-13,531,519,12,2.31,1613
2021-10-14,531,520,11,2.12,1613
2021-10-15,521,494,27,5.47,1613
2021-10-16,291,275,16,5.82,1613
2021-10-17,264,232,32,13.79,1613
2021-10-18,504,512,-8,-1.56,1613
2021-10-19,531,522,9,1.72,1613
2021-10-20,531,522,9,1.72,1613
2021-10-21,531,523,8,1.53,1613
2021-10-22,521,497,24,4.83,1613
2021-10-23,291,279,12,4.3,1613
2021-10-24,264,236,28,11.86,1613
2021-10-25,504,516,-12,-2.33,1613
2021-10-26,531,527,4,0.76,1613
2021-10-27,531,528,3,0.57,1613
2021-10-28,531,530,1,0.19,1613
2021-10-29,521,505,16,3.17,1613
2021-10-30,291,288,3,1.04,1613
2021-10-31,264,246,18,7.32,1613
2021-11-01,562,527,35,6.64,1613
2021-11-02,571,539,32,5.94,1613
2021-11-03,571,541,30,5.55,1613
2021-11-04,571,544,27,4.96,1613
2021-11-05,524,520,4,0.77,1613
2021-11-06,303,303,0,0.0,1613
2021-11-07,269,261,8,3.07,1613
2021-11-08,562,543,19,3.5,1613
2021-11-09,571,554,17,3.07,1613
2021-11-10,571,556,15,2.7,1613
2021-11-11,571,558,13,2.33,1613
2021-11-12,524,533,-9,-1.69,1613
2021-11-13,303,315,-12,-3.81,1613
2021-11-14,269,272,-3,-1.1,1613
2021-11-15,562,553,9,1.63,1613
2021-11-16,571,563,8,1.42,1613
2021-11-17,571,563,8,1.42,1613
2021-11-18,571,563,8,1.42,1613
2021-11-19,524,536,-12,-2.24,1613
2021-11-20,303,317,-14,-4.42,1613
2021-11-21,269,272,-3,-1.1,1613
2021-11-22,562,551,11,2.0,1613
2021-11-23,571,559,12,2.15,1613
2021-11-24,571,557,14,2.51,1613
2021-11-25,571,556,15,2.7,1613
2021-11-26,524,528,-4,-0.76,1613
2021-11-27,303,307,-4,-1.3,1613
2021-11-28,269,262,7,2.67,1613
2021-11-29,562,540,22,4.07,1613
2021-11-30,571,548,23,4.2,1613
2021-12-01,468,546,-78,-14.29,1613
2021-12-02,468,545,-77,-14.13,1613
2021-12-03,418,518,-100,-19.31,1613
2021-12-04,307,297,10,3.37,1613
2021-12-05,267,253,14,5.53,1613
2021-12-06,521,532,-11,-2.07,1613
2021-12-07,468,541,-73,-13.49,1613
2021-12-08,468,540,-72,-13.33,1613
2021-12-09,468,540,-72,-13.33,1613
2021-12-10,418,514,-96,-18.68,1613
2021-12-11,307,295,12,4.07,1613
2021-12-12,267,251,16,6.37,1613
2021-12-13,521,531,-10,-1.88,1613
2021-12-14,468,541,-73,-13.49,1613
2021-12-15,468,541,-73,-13.49,1613
2021-12-16,468,542,-74,-13.65,1613
2021-12-17,418,516,-98,-18.99,1613
2021-12-18,307,297,10,3.37,1613
2021-12-19,267,254,13,5.12,1613
2021-12-20,521,534,-13,-2.43,1613
2021-12-21,468,543,-75,-13.81,1613
2021-12-22,468,543,-75,-13.81,1613
2021-12-23,468,543,-75,-13.81,1613
2021-12-24,418,516,-98,-18.99,1613
2021-12-25,307,297,10,3.37,1613
2021-12-26,267,252,15,5.95,1613
2021-12-27,521,531,-10,-1.88,1613
2021-12-28,468,540,-72,-13.33,1613
2021-12-29,468,538,-70,-13.01,1613
2021-12-30,468,538,-70,-13.01,1613
2021-12-31,418,510,-92,-18.04,1613
2022-01-01,264,290,-26,-8.97,1613
2022-01-02,233,245,-12,-4.9,1613
2022-01-03,465,523,-58,-11.09,1613
2022-01-04,486,532,-46,-8.65,1613
2022-01-05,486,530,-44,-8.3,1613
2022-01-06,486,530,-44,-8.3,1613
2022-01-07,456,502,-46,-9.16,1613
2022-01-08,264,282,-18,-6.38,1613
2022-01-09,233,238,-5,-2.1,1613
2022-01-10,465,517,-52,-10.06,1613
2022-01-11,486,527,-41,-7.78,1613
2022-01-12,486,526,-40,-7.6,1613
2022-01-13,486,526,-40,-7.6,1613
2022-01-14,456,500,-44,-8.8,1613
2022-01-15,264,281,-17,-6.05,1613
2022-01-16,233,238,-5,-2.1,1613
2022-01-17,465,518,-53,-10.23,1613
2022-01-18,486,528,-42,-7.95,1613
2022-01-19,486,529,-43,-8.13,1613
2022-01-20,486,530,-44,-8.3,1613
2022-01-21,456,504,-48,-9.52,1613
2022-01-22,264,286,-22,-7.69,1613
2022-01-23,233,243,-10,-4.12,1613
2022-01-24,465,523,-58,-11.09,1613
2022-01-25,486,533,-47,-8.82,1613
2022-01-26,486,533,-47,-8.82,1613
2022-01-27,486,534,-48,-8.99,1613
2022-01-28,456,508,-52,-10.24,1613
2022-01-29,264,289,-25,-8.65,1613
2022-01-30,233,245,-12,-4.9,1613
2020-02-01,675,1038,-363,-34.97,1614
2020-02-02,578,983,-405,-41.2,1614
2020-02-03,1227,1376,-149,-10.83,1614
2020-02-04,1330,1402,-72,-5.14,1614
2020-02-05,1330,1406,-76,-5.41,1614
2020-02-06,1330,1408,-78,-5.54,1614
2020-02-07,1270,1379,-109,-7.9,1614
2020-02-08,675,1061,-386,-36.38,1614
2020-02-09,578,1006,-428,-42.54,1614
2020-02-10,1227,1397,-170,-12.17,1614
2020-02-11,1330,1423,-93,-6.54,1614
2020-02-12,1330,1426,-96,-6.73,1614
2020-02-13,1330,1428,-98,-6.86,1614
2020-02-14,1270,1398,-128,-9.16,1614
2020-02-15,675,1080,-405,-37.5,1614
2020-02-16,578,1024,-446,-43.55,1614
2020-02-17,1227,1416,-189,-13.35,1614
2020-02-18,1330,1442,-112,-7.77,1614
2020-02-19,1330,1445,-115,-7.96,1614
2020-02-20,1330,1448,-118,-8.15,1614
2020-02-21,1270,1419,-149,-10.5,1614
2020-02-22,675,1102,-427,-38.75,1614
2020-02-23,578,1047,-469,-44.79,1614
2020-02-24,1227,1440,-213,-14.79,1614
2020-02-25,1330,1466,-136,-9.28,1614
2020-02-26,1330,1471,-141,-9.59,1614
2020-02-27,1330,1475,-145,-9.83,1614
2020-02-28,1270,1447,-177,-12.23,1614
2020-02-29,675,1130,-455,-40.27,1614
2020-03-01,535,1076,-541,-50.28,1614
2020-03-02,1093,1470,-377,-25.65,1614
2020-03-03,1092,1497,-405,-27.05,1614
2020-03-04,1092,1502,-410,-27.3,1614
2020-03-05,1092,1506,-414,-27.49,1614
2020-03-06,1018,1478,-460,-31.12,1614
2020-03-07,594,1161,-567,-48.84,1614
2020-03-08,535,1107,-572,-51.67,1614
2020-03-09,1093,1500,-407,-27.13,1614
2020-03-10,1092,1527,-435,-28.49,1614
2020-03-11,1092,1531,-439,-28.67,1614
2020-03-12,1092,1534,-442,-28.81,1614
2020-03-13,1018,1505,-487,-32.36,1614
2020-03-14,594,1187,-593,-49.96,1614
2020-03-15,535,1132,-597,-52.74,1614
2020-03-16,1093,1523,-430,-28.23,1614
2020-03-17,1092,1549,-457,-29.5,1614
2020-03-18,1092,1551,-459,-29.59,1614
2020-03-19,1092,1553,-461,-29.68,1614
2020-03-20,1018,1523,-505,-33.16,1614
2020-03-21,594,1204,-610,-50.66,1614
2020-03-22,535,1148,-613,-53.4,1614
2020-03-23,1093,1538,-445,-28.93,1614
2020-03-24,1092,1563,-471,-30.13,1614
2020-03-25,1092,1565,-473,-30.22,1614
2020-03-26,1092,1567,-475,-30.31,1614
2020-03-27,1018,1536,-518,-33.72,1614
2020-03-28,594,1217,-623,-51.19,1614
2020-03-29,535,1160,-625,-53.88,1614
2020-03-30,1093,1551,-458,-29.53,1614
2020-03-31,1092,1576,-484,-30.71,1614
2020-04-01,989,1579,-590,-37.37,1614
2020-04-02,989,1581,-592,-37.44,1614
2020-04-03,871,1551,-680,-43.84,1614
2020-04-04,562,1232,-670,-54.38,1614
2020-04-05,478,1176,-698,-59.35,1614
2020-04-06,987,1568,-581,-37.05,1614
2020-04-07,989,1593,-604,-37.92,1614
2020-04-08,989,1597,-608,-38.07,1614
2020-04-09,989,1599,-610,-38.15,1614
2020-04-10,871,1570,-699,-44.52,1614
2020-04-11,562,1252,-690,-55.11,1614
2020-04-12,478,1196,-718,-60.03,1614
2020-04-13,987,1588,-601,-37.85,1614
2020-04-14,989,1613,-624,-38.69,1614
2020-04-15,989,1617,-628,-38.84,1614
2020-04-16,989,1619,-630,-38.91,1614
2020-04-17,871,1589,-718,-45.19,1614
2020-04-18,562,1271,-709,-55.78,1614
2020-04-19,478,1214,-736,-60.63,1614
2020-04-20,987,1606,-619,-38.54,1614
2020-04-21,989,1630,-641,-39.33,1614
2020-04-22,989,1633,-644,-39.44,1614
2020-04-23,989,1634,-645,-39.47,1614
2020-04-24,871,1603,-732,-45.66,1614
2020-04-25,562,1283,-721,-56.2,1614
2020-04-26,478,1226,-748,-61.01,1614
2020-04-27,987,1616,-629,-38.92,1614
2020-04-28,989,1640,-651,-39.7,1614
2020-04-29,989,1641,-652,-39.73,1614
2020-04-30,989,1641,-652,-39.73,1614
2020-05-01,1130,1609,-479,-29.77,1614
2020-05-02,619,1289,-670,-51.98,1614
2020-05-03,527,1231,-704,-57.19,1614
2020-05-04,1152,1621,-469,-28.93,1614
2020-05-05,1221,1644,-423,-25.73,1614
2020-05-06,1221,1645,-424,-25.78,1614
2020-05-07,1221,1645,-424,-25.78,1614
2020-05-08,1130,1614,-484,-29.99,1614
2020-05-09,619,1294,-675,-52.16,1614
2020-05-10,527,1237,-710,-57.4,1614
2020-05-11,1152,1627,-475,-29.19,1614
2020-05-12,1221,1652,-431,-26.09,1614
2020-05-13,1221,1654,-433,-26.18,1614
2020-05-14,1221,1656,-435,-26.27,1614
2020-05-15,1130,1626,-496,-30.5,1614
2020-05-16,619,1308,-689,-52.68,1614
2020-05-17,527,1253,-726,-57.94,1614
2020-05-18,1152,1645,-493,-29.97,1614
2020-05-19,1221,1672,-451,-26.97,1614
2020-05-20,1221,1676,-455,-27.15,1614
2020-05-21,1221,1680,-459,-27.32,1614
2020-05-22,1130,1653,-523,-31.64,1614
2020-05-23,619,1337,-718,-53.7,1614
2020-05-24,527,1284,-757,-58.96,1614
2020-05-25,1152,1678,-526,-31.35,1614
2020-05-26,1221,1707,-486,-28.47,1614
2020-05-27,1221,1713,-492,-28.72,1614
2020-05-28,1221,1719,-498,-28.97,1614
2020-05-29,1130,1693,-563,-33.25,1614
2020-05-30,619,1378,-759,-55.08,1614
2020-05-31,527,1326,-799,-60.26,1614
2020-06-01,1164,1721,-557,-32.36,1614
2020-06-02,1201,1750,-549,-31.37,1614
2020-06-03,1201,1757,-556,-31.64,1614
2020-06-04,1201,1763,-562,-31.88,1614
2020-06-05,1091,1737,-646,-37.19,1614
2020-06-06,591,1421,-830,-58.41,1614
2020-06-07,511,1369,-858,-62.67,1614
2020-06-08,1164,1763,-599,-33.98,1614
2020-06-09,1201,1791,-590,-32.94,1614
2020-06-10,1201,1796,-595,-33.13,1614
2020-06-11,1201,1801,-600,-33.31,1614
2020-06-12,1091,1773,-682,-38.47,1614
2020-06-13,591,1456,-865,-59.41,1614
2020-06-14,511,1401,-890,-63.53,1614
2020-06-15,1164,1794,-630,-35.12,1614
2020-06-16,1201,1820,-619,-34.01,1614
2020-06-17,1201,1823,-622,-34.12,1614
2020-06-18,1201,1825,-624,-34.19,1614
2020-06-19,1091,1796,-705,-39.25,1614
2020-06-20,591,1477,-886,-59.99,1614
2020-06-21,511,1420,-909,-64.01,1614
2020-06-22,1164,1811,-647,-35.73,1614
2020-06-23,1201,1835,-634,-34.55,1614
2020-06-24,1201,1837,-636,-34.62,1614
2020-06-25,1201,1838,-637,-34.66,1614
2020-06-26,1091,1808,-717,-39.66,1614
2020-06-27,591,1488,-897,-60.28,1614
2020-06-28,511,1431,-920,-64.29,1614
2020-06-29,1164,1821,-657,-36.08,1614
2020-06-30,1201,1846,-645,-34.94,1614
2020-07-01,1282,1848,-566,-30.63,1614
2020-07-02,1282,1849,-567,-30.67,1614
2020-07-03,1192,1818,-626,-34.43,1614
2020-07-04,602,1499,-897,-59.84,1614
2020-07-05,561,1443,-882,-61.12,1614
2020-07-06,1320,1834,-514,-28.03,1614
2020-07-07,1282,1859,-577,-31.04,1614
2020-07-08,1282,1862,-580,-31.15,1614
2020-07-09,1282,1864,-582,-31.22,1614
2020-07-10,1192,1835,-643,-35.04,1614
2020-07-11,602,1516,-914,-60.29,1614
2020-07-12,561,1461,-900,-61.6,1614
2020-07-13,1320,1853,-533,-28.76,1614
2020-07-14,1282,1879,-597,-31.77,1614
2020-07-15,1282,1882,-600,-31.88,1614
2020-07-16,1282,1885,-603,-31.99,1614
2020-07-17,1192,1856,-664,-35.78,1614
2020-07-18,602,1538,-936,-60.86,1614
2020-07-19,561,1482,-921,-62.15,1614
2020-07-20,1320,1874,-554,-29.56,1614
2020-07-21,1282,1900,-618,-32.53,1614
2020-07-22,1282,1903,-621,-32.63,1614
2020-07-23,1282,1906,-624,-32.74,1614
2020-07-24,1192,1876,-684,-36.46,1614
2020-07-25,602,1558,-956,-61.36,1614
2020-07-26,561,1501,-940,-62.62,1614
2020-07-27,1320,1893,-573,-30.27,1614
2020-07-28,1282,1918,-636,-33.16,1614
2020-07-29,1282,1920,-638,-33.23,1614
2020-07-30,1282,1922,-640,-33.3,1614
2020-07-31,1192,1892,-700,-37.0,1614
2020-08-01,634,1573,-939,-59.69,1614
2020-08-02,560,1516,-956,-63.06,1614
2020-08-03,1171,1907,-736,-38.59,1614
2020-08-04,1218,1932,-714,-36.96,1614
2020-08-05,1218,1934,-716,-37.02,1614
2020-08-06,1218,1936,-718,-37.09,1614
2020-08-07,1159,1906,-747,-39.19,1614
2020-08-08,634,1587,-953,-60.05,1614
2020-08-09,560,1531,-971,-63.42,1614
2020-08-10,1171,1922,-751,-39.07,1614
2020-08-11,1218,1947,-729,-37.44,1614
2020-08-12,1218,1950,-732,-37.54,1614
2020-08-13,1218,1953,-735,-37.63,1614
2020-08-14,1159,1923,-764,-39.73,1614
2020-08-15,634,1605,-971,-60.5,1614
2020-08-16,560,1550,-990,-63.87,1614
2020-08-17,1171,1942,-771,-39.7,1614
2020-08-18,1218,1968,-750,-38.11,1614
2020-08-19,1218,1972,-754,-38.24,1614
2020-08-20,1218,1974,-756,-38.3,1614
2020-08-21,1159,1945,-786,-40.41,1614
2020-08-22,634,1628,-994,-61.06,1614
2020-08-23,560,1572,-1012,-64.38,1614
2020-08-24,1171,1964,-793,-40.38,1614
2020-08-25,1218,1990,-772,-38.79,1614
2020-08-26,1218,1994,-776,-38.92,1614
2020-08-27,1218,1996,-778,-38.98,1614
2020-08-28,1159,1967,-808,-41.08,1614
2020-08-29,634,1648,-1014,-61.53,1614
2020-08-30,560,1592,-1032,-64.82,1614
2020-08-31,1171,1983,-812,-40.95,1614
2020-09-01,1311,2008,-697,-34.71,1614
2020-09-02,1311,2011,-700,-34.81,1614
2020-09-03,1311,2012,-701,-34.84,1614
2020-09-04,1196,1982,-786,-39.66,1614
2020-09-05,678,1662,-984,-59.21,1614
2020-09-06,574,1606,-1032,-64.26,1614
2020-09-07,1309,1996,-687,-34.42,1614
2020-09-08,1311,2021,-710,-35.13,1614
2020-09-09,1311,2023,-712,-35.2,1614
2020-09-10,1311,2024,-713,-35.23,1614
2020-09-11,1196,1994,-798,-40.02,1614
2020-09-12,678,1675,-997,-59.52,1614
2020-09-13,574,1619,-1045,-64.55,1614
2020-09-14,1309,2010,-701,-34.88,1614
2020-09-15,1311,2035,-724,-35.58,1614
2020-09-16,1311,2038,-727,-35.67,1614
2020-09-17,1311,2041,-730,-35.77,1614
2020-09-18,1196,2012,-816,-40.56,1614
2020-09-19,678,1695,-1017,-60.0,1614
2020-09-20,574,1640,-1066,-65.0,1614
2020-09-21,1309,2033,-724,-35.61,1614
2020-09-22,1311,2060,-749,-36.36,1614
2020-09-23,1311,2065,-754,-36.51,1614
2020-09-24,1311,2069,-758,-36.64,1614
2020-09-25,1196,2042,-846,-41.43,1614
2020-09-26,678,1726,-1048,-60.72,1614
2020-09-27,574,1673,-1099,-65.69,1614
2020-09-28,1309,2067,-758,-36.67,1614
2020-09-29,1311,2095,-784,-37.42,1614
2020-09-30,1311,2101,-790,-37.6,1614
2020-10-01,1322,2106,-784,-37.23,1614
2020-10-02,1224,2079,-855,-41.13,1614
2020-10-03,667,1763,-1096,-62.17,1614
2020-10-04,568,1709,-1141,-66.76,1614
2020-10-05,1322,2103,-781,-37.14,1614
2020-10-06,1322,2131,-809,-37.96,1614
2020-10-07,1322,2136,-814,-38.11,1614
2020-10-08,1322,2139,-817,-38.2,1614
2020-10-09,1224,2111,-887,-42.02,1614
2020-10-10,667,1794,-1127,-62.82,1614
2020-10-11,568,1738,-1170,-67.32,1614
2020-10-12,1322,2131,-809,-37.96,1614
2020-10-13,1322,2156,-834,-38.68,1614
2020-10-14,1322,2159,-837,-38.77,1614
2020-10-15,1322,2161,-839,-38.82,1614
2020-10-16,1224,2131,-907,-42.56,1614
2020-10-17,667,1812,-1145,-63.19,1614
2020-10-18,568,1755,-1187,-67.64,1614
2020-10-19,1322,2145,-823,-38.37,1614
2020-10-20,1322,2169,-847,-39.05,1614
2020-10-21,1322,2171,-849,-39.11,1614
2020-10-22,1322,2172,-850,-39.13,1614
2020-10-23,1224,2141,-917,-42.83,1614
2020-10-24,667,1821,-1154,-63.37,1614
2020-10-25,568,1763,-1195,-67.78,1614
2020-10-26,1322,2154,-832,-38.63,1614
2020-10-27,1322,2178,-856,-39.3,1614
2020-10-28,1322,2179,-857,-39.33,1614
2020-10-29,1322,2180,-858,-39.36,1614
2020-10-30,1224,2149,-925,-43.04,1614
2020-10-31,667,1830,-1163,-63.55,1614
2020-11-01,528,1773,-1245,-70.22,1614
2020-11-02,1266,2164,-898,-41.5,1614
2020-11-03,1273,2188,-915,-41.82,1614
2020-11-04,1273,2191,-918,-41.9,1614
2020-11-05,1273,2192,-919,-41.93,1614
2020-11-06,1221,2162,-941,-43.52,1614
2020-11-07,649,1843,-1194,-64.79,1614
2020-11-08,528,1786,-1258,-70.44,1614
2020-11-09,1266,2177,-911,-41.85,1614
2020-11-10,1273,2202,-929,-42.19,1614
2020-11-11,1273,2205,-932,-42.27,1614
2020-11-12,1273,2206,-933,-42.29,1614
2020-11-13,1221,2176,-955,-43.89,1614
2020-11-14,649,1856,-1207,-65.03,1614
2020-11-15,528,1800,-1272,-70.67,1614
2020-11-16,1266,2190,-924,-42.19,1614
2020-11-17,1273,2215,-942,-42.53,1614
2020-11-18,1273,2216,-943,-42.55,1614
2020-11-19,1273,2217,-944,-42.58,1614
2020-11-20,1221,2186,-965,-44.14,1614
2020-11-21,649,1867,-1218,-65.24,1614
2020-11-22,528,1809,-1281,-70.81,1614
2020-11-23,1266,2200,-934,-42.45,1614
2020-11-24,1273,2223,-950,-42.74,1614
2020-11-25,1273,2225,-952,-42.79,1614
2020-11-26,1273,2226,-953,-42.81,1614
2020-11-27,1221,2195,-974,-44.37,1614
2020-11-28,649,1875,-1226,-65.39,1614
2020-11-29,528,1818,-1290,-70.96,1614
2020-11-30,1266,2208,-942,-42.66,1614
2020-12-01,1105,2232,-1127,-50.49,1614
2020-12-02,1105,2235,-1130,-50.56,1614
2020-12-03,1105,2236,-1131,-50.58,1614
2020-12-04,1233,2205,-972,-44.08,1614
2020-12-05,656,1886,-1230,-65.22,1614
2020-12-06,535,1830,-1295,-70.77,1614
2020-12-07,1156,2221,-1065,-47.95,1614
2020-12-08,1105,2245,-1140,-50.78,1614
2020-12-09,1105,2248,-1143,-50.85,1614
2020-12-10,1105,2250,-1145,-50.89,1614
2020-12-11,1233,2219,-986,-44.43,1614
2020-12-12,656,1900,-1244,-65.47,1614
2020-12-13,535,1844,-1309,-70.99,1614
2020-12-14,1156,2235,-1079,-48.28,1614
2020-12-15,1105,2259,-1154,-51.08,1614
2020-12-16,1105,2261,-1156,-51.13,1614
2020-12-17,1105,2262,-1157,-51.15,1614
2020-12-18,1233,2231,-998,-44.73,1614
2020-12-19,656,1911,-1255,-65.67,1614
2020-12-20,535,1853,-1318,-71.13,1614
2020-12-21,1156,2243,-1087,-48.46,1614
2020-12-22,1105,2266,-1161,-51.24,1614
2020-12-23,1105,2266,-1161,-51.24,1614
2020-12-24,1105,2266,-1161,-51.24,1614
2020-12-25,1233,2233,-1000,-44.78,1614
2020-12-26,656,1911,-1255,-65.67,1614
2020-12-27,535,1852,-1317,-71.11,1614
2020-12-28,1156,2240,-1084,-48.39,1614
2020-12-29,1105,2261,-1156,-51.13,1614
2020-12-30,1105,2260,-1155,-51.11,1614
2020-12-31,1105,2259,-1154,-51.08,1614
2021-01-01,1069,2225,-1156,-51.96,1614
2021-01-02,611,1903,-1292,-67.89,1614
2021-01-03,510,1843,-1333,-72.33,1614
2021-01-04,1076,2231,-1155,-51.77,1614
2021-01-05,1148,2252,-1104,-49.02,1614
2021-01-06,1148,2252,-1104,-49.02,1614
2021-01-07,1148,2251,-1103,-49.0,1614
2021-01-08,1069,2219,-1150,-51.83,1614
2021-01-09,611,1897,-1286,-67.79,1614
2021-01-10,510,1839,-1329,-72.27,1614
2021-01-11,1076,2229,-1153,-51.73,1614
2021-01-12,1148,2253,-1105,-49.05,1614
2021-01-13,1148,2254,-1106,-49.07,1614
2021-01-14,1148,2256,-1108,-49.11,1614
2021-01-15,1069,2226,-1157,-51.98,1614
2021-01-16,611,1907,-1296,-67.96,1614
2021-01-17,510,1851,-1341,-72.45,1614
2021-01-18,1076,2243,-1167,-52.03,1614
2021-01-19,1148,2269,-1121,-49.41,1614
2021-01-20,1148,2273,-1125,-49.49,1614
2021-01-21,1148,2277,-1129,-49.58,1614
2021-01-22,1069,2248,-1179,-52.45,1614
2021-01-23,611,1932,-1321,-68.37,1614
2021-01-24,510,1877,-1367,-72.83,1614
2021-01-25,1076,2271,-1195,-52.62,1614
2021-01-26,1148,2298,-1150,-50.04,1614
2021-01-27,1148,2302,-1154,-50.13,1614
2021-01-28,1148,2306,-1158,-50.22,1614
2021-01-29,1069,2278,-1209,-53.07,1614
2021-01-30,611,1961,-1350,-68.84,1614
2021-01-31,510,1907,-1397,-73.26,1614
2021-02-01,1164,2299,-1135,-49.37,1614
2021-02-02,1195,2326,-1131,-48.62,1614
2021-02-03,1195,2330,-1135,-48.71,1614
2021-02-04,1195,2333,-1138,-48.78,1614
2021-02-05,1149,2304,-1155,-50.13,1614
2021-02-06,602,1986,-1384,-69.69,1614
2021-02-07,511,1930,-1419,-73.52,1614
2021-02-08,1164,2322,-1158,-49.87,1614
2021-02-09,1195,2348,-1153,-49.11,1614
2021-02-10,1195,2351,-1156,-49.17,1614
2021-02-11,1195,2353,-1158,-49.21,1614
2021-02-12,1149,2323,-1174,-50.54,1614
2021-02-13,602,2005,-1403,-69.98,1614
2021-02-14,511,1949,-1438,-73.78,1614
2021-02-15,1164,2341,-1177,-50.28,1614
2021-02-16,1195,2366,-1171,-49.49,1614
2021-02-17,1195,2370,-1175,-49.58,1614
2021-02-18,1195,2372,-1177,-49.62,1614
2021-02-19,1149,2343,-1194,-50.96,1614
2021-02-20,602,2026,-1424,-70.29,1614
2021-02-21,511,1971,-1460,-74.07,1614
2021-02-22,1164,2363,-1199,-50.74,1614
2021-02-23,1195,2390,-1195,-50.0,1614
2021-02-24,1195,2394,-1199,-50.08,1614
2021-02-25,1195,2398,-1203,-50.17,1614
2021-02-26,1149,2370,-1221,-51.52,1614
2021-02-27,602,2053,-1451,-70.68,1614
2021-02-28,511,1999,-1488,-74.44,1614
2021-03-01,1236,2392,-1156,-48.33,1614
2021-03-02,1273,2420,-1147,-47.4,1614
2021-03-03,1273,2425,-1152,-47.51,1614
2021-03-04,1273,2429,-1156,-47.59,1614
2021-03-05,1161,2401,-1240,-51.65,1614
2021-03-06,651,2084,-1433,-68.76,1614
2021-03-07,523,2030,-1507,-74.24,1614
2021-03-08,1236,2423,-1187,-48.99,1614
2021-03-09,1273,2450,-1177,-48.04,1614
2021-03-10,1273,2455,-1182,-48.15,1614
2021-03-11,1273,2458,-1185,-48.21,1614
2021-03-12,1161,2429,-1268,-52.2,1614
2021-03-13,651,2111,-1460,-69.16,1614
2021-03-14,523,2056,-1533,-74.56,1614
2021-03-15,1236,2448,-1212,-49.51,1614
2021-03-16,1273,2474,-1201,-48.54,1614
2021-03-17,1273,2477,-1204,-48.61,1614
2021-03-18,1273,2479,-1206,-48.65,1614
2021-03-19,1161,2449,-1288,-52.59,1614
2021-03-20,651,2130,-1479,-69.44,1614
2021-03-21,523,2073,-1550,-74.77,1614
2021-03-22,1236,2464,-1228,-49.84,1614
2021-03-23,1273,2489,-1216,-48.85,1614
2021-03-24,1273,2491,-1218,-48.9,1614
2021-03-25,1273,2493,-1220,-48.94,1614
2021-03-26,1161,2462,-1301,-52.84,1614
2021-03-27,651,2143,-1492,-69.62,1614
2021-03-28,523,2086,-1563,-74.93,1614
2021-03-29,1236,2477,-1241,-50.1,1614
2021-03-30,1273,2502,-1229,-49.12,1614
2021-03-31,1273,2504,-1231,-49.16,1614
2021-04-01,1219,2506,-1287,-51.36,1614
2021-04-02,1164,2476,-1312,-52.99,1614
2021-04-03,638,2157,-1519,-70.42,1614
2021-04-04,529,2101,-1572,-74.82,1614
2021-04-05,1203,2493,-1290,-51.74,1614
2021-04-06,1219,2518,-1299,-51.59,1614
2021-04-07,1219,2521,-1302,-51.65,1614
2021-04-08,1219,2524,-1305,-51.7,1614
2021-04-09,1164,2494,-1330,-53.33,1614
2021-04-10,638,2176,-1538,-70.68,1614
2021-04-11,529,2121,-1592,-75.06,1614
2021-04-12,1203,2513,-1310,-52.13,1614
2021-04-13,1219,2538,-1319,-51.97,1614
2021-04-14,1219,2541,-1322,-52.03,1614
2021-04-15,1219,2544,-1325,-52.08,1614
2021-04-16,1164,2514,-1350,-53.7,1614
2021-04-17,638,2196,-1558,-70.95,1614
2021-04-18,529,2140,-1611,-75.28,1614
2021-04-19,1203,2531,-1328,-52.47,1614
2021-04-20,1219,2556,-1337,-52.31,1614
2021-04-21,1219,2559,-1340,-52.36,1614
2021-04-22,1219,2560,-1341,-52.38,1614
2021-04-23,1164,2529,-1365,-53.97,1614
2021-04-24,638,2210,-1572,-71.13,1614
2021-04-25,529,2153,-1624,-75.43,1614
2021-04-26,1203,2543,-1340,-52.69,1614
2021-04-27,1219,2567,-1348,-52.51,1614
2021-04-28,1219,2568,-1349,-52.53,1614
2021-04-29,1219,2568,-1349,-52.53,1614
2021-04-30,1164,2537,-1373,-54.12,1614
2021-05-01,689,2217,-1528,-68.92,1614
2021-05-02,538,2159,-1621,-75.08,1614
2021-05-03,1276,2548,-1272,-49.92,1614
2021-05-04,1333,2571,-1238,-48.15,1614
2021-05-05,1333,2573,-1240,-48.19,1614
2021-05-06,1333,2573,-1240,-48.19,1614
2021-05-07,1276,2541,-1265,-49.78,1614
2021-05-08,689,2221,-1532,-68.98,1614
2021-05-09,538,2164,-1626,-75.14,1614
2021-05-10,1276,2554,-1278,-50.04,1614
2021-05-11,1333,2578,-1245,-48.29,1614
2021-05-12,1333,2580,-1247,-48.33,1614
2021-05-13,1333,2581,-1248,-48.35,1614
2021-05-14,1276,2551,-1275,-49.98,1614
2021-05-15,689,2233,-1544,-69.14,1614
2021-05-16,538,2177,-1639,-75.29,1614
2021-05-17,1276,2569,-1293,-50.33,1614
2021-05-18,1333,2595,-1262,-48.63,1614
2021-05-19,1333,2599,-1266,-48.71,1614
2021-05-20,1333,2603,-1270,-48.79,1614
2021-05-21,1276,2575,-1299,-50.45,1614
2021-05-22,689,2259,-1570,-69.5,1614
2021-05-23,538,2205,-1667,-75.6,1614
2021-05-24,1276,2600,-1324,-50.92,1614
2021-05-25,1333,2628,-1295,-49.28,1614
2021-05-26,1333,2634,-1301,-49.39,1614
2021-05-27,1333,2639,-1306,-49.49,1614
2021-05-28,1276,2613,-1337,-51.17,1614
2021-05-29,689,2298,-1609,-70.02,1614
2021-05-30,538,2246,-1708,-76.05,1614
2021-05-31,1276,2642,-1366,-51.7,1614
2021-06-01,1395,2671,-1276,-47.77,1614
2021-06-02,1395,2677,-1282,-47.89,1614
2021-06-03,1395,2683,-1288,-48.01,1614
2021-06-04,1277,2657,-1380,-51.94,1614
2021-06-05,661,2342,-1681,-71.78,1614
2021-06-06,568,2290,-1722,-75.2,1614
2021-06-07,1386,2685,-1299,-48.38,1614
2021-06-08,1395,2713,-1318,-48.58,1614
2021-06-09,1395,2719,-1324,-48.69,1614
2021-06-10,1395,2723,-1328,-48.77,1614
2021-06-11,1277,2696,-1419,-52.63,1614
2021-06-12,661,2379,-1718,-72.22,1614
2021-06-13,568,2325,-1757,-75.57,1614
2021-06-14,1386,2718,-1332,-49.01,1614
2021-06-15,1395,2744,-1349,-49.16,1614
2021-06-16,1395,2748,-1353,-49.24,1614
2021-06-17,1395,2750,-1355,-49.27,1614
2021-06-18,1277,2721,-1444,-53.07,1614
2021-06-19,661,2402,-1741,-72.48,1614
2021-06-20,568,2346,-1778,-75.79,1614
2021-06-21,1386,2737,-1351,-49.36,1614
2021-06-22,1395,2762,-1367,-49.49,1614
2021-06-23,1395,2764,-1369,-49.53,1614
2021-06-24,1395,2765,-1370,-49.55,1614
2021-06-25,1277,2734,-1457,-53.29,1614
2021-06-26,661,2415,-1754,-72.63,1614
2021-06-27,568,2357,-1789,-75.9,1614
2021-06-28,1386,2748,-1362,-49.56,1614
2021-06-29,1395,2772,-1377,-49.68,1614
2021-06-30,1395,2774,-1379,-49.71,1614
2021-07-01,1323,2775,-1452,-52.32,1614
2021-07-02,1280,2745,-1465,-53.37,1614
2021-07-03,639,2425,-1786,-73.65,1614
2021-07-04,546,2369,-1823,-76.95,1614
2021-07-05,1285,2760,-1475,-53.44,1614
2021-07-06,1323,2785,-1462,-52.5,1614
2021-07-07,1323,2787,-1464,-52.53,1614
2021-07-08,1323,2789,-1466,-52.56,1614
2021-07-09,1280,2760,-1480,-53.62,1614
2021-07-10,639,2441,-1802,-73.82,1614
2021-07-11,546,2386,-1840,-77.12,1614
2021-07-12,1285,2778,-1493,-53.74,1614
2021-07-13,1323,2803,-1480,-52.8,1614
2021-07-14,1323,2807,-1484,-52.87,1614
2021-07-15,1323,2809,-1486,-52.9,1614
2021-07-16,1280,2780,-1500,-53.96,1614
2021-07-17,639,2462,-1823,-74.05,1614
2021-07-18,546,2407,-1861,-77.32,1614
2021-07-19,1285,2799,-1514,-54.09,1614
2021-07-20,1323,2825,-1502,-53.17,1614
2021-07-21,1323,2828,-1505,-53.22,1614
2021-07-22,1323,2830,-1507,-53.25,1614
2021-07-23,1280,2801,-1521,-54.3,1614
2021-07-24,639,2483,-1844,-74.27,1614
2021-07-25,546,2427,-1881,-77.5,1614
2021-07-26,1285,2818,-1533,-54.4,1614
2021-07-27,1323,2843,-1520,-53.46,1614
2021-07-28,1323,2846,-1523,-53.51,1614
2021-07-29,1323,2848,-1525,-53.55,1614
2021-07-30,1280,2818,-1538,-54.58,1614
2021-07-31,639,2499,-1860,-74.43,1614
2021-08-01,540,2442,-1902,-77.89,1614
2021-08-02,1212,2833,-1621,-57.22,1614
2021-08-03,1255,2858,-1603,-56.09,1614
2021-08-04,1255,2860,-1605,-56.12,1614
2021-08-05,1255,2862,-1607,-56.15,1614
2021-08-06,1170,2831,-1661,-58.67,1614
2021-08-07,632,2512,-1880,-74.84,1614
2021-08-08,540,2456,-1916,-78.01,1614
2021-08-09,1212,2847,-1635,-57.43,1614
2021-08-10,1255,2873,-1618,-56.32,1614
2021-08-11,1255,2876,-1621,-56.36,1614
2021-08-12,1255,2878,-1623,-56.39,1614
2021-08-13,1170,2848,-1678,-58.92,1614
2021-08-14,632,2530,-1898,-75.02,1614
2021-08-15,540,2474,-1934,-78.17,1614
2021-08-16,1212,2866,-1654,-57.71,1614
2021-08-17,1255,2892,-1637,-56.6,1614
2021-08-18,1255,2896,-1641,-56.66,1614
2021-08-19,1255,2899,-1644,-56.71,1614
2021-08-20,1170,2870,-1700,-59.23,1614
2021-08-21,632,2552,-1920,-75.24,1614
2021-08-22,540,2497,-1957,-78.37,1614
2021-08-23,1212,2889,-1677,-58.05,1614
2021-08-24,1255,2915,-1660,-56.95,1614
2021-08-25,1255,2918,-1663,-56.99,1614
2021-08-26,1255,2921,-1666,-57.04,1614
2021-08-27,1170,2891,-1721,-59.53,1614
2021-08-28,632,2573,-1941,-75.44,1614
2021-08-29,540,2517,-1977,-78.55,1614
2021-08-30,1212,2909,-1697,-58.34,1614
2021-08-31,1255,2934,-1679,-57.23,1614
2021-09-01,1348,2936,-1588,-54.09,1614
2021-09-02,1348,2938,-1590,-54.12,1614
2021-09-03,1284,2908,-1624,-55.85,1614
2021-09-04,696,2589,-1893,-73.12,1614
2021-09-05,612,2532,-1920,-75.83,1614
2021-09-06,1325,2923,-1598,-54.67,1614
2021-09-07,1348,2947,-1599,-54.26,1614
2021-09-08,1348,2949,-1601,-54.29,1614
2021-09-09,1348,2950,-1602,-54.31,1614
2021-09-10,1284,2920,-1636,-56.03,1614
2021-09-11,696,2601,-1905,-73.24,1614
2021-09-12,612,2544,-1932,-75.94,1614
2021-09-13,1325,2935,-1610,-54.86,1614
2021-09-14,1348,2960,-1612,-54.46,1614
2021-09-15,1348,2963,-1615,-54.51,1614
2021-09-16,1348,2966,-1618,-54.55,1614
2021-09-17,1284,2936,-1652,-56.27,1614
2021-09-18,696,2619,-1923,-73.42,1614
2021-09-19,612,2563,-1951,-76.12,1614
2021-09-20,1325,2956,-1631,-55.18,1614
2021-09-21,1348,2983,-1635,-54.81,1614
2021-09-22,1348,2988,-1640,-54.89,1614
2021-09-23,1348,2992,-1644,-54.95,1614
2021-09-24,1284,2964,-1680,-56.68,1614
2021-09-25,696,2648,-1952,-73.72,1614
2021-09-26,612,2594,-1982,-76.41,1614
2021-09-27,1325,2989,-1664,-55.67,1614
2021-09-28,1348,3017,-1669,-55.32,1614
2021-09-29,1348,3022,-1674,-55.39,1614
2021-09-30,1348,3027,-1679,-55.47,1614
2021-10-01,1320,3000,-1680,-56.0,1614
2021-10-02,704,2685,-1981,-73.78,1614
2021-10-03,572,2631,-2059,-78.26,1614
2021-10-04,1345,3025,-1680,-55.54,1614
2021-10-05,1363,3053,-1690,-55.36,1614
2021-10-06,1363,3058,-1695,-55.43,1614
2021-10-07,1363,3062,-1699,-55.49,1614
2021-10-08,1320,3034,-1714,-56.49,1614
2021-10-09,704,2717,-2013,-74.09,1614
2021-10-10,572,2662,-2090,-78.51,1614
2021-10-11,1345,3055,-1710,-55.97,1614
2021-10-12,1363,3081,-1718,-55.76,1614
2021-10-13,1363,3084,-1721,-55.8,1614
2021-10-14,1363,3086,-1723,-55.83,1614
2021-10-15,1320,3057,-1737,-56.82,1614
2021-10-16,704,2738,-2034,-74.29,1614
2021-10-17,572,2681,-2109,-78.66,1614
2021-10-18,1345,3072,-1727,-56.22,1614
2021-10-19,1363,3096,-1733,-55.98,1614
2021-10-20,1363,3098,-1735,-56.0,1614
2021-10-21,1363,3099,-1736,-56.02,1614
2021-10-22,1320,3068,-1748,-56.98,1614
2021-10-23,704,2748,-2044,-74.38,1614
2021-10-24,572,2690,-2118,-78.74,1614
2021-10-25,1345,3081,-1736,-56.35,1614
2021-10-26,1363,3104,-1741,-56.09,1614
2021-10-27,1363,3106,-1743,-56.12,1614
2021-10-28,1363,3107,-1744,-56.13,1614
2021-10-29,1320,3076,-1756,-57.09,1614
2021-10-30,704,2756,-2052,-74.46,1614
2021-10-31,572,2699,-2127,-78.81,1614
2021-11-01,1260,3090,-1830,-59.22,1614
2021-11-02,1313,3114,-1801,-57.84,1614
2021-11-03,1313,3117,-1804,-57.88,1614
2021-11-04,1313,3118,-1805,-57.89,1614
2021-11-05,1223,3088,-1865,-60.4,1614
2021-11-06,694,2769,-2075,-74.94,1614
2021-11-07,553,2712,-2159,-79.61,1614
2021-11-08,1260,3103,-1843,-59.39,1614
2021-11-09,1313,3128,-1815,-58.02,1614
2021-11-10,1313,3131,-1818,-58.06,1614
2021-11-11,1313,3132,-1819,-58.08,1614
2021-11-12,1223,3102,-1879,-60.57,1614
2021-11-13,694,2783,-2089,-75.06,1614
2021-11-14,553,2726,-2173,-79.71,1614
2021-11-15,1260,3117,-1857,-59.58,1614
2021-11-16,1313,3141,-1828,-58.2,1614
2021-11-17,1313,3143,-1830,-58.22,1614
2021-11-18,1313,3144,-1831,-58.24,1614
2021-11-19,1223,3113,-1890,-60.71,1614
2021-11-20,694,2793,-2099,-75.15,1614
2021-11-21,553,2736,-2183,-79.79,1614
2021-11-22,1260,3126,-1866,-59.69,1614
2021-11-23,1313,3150,-1837,-58.32,1614
2021-11-24,1313,3152,-1839,-58.34,1614
2021-11-25,1313,3153,-1840,-58.36,1614
2021-11-26,1223,3122,-1899,-60.83,1614
2021-11-27,694,2802,-2108,-75.23,1614
2021-11-28,553,2744,-2191,-79.85,1614
2021-11-29,1260,3135,-1875,-59.81,1614
2021-11-30,1313,3159,-1846,-58.44,1614
2021-12-01,1135,3161,-2026,-64.09,1614
2021-12-02,1135,3162,-2027,-64.1,1614
2021-12-03,1032,3131,-2099,-67.04,1614
2021-12-04,661,2812,-2151,-76.49,1614
2021-12-05,523,2755,-2232,-81.02,1614
2021-12-06,1200,3146,-1946,-61.86,1614
2021-12-07,1135,3171,-2036,-64.21,1614
2021-12-08,1135,3174,-2039,-64.24,1614
2021-12-09,1135,3175,-2040,-64.25,1614
2021-12-10,1032,3145,-2113,-67.19,1614
2021-12-11,661,2826,-2165,-76.61,1614
2021-12-12,523,2770,-2247,-81.12,1614
2021-12-13,1200,3161,-1961,-62.04,1614
2021-12-14,1135,3185,-2050,-64.36,1614
2021-12-15,1135,3188,-2053,-64.4,1614
2021-12-16,1135,3189,-2054,-64.41,1614
2021-12-17,1032,3158,-2126,-67.32,1614
2021-12-18,661,2838,-2177,-76.71,1614
2021-12-19,523,2781,-2258,-81.19,1614
2021-12-20,1200,3171,-1971,-62.16,1614
2021-12-21,1135,3194,-2059,-64.46,1614
2021-12-22,1135,3195,-2060,-64.48,1614
2021-12-23,1135,3194,-2059,-64.46,1614
2021-12-24,1032,3162,-2130,-67.36,1614
2021-12-25,661,2840,-2179,-76.73,1614
2021-12-26,523,2781,-2258,-81.19,1614
2021-12-27,1200,3169,-1969,-62.13,1614
2021-12-28,1135,3191,-2056,-64.43,1614
2021-12-29,1135,3190,-2055,-64.42,1614
2021-12-30,1135,3189,-2054,-64.41,1614
2021-12-31,1032,3155,-2123,-67.29,1614
2022-01-01,613,2833,-2220,-78.36,1614
2022-01-02,504,2773,-2269,-81.82,1614
2022-01-03,1128,3161,-2033,-64.32,1614
2022-01-04,1108,3182,-2074,-65.18,1614
2022-01-05,1108,3181,-2073,-65.17,1614
2022-01-06,1108,3180,-2072,-65.16,1614
2022-01-07,1084,3147,-2063,-65.55,1614
2022-01-08,613,2826,-2213,-78.31,1614
2022-01-09,504,2767,-2263,-81.79,1614
2022-01-10,1128,3157,-2029,-64.27,1614
2022-01-11,1108,3180,-2072,-65.16,1614
2022-01-12,1108,3181,-2073,-65.17,1614
2022-01-13,1108,3182,-2074,-65.18,1614
2022-01-14,1084,3151,-2067,-65.6,1614
2022-01-15,613,2832,-2219,-78.35,1614
2022-01-16,504,2776,-2272,-81.84,1614
2022-01-17,1128,3168,-2040,-64.39,1614
2022-01-18,1108,3194,-2086,-65.31,1614
2022-01-19,1108,3197,-2089,-65.34,1614
2022-01-20,1108,3200,-2092,-65.38,1614
2022-01-21,1084,3172,-2088,-65.83,1614
2022-01-22,613,2855,-2242,-78.53,1614
2022-01-23,504,2800,-2296,-82.0,1614
2022-01-24,1128,3194,-2066,-64.68,1614
2022-01-25,1108,3221,-2113,-65.6,1614
2022-01-26,1108,3225,-2117,-65.64,1614
2022-01-27,1108,3229,-2121,-65.69,1614
2022-01-28,1084,3201,-2117,-66.14,1614
2022-01-29,613,2884,-2271,-78.74,1614
2022-01-30,504,2830,-2326,-82.19,1614
2020-02-01,359,326,33,10.12,1192
2020-02-02,253,187,66,35.29,1192
2020-02-03,689,682,7,1.03,1192
2020-02-04,685,690,-5,-0.72,1192
2020-02-05,685,689,-4,-0.58,1192
2020-02-06,685,689,-4,-0.58,1192
2020-02-07,632,629,3,0.48,1192
2020-02-08,359,324,35,10.8,1192
2020-02-09,253,185,68,36.76,1192
2020-02-10,689,679,10,1.47,1192
2020-02-11,685,687,-2,-0.29,1192
2020-02-12,685,687,-2,-0.29,1192
2020-02-13,685,688,-3,-0.44,1192
2020-02-14,632,628,4,0.64,1192
2020-02-15,359,324,35,10.8,1192
2020-02-16,253,186,67,36.02,1192
2020-02-17,689,682,7,1.03,1192
2020-02-18,685,691,-6,-0.87,1192
2020-02-19,685,692,-7,-1.01,1192
2020-02-20,685,693,-8,-1.15,1192
2020-02-21,632,635,-3,-0.47,1192
2020-02-22,359,332,27,8.13,1192
2020-02-23,253,195,58,29.74,1192
2020-02-24,689,692,-3,-0.43,1192
2020-02-25,685,702,-17,-2.42,1192
2020-02-26,685,703,-18,-2.56,1192
2020-02-27,685,705,-20,-2.84,1192
2020-02-28,632,647,-15,-2.32,1192
2020-02-29,359,344,15,4.36,1192
2020-03-01,240,207,33,15.94,1192
2020-03-02,642,703,-61,-8.68,1192
2020-03-03,646,713,-67,-9.4,1192
2020-03-04,646,714,-68,-9.52,1192
2020-03-05,646,715,-69,-9.65,1192
2020-03-06,598,656,-58,-8.84,1192
2020-03-07,338,352,-14,-3.98,1192
2020-03-08,240,214,26,12.15,1192
2020-03-09,642,709,-67,-9.45,1192
2020-03-10,646,718,-72,-10.03,1192
2020-03-11,646,718,-72,-10.03,1192
2020-03-12,646,718,-72,-10.03,1192
2020-03-13,598,659,-61,-9.26,1192
2020-03-14,338,354,-16,-4.52,1192
2020-03-15,240,216,24,11.11,1192
2020-03-16,642,710,-68,-9.58,1192
2020-03-17,646,719,-73,-10.15,1192
2020-03-18,646,719,-73,-10.15,1192
2020-03-19,646,720,-74,-10.28,1192
2020-03-20,598,661,-63,-9.53,1192
2020-03-21,338,358,-20,-5.59,1192
2020-03-22,240,220,20,9.09,1192
2020-03-23,642,716,-74,-10.34,1192
2020-03-24,646,726,-80,-11.02,1192
2020-03-25,646,728,-82,-11.26,1192
2020-03-26,646,730,-84,-11.51,1192
2020-03-27,598,673,-75,-11.14,1192
2020-03-28,338,371,-33,-8.89,1192
2020-03-29,240,235,5,2.13,1192
2020-03-30,642,733,-91,-12.41,1192
2020-03-31,646,744,-98,-13.17,1192
2020-04-01,648,747,-99,-13.25,1192
2020-04-02,648,750,-102,-13.6,1192
2020-04-03,594,694,-100,-14.41,1192
2020-04-04,316,392,-76,-19.39,1192
2020-04-05,217,256,-39,-15.23,1192
2020-04-06,670,754,-84,-11.14,1192
2020-04-07,648,765,-117,-15.29,1192
2020-04-08,648,767,-119,-15.51,1192
2020-04-09,648,769,-121,-15.73,1192
2020-04-10,594,712,-118,-16.57,1192
2020-04-11,316,409,-93,-22.74,1192
2020-04-12,217,272,-55,-20.22,1192
2020-04-13,670,768,-98,-12.76,1192
2020-04-14,648,777,-129,-16.6,1192
2020-04-15,648,777,-129,-16.6,1192
2020-04-16,648,778,-130,-16.71,1192
2020-04-17,594,719,-125,-17.39,1192
2020-04-18,316,414,-98,-23.67,1192
2020-04-19,217,276,-59,-21.38,1192
2020-04-20,670,770,-100,-12.99,1192
2020-04-21,648,777,-129,-16.6,1192
2020-04-22,648,777,-129,-16.6,1192
2020-04-23,648,776,-128,-16.49,1192
2020-04-24,594,716,-122,-17.04,1192
2020-04-25,316,411,-95,-23.11,1192
2020-04-26,217,272,-55,-20.22,1192
2020-04-27,670,766,-96,-12.53,1192
2020-04-28,648,773,-125,-16.17,1192
2020-04-29,648,772,-124,-16.06,1192
2020-04-30,648,772,-124,-16.06,1192
2020-05-01,704,713,-9,-1.26,1192
2020-05-02,352,408,-56,-13.73,1192
2020-05-03,229,269,-40,-14.87,1192
2020-05-04,753,764,-11,-1.44,1192
2020-05-05,729,772,-43,-5.57,1192
2020-05-06,729,773,-44,-5.69,1192
2020-05-07,729,773,-44,-5.69,1192
2020-05-08,704,714,-10,-1.4,1192
2020-05-09,352,410,-58,-14.15,1192
2020-05-10,229,272,-43,-15.81,1192
2020-05-11,753,767,-14,-1.83,1192
2020-05-12,729,776,-47,-6.06,1192
2020-05-13,729,776,-47,-6.06,1192
2020-05-14,729,777,-48,-6.18,1192
2020-05-15,704,718,-14,-1.95,1192
2020-05-16,352,413,-61,-14.77,1192
2020-05-17,229,275,-46,-16.73,1192
2020-05-18,753,770,-17,-2.21,1192
2020-05-19,729,778,-49,-6.3,1192
2020-05-20,729,778,-49,-6.3,1192
2020-05-21,729,778,-49,-6.3,1192
2020-05-22,704,718,-14,-1.95,1192
2020-05-23,352,413,-61,-14.77,1192
2020-05-24,229,274,-45,-16.42,1192
2020-05-25,753,768,-15,-1.95,1192
2020-05-26,729,776,-47,-6.06,1192
2020-05-27,729,775,-46,-5.94,1192
2020-05-28,729,775,-46,-5.94,1192
2020-05-29,704,715,-11,-1.54,1192
2020-05-30,352,410,-58,-14.15,1192
2020-05-31,229,271,-42,-15.5,1192
2020-06-01,763,766,-3,-0.39,1192
2020-06-02,778,774,4,0.52,1192
2020-06-03,778,773,5,0.65,1192
2020-06-04,778,774,4,0.52,1192
2020-06-05,693,714,-21,-2.94,1192
2020-06-06,367,410,-43,-10.49,1192
2020-06-07,231,272,-41,-15.07,1192
2020-06-08,763,767,-4,-0.52,1192
2020-06-09,778,775,3,0.39,1192
2020-06-10,778,775,3,0.39,1192
2020-06-11,778,776,2,0.26,1192
2020-06-12,693,717,-24,-3.35,1192
2020-06-13,367,413,-46,-11.14,1192
2020-06-14,231,275,-44,-16.0,1192
2020-06-15,763,769,-6,-0.78,1192
2020-06-16,778,778,0,0.0,1192
2020-06-17,778,778,0,0.0,1192
2020-06-18,778,778,0,0.0,1192
2020-06-19,693,718,-25,-3.48,1192
2020-06-20,367,413,-46,-11.14,1192
2020-06-21,231,274,-43,-15.69,1192
2020-06-22,763,768,-5,-0.65,1192
2020-06-23,778,775,3,0.39,1192
2020-06-24,778,774,4,0.52,1192
2020-06-25,778,773,5,0.65,1192
2020-06-26,693,713,-20,-2.81,1192
2020-06-27,367,407,-40,-9.83,1192
2020-06-28,231,267,-36,-13.48,1192
2020-06-29,763,760,3,0.39,1192
2020-06-30,778,767,11,1.43,1192
2020-07-01,976,765,211,27.58,1192
2020-07-02,976,764,212,27.75,1192
2020-07-03,898,703,195,27.74,1192
2020-07-04,474,396,78,19.7,1192
2020-07-05,318,257,61,23.74,1192
2020-07-06,1022,750,272,36.27,1192
2020-07-07,976,757,219,28.93,1192
2020-07-08,976,756,220,29.1,1192
2020-07-09,976,755,221,29.27,1192
2020-07-10,898,695,203,29.21,1192
2020-07-11,474,390,84,21.54,1192
2020-07-12,318,251,67,26.69,1192
2020-07-13,1022,746,276,37.0,1192
2020-07-14,976,754,222,29.44,1192
2020-07-15,976,754,222,29.44,1192
2020-07-16,976,754,222,29.44,1192
2020-07-17,898,695,203,29.21,1192
2020-07-18,474,390,84,21.54,1192
2020-07-19,318,252,66,26.19,1192
2020-07-20,1022,746,276,37.0,1192
2020-07-21,976,754,222,29.44,1192
2020-07-22,976,754,222,29.44,1192
2020-07-23,976,754,222,29.44,1192
2020-07-24,898,694,204,29.39,1192
2020-07-25,474,389,85,21.85,1192
2020-07-26,318,250,68,27.2,1192
2020-07-27,1022,743,279,37.55,1192
2020-07-28,976,750,226,30.13,1192
2020-07-29,976,749,227,30.31,1192
2020-07-30,976,748,228,30.48,1192
2020-07-31,898,687,211,30.71,1192
2020-08-01,349,380,-31,-8.16,1192
2020-08-02,232,240,-8,-3.33,1192
2020-08-03,701,732,-31,-4.23,1192
2020-08-04,704,738,-34,-4.61,1192
2020-08-05,704,736,-32,-4.35,1192
2020-08-06,704,734,-30,-4.09,1192
2020-08-07,630,672,-42,-6.25,1192
2020-08-08,349,365,-16,-4.38,1192
2020-08-09,232,225,7,3.11,1192
2020-08-10,701,718,-17,-2.37,1192
2020-08-11,704,724,-20,-2.76,1192
2020-08-12,704,723,-19,-2.63,1192
2020-08-13,704,722,-18,-2.49,1192
2020-08-14,630,662,-32,-4.83,1192
2020-08-15,349,356,-7,-1.97,1192
2020-08-16,232,218,14,6.42,1192
2020-08-17,701,712,-11,-1.54,1192
2020-08-18,704,721,-17,-2.36,1192
2020-08-19,704,721,-17,-2.36,1192
2020-08-20,704,722,-18,-2.49,1192
2020-08-21,630,664,-34,-5.12,1192
2020-08-22,349,360,-11,-3.06,1192
2020-08-23,232,224,8,3.57,1192
2020-08-24,701,720,-19,-2.64,1192
2020-08-25,704,730,-26,-3.56,1192
2020-08-26,704,732,-28,-3.83,1192
2020-08-27,704,734,-30,-4.09,1192
2020-08-28,630,676,-46,-6.8,1192
2020-08-29,349,373,-24,-6.43,1192
2020-08-30,232,237,-5,-2.11,1192
2020-08-31,701,733,-32,-4.37,1192
2020-09-01,754,743,11,1.48,1192
2020-09-02,754,744,10,1.34,1192
2020-09-03,754,745,9,1.21,1192
2020-09-04,700,687,13,1.89,1192
2020-09-05,386,383,3,0.78,1192
2020-09-06,238,245,-7,-2.86,1192
2020-09-07,716,740,-24,-3.24,1192
2020-09-08,754,749,5,0.67,1192
2020-09-09,754,749,5,0.67,1192
2020-09-10,754,749,5,0.67,1192
2020-09-11,700,689,11,1.6,1192
2020-09-12,386,384,2,0.52,1192
2020-09-13,238,245,-7,-2.86,1192
2020-09-14,716,739,-23,-3.11,1192
2020-09-15,754,747,7,0.94,1192
2020-09-16,754,747,7,0.94,1192
2020-09-17,754,747,7,0.94,1192
2020-09-18,700,687,13,1.89,1192
2020-09-19,386,382,4,1.05,1192
2020-09-20,238,244,-6,-2.46,1192
2020-09-21,716,739,-23,-3.11,1192
2020-09-22,754,747,7,0.94,1192
2020-09-23,754,747,7,0.94,1192
2020-09-24,754,748,6,0.8,1192
2020-09-25,700,689,11,1.6,1192
2020-09-26,386,386,0,0.0,1192
2020-09-27,238,248,-10,-4.03,1192
2020-09-28,716,744,-28,-3.76,1192
2020-09-29,754,753,1,0.13,1192
2020-09-30,754,754,0,0.0,1192
2020-10-01,727,756,-29,-3.84,1192
2020-10-02,672,698,-26,-3.72,1192
2020-10-03,364,394,-30,-7.61,1192
2020-10-04,238,257,-19,-7.39,1192
2020-10-05,729,753,-24,-3.19,1192
2020-10-06,727,762,-35,-4.59,1192
2020-10-07,727,763,-36,-4.72,1192
2020-10-08,727,764,-37,-4.84,1192
2020-10-09,672,705,-33,-4.68,1192
2020-10-10,364,400,-36,-9.0,1192
2020-10-11,238,262,-24,-9.16,1192
2020-10-12,729,757,-28,-3.7,1192
2020-10-13,727,765,-38,-4.97,1192
2020-10-14,727,764,-37,-4.84,1192
2020-10-15,727,764,-37,-4.84,1192
2020-10-16,672,704,-32,-4.55,1192
2020-10-17,364,398,-34,-8.54,1192
2020-10-18,238,259,-21,-8.11,1192
2020-10-19,729,753,-24,-3.19,1192
2020-10-20,727,760,-33,-4.34,1192
2020-10-21,727,759,-32,-4.22,1192
2020-10-22,727,758,-31,-4.09,1192
2020-10-23,672,698,-26,-3.72,1192
2020-10-24,364,392,-28,-7.14,1192
2020-10-25,238,253,-15,-5.93,1192
2020-10-26,729,747,-18,-2.41,1192
2020-10-27,727,755,-28,-3.71,1192
2020-10-28,727,755,-28,-3.71,1192
2020-10-29,727,755,-28,-3.71,1192
2020-10-30,672,695,-23,-3.31,1192
2020-10-31,364,391,-27,-6.91,1192
2020-11-01,240,253,-13,-5.14,1192
2020-11-02,708,747,-39,-5.22,1192
2020-11-03,718,756,-38,-5.03,1192
2020-11-04,718,757,-39,-5.15,1192
2020-11-05,718,757,-39,-5.15,1192
2020-11-06,665,699,-34,-4.86,1192
2020-11-07,364,394,-30,-7.61,1192
2020-11-08,240,257,-17,-6.61,1192
2020-11-09,708,752,-44,-5.85,1192
2020-11-10,718,760,-42,-5.53,1192
2020-11-11,718,760,-42,-5.53,1192
2020-11-12,718,760,-42,-5.53,1192
2020-11-13,665,701,-36,-5.14,1192
2020-11-14,364,396,-32,-8.08,1192
2020-11-15,240,257,-17,-6.61,1192
2020-11-16,708,751,-43,-5.73,1192
2020-11-17,718,758,-40,-5.28,1192
2020-11-18,718,757,-39,-5.15,1192
2020-11-19,718,756,-38,-5.03,1192
2020-11-20,665,696,-31,-4.45,1192
2020-11-21,364,389,-25,-6.43,1192
2020-11-22,240,249,-9,-3.61,1192
2020-11-23,708,742,-34,-4.58,1192
2020-11-24,718,748,-30,-4.01,1192
2020-11-25,718,746,-28,-3.75,1192
2020-11-26,718,745,-27,-3.62,1192
2020-11-27,665,684,-19,-2.78,1192
2020-11-28,364,377,-13,-3.45,1192
2020-11-29,240,237,3,1.27,1192
2020-11-30,708,730,-22,-3.01,1192
2020-12-01,630,736,-106,-14.4,1192
2020-12-02,630,735,-105,-14.29,1192
2020-12-03,630,734,-104,-14.17,1192
2020-12-04,656,674,-18,-2.67,1192
2020-12-05,355,368,-13,-3.53,1192
2020-12-06,246,229,17,7.42,1192
2020-12-07,654,723,-69,-9.54,1192
2020-12-08,630,730,-100,-13.7,1192
2020-12-09,630,730,-100,-13.7,1192
2020-12-10,630,730,-100,-13.7,1192
2020-12-11,656,670,-14,-2.09,1192
2020-12-12,355,365,-10,-2.74,1192
2020-12-13,246,226,20,8.85,1192
2020-12-14,654,721,-67,-9.29,1192
2020-12-15,630,728,-98,-13.46,1192
2020-12-16,630,728,-98,-13.46,1192
2020-12-17,630,727,-97,-13.34,1192
2020-12-18,656,667,-11,-1.65,1192
2020-12-19,355,361,-6,-1.66,1192
2020-12-20,246,222,24,10.81,1192
2020-12-21,654,715,-61,-8.53,1192
2020-12-22,630,722,-92,-12.74,1192
2020-12-23,630,720,-90,-12.5,1192
2020-12-24,630,718,-88,-12.26,1192
2020-12-25,656,656,0,0.0,1192
2020-12-26,355,349,6,1.72,1192
2020-12-27,246,208,38,18.27,1192
2020-12-28,654,700,-46,-6.57,1192
2020-12-29,630,705,-75,-10.64,1192
2020-12-30,630,702,-72,-10.26,1192
2020-12-31,630,700,-70,-10.0,1192
2021-01-01,610,637,-27,-4.24,1192
2021-01-02,386,330,56,16.97,1192
2021-01-03,289,189,100,52.91,1192
2021-01-04,621,680,-59,-8.68,1192
2021-01-05,648,686,-38,-5.54,1192
2021-01-06,648,684,-36,-5.26,1192
2021-01-07,648,682,-34,-4.99,1192
2021-01-08,610,621,-11,-1.77,1192
2021-01-09,386,314,72,22.93,1192
2021-01-10,289,174,115,66.09,1192
2021-01-11,621,668,-47,-7.04,1192
2021-01-12,648,675,-27,-4.0,1192
2021-01-13,648,675,-27,-4.0,1192
2021-01-14,648,674,-26,-3.86,1192
2021-01-15,610,615,-5,-0.81,1192
2021-01-16,386,310,76,24.52,1192
2021-01-17,289,172,117,68.02,1192
2021-01-18,621,667,-46,-6.9,1192
2021-01-19,648,676,-28,-4.14,1192
2021-01-20,648,677,-29,-4.28,1192
2021-01-21,648,678,-30,-4.42,1192
2021-01-22,610,619,-9,-1.45,1192
2021-01-23,386,315,71,22.54,1192
2021-01-24,289,177,112,63.28,1192
2021-01-25,621,673,-52,-7.73,1192
2021-01-26,648,681,-33,-4.85,1192
2021-01-27,648,682,-34,-4.99,1192
2021-01-28,648,682,-34,-4.99,1192
2021-01-29,610,623,-13,-2.09,1192
2021-01-30,386,318,68,21.38,1192
2021-01-31,289,180,109,60.56,1192
2021-02-01,676,674,2,0.3,1192
2021-02-02,678,682,-4,-0.59,1192
2021-02-03,678,682,-4,-0.59,1192
2021-02-04,678,682,-4,-0.59,1192
2021-02-05,641,622,19,3.05,1192
2021-02-06,342,317,25,7.89,1192
2021-02-07,253,178,75,42.13,1192
2021-02-08,676,672,4,0.6,1192
2021-02-09,678,680,-2,-0.29,1192
2021-02-10,678,680,-2,-0.29,1192
2021-02-11,678,680,-2,-0.29,1192
2021-02-12,641,620,21,3.39,1192
2021-02-13,342,316,26,8.23,1192
2021-02-14,253,178,75,42.13,1192
2021-02-15,676,673,3,0.45,1192
2021-02-16,678,682,-4,-0.59,1192
2021-02-17,678,683,-5,-0.73,1192
2021-02-18,678,684,-6,-0.88,1192
2021-02-19,641,626,15,2.4,1192
2021-02-20,342,322,20,6.21,1192
2021-02-21,253,186,67,36.02,1192
2021-02-22,676,682,-6,-0.88,1192
2021-02-23,678,692,-14,-2.02,1192
2021-02-24,678,693,-15,-2.16,1192
2021-02-25,678,695,-17,-2.45,1192
2021-02-26,641,638,3,0.47,1192
2021-02-27,342,334,8,2.4,1192
2021-02-28,253,198,55,27.78,1192
2021-03-01,721,694,27,3.89,1192
2021-03-02,705,703,2,0.28,1192
2021-03-03,705,705,0,0.0,1192
2021-03-04,705,706,-1,-0.14,1192
2021-03-05,673,648,25,3.86,1192
2021-03-06,372,343,29,8.45,1192
2021-03-07,254,206,48,23.3,1192
2021-03-08,721,701,20,2.85,1192
2021-03-09,705,709,-4,-0.56,1192
2021-03-10,705,710,-5,-0.7,1192
2021-03-11,705,710,-5,-0.7,1192
2021-03-12,673,651,22,3.38,1192
2021-03-13,372,346,26,7.51,1192
2021-03-14,254,208,46,22.12,1192
2021-03-15,721,703,18,2.56,1192
2021-03-16,705,711,-6,-0.84,1192
2021-03-17,705,711,-6,-0.84,1192
2021-03-18,705,712,-7,-0.98,1192
2021-03-19,673,653,20,3.06,1192
2021-03-20,372,349,23,6.59,1192
2021-03-21,254,211,43,20.38,1192
2021-03-22,721,707,14,1.98,1192
2021-03-23,705,717,-12,-1.67,1192
2021-03-24,705,718,-13,-1.81,1192
2021-03-25,705,720,-15,-2.08,1192
2021-03-26,673,663,10,1.51,1192
2021-03-27,372,360,12,3.33,1192
2021-03-28,254,224,30,13.39,1192
2021-03-29,721,722,-1,-0.14,1192
2021-03-30,705,733,-28,-3.82,1192
2021-03-31,705,735,-30,-4.08,1192
2021-04-01,713,739,-26,-3.52,1192
2021-04-02,688,682,6,0.88,1192
2021-04-03,352,380,-28,-7.37,1192
2021-04-04,248,245,3,1.22,1192
2021-04-05,728,743,-15,-2.02,1192
2021-04-06,713,754,-41,-5.44,1192
2021-04-07,713,756,-43,-5.69,1192
2021-04-08,713,759,-46,-6.06,1192
2021-04-09,688,702,-14,-1.99,1192
2021-04-10,352,399,-47,-11.78,1192
2021-04-11,248,262,-14,-5.34,1192
2021-04-12,728,759,-31,-4.08,1192
2021-04-13,713,768,-55,-7.16,1192
2021-04-14,713,769,-56,-7.28,1192
2021-04-15,713,770,-57,-7.4,1192
2021-04-16,688,711,-23,-3.23,1192
2021-04-17,352,406,-54,-13.3,1192
2021-04-18,248,268,-20,-7.46,1192
2021-04-19,728,762,-34,-4.46,1192
2021-04-20,713,770,-57,-7.4,1192
2021-04-21,713,770,-57,-7.4,1192
2021-04-22,713,769,-56,-7.28,1192
2021-04-23,688,709,-21,-2.96,1192
2021-04-24,352,404,-52,-12.87,1192
2021-04-25,248,265,-17,-6.42,1192
2021-04-26,728,759,-31,-4.08,1192
2021-04-27,713,766,-53,-6.92,1192
2021-04-28,713,765,-52,-6.8,1192
2021-04-29,713,765,-52,-6.8,1192
2021-04-30,688,705,-17,-2.41,1192
2021-05-01,365,400,-35,-8.75,1192
2021-05-02,248,262,-14,-5.34,1192
2021-05-03,758,756,2,0.26,1192
2021-05-04,761,764,-3,-0.39,1192
2021-05-05,761,765,-4,-0.52,1192
2021-05-06,761,765,-4,-0.52,1192
2021-05-07,708,706,2,0.28,1192
2021-05-08,365,402,-37,-9.2,1192
2021-05-09,248,264,-16,-6.06,1192
2021-05-10,758,759,-1,-0.13,1192
2021-05-11,761,767,-6,-0.78,1192
2021-05-12,761,768,-7,-0.91,1192
2021-05-13,761,768,-7,-0.91,1192
2021-05-14,708,710,-2,-0.28,1192
2021-05-15,365,405,-40,-9.88,1192
2021-05-16,248,267,-19,-7.12,1192
2021-05-17,758,762,-4,-0.52,1192
2021-05-18,761,770,-9,-1.17,1192
2021-05-19,761,770,-9,-1.17,1192
2021-05-20,761,770,-9,-1.17,1192
2021-05-21,708,711,-3,-0.42,1192
2021-05-22,365,406,-41,-10.1,1192
2021-05-23,248,267,-19,-7.12,1192
2021-05-24,758,761,-3,-0.39,1192
2021-05-25,761,769,-8,-1.04,1192
2021-05-26,761,768,-7,-0.91,1192
2021-05-27,761,768,-7,-0.91,1192
2021-05-28,708,708,0,0.0,1192
2021-05-29,365,403,-38,-9.43,1192
2021-05-30,248,264,-16,-6.06,1192
2021-05-31,758,758,0,0.0,1192
2021-06-01,757,766,-9,-1.17,1192
2021-06-02,757,766,-9,-1.17,1192
2021-06-03,757,766,-9,-1.17,1192
2021-06-04,721,707,14,1.98,1192
2021-06-05,368,402,-34,-8.46,1192
2021-06-06,261,264,-3,-1.14,1192
2021-06-07,753,758,-5,-0.66,1192
2021-06-08,757,767,-10,-1.3,1192
2021-06-09,757,767,-10,-1.3,1192
2021-06-10,757,768,-11,-1.43,1192
2021-06-11,721,709,12,1.69,1192
2021-06-12,368,404,-36,-8.91,1192
2021-06-13,261,266,-5,-1.88,1192
2021-06-14,753,761,-8,-1.05,1192
2021-06-15,757,770,-13,-1.69,1192
2021-06-16,757,770,-13,-1.69,1192
2021-06-17,757,770,-13,-1.69,1192
2021-06-18,721,711,10,1.41,1192
2021-06-19,368,406,-38,-9.36,1192
2021-06-20,261,267,-6,-2.25,1192
2021-06-21,753,761,-8,-1.05,1192
2021-06-22,757,769,-12,-1.56,1192
2021-06-23,757,768,-11,-1.43,1192
2021-06-24,757,767,-10,-1.3,1192
2021-06-25,721,707,14,1.98,1192
2021-06-26,368,401,-33,-8.23,1192
2021-06-27,261,261,0,0.0,1192
2021-06-28,753,754,-1,-0.13,1192
2021-06-29,757,761,-4,-0.53,1192
2021-06-30,757,759,-2,-0.26,1192
2021-07-01,734,758,-24,-3.17,1192
2021-07-02,680,697,-17,-2.44,1192
2021-07-03,394,391,3,0.77,1192
2021-07-04,273,251,22,8.76,1192
2021-07-05,750,744,6,0.81,1192
2021-07-06,734,751,-17,-2.26,1192
2021-07-07,734,750,-16,-2.13,1192
2021-07-08,734,749,-15,-2.0,1192
2021-07-09,680,689,-9,-1.31,1192
2021-07-10,394,383,11,2.87,1192
2021-07-11,273,244,29,11.89,1192
2021-07-12,750,738,12,1.63,1192
2021-07-13,734,746,-12,-1.61,1192
2021-07-14,734,746,-12,-1.61,1192
2021-07-15,734,746,-12,-1.61,1192
2021-07-16,680,687,-7,-1.02,1192
2021-07-17,394,382,12,3.14,1192
2021-07-18,273,244,29,11.89,1192
2021-07-19,750,738,12,1.63,1192
2021-07-20,734,747,-13,-1.74,1192
2021-07-21,734,747,-13,-1.74,1192
2021-07-22,734,747,-13,-1.74,1192
2021-07-23,680,687,-7,-1.02,1192
2021-07-24,394,382,12,3.14,1192
2021-07-25,273,243,30,12.35,1192
2021-07-26,750,737,13,1.76,1192
2021-07-27,734,744,-10,-1.34,1192
2021-07-28,734,743,-9,-1.21,1192
2021-07-29,734,742,-8,-1.08,1192
2021-07-30,680,681,-1,-0.15,1192
2021-07-31,394,374,20,5.35,1192
2021-08-01,279,234,45,19.23,1192
2021-08-02,712,727,-15,-2.06,1192
2021-08-03,716,733,-17,-2.32,1192
2021-08-04,716,731,-15,-2.05,1192
2021-08-05,716,729,-13,-1.78,1192
2021-08-06,673,667,6,0.9,1192
2021-08-07,364,360,4,1.11,1192
2021-08-08,279,220,59,26.82,1192
2021-08-09,712,712,0,0.0,1192
2021-08-10,716,719,-3,-0.42,1192
2021-08-11,716,717,-1,-0.14,1192
2021-08-12,716,716,0,0.0,1192
2021-08-13,673,655,18,2.75,1192
2021-08-14,364,349,15,4.3,1192
2021-08-15,279,210,69,32.86,1192
2021-08-16,712,705,7,0.99,1192
2021-08-17,716,713,3,0.42,1192
2021-08-18,716,713,3,0.42,1192
2021-08-19,716,714,2,0.28,1192
2021-08-20,673,655,18,2.75,1192
2021-08-21,364,351,13,3.7,1192
2021-08-22,279,214,65,30.37,1192
2021-08-23,712,710,2,0.28,1192
2021-08-24,716,720,-4,-0.56,1192
2021-08-25,716,722,-6,-0.83,1192
2021-08-26,716,724,-8,-1.1,1192
2021-08-27,673,666,7,1.05,1192
2021-08-28,364,363,1,0.28,1192
2021-08-29,279,227,52,22.91,1192
2021-08-30,712,723,-11,-1.52,1192
2021-08-31,716,733,-17,-2.32,1192
2021-09-01,738,734,4,0.54,1192
2021-09-02,738,736,2,0.27,1192
2021-09-03,707,678,29,4.28,1192
2021-09-04,382,374,8,2.14,1192
2021-09-05,289,237,52,21.94,1192
2021-09-06,748,732,16,2.19,1192
2021-09-07,738,741,-3,-0.4,1192
2021-09-08,738,741,-3,-0.4,1192
2021-09-09,738,741,-3,-0.4,1192
2021-09-10,707,682,25,3.67,1192
2021-09-11,382,377,5,1.33,1192
2021-09-12,289,238,51,21.43,1192
2021-09-13,748,732,16,2.19,1192
2021-09-14,738,740,-2,-0.27,1192
2021-09-15,738,740,-2,-0.27,1192
2021-09-16,738,739,-1,-0.14,1192
2021-09-17,707,680,27,3.97,1192
2021-09-18,382,375,7,1.87,1192
2021-09-19,289,236,53,22.46,1192
2021-09-20,748,731,17,2.33,1192
2021-09-21,738,739,-1,-0.14,1192
2021-09-22,738,739,-1,-0.14,1192
2021-09-23,738,740,-2,-0.27,1192
2021-09-24,707,681,26,3.82,1192
2021-09-25,382,377,5,1.33,1192
2021-09-26,289,239,50,20.92,1192
2021-09-27,748,735,13,1.77,1192
2021-09-28,738,744,-6,-0.81,1192
2021-09-29,738,745,-7,-0.94,1192
2021-09-30,738,747,-9,-1.2,1192
2021-10-01,691,689,2,0.29,1192
2021-10-02,390,385,5,1.3,1192
2021-10-03,282,248,34,13.71,1192
2021-10-04,718,744,-26,-3.49,1192
2021-10-05,747,753,-6,-0.8,1192
2021-10-06,747,754,-7,-0.93,1192
2021-10-07,747,755,-8,-1.06,1192
2021-10-08,691,696,-5,-0.72,1192
2021-10-09,390,392,-2,-0.51,1192
2021-10-10,282,254,28,11.02,1192
2021-10-11,718,749,-31,-4.14,1192
2021-10-12,747,757,-10,-1.32,1192
2021-10-13,747,757,-10,-1.32,1192
2021-10-14,747,757,-10,-1.32,1192
2021-10-15,691,697,-6,-0.86,1192
2021-10-16,390,391,-1,-0.26,1192
2021-10-17,282,252,30,11.9,1192
2021-10-18,718,746,-28,-3.75,1192
2021-10-19,747,753,-6,-0.8,1192
2021-10-20,747,752,-5,-0.66,1192
2021-10-21,747,751,-4,-0.53,1192
2021-10-22,691,691,0,0.0,1192
2021-10-23,390,385,5,1.3,1192
2021-10-24,282,246,36,14.63,1192
2021-10-25,718,740,-22,-2.97,1192
2021-10-26,747,748,-1,-0.13,1192
2021-10-27,747,747,0,0.0,1192
2021-10-28,747,747,0,0.0,1192
2021-10-29,691,688,3,0.44,1192
2021-10-30,390,383,7,1.83,1192
2021-10-31,282,244,38,15.57,1192
2021-11-01,735,739,-4,-0.54,1192
2021-11-02,750,748,2,0.27,1192
2021-11-03,750,748,2,0.27,1192
2021-11-04,750,749,1,0.13,1192
2021-11-05,683,690,-7,-1.01,1192
2021-11-06,379,386,-7,-1.81,1192
2021-11-07,245,248,-3,-1.21,1192
2021-11-08,735,743,-8,-1.08,1192
2021-11-09,750,752,-2,-0.27,1192
2021-11-10,750,752,-2,-0.27,1192
2021-11-11,750,753,-3,-0.4,1192
2021-11-12,683,693,-10,-1.44,1192
2021-11-13,379,389,-10,-2.57,1192
2021-11-14,245,250,-5,-2.0,1192
2021-11-15,735,744,-9,-1.21,1192
2021-11-16,750,752,-2,-0.27,1192
2021-11-17,750,751,-1,-0.13,1192
2021-11-18,750,750,0,0.0,1192
2021-11-19,683,690,-7,-1.01,1192
2021-11-20,379,383,-4,-1.04,1192
2021-11-21,245,244,1,0.41,1192
2021-11-22,735,737,-2,-0.27,1192
2021-11-23,750,743,7,0.94,1192
2021-11-24,750,741,9,1.21,1192
2021-11-25,750,739,11,1.49,1192
2021-11-26,683,678,5,0.74,1192
2021-11-27,379,371,8,2.16,1192
2021-11-28,245,231,14,6.06,1192
2021-11-29,735,724,11,1.52,1192
2021-11-30,750,731,19,2.6,1192
2021-12-01,606,729,-123,-16.87,1192
2021-12-02,606,728,-122,-16.76,1192
2021-12-03,475,667,-192,-28.79,1192
2021-12-04,372,361,11,3.05,1192
2021-12-05,229,222,7,3.15,1192
2021-12-06,636,716,-80,-11.17,1192
2021-12-07,606,723,-117,-16.18,1192
2021-12-08,606,723,-117,-16.18,1192
2021-12-09,606,722,-116,-16.07,1192
2021-12-10,475,663,-188,-28.36,1192
2021-12-11,372,358,14,3.91,1192
2021-12-12,229,219,10,4.57,1192
2021-12-13,636,713,-77,-10.8,1192
2021-12-14,606,721,-115,-15.95,1192
2021-12-15,606,721,-115,-15.95,1192
2021-12-16,606,720,-114,-15.83,1192
2021-12-17,475,660,-185,-28.03,1192
2021-12-18,372,355,17,4.79,1192
2021-12-19,229,216,13,6.02,1192
2021-12-20,636,709,-73,-10.3,1192
2021-12-21,606,716,-110,-15.36,1192
2021-12-22,606,714,-108,-15.13,1192
2021-12-23,606,713,-107,-15.01,1192
2021-12-24,475,651,-176,-27.04,1192
2021-12-25,372,344,28,8.14,1192
2021-12-26,229,204,25,12.25,1192
2021-12-27,636,696,-60,-8.62,1192
2021-12-28,606,701,-95,-13.55,1192
2021-12-29,606,698,-92,-13.18,1192
2021-12-30,606,695,-89,-12.81,1192
2021-12-31,475,633,-158,-24.96,1192
2022-01-01,306,325,-19,-5.85,1192
2022-01-02,174,184,-10,-5.43,1192
2022-01-03,550,676,-126,-18.64,1192
2022-01-04,574,682,-108,-15.84,1192
2022-01-05,574,679,-105,-15.46,1192
2022-01-06,574,677,-103,-15.21,1192
2022-01-07,528,615,-87,-14.15,1192
2022-01-08,306,308,-2,-0.65,1192
2022-01-09,174,168,6,3.57,1192
2022-01-10,550,662,-112,-16.92,1192
2022-01-11,574,669,-95,-14.2,1192
2022-01-12,574,668,-94,-14.07,1192
2022-01-13,574,667,-93,-13.94,1192
2022-01-14,528,608,-80,-13.16,1192
2022-01-15,306,303,3,0.99,1192
2022-01-16,174,164,10,6.1,1192
2022-01-17,550,659,-109,-16.54,1192
2022-01-18,574,668,-94,-14.07,1192
2022-01-19,574,668,-94,-14.07,1192
2022-01-20,574,669,-95,-14.2,1192
2022-01-21,528,610,-82,-13.44,1192
2022-01-22,306,306,0,0.0,1192
2022-01-23,174,169,5,2.96,1192
2022-01-24,550,664,-114,-17.17,1192
2022-01-25,574,673,-99,-14.71,1192
2022-01-26,574,673,-99,-14.71,1192
2022-01-27,574,674,-100,-14.84,1192
2022-01-28,528,615,-87,-14.15,1192
2022-01-29,306,310,-4,-1.29,1192
2022-01-30,174,172,2,1.16,1192
2020-02-01,124,83,41,49.4,1206
2020-02-02,56,21,35,166.67,1206
2020-02-03,285,286,-1,-0.35,1206
2020-02-04,286,297,-11,-3.7,1206
2020-02-05,286,297,-11,-3.7,1206
2020-02-06,286,297,-11,-3.7,1206
2020-02-07,272,266,6,2.26,1206
2020-02-08,124,85,39,45.88,1206
2020-02-09,56,22,34,154.55,1206
2020-02-10,285,287,-2,-0.7,1206
2020-02-11,286,298,-12,-4.03,1206
2020-02-12,286,298,-12,-4.03,1206
2020-02-13,286,297,-11,-3.7,1206
2020-02-14,272,266,6,2.26,1206
2020-02-15,124,85,39,45.88,1206
2020-02-16,56,23,33,143.48,1206
2020-02-17,285,288,-3,-1.04,1206
2020-02-18,286,299,-13,-4.35,1206
2020-02-19,286,300,-14,-4.67,1206
2020-02-20,286,299,-13,-4.35,1206
2020-02-21,272,269,3,1.12,1206
2020-02-22,124,88,36,40.91,1206
2020-02-23,56,27,29,107.41,1206
2020-02-24,285,292,-7,-2.4,1206
2020-02-25,286,304,-18,-5.92,1206
2020-02-26,286,304,-18,-5.92,1206
2020-02-27,286,304,-18,-5.92,1206
2020-02-28,272,274,-2,-0.73,1206
2020-02-29,124,94,30,31.91,1206
2020-03-01,44,32,12,37.5,1206
2020-03-02,239,298,-59,-19.8,1206
2020-03-03,234,309,-75,-24.27,1206
2020-03-04,234,310,-76,-24.52,1206
2020-03-05,234,309,-75,-24.27,1206
2020-03-06,232,279,-47,-16.85,1206
2020-03-07,92,98,-6,-6.12,1206
2020-03-08,44,36,8,22.22,1206
2020-03-09,239,301,-62,-20.6,1206
2020-03-10,234,312,-78,-25.0,1206
2020-03-11,234,313,-79,-25.24,1206
2020-03-12,234,312,-78,-25.0,1206
2020-03-13,232,281,-49,-17.44,1206
2020-03-14,92,100,-8,-8.0,1206
2020-03-15,44,38,6,15.79,1206
2020-03-16,239,303,-64,-21.12,1206
2020-03-17,234,314,-80,-25.48,1206
2020-03-18,234,314,-80,-25.48,1206
2020-03-19,234,313,-79,-25.24,1206
2020-03-20,232,282,-50,-17.73,1206
2020-03-21,92,101,-9,-8.91,1206
2020-03-22,44,39,5,12.82,1206
2020-03-23,239,304,-65,-21.38,1206
2020-03-24,234,315,-81,-25.71,1206
2020-03-25,234,316,-82,-25.95,1206
2020-03-26,234,315,-81,-25.71,1206
2020-03-27,232,285,-53,-18.6,1206
2020-03-28,92,104,-12,-11.54,1206
2020-03-29,44,42,2,4.76,1206
2020-03-30,239,307,-68,-22.15,1206
2020-03-31,234,319,-85,-26.65,1206
2020-04-01,233,319,-86,-26.96,1206
2020-04-02,233,319,-86,-26.96,1206
2020-04-03,195,289,-94,-32.53,1206
2020-04-04,92,108,-16,-14.81,1206
2020-04-05,29,47,-18,-38.3,1206
2020-04-06,235,312,-77,-24.68,1206
2020-04-07,233,323,-90,-27.86,1206
2020-04-08,233,324,-91,-28.09,1206
2020-04-09,233,323,-90,-27.86,1206
2020-04-10,195,293,-98,-33.45,1206
2020-04-11,92,112,-20,-17.86,1206
2020-04-12,29,50,-21,-42.0,1206
2020-04-13,235,315,-80,-25.4,1206
2020-04-14,233,326,-93,-28.53,1206
2020-04-15,233,326,-93,-28.53,1206
2020-04-16,233,326,-93,-28.53,1206
2020-04-17,195,295,-100,-33.9,1206
2020-04-18,92,114,-22,-19.3,1206
2020-04-19,29,52,-23,-44.23,1206
2020-04-20,235,317,-82,-25.87,1206
2020-04-21,233,328,-95,-28.96,1206
2020-04-22,233,328,-95,-28.96,1206
2020-04-23,233,327,-94,-28.75,1206
2020-04-24,195,297,-102,-34.34,1206
2020-04-25,92,116,-24,-20.69,1206
2020-04-26,29,54,-25,-46.3,1206
2020-04-27,235,319,-84,-26.33,1206
2020-04-28,233,330,-97,-29.39,1206
2020-04-29,233,331,-98,-29.61,1206
2020-04-30,233,331,-98,-29.61,1206
2020-05-01,254,300,-46,-15.33,1206
2020-05-02,110,120,-10,-8.33,1206
2020-05-03,48,58,-10,-17.24,1206
2020-05-04,300,323,-23,-7.12,1206
2020-05-05,282,335,-53,-15.82,1206
2020-05-06,282,336,-54,-16.07,1206
2020-05-07,282,336,-54,-16.07,1206
2020-05-08,254,305,-51,-16.72,1206
2020-05-09,110,125,-15,-12.0,1206
2020-05-10,48,63,-15,-23.81,1206
2020-05-11,300,328,-28,-8.54,1206
2020-05-12,282,340,-58,-17.06,1206
2020-05-13,282,340,-58,-17.06,1206
2020-05-14,282,340,-58,-17.06,1206
2020-05-15,254,309,-55,-17.8,1206
2020-05-16,110,128,-18,-14.06,1206
2020-05-17,48,66,-18,-27.27,1206
2020-05-18,300,331,-31,-9.37,1206
2020-05-19,282,341,-59,-17.3,1206
2020-05-20,282,341,-59,-17.3,1206
2020-05-21,282,340,-58,-17.06,1206
2020-05-22,254,309,-55,-17.8,1206
2020-05-23,110,127,-17,-13.39,1206
2020-05-24,48,65,-17,-26.15,1206
2020-05-25,300,329,-29,-8.81,1206
2020-05-26,282,339,-57,-16.81,1206
2020-05-27,282,338,-56,-16.57,1206
2020-05-28,282,337,-55,-16.32,1206
2020-05-29,254,305,-51,-16.72,1206
2020-05-30,110,123,-13,-10.57,1206
2020-05-31,48,61,-13,-21.31,1206
2020-06-01,324,325,-1,-0.31,1206
2020-06-02,324,335,-11,-3.28,1206
2020-06-03,324,334,-10,-2.99,1206
2020-06-04,324,333,-9,-2.7,1206
2020-06-05,289,302,-13,-4.3,1206
2020-06-06,112,120,-8,-6.67,1206
2020-06-07,53,58,-5,-8.62,1206
2020-06-08,324,322,2,0.62,1206
2020-06-09,324,333,-9,-2.7,1206
2020-06-10,324,333,-9,-2.7,1206
2020-06-11,324,332,-8,-2.41,1206
2020-06-12,289,301,-12,-3.99,1206
2020-06-13,112,120,-8,-6.67,1206
2020-06-14,53,58,-5,-8.62,1206
2020-06-15,324,322,2,0.62,1206
2020-06-16,324,333,-9,-2.7,1206
2020-06-17,324,334,-10,-2.99,1206
2020-06-18,324,333,-9,-2.7,1206
2020-06-19,289,302,-13,-4.3,1206
2020-06-20,112,122,-10,-8.2,1206
2020-06-21,53,60,-7,-11.67,1206
2020-06-22,324,325,-1,-0.31,1206
2020-06-23,324,336,-12,-3.57,1206
2020-06-24,324,336,-12,-3.57,1206
2020-06-25,324,336,-12,-3.57,1206
2020-06-26,289,306,-17,-5.56,1206
2020-06-27,112,125,-13,-10.4,1206
2020-06-28,53,63,-10,-15.87,1206
2020-06-29,324,328,-4,-1.22,1206
2020-06-30,324,339,-15,-4.42,1206
2020-07-01,280,340,-60,-17.65,1206
2020-07-02,280,340,-60,-17.65,1206
2020-07-03,233,309,-76,-24.6,1206
2020-07-04,94,129,-35,-27.13,1206
2020-07-05,42,67,-25,-37.31,1206
2020-07-06,279,332,-53,-15.96,1206
2020-07-07,280,344,-64,-18.6,1206
2020-07-08,280,344,-64,-18.6,1206
2020-07-09,280,344,-64,-18.6,1206
2020-07-10,233,313,-80,-25.56,1206
2020-07-11,94,133,-39,-29.32,1206
2020-07-12,42,71,-29,-40.85,1206
2020-07-13,279,336,-57,-16.96,1206
2020-07-14,280,346,-66,-19.08,1206
2020-07-15,280,346,-66,-19.08,1206
2020-07-16,280,346,-66,-19.08,1206
2020-07-17,233,314,-81,-25.8,1206
2020-07-18,94,133,-39,-29.32,1206
2020-07-19,42,70,-28,-40.0,1206
2020-07-20,279,334,-55,-16.47,1206
2020-07-21,280,343,-63,-18.37,1206
2020-07-22,280,342,-62,-18.13,1206
2020-07-23,280,340,-60,-17.65,1206
2020-07-24,233,308,-75,-24.35,1206
2020-07-25,94,125,-31,-24.8,1206
2020-07-26,42,61,-19,-31.15,1206
2020-07-27,279,323,-44,-13.62,1206
2020-07-28,280,332,-52,-15.66,1206
2020-07-29,280,330,-50,-15.15,1206
2020-07-30,280,326,-46,-14.11,1206
2020-07-31,233,293,-60,-20.48,1206
2020-08-01,77,109,-32,-29.36,1206
2020-08-02,39,44,-5,-11.36,1206
2020-08-03,260,307,-47,-15.31,1206
2020-08-04,255,315,-60,-19.05,1206
2020-08-05,255,312,-57,-18.27,1206
2020-08-06,255,309,-54,-17.48,1206
2020-08-07,244,276,-32,-11.59,1206
2020-08-08,77,93,-16,-17.2,1206
2020-08-09,39,29,10,34.48,1206
2020-08-10,260,292,-32,-10.96,1206
2020-08-11,255,301,-46,-15.28,1206
2020-08-12,255,300,-45,-15.0,1206
2020-08-13,255,299,-44,-14.72,1206
2020-08-14,244,267,-23,-8.61,1206
2020-08-15,77,85,-8,-9.41,1206
2020-08-16,39,23,16,69.57,1206
2020-08-17,260,288,-28,-9.72,1206
2020-08-18,255,299,-44,-14.72,1206
2020-08-19,255,300,-45,-15.0,1206
2020-08-20,255,300,-45,-15.0,1206
2020-08-21,244,270,-26,-9.63,1206
2020-08-22,77,90,-13,-14.44,1206
2020-08-23,39,29,10,34.48,1206
2020-08-24,260,295,-35,-11.86,1206
2020-08-25,255,307,-52,-16.94,1206
2020-08-26,255,309,-54,-17.48,1206
2020-08-27,255,310,-55,-17.74,1206
2020-08-28,244,280,-36,-12.86,1206
2020-08-29,77,101,-24,-23.76,1206
2020-08-30,39,40,-1,-2.5,1206
2020-08-31,260,306,-46,-15.03,1206
2020-09-01,305,318,-13,-4.09,1206
2020-09-02,305,319,-14,-4.39,1206
2020-09-03,305,319,-14,-4.39,1206
2020-09-04,272,289,-17,-5.88,1206
2020-09-05,118,109,9,8.26,1206
2020-09-06,55,47,8,17.02,1206
2020-09-07,318,312,6,1.92,1206
2020-09-08,305,323,-18,-5.57,1206
2020-09-09,305,323,-18,-5.57,1206
2020-09-10,305,323,-18,-5.57,1206
2020-09-11,272,292,-20,-6.85,1206
2020-09-12,118,110,8,7.27,1206
2020-09-13,55,48,7,14.58,1206
2020-09-14,318,313,5,1.6,1206
2020-09-15,305,323,-18,-5.57,1206
2020-09-16,305,323,-18,-5.57,1206
2020-09-17,305,322,-17,-5.28,1206
2020-09-18,272,291,-19,-6.53,1206
2020-09-19,118,110,8,7.27,1206
2020-09-20,55,48,7,14.58,1206
2020-09-21,318,312,6,1.92,1206
2020-09-22,305,323,-18,-5.57,1206
2020-09-23,305,324,-19,-5.86,1206
2020-09-24,305,323,-18,-5.57,1206
2020-09-25,272,293,-21,-7.17,1206
2020-09-26,118,112,6,5.36,1206
2020-09-27,55,51,4,7.84,1206
2020-09-28,318,316,2,0.63,1206
2020-09-29,305,328,-23,-7.01,1206
2020-09-30,305,329,-24,-7.29,1206
2020-10-01,270,329,-59,-17.93,1206
2020-10-02,267,299,-32,-10.7,1206
2020-10-03,106,118,-12,-10.17,1206
2020-10-04,55,57,-2,-3.51,1206
2020-10-05,311,323,-12,-3.72,1206
2020-10-06,270,334,-64,-19.16,1206
2020-10-07,270,335,-65,-19.4,1206
2020-10-08,270,335,-65,-19.4,1206
2020-10-09,267,304,-37,-12.17,1206
2020-10-10,106,123,-17,-13.82,1206
2020-10-11,55,62,-7,-11.29,1206
2020-10-12,311,326,-15,-4.6,1206
2020-10-13,270,337,-67,-19.88,1206
2020-10-14,270,337,-67,-19.88,1206
2020-10-15,270,336,-66,-19.64,1206
2020-10-16,267,305,-38,-12.46,1206
2020-10-17,106,123,-17,-13.82,1206
2020-10-18,55,61,-6,-9.84,1206
2020-10-19,311,325,-14,-4.31,1206
2020-10-20,270,335,-65,-19.4,1206
2020-10-21,270,334,-64,-19.16,1206
2020-10-22,270,333,-63,-18.92,1206
2020-10-23,267,301,-34,-11.3,1206
2020-10-24,106,120,-14,-11.67,1206
2020-10-25,55,57,-2,-3.51,1206
2020-10-26,311,321,-10,-3.12,1206
2020-10-27,270,331,-61,-18.43,1206
2020-10-28,270,331,-61,-18.43,1206
2020-10-29,270,330,-60,-18.18,1206
2020-10-30,267,299,-32,-10.7,1206
2020-10-31,106,117,-11,-9.4,1206
2020-11-01,49,55,-6,-10.91,1206
2020-11-02,310,320,-10,-3.12,1206
2020-11-03,285,331,-46,-13.9,1206
2020-11-04,285,331,-46,-13.9,1206
2020-11-05,285,330,-45,-13.64,1206
2020-11-06,277,299,-22,-7.36,1206
2020-11-07,108,118,-10,-8.47,1206
2020-11-08,49,56,-7,-12.5,1206
2020-11-09,310,321,-11,-3.43,1206
2020-11-10,285,332,-47,-14.16,1206
2020-11-11,285,332,-47,-14.16,1206
2020-11-12,285,331,-46,-13.9,1206
2020-11-13,277,300,-23,-7.67,1206
2020-11-14,108,119,-11,-9.24,1206
2020-11-15,49,56,-7,-12.5,1206
2020-11-16,310,320,-10,-3.12,1206
2020-11-17,285,331,-46,-13.9,1206
2020-11-18,285,330,-45,-13.64,1206
2020-11-19,285,328,-43,-13.11,1206
2020-11-20,277,297,-20,-6.73,1206
2020-11-21,108,114,-6,-5.26,1206
2020-11-22,49,51,-2,-3.92,1206
2020-11-23,310,315,-5,-1.59,1206
2020-11-24,285,324,-39,-12.04,1206
2020-11-25,285,323,-38,-11.76,1206
2020-11-26,285,321,-36,-11.21,1206
2020-11-27,277,289,-12,-4.15,1206
2020-11-28,108,106,2,1.89,1206
2020-11-29,49,43,6,13.95,1206
2020-11-30,310,306,4,1.31,1206
2020-12-01,270,316,-46,-14.56,1206
2020-12-02,270,315,-45,-14.29,1206
2020-12-03,270,313,-43,-13.74,1206
2020-12-04,313,281,32,11.39,1206
2020-12-05,135,99,36,36.36,1206
2020-12-06,50,36,14,38.89,1206
2020-12-07,282,300,-18,-6.0,1206
2020-12-08,270,310,-40,-12.9,1206
2020-12-09,270,310,-40,-12.9,1206
2020-12-10,270,308,-38,-12.34,1206
2020-12-11,313,277,36,13.0,1206
2020-12-12,135,95,40,42.11,1206
2020-12-13,50,33,17,51.52,1206
2020-12-14,282,297,-15,-5.05,1206
2020-12-15,270,308,-38,-12.34,1206
2020-12-16,270,307,-37,-12.05,1206
2020-12-17,270,306,-36,-11.76,1206
2020-12-18,313,275,38,13.82,1206
2020-12-19,135,93,42,45.16,1206
2020-12-20,50,30,20,66.67,1206
2020-12-21,282,294,-12,-4.08,1206
2020-12-22,270,304,-34,-11.18,1206
2020-12-23,270,303,-33,-10.89,1206
2020-12-24,270,301,-31,-10.3,1206
2020-12-25,313,269,44,16.36,1206
2020-12-26,135,87,48,55.17,1206
2020-12-27,50,23,27,117.39,1206
2020-12-28,282,287,-5,-1.74,1206
2020-12-29,270,296,-26,-8.78,1206
2020-12-30,270,294,-24,-8.16,1206
2020-12-31,270,292,-22,-7.53,1206
2021-01-01,221,260,-39,-15.0,1206
2021-01-02,99,77,22,28.57,1206
2021-01-03,53,13,40,307.69,1206
2021-01-04,240,276,-36,-13.04,1206
2021-01-05,245,286,-41,-14.34,1206
2021-01-06,245,284,-39,-13.73,1206
2021-01-07,245,282,-37,-13.12,1206
2021-01-08,221,250,-29,-11.6,1206
2021-01-09,99,68,31,45.59,1206
2021-01-10,53,5,48,960.0,1206
2021-01-11,240,269,-29,-10.78,1206
2021-01-12,245,279,-34,-12.19,1206
2021-01-13,245,279,-34,-12.19,1206
2021-01-14,245,278,-33,-11.87,1206
2021-01-15,221,246,-25,-10.16,1206
2021-01-16,99,65,34,52.31,1206
2021-01-17,53,3,50,1666.67,1206
2021-01-18,240,268,-28,-10.45,1206
2021-01-19,245,279,-34,-12.19,1206
2021-01-20,245,279,-34,-12.19,1206
2021-01-21,245,279,-34,-12.19,1206
2021-01-22,221,249,-28,-11.24,1206
2021-01-23,99,68,31,45.59,1206
2021-01-24,53,6,47,783.33,1206
2021-01-25,240,271,-31,-11.44,1206
2021-01-26,245,283,-38,-13.43,1206
2021-01-27,245,283,-38,-13.43,1206
2021-01-28,245,283,-38,-13.43,1206
2021-01-29,221,252,-31,-12.3,1206
2021-01-30,99,72,27,37.5,1206
2021-01-31,53,10,43,430.0,1206
2021-02-01,272,275,-3,-1.09,1206
2021-02-02,258,286,-28,-9.79,1206
2021-02-03,258,286,-28,-9.79,1206
2021-02-04,258,285,-27,-9.47,1206
2021-02-05,241,254,-13,-5.12,1206
2021-02-06,88,73,15,20.55,1206
2021-02-07,46,11,35,318.18,1206
2021-02-08,272,276,-4,-1.45,1206
2021-02-09,258,287,-29,-10.1,1206
2021-02-10,258,287,-29,-10.1,1206
2021-02-11,258,286,-28,-9.79,1206
2021-02-12,241,255,-14,-5.49,1206
2021-02-13,88,74,14,18.92,1206
2021-02-14,46,12,34,283.33,1206
2021-02-15,272,277,-5,-1.81,1206
2021-02-16,258,288,-30,-10.42,1206
2021-02-17,258,288,-30,-10.42,1206
2021-02-18,258,288,-30,-10.42,1206
2021-02-19,241,257,-16,-6.23,1206
2021-02-20,88,76,12,15.79,1206
2021-02-21,46,15,31,206.67,1206
2021-02-22,272,280,-8,-2.86,1206
2021-02-23,258,291,-33,-11.34,1206
2021-02-24,258,292,-34,-11.64,1206
2021-02-25,258,292,-34,-11.64,1206
2021-02-26,241,262,-21,-8.02,1206
2021-02-27,88,81,7,8.64,1206
2021-02-28,46,20,26,130.0,1206
2021-03-01,291,285,6,2.11,1206
2021-03-02,283,297,-14,-4.71,1206
2021-03-03,283,297,-14,-4.71,1206
2021-03-04,283,297,-14,-4.71,1206
2021-03-05,273,267,6,2.25,1206
2021-03-06,116,86,30,34.88,1206
2021-03-07,43,25,18,72.0,1206
2021-03-08,291,290,1,0.34,1206
2021-03-09,283,301,-18,-5.98,1206
2021-03-10,283,301,-18,-5.98,1206
2021-03-11,283,301,-18,-5.98,1206
2021-03-12,273,270,3,1.11,1206
2021-03-13,116,89,27,30.34,1206
2021-03-14,43,27,16,59.26,1206
2021-03-15,291,291,0,0.0,1206
2021-03-16,283,302,-19,-6.29,1206
2021-03-17,283,302,-19,-6.29,1206
2021-03-18,283,302,-19,-6.29,1206
2021-03-19,273,271,2,0.74,1206
2021-03-20,116,90,26,28.89,1206
2021-03-21,43,28,15,53.57,1206
2021-03-22,291,293,-2,-0.68,1206
2021-03-23,283,304,-21,-6.91,1206
2021-03-24,283,304,-21,-6.91,1206
2021-03-25,283,303,-20,-6.6,1206
2021-03-26,273,273,0,0.0,1206
2021-03-27,116,92,24,26.09,1206
2021-03-28,43,30,13,43.33,1206
2021-03-29,291,295,-4,-1.36,1206
2021-03-30,283,307,-24,-7.82,1206
2021-03-31,283,307,-24,-7.82,1206
2021-04-01,291,307,-16,-5.21,1206
2021-04-02,250,277,-27,-9.75,1206
2021-04-03,101,96,5,5.21,1206
2021-04-04,43,34,9,26.47,1206
2021-04-05,284,300,-16,-5.33,1206
2021-04-06,291,311,-20,-6.43,1206
2021-04-07,291,312,-21,-6.73,1206
2021-04-08,291,311,-20,-6.43,1206
2021-04-09,250,281,-31,-11.03,1206
2021-04-10,101,100,1,1.0,1206
2021-04-11,43,38,5,13.16,1206
2021-04-12,284,303,-19,-6.27,1206
2021-04-13,291,314,-23,-7.32,1206
2021-04-14,291,315,-24,-7.62,1206
2021-04-15,291,314,-23,-7.32,1206
2021-04-16,250,284,-34,-11.97,1206
2021-04-17,101,102,-1,-0.98,1206
2021-04-18,43,41,2,4.88,1206
2021-04-19,284,305,-21,-6.89,1206
2021-04-20,291,316,-25,-7.91,1206
2021-04-21,291,316,-25,-7.91,1206
2021-04-22,291,316,-25,-7.91,1206
2021-04-23,250,285,-35,-12.28,1206
2021-04-24,101,104,-3,-2.88,1206
2021-04-25,43,42,1,2.38,1206
2021-04-26,284,307,-23,-7.49,1206
2021-04-27,291,318,-27,-8.49,1206
2021-04-28,291,319,-28,-8.78,1206
2021-04-29,291,319,-28,-8.78,1206
2021-04-30,250,288,-38,-13.19,1206
2021-05-01,117,108,9,8.33,1206
2021-05-02,50,46,4,8.7,1206
2021-05-03,291,311,-20,-6.43,1206
2021-05-04,304,323,-19,-5.88,1206
2021-05-05,304,323,-19,-5.88,1206
2021-05-06,304,323,-19,-5.88,1206
2021-05-07,288,293,-5,-1.71,1206
2021-05-08,117,113,4,3.54,1206
2021-05-09,50,51,-1,-1.96,1206
2021-05-10,291,316,-25,-7.91,1206
2021-05-11,304,328,-24,-7.32,1206
2021-05-12,304,328,-24,-7.32,1206
2021-05-13,304,328,-24,-7.32,1206
2021-05-14,288,298,-10,-3.36,1206
2021-05-15,117,117,0,0.0,1206
2021-05-16,50,55,-5,-9.09,1206
2021-05-17,291,319,-28,-8.78,1206
2021-05-18,304,330,-26,-7.88,1206
2021-05-19,304,330,-26,-7.88,1206
2021-05-20,304,329,-25,-7.6,1206
2021-05-21,288,298,-10,-3.36,1206
2021-05-22,117,117,0,0.0,1206
2021-05-23,50,54,-4,-7.41,1206
2021-05-24,291,318,-27,-8.49,1206
2021-05-25,304,328,-24,-7.32,1206
2021-05-26,304,328,-24,-7.32,1206
2021-05-27,304,326,-22,-6.75,1206
2021-05-28,288,295,-7,-2.37,1206
2021-05-29,117,113,4,3.54,1206
2021-05-30,50,50,0,0.0,1206
2021-05-31,291,314,-23,-7.32,1206
2021-06-01,312,324,-12,-3.7,1206
2021-06-02,312,324,-12,-3.7,1206
2021-06-03,312,322,-10,-3.11,1206
2021-06-04,277,291,-14,-4.81,1206
2021-06-05,114,109,5,4.59,1206
2021-06-06,53,47,6,12.77,1206
2021-06-07,298,311,-13,-4.18,1206
2021-06-08,312,322,-10,-3.11,1206
2021-06-09,312,321,-9,-2.8,1206
2021-06-10,312,321,-9,-2.8,1206
2021-06-11,277,290,-13,-4.48,1206
2021-06-12,114,108,6,5.56,1206
2021-06-13,53,46,7,15.22,1206
2021-06-14,298,311,-13,-4.18,1206
2021-06-15,312,322,-10,-3.11,1206
2021-06-16,312,322,-10,-3.11,1206
2021-06-17,312,321,-9,-2.8,1206
2021-06-18,277,291,-14,-4.81,1206
2021-06-19,114,110,4,3.64,1206
2021-06-20,53,48,5,10.42,1206
2021-06-21,298,313,-15,-4.79,1206
2021-06-22,312,324,-12,-3.7,1206
2021-06-23,312,325,-13,-4.0,1206
2021-06-24,312,324,-12,-3.7,1206
2021-06-25,277,294,-17,-5.78,1206
2021-06-26,114,113,1,0.88,1206
2021-06-27,53,51,2,3.92,1206
2021-06-28,298,316,-18,-5.7,1206
2021-06-29,312,328,-16,-4.88,1206
2021-06-30,312,328,-16,-4.88,1206
2021-07-01,292,328,-36,-10.98,1206
2021-07-02,250,297,-47,-15.82,1206
2021-07-03,109,117,-8,-6.84,1206
2021-07-04,46,55,-9,-16.36,1206
2021-07-05,290,320,-30,-9.38,1206
2021-07-06,292,332,-40,-12.05,1206
2021-07-07,292,332,-40,-12.05,1206
2021-07-08,292,332,-40,-12.05,1206
2021-07-09,250,302,-52,-17.22,1206
2021-07-10,109,121,-12,-9.92,1206
2021-07-11,46,59,-13,-22.03,1206
2021-07-12,290,324,-34,-10.49,1206
2021-07-13,292,335,-43,-12.84,1206
2021-07-14,292,335,-43,-12.84,1206
2021-07-15,292,334,-42,-12.57,1206
2021-07-16,250,303,-53,-17.49,1206
2021-07-17,109,122,-13,-10.66,1206
2021-07-18,46,59,-13,-22.03,1206
2021-07-19,290,323,-33,-10.22,1206
2021-07-20,292,333,-41,-12.31,1206
2021-07-21,292,332,-40,-12.05,1206
2021-07-22,292,331,-39,-11.78,1206
2021-07-23,250,298,-48,-16.11,1206
2021-07-24,109,116,-7,-6.03,1206
2021-07-25,46,52,-6,-11.54,1206
2021-07-26,290,315,-25,-7.94,1206
2021-07-27,292,323,-31,-9.6,1206
2021-07-28,292,321,-29,-9.03,1206
2021-07-29,292,318,-26,-8.18,1206
2021-07-30,250,285,-35,-12.28,1206
2021-07-31,109,101,8,7.92,1206
2021-08-01,43,36,7,19.44,1206
2021-08-02,272,298,-26,-8.72,1206
2021-08-03,278,307,-29,-9.45,1206
2021-08-04,278,304,-26,-8.55,1206
2021-08-05,278,301,-23,-7.64,1206
2021-08-06,228,268,-40,-14.93,1206
2021-08-07,101,84,17,20.24,1206
2021-08-08,43,20,23,115.0,1206
2021-08-09,272,283,-11,-3.89,1206
2021-08-10,278,292,-14,-4.79,1206
2021-08-11,278,290,-12,-4.14,1206
2021-08-12,278,288,-10,-3.47,1206
2021-08-13,228,256,-28,-10.94,1206
2021-08-14,101,75,26,34.67,1206
2021-08-15,43,12,31,258.33,1206
2021-08-16,272,276,-4,-1.45,1206
2021-08-17,278,287,-9,-3.14,1206
2021-08-18,278,288,-10,-3.47,1206
2021-08-19,278,287,-9,-3.14,1206
2021-08-20,228,257,-29,-11.28,1206
2021-08-21,101,77,24,31.17,1206
2021-08-22,43,16,27,168.75,1206
2021-08-23,272,282,-10,-3.55,1206
2021-08-24,278,294,-16,-5.44,1206
2021-08-25,278,296,-18,-6.08,1206
2021-08-26,278,296,-18,-6.08,1206
2021-08-27,228,267,-39,-14.61,1206
2021-08-28,101,87,14,16.09,1206
2021-08-29,43,27,16,59.26,1206
2021-08-30,272,293,-21,-7.17,1206
2021-08-31,278,305,-27,-8.85,1206
2021-09-01,307,306,1,0.33,1206
2021-09-02,307,307,0,0.0,1206
2021-09-03,247,277,-30,-10.83,1206
2021-09-04,110,97,13,13.4,1206
2021-09-05,43,35,8,22.86,1206
2021-09-06,294,300,-6,-2.0,1206
2021-09-07,307,312,-5,-1.6,1206
2021-09-08,307,312,-5,-1.6,1206
2021-09-09,307,311,-4,-1.29,1206
2021-09-10,247,281,-34,-12.1,1206
2021-09-11,110,99,11,11.11,1206
2021-09-12,43,37,6,16.22,1206
2021-09-13,294,302,-8,-2.65,1206
2021-09-14,307,312,-5,-1.6,1206
2021-09-15,307,312,-5,-1.6,1206
2021-09-16,307,311,-4,-1.29,1206
2021-09-17,247,280,-33,-11.79,1206
2021-09-18,110,98,12,12.24,1206
2021-09-19,43,36,7,19.44,1206
2021-09-20,294,301,-7,-2.33,1206
2021-09-21,307,312,-5,-1.6,1206
2021-09-22,307,312,-5,-1.6,1206
2021-09-23,307,311,-4,-1.29,1206
2021-09-24,247,281,-34,-12.1,1206
2021-09-25,110,100,10,10.0,1206
2021-09-26,43,39,4,10.26,1206
2021-09-27,294,304,-10,-3.29,1206
2021-09-28,307,315,-8,-2.54,1206
2021-09-29,307,316,-9,-2.85,1206
2021-09-30,307,316,-9,-2.85,1206
2021-10-01,256,286,-30,-10.49,1206
2021-10-02,114,106,8,7.55,1206
2021-10-03,42,45,-3,-6.67,1206
2021-10-04,287,310,-23,-7.42,1206
2021-10-05,314,322,-8,-2.48,1206
2021-10-06,314,323,-9,-2.79,1206
2021-10-07,314,323,-9,-2.79,1206
2021-10-08,256,292,-36,-12.33,1206
2021-10-09,114,112,2,1.79,1206
2021-10-10,42,50,-8,-16.0,1206
2021-10-11,287,315,-28,-8.89,1206
2021-10-12,314,326,-12,-3.68,1206
2021-10-13,314,326,-12,-3.68,1206
2021-10-14,314,325,-11,-3.38,1206
2021-10-15,256,294,-38,-12.93,1206
2021-10-16,114,112,2,1.79,1206
2021-10-17,42,50,-8,-16.0,1206
2021-10-18,287,314,-27,-8.6,1206
2021-10-19,314,324,-10,-3.09,1206
2021-10-20,314,324,-10,-3.09,1206
2021-10-21,314,322,-8,-2.48,1206
2021-10-22,256,291,-35,-12.03,1206
2021-10-23,114,109,5,4.59,1206
2021-10-24,42,46,-4,-8.7,1206
2021-10-25,287,310,-23,-7.42,1206
2021-10-26,314,321,-7,-2.18,1206
2021-10-27,314,320,-6,-1.88,1206
2021-10-28,314,319,-5,-1.57,1206
2021-10-29,256,288,-32,-11.11,1206
2021-10-30,114,106,8,7.55,1206
2021-10-31,42,44,-2,-4.55,1206
2021-11-01,301,309,-8,-2.59,1206
2021-11-02,288,319,-31,-9.72,1206
2021-11-03,288,319,-31,-9.72,1206
2021-11-04,288,319,-31,-9.72,1206
2021-11-05,248,288,-40,-13.89,1206
2021-11-06,103,107,-4,-3.74,1206
2021-11-07,48,45,3,6.67,1206
2021-11-08,301,310,-9,-2.9,1206
2021-11-09,288,321,-33,-10.28,1206
2021-11-10,288,321,-33,-10.28,1206
2021-11-11,288,320,-32,-10.0,1206
2021-11-12,248,289,-41,-14.19,1206
2021-11-13,103,108,-5,-4.63,1206
2021-11-14,48,45,3,6.67,1206
2021-11-15,301,310,-9,-2.9,1206
2021-11-16,288,320,-32,-10.0,1206
2021-11-17,288,319,-31,-9.72,1206
2021-11-18,288,318,-30,-9.43,1206
2021-11-19,248,286,-38,-13.29,1206
2021-11-20,103,104,-1,-0.96,1206
2021-11-21,48,41,7,17.07,1206
2021-11-22,301,305,-4,-1.31,1206
2021-11-23,288,314,-26,-8.28,1206
2021-11-24,288,313,-25,-7.99,1206
2021-11-25,288,311,-23,-7.4,1206
2021-11-26,248,279,-31,-11.11,1206
2021-11-27,103,97,6,6.19,1206
2021-11-28,48,33,15,45.45,1206
2021-11-29,301,297,4,1.35,1206
2021-11-30,288,306,-18,-5.88,1206
2021-12-01,238,305,-67,-21.97,1206
2021-12-02,238,303,-65,-21.45,1206
2021-12-03,182,271,-89,-32.84,1206
2021-12-04,101,89,12,13.48,1206
2021-12-05,47,26,21,80.77,1206
2021-12-06,256,290,-34,-11.72,1206
2021-12-07,238,300,-62,-20.67,1206
2021-12-08,238,299,-61,-20.4,1206
2021-12-09,238,298,-60,-20.13,1206
2021-12-10,182,266,-84,-31.58,1206
2021-12-11,101,85,16,18.82,1206
2021-12-12,47,22,25,113.64,1206
2021-12-13,256,286,-30,-10.49,1206
2021-12-14,238,297,-59,-19.87,1206
2021-12-15,238,296,-58,-19.59,1206
2021-12-16,238,295,-57,-19.32,1206
2021-12-17,182,264,-82,-31.06,1206
2021-12-18,101,82,19,23.17,1206
2021-12-19,47,20,27,135.0,1206
2021-12-20,256,284,-28,-9.86,1206
2021-12-21,238,294,-56,-19.05,1206
2021-12-22,238,293,-55,-18.77,1206
2021-12-23,238,291,-53,-18.21,1206
2021-12-24,182,259,-77,-29.73,1206
2021-12-25,101,77,24,31.17,1206
2021-12-26,47,14,33,235.71,1206
2021-12-27,256,277,-21,-7.58,1206
2021-12-28,238,286,-48,-16.78,1206
2021-12-29,238,285,-47,-16.49,1206
2021-12-30,238,283,-45,-15.9,1206
2021-12-31,182,250,-68,-27.2,1206
2022-01-01,94,68,26,38.24,1206
2022-01-02,42,4,38,950.0,1206
2022-01-03,229,267,-38,-14.23,1206
2022-01-04,217,276,-59,-21.38,1206
2022-01-05,217,275,-58,-21.09,1206
2022-01-06,217,273,-56,-20.51,1206
2022-01-07,196,241,-45,-18.67,1206
2022-01-08,94,58,36,62.07,1206
2022-01-09,42,15,27,180.0,1206
2022-01-10,229,259,-30,-11.58,1206
2022-01-11,217,269,-52,-19.33,1206
2022-01-12,217,268,-51,-19.03,1206
2022-01-13,217,267,-50,-18.73,1206
2022-01-14,196,235,-39,-16.6,1206
2022-01-15,94,54,40,74.07,1206
2022-01-16,42,12,30,250.0,1206
2022-01-17,229,256,-27,-10.55,1206
2022-01-18,217,267,-50,-18.73,1206
2022-01-19,217,268,-51,-19.03,1206
2022-01-20,217,267,-50,-18.73,1206
2022-01-21,196,237,-41,-17.3,1206
2022-01-22,94,56,38,67.86,1206
2022-01-23,42,16,26,162.5,1206
2022-01-24,229,259,-30,-11.58,1206
2022-01-25,217,271,-54,-19.93,1206
2022-01-26,217,271,-54,-19.93,1206
2022-01-27,217,271,-54,-19.93,1206
2022-01-28,196,241,-45,-18.67,1206
2022-01-29,94,60,34,56.67,1206
2022-01-30,42,15,27,180.0,1206
2020-02-01,329,260,69,26.54,1627
2020-02-02,210,126,84,66.67,1627
2020-02-03,810,615,195,31.71,1627
2020-02-04,753,614,139,22.64,1627
2020-02-05,753,605,148,24.46,1627
2020-02-06,753,596,157,26.34,1627
2020-02-07,676,502,174,34.66,1627
2020-02-08,329,201,128,63.68,1627
2020-02-09,210,68,142,208.82,1627
2020-02-10,810,558,252,45.16,1627
2020-02-11,753,559,194,34.7,1627
2020-02-12,753,552,201,36.41,1627
2020-02-13,753,547,206,37.66,1627
2020-02-14,676,456,220,48.25,1627
2020-02-15,329,158,171,108.23,1627
2020-02-16,210,29,181,624.14,1627
2020-02-17,810,524,286,54.58,1627
2020-02-18,753,529,224,42.34,1627
2020-02-19,753,526,227,43.16,1627
2020-02-20,753,525,228,43.43,1627
2020-02-21,676,439,237,53.99,1627
2020-02-22,329,145,184,126.9,1627
2020-02-23,210,19,191,1005.26,1627
2020-02-24,810,516,294,56.98,1627
2020-02-25,753,524,229,43.7,1627
2020-02-26,753,524,229,43.7,1627
2020-02-27,753,524,229,43.7,1627
2020-02-28,676,438,238,54.34,1627
2020-02-29,329,144,185,128.47,1627
2020-03-01,120,18,102,566.67,1627
2020-03-02,578,515,63,12.23,1627
2020-03-03,554,522,32,6.13,1627
2020-03-04,554,519,35,6.74,1627
2020-03-05,554,518,36,6.95,1627
2020-03-06,513,430,83,19.3,1627
2020-03-07,226,134,92,68.66,1627
2020-03-08,120,6,114,1900.0,1627
2020-03-09,578,500,78,15.6,1627
2020-03-10,554,504,50,9.92,1627
2020-03-11,554,500,54,10.8,1627
2020-03-12,554,497,57,11.47,1627
2020-03-13,513,407,106,26.04,1627
2020-03-14,226,110,116,105.45,1627
2020-03-15,120,37,83,224.32,1627
2020-03-16,578,474,104,21.94,1627
2020-03-17,554,478,76,15.9,1627
2020-03-18,554,474,80,16.88,1627
2020-03-19,554,471,83,17.62,1627
2020-03-20,513,382,131,34.29,1627
2020-03-21,226,86,140,162.79,1627
2020-03-22,120,21,99,471.43,1627
2020-03-23,578,453,125,27.59,1627
2020-03-24,554,458,96,20.96,1627
2020-03-25,554,456,98,21.49,1627
2020-03-26,554,454,100,22.03,1627
2020-03-27,513,367,146,39.78,1627
2020-03-28,226,73,153,209.59,1627
2020-03-29,120,16,104,650.0,1627
2020-03-30,578,442,136,30.77,1627
2020-03-31,554,449,105,23.39,1627
2020-04-01,499,447,52,11.63,1627
2020-04-02,499,446,53,11.88,1627
2020-04-03,384,359,25,6.96,1627
2020-04-04,166,64,102,159.38,1627
2020-04-05,86,14,72,514.29,1627
2020-04-06,503,433,70,16.17,1627
2020-04-07,499,439,60,13.67,1627
2020-04-08,499,436,63,14.45,1627
2020-04-09,499,434,65,14.98,1627
2020-04-10,384,346,38,10.98,1627
2020-04-11,166,50,116,232.0,1627
2020-04-12,86,4,82,2050.0,1627
2020-04-13,503,416,87,20.91,1627
2020-04-14,499,420,79,18.81,1627
2020-04-15,499,417,82,19.66,1627
2020-04-16,499,414,85,20.53,1627
2020-04-17,384,325,59,18.15,1627
2020-04-18,166,29,137,472.41,1627
2020-04-19,86,29,57,196.55,1627
2020-04-20,503,395,108,27.34,1627
2020-04-21,499,400,99,24.75,1627
2020-04-22,499,398,101,25.38,1627
2020-04-23,499,396,103,26.01,1627
2020-04-24,384,309,75,24.27,1627
2020-04-25,166,14,152,1085.71,1627
2020-04-26,86,14,72,514.29,1627
2020-04-27,503,385,118,30.65,1627
2020-04-28,499,392,107,27.3,1627
2020-04-29,499,392,107,27.3,1627
2020-04-30,499,392,107,27.3,1627
2020-05-01,619,307,312,101.63,1627
2020-05-02,265,14,251,1792.86,1627
2020-05-03,125,14,111,792.86,1627
2020-05-04,658,388,270,69.59,1627
2020-05-05,651,396,255,64.39,1627
2020-05-06,651,397,254,63.98,1627
2020-05-07,651,398,253,63.57,1627
2020-05-08,619,312,307,98.4,1627
2020-05-09,265,19,246,1294.74,1627
2020-05-10,125,19,106,557.89,1627
2020-05-11,658,391,267,68.29,1627
2020-05-12,651,398,253,63.57,1627
2020-05-13,651,396,255,64.39,1627
2020-05-14,651,395,256,64.81,1627
2020-05-15,619,307,312,101.63,1627
2020-05-16,265,12,253,2108.33,1627
2020-05-17,125,12,113,941.67,1627
2020-05-18,658,378,280,74.07,1627
2020-05-19,651,382,269,70.42,1627
2020-05-20,651,377,274,72.68,1627
2020-05-21,651,373,278,74.53,1627
2020-05-22,619,283,336,118.73,1627
2020-05-23,265,40,225,562.5,1627
2020-05-24,125,40,85,212.5,1627
2020-05-25,658,348,310,89.08,1627
2020-05-26,651,350,301,86.0,1627
2020-05-27,651,345,306,88.7,1627
2020-05-28,651,340,311,91.47,1627
2020-05-29,619,249,370,148.59,1627
2020-05-30,265,24,241,1004.17,1627
2020-05-31,125,24,101,420.83,1627
2020-06-01,710,315,395,125.4,1627
2020-06-02,662,318,344,108.18,1627
2020-06-03,662,314,348,110.83,1627
2020-06-04,662,311,351,112.86,1627
2020-06-05,630,222,408,183.78,1627
2020-06-06,264,11,253,2300.0,1627
2020-06-07,190,11,179,1627.27,1627
2020-06-08,710,292,418,143.15,1627
2020-06-09,662,297,365,122.9,1627
2020-06-10,662,294,368,125.17,1627
2020-06-11,662,292,370,126.71,1627
2020-06-12,630,204,426,208.82,1627
2020-06-13,264,3,261,8700.0,1627
2020-06-14,190,3,187,6233.33,1627
2020-06-15,710,277,433,156.32,1627
2020-06-16,662,283,379,133.92,1627
2020-06-17,662,280,382,136.43,1627
2020-06-18,662,278,384,138.13,1627
2020-06-19,630,190,440,231.58,1627
2020-06-20,264,3,261,8700.0,1627
2020-06-21,190,3,187,6233.33,1627
2020-06-22,710,262,448,170.99,1627
2020-06-23,662,267,395,147.94,1627
2020-06-24,662,264,398,150.76,1627
2020-06-25,662,262,400,152.67,1627
2020-06-26,630,173,457,264.16,1627
2020-06-27,264,173,91,52.6,1627
2020-06-28,190,173,17,9.83,1627
2020-06-29,710,245,465,189.8,1627
2020-06-30,662,250,412,164.8,1627
2020-07-01,625,247,378,153.04,1627
2020-07-02,625,245,380,155.1,1627
2020-07-03,534,158,376,237.97,1627
2020-07-04,264,158,106,67.09,1627
2020-07-05,122,158,-36,-22.78,1627
2020-07-06,611,232,379,163.36,1627
2020-07-07,625,238,387,162.61,1627
2020-07-08,625,236,389,164.83,1627
2020-07-09,625,236,389,164.83,1627
2020-07-10,534,149,385,258.39,1627
2020-07-11,264,149,115,77.18,1627
2020-07-12,122,149,-27,-18.12,1627
2020-07-13,611,225,386,171.56,1627
2020-07-14,625,232,393,169.4,1627
2020-07-15,625,230,395,171.74,1627
2020-07-16,625,229,396,172.93,1627
2020-07-17,534,142,392,276.06,1627
2020-07-18,264,142,122,85.92,1627
2020-07-19,122,142,-20,-14.08,1627
2020-07-20,611,215,396,184.19,1627
2020-07-21,625,221,404,182.81,1627
2020-07-22,625,217,408,188.02,1627
2020-07-23,625,214,411,192.06,1627
2020-07-24,534,125,409,327.2,1627
2020-07-25,264,125,139,111.2,1627
2020-07-26,122,125,-3,-2.4,1627
2020-07-27,611,191,420,219.9,1627
2020-07-28,625,194,431,222.16,1627
2020-07-29,625,188,437,232.45,1627
2020-07-30,625,183,442,241.53,1627
2020-07-31,534,92,442,480.43,1627
2020-08-01,186,92,94,102.17,1627
2020-08-02,105,92,13,14.13,1627
2020-08-03,520,154,366,237.66,1627
2020-08-04,434,156,278,178.21,1627
2020-08-05,434,150,284,189.33,1627
2020-08-06,434,145,289,199.31,1627
2020-08-07,354,55,299,543.64,1627
2020-08-08,186,55,131,238.18,1627
2020-08-09,105,55,50,90.91,1627
2020-08-10,520,122,398,326.23,1627
2020-08-11,434,126,308,244.44,1627
2020-08-12,434,123,311,252.85,1627
2020-08-13,434,121,313,258.68,1627
2020-08-14,354,34,320,941.18,1627
2020-08-15,186,34,152,447.06,1627
2020-08-16,105,34,71,208.82,1627
2020-08-17,520,110,410,372.73,1627
2020-08-18,434,118,316,267.8,1627
2020-08-19,434,118,316,267.8,1627
2020-08-20,434,120,314,261.67,1627
2020-08-21,354,35,319,911.43,1627
2020-08-22,186,35,151,431.43,1627
2020-08-23,105,35,70,200.0,1627
2020-08-24,520,120,400,333.33,1627
2020-08-25,434,130,304,233.85,1627
2020-08-26,434,131,303,231.3,1627
2020-08-27,434,134,300,223.88,1627
2020-08-28,354,51,303,594.12,1627
2020-08-29,186,51,135,264.71,1627
2020-08-30,105,51,54,105.88,1627
2020-08-31,520,136,384,282.35,1627
2020-09-01,632,146,486,332.88,1627
2020-09-02,632,147,485,329.93,1627
2020-09-03,632,149,483,324.16,1627
2020-09-04,607,65,542,833.85,1627
2020-09-05,265,65,200,307.69,1627
2020-09-06,160,65,95,146.15,1627
2020-09-07,681,148,533,360.14,1627
2020-09-08,632,156,476,305.13,1627
2020-09-09,632,157,475,302.55,1627
2020-09-10,632,158,474,300.0,1627
2020-09-11,607,73,534,731.51,1627
2020-09-12,265,73,192,263.01,1627
2020-09-13,160,73,87,119.18,1627
2020-09-14,681,153,528,345.1,1627
2020-09-15,632,161,471,292.55,1627
2020-09-16,632,161,471,292.55,1627
2020-09-17,632,162,470,290.12,1627
2020-09-18,607,76,531,698.68,1627
2020-09-19,265,76,189,248.68,1627
2020-09-20,160,76,84,110.53,1627
2020-09-21,681,155,526,339.35,1627
2020-09-22,632,163,469,287.73,1627
2020-09-23,632,161,471,292.55,1627
2020-09-24,632,161,471,292.55,1627
2020-09-25,607,75,532,709.33,1627
2020-09-26,265,75,190,253.33,1627
2020-09-27,160,75,85,113.33,1627
2020-09-28,681,150,531,354.0,1627
2020-09-29,632,155,477,307.74,1627
2020-09-30,632,153,479,313.07,1627
2020-10-01,738,151,587,388.74,1627
2020-10-02,682,63,619,982.54,1627
2020-10-03,298,63,235,373.02,1627
2020-10-04,146,63,83,131.75,1627
2020-10-05,750,133,617,463.91,1627
2020-10-06,738,138,600,434.78,1627
2020-10-07,738,134,604,450.75,1627
2020-10-08,738,131,607,463.36,1627
2020-10-09,682,43,639,1486.05,1627
2020-10-10,298,43,255,593.02,1627
2020-10-11,146,43,103,239.53,1627
2020-10-12,750,113,637,563.72,1627
2020-10-13,738,119,619,520.17,1627
2020-10-14,738,117,621,530.77,1627
2020-10-15,738,116,622,536.21,1627
2020-10-16,682,29,653,2251.72,1627
2020-10-17,298,29,269,927.59,1627
2020-10-18,146,29,117,403.45,1627
2020-10-19,750,109,641,588.07,1627
2020-10-20,738,118,620,525.42,1627
2020-10-21,738,119,619,520.17,1627
2020-10-22,738,122,616,504.92,1627
2020-10-23,682,40,642,1605.0,1627
2020-10-24,298,40,258,645.0,1627
2020-10-25,146,40,106,265.0,1627
2020-10-26,750,130,620,476.92,1627
2020-10-27,738,142,596,419.72,1627
2020-10-28,738,147,591,402.04,1627
2020-10-29,738,152,586,385.53,1627
2020-10-30,682,71,611,860.56,1627
2020-10-31,298,71,227,319.72,1627
2020-11-01,129,71,58,81.69,1627
2020-11-02,684,165,519,314.55,1627
2020-11-03,665,177,488,275.71,1627
2020-11-04,665,181,484,267.4,1627
2020-11-05,665,185,480,259.46,1627
2020-11-06,572,102,470,460.78,1627
2020-11-07,253,10,243,2430.0,1627
2020-11-08,129,10,119,1190.0,1627
2020-11-09,684,188,496,263.83,1627
2020-11-10,665,198,467,235.86,1627
2020-11-11,665,198,467,235.86,1627
2020-11-12,665,199,466,234.17,1627
2020-11-13,572,113,459,406.19,1627
2020-11-14,253,16,237,1481.25,1627
2020-11-15,129,16,113,706.25,1627
2020-11-16,684,190,494,260.0,1627
2020-11-17,665,197,468,237.56,1627
2020-11-18,665,195,470,241.03,1627
2020-11-19,665,194,471,242.78,1627
2020-11-20,572,108,464,429.63,1627
2020-11-21,253,14,239,1707.14,1627
2020-11-22,129,14,115,821.43,1627
2020-11-23,684,185,499,269.73,1627
2020-11-24,665,193,472,244.56,1627
2020-11-25,665,193,472,244.56,1627
2020-11-26,665,194,471,242.78,1627
2020-11-27,572,110,462,420.0,1627
2020-11-28,253,23,230,1000.0,1627
2020-11-29,129,23,106,460.87,1627
2020-11-30,684,196,488,248.98,1627
2020-12-01,609,207,402,194.2,1627
2020-12-02,609,210,399,190.0,1627
2020-12-03,609,215,394,183.26,1627
2020-12-04,667,133,534,401.5,1627
2020-12-05,327,38,289,760.53,1627
2020-12-06,132,38,94,247.37,1627
2020-12-07,567,224,343,153.12,1627
2020-12-08,609,235,374,159.15,1627
2020-12-09,609,238,371,155.88,1627
2020-12-10,609,242,367,151.65,1627
2020-12-11,667,158,509,322.15,1627
2020-12-12,327,45,282,626.67,1627
2020-12-13,132,45,87,193.33,1627
2020-12-14,567,240,327,136.25,1627
2020-12-15,609,248,361,145.56,1627
2020-12-16,609,246,363,147.56,1627
2020-12-17,609,244,365,149.59,1627
2020-12-18,667,155,512,330.32,1627
2020-12-19,327,58,269,463.79,1627
2020-12-20,132,58,74,127.59,1627
2020-12-21,567,220,347,157.73,1627
2020-12-22,609,222,387,174.32,1627
2020-12-23,609,215,394,183.26,1627
2020-12-24,609,208,401,192.79,1627
2020-12-25,667,115,552,480.0,1627
2020-12-26,327,33,294,890.91,1627
2020-12-27,132,33,99,300.0,1627
2020-12-28,567,170,397,233.53,1627
2020-12-29,609,169,440,260.36,1627
2020-12-30,609,161,448,278.26,1627
2020-12-31,609,154,455,295.45,1627
2021-01-01,532,61,471,772.13,1627
2021-01-02,218,7,211,3014.29,1627
2021-01-03,101,7,94,1342.86,1627
2021-01-04,598,121,477,394.21,1627
2021-01-05,619,123,496,403.25,1627
2021-01-06,619,118,501,424.58,1627
2021-01-07,619,115,504,438.26,1627
2021-01-08,532,26,506,1946.15,1627
2021-01-09,218,26,192,738.46,1627
2021-01-10,101,26,75,288.46,1627
2021-01-11,598,98,500,510.2,1627
2021-01-12,619,104,515,495.19,1627
2021-01-13,619,103,516,500.97,1627
2021-01-14,619,102,517,506.86,1627
2021-01-15,532,15,517,3446.67,1627
2021-01-16,218,0,218,inf,1627
2021-01-17,101,0,101,inf,1627
2021-01-18,598,91,507,557.14,1627
2021-01-19,619,97,522,538.14,1627
2021-01-20,619,95,524,551.58,1627
2021-01-21,619,93,526,565.59,1627
2021-01-22,532,4,528,13200.0,1627
2021-01-23,218,4,214,5350.0,1627
2021-01-24,101,4,97,2425.0,1627
2021-01-25,598,70,528,754.29,1627
2021-01-26,619,73,546,747.95,1627
2021-01-27,619,66,553,837.88,1627
2021-01-28,619,60,559,931.67,1627
2021-01-29,532,121,411,339.67,1627
2021-01-30,218,121,97,80.17,1627
2021-01-31,101,121,-20,-16.53,1627
2021-02-01,678,22,656,2981.82,1627
2021-02-02,672,21,651,3100.0,1627
2021-02-03,672,11,661,6009.09,1627
2021-02-04,672,3,669,22300.0,1627
2021-02-05,533,103,430,417.48,1627
2021-02-06,262,103,159,154.37,1627
2021-02-07,133,103,30,29.13,1627
2021-02-08,678,128,550,429.69,1627
2021-02-09,672,133,539,405.26,1627
2021-02-10,672,129,543,420.93,1627
2021-02-11,672,125,547,437.6,1627
2021-02-12,533,78,455,583.33,1627
2021-02-13,262,78,184,235.9,1627
2021-02-14,133,78,55,70.51,1627
2021-02-15,678,110,568,516.36,1627
2021-02-16,672,112,560,500.0,1627
2021-02-17,672,115,557,484.35,1627
2021-02-18,672,110,562,510.91,1627
2021-02-19,533,71,462,650.7,1627
2021-02-20,262,71,191,269.01,1627
2021-02-21,133,71,62,87.32,1627
2021-02-22,678,110,568,516.36,1627
2021-02-23,672,114,558,489.47,1627
2021-02-24,672,118,554,469.49,1627
2021-02-25,672,115,557,484.35,1627
2021-02-26,533,76,457,601.32,1627
2021-02-27,262,76,186,244.74,1627
2021-02-28,133,76,57,75.0,1627
2021-03-01,703,111,592,533.33,1627
2021-03-02,668,126,542,430.16,1627
2021-03-03,668,120,548,456.67,1627
2021-03-04,668,125,543,434.4,1627
2021-03-05,606,77,529,687.01,1627
2021-03-06,265,77,188,244.16,1627
2021-03-07,142,77,65,84.42,1627
2021-03-08,703,109,594,544.95,1627
2021-03-09,668,119,549,461.34,1627
2021-03-10,668,114,554,485.96,1627
2021-03-11,668,115,553,480.87,1627
2021-03-12,606,69,537,778.26,1627
2021-03-13,265,69,196,284.06,1627
2021-03-14,142,69,73,105.8,1627
2021-03-15,703,108,595,550.93,1627
2021-03-16,668,112,556,496.43,1627
2021-03-17,668,105,563,536.19,1627
2021-03-18,668,109,559,512.84,1627
2021-03-19,606,64,542,846.88,1627
2021-03-20,265,64,201,314.06,1627
2021-03-21,142,64,78,121.88,1627
2021-03-22,703,100,603,603.0,1627
2021-03-23,668,104,564,542.31,1627
2021-03-24,668,103,565,548.54,1627
2021-03-25,668,104,564,542.31,1627
2021-03-26,606,51,555,1088.24,1627
2021-03-27,265,51,214,419.61,1627
2021-03-28,142,51,91,178.43,1627
2021-03-29,703,96,607,632.29,1627
2021-03-30,668,103,565,548.54,1627
2021-03-31,668,104,564,542.31,1627
2021-04-01,644,95,549,577.89,1627
2021-04-02,536,64,472,737.5,1627
2021-04-03,232,64,168,262.5,1627
2021-04-04,101,64,37,57.81,1627
2021-04-05,671,95,576,606.32,1627
2021-04-06,644,106,538,507.55,1627
2021-04-07,644,98,546,557.14,1627
2021-04-08,644,107,537,501.87,1627
2021-04-09,536,48,488,1016.67,1627
2021-04-10,232,48,184,383.33,1627
2021-04-11,101,48,53,110.42,1627
2021-04-12,671,82,589,718.29,1627
2021-04-13,644,92,552,600.0,1627
2021-04-14,644,90,554,615.56,1627
2021-04-15,644,89,555,623.6,1627
2021-04-16,536,45,491,1091.11,1627
2021-04-17,232,45,187,415.56,1627
2021-04-18,101,45,56,124.44,1627
2021-04-19,671,87,584,671.26,1627
2021-04-20,644,87,557,640.23,1627
2021-04-21,644,92,552,600.0,1627
2021-04-22,644,89,555,623.6,1627
2021-04-23,536,44,492,1118.18,1627
2021-04-24,232,44,188,427.27,1627
2021-04-25,101,44,57,129.55,1627
2021-04-26,671,85,586,689.41,1627
2021-04-27,644,92,552,600.0,1627
2021-04-28,644,85,559,657.65,1627
2021-04-29,644,89,555,623.6,1627
2021-04-30,536,46,490,1065.22,1627
2021-05-01,240,46,194,421.74,1627
2021-05-02,145,46,99,215.22,1627
2021-05-03,658,85,573,674.12,1627
2021-05-04,667,103,564,547.57,1627
2021-05-05,667,100,567,567.0,1627
2021-05-06,667,92,575,625.0,1627
2021-05-07,598,57,541,949.12,1627
2021-05-08,240,57,183,321.05,1627
2021-05-09,145,57,88,154.39,1627
2021-05-10,658,96,562,585.42,1627
2021-05-11,667,108,559,517.59,1627
2021-05-12,667,105,562,535.24,1627
2021-05-13,667,98,569,580.61,1627
2021-05-14,598,60,538,896.67,1627
2021-05-15,240,60,180,300.0,1627
2021-05-16,145,60,85,141.67,1627
2021-05-17,658,95,563,592.63,1627
2021-05-18,667,98,569,580.61,1627
2021-05-19,667,91,576,632.97,1627
2021-05-20,667,102,565,553.92,1627
2021-05-21,598,47,551,1172.34,1627
2021-05-22,240,47,193,410.64,1627
2021-05-23,145,47,98,208.51,1627
2021-05-24,658,93,565,607.53,1627
2021-05-25,667,89,578,649.44,1627
2021-05-26,667,81,586,723.46,1627
2021-05-27,667,82,585,713.41,1627
2021-05-28,598,41,557,1358.54,1627
2021-05-29,240,41,199,485.37,1627
2021-05-30,145,41,104,253.66,1627
2021-05-31,658,78,580,743.59,1627
2021-06-01,594,80,514,642.5,1627
2021-06-02,594,85,509,598.82,1627
2021-06-03,594,80,514,642.5,1627
2021-06-04,492,29,463,1596.55,1627
2021-06-05,212,29,183,631.03,1627
2021-06-06,122,29,93,320.69,1627
2021-06-07,588,70,518,740.0,1627
2021-06-08,594,73,521,713.7,1627
2021-06-09,594,75,519,692.0,1627
2021-06-10,594,67,527,786.57,1627
2021-06-11,492,25,467,1868.0,1627
2021-06-12,212,25,187,748.0,1627
2021-06-13,122,25,97,388.0,1627
2021-06-14,588,65,523,804.62,1627
2021-06-15,594,77,517,671.43,1627
2021-06-16,594,70,524,748.57,1627
2021-06-17,594,63,531,842.86,1627
2021-06-18,492,22,470,2136.36,1627
2021-06-19,212,22,190,863.64,1627
2021-06-20,122,22,100,454.55,1627
2021-06-21,588,62,526,848.39,1627
2021-06-22,594,58,536,924.14,1627
2021-06-23,594,71,523,736.62,1627
2021-06-24,594,58,536,924.14,1627
2021-06-25,492,20,472,2360.0,1627
2021-06-26,212,20,192,960.0,1627
2021-06-27,122,20,102,510.0,1627
2021-06-28,588,60,528,880.0,1627
2021-06-29,594,54,540,1000.0,1627
2021-06-30,594,68,526,773.53,1627
2021-07-01,543,67,476,710.45,1627
2021-07-02,479,26,453,1742.31,1627
2021-07-03,220,26,194,746.15,1627
2021-07-04,129,26,103,396.15,1627
2021-07-05,518,61,457,749.18,1627
2021-07-06,543,65,478,735.38,1627
2021-07-07,543,61,482,790.16,1627
2021-07-08,543,53,490,924.53,1627
2021-07-09,479,16,463,2893.75,1627
2021-07-10,220,16,204,1275.0,1627
2021-07-11,129,16,113,706.25,1627
2021-07-12,518,59,459,777.97,1627
2021-07-13,543,57,486,852.63,1627
2021-07-14,543,60,483,805.0,1627
2021-07-15,543,58,485,836.21,1627
2021-07-16,479,20,459,2295.0,1627
2021-07-17,220,20,200,1000.0,1627
2021-07-18,129,20,109,545.0,1627
2021-07-19,518,59,459,777.97,1627
2021-07-20,543,65,478,735.38,1627
2021-07-21,543,59,484,820.34,1627
2021-07-22,543,67,476,710.45,1627
2021-07-23,479,20,459,2295.0,1627
2021-07-24,220,20,200,1000.0,1627
2021-07-25,129,20,109,545.0,1627
2021-07-26,518,53,465,877.36,1627
2021-07-27,543,53,490,924.53,1627
2021-07-28,543,56,487,869.64,1627
2021-07-29,543,57,486,852.63,1627
2021-07-30,479,4,475,11875.0,1627
2021-07-31,220,4,216,5400.0,1627
2021-08-01,135,4,131,3275.0,1627
2021-08-02,554,47,507,1078.72,1627
2021-08-03,552,43,509,1183.72,1627
2021-08-04,552,38,514,1352.63,1627
2021-08-05,552,34,518,1523.53,1627
2021-08-06,461,34,427,1255.88,1627
2021-08-07,203,34,169,497.06,1627
2021-08-08,135,34,101,297.06,1627
2021-08-09,554,33,521,1578.79,1627
2021-08-10,552,38,514,1352.63,1627
2021-08-11,552,29,523,1803.45,1627
2021-08-12,552,39,513,1315.38,1627
2021-08-13,461,39,422,1082.05,1627
2021-08-14,203,39,164,420.51,1627
2021-08-15,135,39,96,246.15,1627
2021-08-16,554,29,525,1810.34,1627
2021-08-17,552,34,518,1523.53,1627
2021-08-18,552,30,522,1740.0,1627
2021-08-19,552,37,515,1391.89,1627
2021-08-20,461,37,424,1145.95,1627
2021-08-21,203,37,166,448.65,1627
2021-08-22,135,37,98,264.86,1627
2021-08-23,554,46,508,1104.35,1627
2021-08-24,552,44,508,1154.55,1627
2021-08-25,552,49,503,1026.53,1627
2021-08-26,552,46,506,1100.0,1627
2021-08-27,461,0,461,inf,1627
2021-08-28,203,0,203,inf,1627
2021-08-29,135,0,135,inf,1627
2021-08-30,554,45,509,1131.11,1627
2021-08-31,552,58,494,851.72,1627
2021-09-01,658,64,594,928.12,1627
2021-09-02,658,67,591,882.09,1627
2021-09-03,562,14,548,3914.29,1627
2021-09-04,264,14,250,1785.71,1627
2021-09-05,156,14,142,1014.29,1627
2021-09-06,648,57,591,1036.84,1627
2021-09-07,658,66,592,896.97,1627
2021-09-08,658,73,585,801.37,1627
2021-09-09,658,67,591,882.09,1627
2021-09-10,562,33,529,1603.03,1627
2021-09-11,264,33,231,700.0,1627
2021-09-12,156,33,123,372.73,1627
2021-09-13,648,73,575,787.67,1627
2021-09-14,658,81,577,712.35,1627
2021-09-15,658,66,592,896.97,1627
2021-09-16,658,78,580,743.59,1627
2021-09-17,562,41,521,1270.73,1627
2021-09-18,264,41,223,543.9,1627
2021-09-19,156,41,115,280.49,1627
2021-09-20,648,76,572,752.63,1627
2021-09-21,658,83,575,692.77,1627
2021-09-22,658,83,575,692.77,1627
2021-09-23,658,85,573,674.12,1627
2021-09-24,562,39,523,1341.03,1627
2021-09-25,264,39,225,576.92,1627
2021-09-26,156,39,117,300.0,1627
2021-09-27,648,95,553,582.11,1627
2021-09-28,658,91,567,623.08,1627
2021-09-29,658,85,573,674.12,1627
2021-09-30,658,92,566,615.22,1627
2021-10-01,558,44,514,1168.18,1627
2021-10-02,273,44,229,520.45,1627
2021-10-03,142,44,98,222.73,1627
2021-10-04,622,76,546,718.42,1627
2021-10-05,680,81,599,739.51,1627
2021-10-06,680,88,592,672.73,1627
2021-10-07,680,83,597,719.28,1627
2021-10-08,558,37,521,1408.11,1627
2021-10-09,273,37,236,637.84,1627
2021-10-10,142,37,105,283.78,1627
2021-10-11,622,81,541,667.9,1627
2021-10-12,680,78,602,771.79,1627
2021-10-13,680,77,603,783.12,1627
2021-10-14,680,81,599,739.51,1627
2021-10-15,558,37,521,1408.11,1627
2021-10-16,273,37,236,637.84,1627
2021-10-17,142,37,105,283.78,1627
2021-10-18,622,81,541,667.9,1627
2021-10-19,680,86,594,690.7,1627
2021-10-20,680,88,592,672.73,1627
2021-10-21,680,84,596,709.52,1627
2021-10-22,558,50,508,1016.0,1627
2021-10-23,273,50,223,446.0,1627
2021-10-24,142,50,92,184.0,1627
2021-10-25,622,92,530,576.09,1627
2021-10-26,680,92,588,639.13,1627
2021-10-27,680,103,577,560.19,1627
2021-10-28,680,102,578,566.67,1627
2021-10-29,558,63,495,785.71,1627
2021-10-30,273,63,210,333.33,1627
2021-10-31,142,63,79,125.4,1627
2021-11-01,688,117,571,488.03,1627
2021-11-02,672,123,549,446.34,1627
2021-11-03,672,130,542,416.92,1627
2021-11-04,672,125,547,437.6,1627
2021-11-05,614,87,527,605.75,1627
2021-11-06,269,87,182,209.2,1627
2021-11-07,148,87,61,70.11,1627
2021-11-08,688,139,549,394.96,1627
2021-11-09,672,138,534,386.96,1627
2021-11-10,672,138,534,386.96,1627
2021-11-11,672,141,531,376.6,1627
2021-11-12,614,103,511,496.12,1627
2021-11-13,269,103,166,161.17,1627
2021-11-14,148,103,45,43.69,1627
2021-11-15,688,140,548,391.43,1627
2021-11-16,672,147,525,357.14,1627
2021-11-17,672,145,527,363.45,1627
2021-11-18,672,151,521,345.03,1627
2021-11-19,614,102,512,501.96,1627
2021-11-20,269,102,167,163.73,1627
2021-11-21,148,102,46,45.1,1627
2021-11-22,688,150,538,358.67,1627
2021-11-23,672,155,517,333.55,1627
2021-11-24,672,148,524,354.05,1627
2021-11-25,672,166,506,304.82,1627
2021-11-26,614,106,508,479.25,1627
2021-11-27,269,106,163,153.77,1627
2021-11-28,148,106,42,39.62,1627
2021-11-29,688,154,534,346.75,1627
2021-11-30,672,162,510,314.81,1627
2021-12-01,572,169,403,238.46,1627
2021-12-02,572,166,406,244.58,1627
2021-12-03,464,129,335,259.69,1627
2021-12-04,276,129,147,113.95,1627
2021-12-05,127,129,-2,-1.55,1627
2021-12-06,650,183,467,255.19,1627
2021-12-07,572,191,381,199.48,1627
2021-12-08,572,193,379,196.37,1627
2021-12-09,572,186,386,207.53,1627
2021-12-10,464,156,308,197.44,1627
2021-12-11,276,156,120,76.92,1627
2021-12-12,127,156,-29,-18.59,1627
2021-12-13,650,192,458,238.54,1627
2021-12-14,572,195,377,193.33,1627
2021-12-15,572,193,379,196.37,1627
2021-12-16,572,203,369,181.77,1627
2021-12-17,464,154,310,201.3,1627
2021-12-18,276,13,263,2023.08,1627
2021-12-19,127,13,114,876.92,1627
2021-12-20,650,200,450,225.0,1627
2021-12-21,572,192,380,197.92,1627
2021-12-22,572,198,374,188.89,1627
2021-12-23,572,202,370,183.17,1627
2021-12-24,464,144,320,222.22,1627
2021-12-25,276,144,132,91.67,1627
2021-12-26,127,144,-17,-11.81,1627
2021-12-27,650,178,472,265.17,1627
2021-12-28,572,177,395,223.16,1627
2021-12-29,572,172,400,232.56,1627
2021-12-30,572,170,402,236.47,1627
2021-12-31,464,134,330,246.27,1627
2022-01-01,236,134,102,76.12,1627
2022-01-02,112,134,-22,-16.42,1627
2022-01-03,604,171,433,253.22,1627
2022-01-04,545,166,379,228.31,1627
2022-01-05,545,152,393,258.55,1627
2022-01-06,545,151,394,260.93,1627
2022-01-07,493,106,387,365.09,1627
2022-01-08,236,106,130,122.64,1627
2022-01-09,112,106,6,5.66,1627
2022-01-10,604,146,458,313.7,1627
2022-01-11,545,154,391,253.9,1627
2022-01-12,545,156,389,249.36,1627
2022-01-13,545,152,393,258.55,1627
2022-01-14,493,106,387,365.09,1627
2022-01-15,236,106,130,122.64,1627
2022-01-16,112,106,6,5.66,1627
2022-01-17,604,142,462,325.35,1627
2022-01-18,545,154,391,253.9,1627
2022-01-19,545,161,384,238.51,1627
2022-01-20,545,154,391,253.9,1627
2022-01-21,493,112,381,340.18,1627
2022-01-22,236,112,124,110.71,1627
2022-01-23,112,112,0,0.0,1627
2022-01-24,604,156,448,287.18,1627
2022-01-25,545,149,396,265.77,1627
2022-01-26,545,141,404,286.52,1627
2022-01-27,545,150,395,263.33,1627
2022-01-28,493,98,395,403.06,1627
2022-01-29,236,98,138,140.82,1627
2022-01-30,112,98,14,14.29,1627
2020-02-01,250,3,247,8233.33,1205
2020-02-02,123,3,120,4000.0,1205
2020-02-03,563,369,194,52.57,1205
2020-02-04,600,375,225,60.0,1205
2020-02-05,600,376,224,59.57,1205
2020-02-06,600,374,226,60.43,1205
2020-02-07,557,309,248,80.26,1205
2020-02-08,250,43,207,481.4,1205
2020-02-09,123,43,80,186.05,1205
2020-02-10,563,352,211,59.94,1205
2020-02-11,600,359,241,67.13,1205
2020-02-12,600,361,239,66.2,1205
2020-02-13,600,360,240,66.67,1205
2020-02-14,557,298,259,86.91,1205
2020-02-15,250,41,209,509.76,1205
2020-02-16,123,41,82,200.0,1205
2020-02-17,563,346,217,62.72,1205
2020-02-18,600,356,244,68.54,1205
2020-02-19,600,360,240,66.67,1205
2020-02-20,600,361,239,66.2,1205
2020-02-21,557,300,257,85.67,1205
2020-02-22,250,41,209,509.76,1205
2020-02-23,123,41,82,200.0,1205
2020-02-24,563,355,208,58.59,1205
2020-02-25,600,365,235,64.38,1205
2020-02-26,600,371,229,61.73,1205
2020-02-27,600,373,227,60.86,1205
2020-02-28,557,313,244,77.96,1205
2020-02-29,250,49,201,410.2,1205
2020-03-01,99,49,50,102.04,1205
2020-03-02,478,367,111,30.25,1205
2020-03-03,476,377,99,26.26,1205
2020-03-04,476,382,94,24.61,1205
2020-03-05,476,383,93,24.28,1205
2020-03-06,456,322,134,41.61,1205
2020-03-07,227,1,226,22600.0,1205
2020-03-08,99,1,98,9800.0,1205
2020-03-09,478,372,106,28.49,1205
2020-03-10,476,380,96,25.26,1205
2020-03-11,476,383,93,24.28,1205
2020-03-12,476,383,93,24.28,1205
2020-03-13,456,320,136,42.5,1205
2020-03-14,227,50,177,354.0,1205
2020-03-15,99,50,49,98.0,1205
2020-03-16,478,367,111,30.25,1205
2020-03-17,476,375,101,26.93,1205
2020-03-18,476,378,98,25.93,1205
2020-03-19,476,378,98,25.93,1205
2020-03-20,456,315,141,44.76,1205
2020-03-21,227,47,180,382.98,1205
2020-03-22,99,47,52,110.64,1205
2020-03-23,478,364,114,31.32,1205
2020-03-24,476,373,103,27.61,1205
2020-03-25,476,377,99,26.26,1205
2020-03-26,476,379,97,25.59,1205
2020-03-27,456,318,138,43.4,1205
2020-03-28,227,50,177,354.0,1205
2020-03-29,99,50,49,98.0,1205
2020-03-30,478,371,107,28.84,1205
2020-03-31,476,381,95,24.93,1205
2020-04-01,468,386,82,21.24,1205
2020-04-02,468,388,80,20.62,1205
2020-04-03,405,327,78,23.85,1205
2020-04-04,202,7,195,2785.71,1205
2020-04-05,85,7,78,1114.29,1205
2020-04-06,470,381,89,23.36,1205
2020-04-07,468,391,77,19.69,1205
2020-04-08,468,395,73,18.48,1205
2020-04-09,468,396,72,18.18,1205
2020-04-10,405,335,70,20.9,1205
2020-04-11,202,13,189,1453.85,1205
2020-04-12,85,13,72,553.85,1205
2020-04-13,470,384,86,22.4,1205
2020-04-14,468,392,76,19.39,1205
2020-04-15,468,395,73,18.48,1205
2020-04-16,468,395,73,18.48,1205
2020-04-17,405,332,73,21.99,1205
2020-04-18,202,9,193,2144.44,1205
2020-04-19,85,9,76,844.44,1205
2020-04-20,470,378,92,24.34,1205
2020-04-21,468,385,83,21.56,1205
2020-04-22,468,388,80,20.62,1205
2020-04-23,468,387,81,20.93,1205
2020-04-24,405,324,81,25.0,1205
2020-04-25,202,2,200,10000.0,1205
2020-04-26,85,2,83,4150.0,1205
2020-04-27,470,372,98,26.34,1205
2020-04-28,468,380,88,23.16,1205
2020-04-29,468,384,84,21.88,1205
2020-04-30,468,384,84,21.88,1205
2020-05-01,508,323,185,57.28,1205
2020-05-02,248,2,246,12300.0,1205
2020-05-03,125,2,123,6150.0,1205
2020-05-04,572,374,198,52.94,1205
2020-05-05,560,383,177,46.21,1205
2020-05-06,560,387,173,44.7,1205
2020-05-07,560,388,172,44.33,1205
2020-05-08,508,327,181,55.35,1205
2020-05-09,248,6,242,4033.33,1205
2020-05-10,125,6,119,1983.33,1205
2020-05-11,572,378,194,51.32,1205
2020-05-12,560,386,174,45.08,1205
2020-05-13,560,389,171,43.96,1205
2020-05-14,560,390,170,43.59,1205
2020-05-15,508,327,181,55.35,1205
2020-05-16,248,4,244,6100.0,1205
2020-05-17,125,4,121,3025.0,1205
2020-05-18,572,373,199,53.35,1205
2020-05-19,560,379,181,47.76,1205
2020-05-20,560,381,179,46.98,1205
2020-05-21,560,379,181,47.76,1205
2020-05-22,508,315,193,61.27,1205
2020-05-23,248,45,203,451.11,1205
2020-05-24,125,45,80,177.78,1205
2020-05-25,572,358,214,59.78,1205
2020-05-26,560,364,196,53.85,1205
2020-05-27,560,365,195,53.42,1205
2020-05-28,560,364,196,53.85,1205
2020-05-29,508,300,208,69.33,1205
2020-05-30,248,43,205,476.74,1205
2020-05-31,125,43,82,190.7,1205
2020-06-01,657,346,311,89.88,1205
2020-06-02,663,354,309,87.29,1205
2020-06-03,663,356,307,86.24,1205
2020-06-04,663,357,306,85.71,1205
2020-06-05,589,295,294,99.66,1205
2020-06-06,230,33,197,596.97,1205
2020-06-07,123,33,90,272.73,1205
2020-06-08,657,345,312,90.43,1205
2020-06-09,663,354,309,87.29,1205
2020-06-10,663,358,305,85.2,1205
2020-06-11,663,359,304,84.68,1205
2020-06-12,589,297,292,98.32,1205
2020-06-13,230,38,192,505.26,1205
2020-06-14,123,38,85,223.68,1205
2020-06-15,657,345,312,90.43,1205
2020-06-16,663,352,311,88.35,1205
2020-06-17,663,353,310,87.82,1205
2020-06-18,663,351,312,88.89,1205
2020-06-19,589,285,304,106.67,1205
2020-06-20,230,33,197,596.97,1205
2020-06-21,123,33,90,272.73,1205
2020-06-22,657,320,337,105.31,1205
2020-06-23,663,322,341,105.9,1205
2020-06-24,663,318,345,108.49,1205
2020-06-25,663,310,353,113.87,1205
2020-06-26,589,240,349,145.42,1205
2020-06-27,230,7,223,3185.71,1205
2020-06-28,123,7,116,1657.14,1205
2020-06-29,657,261,396,151.72,1205
2020-06-30,663,259,404,155.98,1205
2020-07-01,600,252,348,138.1,1205
2020-07-02,600,243,357,146.91,1205
2020-07-03,545,170,375,220.59,1205
2020-07-04,240,170,70,41.18,1205
2020-07-05,110,170,-60,-35.29,1205
2020-07-06,585,191,394,206.28,1205
2020-07-07,600,191,409,214.14,1205
2020-07-08,600,186,414,222.58,1205
2020-07-09,600,180,420,233.33,1205
2020-07-10,545,111,434,390.99,1205
2020-07-11,240,111,129,116.22,1205
2020-07-12,110,111,-1,-0.9,1205
2020-07-13,585,147,438,297.96,1205
2020-07-14,600,153,447,292.16,1205
2020-07-15,600,155,445,287.1,1205
2020-07-16,600,154,446,289.61,1205
2020-07-17,545,92,453,492.39,1205
2020-07-18,240,92,148,160.87,1205
2020-07-19,110,92,18,19.57,1205
2020-07-20,585,146,439,300.68,1205
2020-07-21,600,157,443,282.17,1205
2020-07-22,600,164,436,265.85,1205
2020-07-23,600,168,432,257.14,1205
2020-07-24,545,110,435,395.45,1205
2020-07-25,240,110,130,118.18,1205
2020-07-26,110,110,0,0.0,1205
2020-07-27,585,170,415,244.12,1205
2020-07-28,600,183,417,227.87,1205
2020-07-29,600,189,411,217.46,1205
2020-07-30,600,193,407,210.88,1205
2020-07-31,545,133,412,309.77,1205
2020-08-01,225,133,92,69.17,1205
2020-08-02,108,133,-25,-18.8,1205
2020-08-03,565,188,377,200.53,1205
2020-08-04,554,197,357,181.22,1205
2020-08-05,554,200,354,177.0,1205
2020-08-06,554,201,353,175.62,1205
2020-08-07,481,138,343,248.55,1205
2020-08-08,225,138,87,63.04,1205
2020-08-09,108,138,-30,-21.74,1205
2020-08-10,565,184,381,207.07,1205
2020-08-11,554,191,363,190.05,1205
2020-08-12,554,193,361,187.05,1205
2020-08-13,554,192,362,188.54,1205
2020-08-14,481,128,353,275.78,1205
2020-08-15,225,128,97,75.78,1205
2020-08-16,108,128,-20,-15.62,1205
2020-08-17,565,175,390,222.86,1205
2020-08-18,554,183,371,202.73,1205
2020-08-19,554,186,368,197.85,1205
2020-08-20,554,187,367,196.26,1205
2020-08-21,481,126,355,281.75,1205
2020-08-22,225,126,99,78.57,1205
2020-08-23,108,126,-18,-14.29,1205
2020-08-24,565,181,384,212.15,1205
2020-08-25,554,192,362,188.54,1205
2020-08-26,554,198,356,179.8,1205
2020-08-27,554,202,352,174.26,1205
2020-08-28,481,143,338,236.36,1205
2020-08-29,225,143,82,57.34,1205
2020-08-30,108,143,-35,-24.48,1205
2020-08-31,565,204,361,176.96,1205
2020-09-01,631,216,415,192.13,1205
2020-09-02,631,223,408,182.96,1205
2020-09-03,631,227,404,177.97,1205
2020-09-04,563,169,394,233.14,1205
2020-09-05,245,169,76,44.97,1205
2020-09-06,136,169,-33,-19.53,1205
2020-09-07,613,226,387,171.24,1205
2020-09-08,631,237,394,166.24,1205
2020-09-09,631,242,389,160.74,1205
2020-09-10,631,244,387,158.61,1205
2020-09-11,563,183,380,207.65,1205
2020-09-12,245,183,62,33.88,1205
2020-09-13,136,183,-47,-25.68,1205
2020-09-14,613,232,381,164.22,1205
2020-09-15,631,241,390,161.83,1205
2020-09-16,631,243,388,159.67,1205
2020-09-17,631,243,388,159.67,1205
2020-09-18,563,180,383,212.78,1205
2020-09-19,245,180,65,36.11,1205
2020-09-20,136,180,-44,-24.44,1205
2020-09-21,613,226,387,171.24,1205
2020-09-22,631,233,398,170.82,1205
2020-09-23,631,236,395,167.37,1205
2020-09-24,631,235,396,168.51,1205
2020-09-25,563,173,390,225.43,1205
2020-09-26,245,173,72,41.62,1205
2020-09-27,136,173,-37,-21.39,1205
2020-09-28,613,221,392,177.38,1205
2020-09-29,631,230,401,174.35,1205
2020-09-30,631,233,398,170.82,1205
2020-10-01,683,234,449,191.88,1205
2020-10-02,630,173,457,264.16,1205
2020-10-03,291,173,118,68.21,1205
2020-10-04,130,173,-43,-24.86,1205
2020-10-05,697,225,472,209.78,1205
2020-10-06,683,234,449,191.88,1205
2020-10-07,683,238,445,186.97,1205
2020-10-08,683,240,443,184.58,1205
2020-10-09,630,178,452,253.93,1205
2020-10-10,291,178,113,63.48,1205
2020-10-11,130,178,-48,-26.97,1205
2020-10-12,697,229,468,204.37,1205
2020-10-13,683,238,445,186.97,1205
2020-10-14,683,241,442,183.4,1205
2020-10-15,683,241,442,183.4,1205
2020-10-16,630,178,452,253.93,1205
2020-10-17,291,178,113,63.48,1205
2020-10-18,130,178,-48,-26.97,1205
2020-10-19,697,224,473,211.16,1205
2020-10-20,683,232,451,194.4,1205
2020-10-21,683,233,450,193.13,1205
2020-10-22,683,232,451,194.4,1205
2020-10-23,630,169,461,272.78,1205
2020-10-24,291,169,122,72.19,1205
2020-10-25,130,169,-39,-23.08,1205
2020-10-26,697,214,483,225.7,1205
2020-10-27,683,221,462,209.05,1205
2020-10-28,683,223,460,206.28,1205
2020-10-29,683,222,461,207.66,1205
2020-10-30,630,159,471,296.23,1205
2020-10-31,291,159,132,83.02,1205
2020-11-01,124,159,-35,-22.01,1205
2020-11-02,671,207,464,224.15,1205
2020-11-03,658,215,443,206.05,1205
2020-11-04,658,219,439,200.46,1205
2020-11-05,658,219,439,200.46,1205
2020-11-06,590,157,433,275.8,1205
2020-11-07,243,157,86,54.78,1205
2020-11-08,124,157,-33,-21.02,1205
2020-11-09,671,208,463,222.6,1205
2020-11-10,658,217,441,203.23,1205
2020-11-11,658,221,437,197.74,1205
2020-11-12,658,221,437,197.74,1205
2020-11-13,590,159,431,271.07,1205
2020-11-14,243,159,84,52.83,1205
2020-11-15,124,159,-35,-22.01,1205
2020-11-16,671,208,463,222.6,1205
2020-11-17,658,216,442,204.63,1205
2020-11-18,658,218,440,201.83,1205
2020-11-19,658,217,441,203.23,1205
2020-11-20,590,153,437,285.62,1205
2020-11-21,243,153,90,58.82,1205
2020-11-22,124,153,-29,-18.95,1205
2020-11-23,671,196,475,242.35,1205
2020-11-24,658,202,456,225.74,1205
2020-11-25,658,202,456,225.74,1205
2020-11-26,658,200,458,229.0,1205
2020-11-27,590,134,456,340.3,1205
2020-11-28,243,134,109,81.34,1205
2020-11-29,124,134,-10,-7.46,1205
2020-11-30,671,173,498,287.86,1205
2020-12-01,527,178,349,196.07,1205
2020-12-02,527,178,349,196.07,1205
2020-12-03,527,176,351,199.43,1205
2020-12-04,613,110,503,457.27,1205
2020-12-05,275,110,165,150.0,1205
2020-12-06,119,110,9,8.18,1205
2020-12-07,532,152,380,250.0,1205
2020-12-08,527,158,369,233.54,1205
2020-12-09,527,159,368,231.45,1205
2020-12-10,527,158,369,233.54,1205
2020-12-11,613,95,518,545.26,1205
2020-12-12,275,95,180,189.47,1205
2020-12-13,119,95,24,25.26,1205
2020-12-14,532,141,391,277.3,1205
2020-12-15,527,149,378,253.69,1205
2020-12-16,527,152,375,246.71,1205
2020-12-17,527,152,375,246.71,1205
2020-12-18,613,90,523,581.11,1205
2020-12-19,275,90,185,205.56,1205
2020-12-20,119,90,29,32.22,1205
2020-12-21,532,140,392,280.0,1205
2020-12-22,527,148,379,256.08,1205
2020-12-23,527,152,375,246.71,1205
2020-12-24,527,152,375,246.71,1205
2020-12-25,613,90,523,581.11,1205
2020-12-26,275,90,185,205.56,1205
2020-12-27,119,90,29,32.22,1205
2020-12-28,532,139,393,282.73,1205
2020-12-29,527,147,380,258.5,1205
2020-12-30,527,150,377,251.33,1205
2020-12-31,527,150,377,251.33,1205
2021-01-01,455,88,367,417.05,1205
2021-01-02,204,88,116,131.82,1205
2021-01-03,99,88,11,12.5,1205
2021-01-04,488,135,353,261.48,1205
2021-01-05,523,143,380,265.73,1205
2021-01-06,523,146,377,258.22,1205
2021-01-07,523,146,377,258.22,1205
2021-01-08,455,84,371,441.67,1205
2021-01-09,204,84,120,142.86,1205
2021-01-10,99,84,15,17.86,1205
2021-01-11,488,132,356,269.7,1205
2021-01-12,523,140,383,273.57,1205
2021-01-13,523,143,380,265.73,1205
2021-01-14,523,143,380,265.73,1205
2021-01-15,455,81,374,461.73,1205
2021-01-16,204,81,123,151.85,1205
2021-01-17,99,81,18,22.22,1205
2021-01-18,488,129,359,278.29,1205
2021-01-19,523,137,386,281.75,1205
2021-01-20,523,140,383,273.57,1205
2021-01-21,523,140,383,273.57,1205
2021-01-22,455,77,378,490.91,1205
2021-01-23,204,77,127,164.94,1205
2021-01-24,99,77,22,28.57,1205
2021-01-25,488,123,365,296.75,1205
2021-01-26,523,130,393,302.31,1205
2021-01-27,523,132,391,296.21,1205
2021-01-28,523,131,392,299.24,1205
2021-01-29,455,67,388,579.1,1205
2021-01-30,204,67,137,204.48,1205
2021-01-31,99,67,32,47.76,1205
2021-02-01,603,109,494,453.21,1205
2021-02-02,581,115,466,405.22,1205
2021-02-03,581,116,465,400.86,1205
2021-02-04,581,114,467,409.65,1205
2021-02-05,539,49,490,1000.0,1205
2021-02-06,218,49,169,344.9,1205
2021-02-07,116,49,67,136.73,1205
2021-02-08,603,92,511,555.43,1205
2021-02-09,581,98,483,492.86,1205
2021-02-10,581,100,481,481.0,1205
2021-02-11,581,99,482,486.87,1205
2021-02-12,539,36,503,1397.22,1205
2021-02-13,218,36,182,505.56,1205
2021-02-14,116,36,80,222.22,1205
2021-02-15,603,83,520,626.51,1205
2021-02-16,581,92,489,531.52,1205
2021-02-17,581,96,485,505.21,1205
2021-02-18,581,97,484,498.97,1205
2021-02-19,539,36,503,1397.22,1205
2021-02-20,218,36,182,505.56,1205
2021-02-21,116,36,80,222.22,1205
2021-02-22,603,90,513,570.0,1205
2021-02-23,581,100,481,481.0,1205
2021-02-24,581,105,476,453.33,1205
2021-02-25,581,108,473,437.96,1205
2021-02-26,539,48,491,1022.92,1205
2021-02-27,218,48,170,354.17,1205
2021-02-28,116,48,68,141.67,1205
2021-03-01,610,102,508,498.04,1205
2021-03-02,622,113,509,450.44,1205
2021-03-03,622,117,505,431.62,1205
2021-03-04,622,119,503,422.69,1205
2021-03-05,573,58,515,887.93,1205
2021-03-06,248,58,190,327.59,1205
2021-03-07,120,58,62,106.9,1205
2021-03-08,610,109,501,459.63,1205
2021-03-09,622,117,505,431.62,1205
2021-03-10,622,120,502,418.33,1205
2021-03-11,622,121,501,414.05,1205
2021-03-12,573,58,515,887.93,1205
2021-03-13,248,58,190,327.59,1205
2021-03-14,120,58,62,106.9,1205
2021-03-15,610,105,505,480.95,1205
2021-03-16,622,113,509,450.44,1205
2021-03-17,622,116,506,436.21,1205
2021-03-18,622,115,507,440.87,1205
2021-03-19,573,53,520,981.13,1205
2021-03-20,248,53,195,367.92,1205
2021-03-21,120,53,67,126.42,1205
2021-03-22,610,101,509,503.96,1205
2021-03-23,622,110,512,465.45,1205
2021-03-24,622,114,508,445.61,1205
2021-03-25,622,115,507,440.87,1205
2021-03-26,573,53,520,981.13,1205
2021-03-27,248,53,195,367.92,1205
2021-03-28,120,53,67,126.42,1205
2021-03-29,610,106,504,475.47,1205
2021-03-30,622,116,506,436.21,1205
2021-03-31,622,121,501,414.05,1205
2021-04-01,641,123,518,421.14,1205
2021-04-02,601,63,538,853.97,1205
2021-04-03,244,63,181,287.3,1205
2021-04-04,121,63,58,92.06,1205
2021-04-05,679,116,563,485.34,1205
2021-04-06,641,126,515,408.73,1205
2021-04-07,641,131,510,389.31,1205
2021-04-08,641,132,509,385.61,1205
2021-04-09,601,71,530,746.48,1205
2021-04-10,244,71,173,243.66,1205
2021-04-11,121,71,50,70.42,1205
2021-04-12,679,121,558,461.16,1205
2021-04-13,641,130,511,393.08,1205
2021-04-14,641,133,508,381.95,1205
2021-04-15,641,133,508,381.95,1205
2021-04-16,601,70,531,758.57,1205
2021-04-17,244,70,174,248.57,1205
2021-04-18,121,70,51,72.86,1205
2021-04-19,679,116,563,485.34,1205
2021-04-20,641,124,517,416.94,1205
2021-04-21,641,126,515,408.73,1205
2021-04-22,641,126,515,408.73,1205
2021-04-23,601,63,538,853.97,1205
2021-04-24,244,63,181,287.3,1205
2021-04-25,121,63,58,92.06,1205
2021-04-26,679,110,569,517.27,1205
2021-04-27,641,118,523,443.22,1205
2021-04-28,641,121,520,429.75,1205
2021-04-29,641,121,520,429.75,1205
2021-04-30,601,59,542,918.64,1205
2021-05-01,296,59,237,401.69,1205
2021-05-02,144,59,85,144.07,1205
2021-05-03,819,110,709,644.55,1205
2021-05-04,760,119,641,538.66,1205
2021-05-05,760,123,637,517.89,1205
2021-05-06,760,125,635,508.0,1205
2021-05-07,686,63,623,988.89,1205
2021-05-08,296,63,233,369.84,1205
2021-05-09,144,63,81,128.57,1205
2021-05-10,819,114,705,618.42,1205
2021-05-11,760,123,637,517.89,1205
2021-05-12,760,127,633,498.43,1205
2021-05-13,760,127,633,498.43,1205
2021-05-14,686,65,621,955.38,1205
2021-05-15,296,65,231,355.38,1205
2021-05-16,144,65,79,121.54,1205
2021-05-17,819,111,708,637.84,1205
2021-05-18,760,119,641,538.66,1205
2021-05-19,760,120,640,533.33,1205
2021-05-20,760,119,641,538.66,1205
2021-05-21,686,55,631,1147.27,1205
2021-05-22,296,55,241,438.18,1205
2021-05-23,144,55,89,161.82,1205
2021-05-24,819,98,721,735.71,1205
2021-05-25,760,104,656,630.77,1205
2021-05-26,760,105,655,623.81,1205
2021-05-27,760,103,657,637.86,1205
2021-05-28,686,39,647,1658.97,1205
2021-05-29,296,39,257,658.97,1205
2021-05-30,144,39,105,269.23,1205
2021-05-31,819,84,735,875.0,1205
2021-06-01,794,92,702,763.04,1205
2021-06-02,794,94,700,744.68,1205
2021-06-03,794,94,700,744.68,1205
2021-06-04,708,32,676,2112.5,1205
2021-06-05,276,32,244,762.5,1205
2021-06-06,147,32,115,359.38,1205
2021-06-07,782,82,700,853.66,1205
2021-06-08,794,91,703,772.53,1205
2021-06-09,794,95,699,735.79,1205
2021-06-10,794,96,698,727.08,1205
2021-06-11,708,34,674,1982.35,1205
2021-06-12,276,34,242,711.76,1205
2021-06-13,147,34,113,332.35,1205
2021-06-14,782,83,699,842.17,1205
2021-06-15,794,91,703,772.53,1205
2021-06-16,794,92,702,763.04,1205
2021-06-17,794,91,703,772.53,1205
2021-06-18,708,26,682,2623.08,1205
2021-06-19,276,26,250,961.54,1205
2021-06-20,147,26,121,465.38,1205
2021-06-21,782,64,718,1121.88,1205
2021-06-22,794,67,727,1085.07,1205
2021-06-23,794,64,730,1140.62,1205
2021-06-24,794,57,737,1292.98,1205
2021-06-25,708,61,647,1060.66,1205
2021-06-26,276,61,215,352.46,1205
2021-06-27,147,61,86,140.98,1205
2021-06-28,782,10,772,7720.0,1205
2021-06-29,794,9,785,8722.22,1205
2021-06-30,794,2,792,39600.0,1205
2021-07-01,616,66,550,833.33,1205
2021-07-02,583,31,552,1780.65,1205
2021-07-03,231,31,200,645.16,1205
2021-07-04,121,31,90,290.32,1205
2021-07-05,630,39,591,1515.38,1205
2021-07-06,616,36,580,1611.11,1205
2021-07-07,616,39,577,1479.49,1205
2021-07-08,616,34,582,1711.76,1205
2021-07-09,583,3,580,19333.33,1205
2021-07-10,231,3,228,7600.0,1205
2021-07-11,121,3,118,3933.33,1205
2021-07-12,630,16,614,3837.5,1205
2021-07-13,616,17,599,3523.53,1205
2021-07-14,616,22,594,2700.0,1205
2021-07-15,616,17,599,3523.53,1205
2021-07-16,583,17,566,3329.41,1205
2021-07-17,231,17,214,1258.82,1205
2021-07-18,121,17,104,611.76,1205
2021-07-19,630,12,618,5150.0,1205
2021-07-20,616,17,599,3523.53,1205
2021-07-21,616,24,592,2466.67,1205
2021-07-22,616,29,587,2024.14,1205
2021-07-23,583,29,554,1910.34,1205
2021-07-24,231,29,202,696.55,1205
2021-07-25,121,29,92,317.24,1205
2021-07-26,630,29,601,2072.41,1205
2021-07-27,616,30,586,1953.33,1205
2021-07-28,616,30,586,1953.33,1205
2021-07-29,616,33,583,1766.67,1205
2021-07-30,583,6,577,9616.67,1205
2021-07-31,231,6,225,3750.0,1205
2021-08-01,124,6,118,1966.67,1205
2021-08-02,600,31,569,1835.48,1205
2021-08-03,613,38,575,1513.16,1205
2021-08-04,613,40,573,1432.5,1205
2021-08-05,613,48,565,1177.08,1205
2021-08-06,548,7,541,7728.57,1205
2021-08-07,208,7,201,2871.43,1205
2021-08-08,124,7,117,1671.43,1205
2021-08-09,600,36,564,1566.67,1205
2021-08-10,613,36,577,1602.78,1205
2021-08-11,613,40,573,1432.5,1205
2021-08-12,613,43,570,1325.58,1205
2021-08-13,548,7,541,7728.57,1205
2021-08-14,208,7,201,2871.43,1205
2021-08-15,124,7,117,1671.43,1205
2021-08-16,600,30,570,1900.0,1205
2021-08-17,613,33,580,1757.58,1205
2021-08-18,613,36,577,1602.78,1205
2021-08-19,613,38,575,1513.16,1205
2021-08-20,548,9,539,5988.89,1205
2021-08-21,208,9,199,2211.11,1205
2021-08-22,124,9,115,1277.78,1205
2021-08-23,600,28,572,2042.86,1205
2021-08-24,613,37,576,1556.76,1205
2021-08-25,613,43,570,1325.58,1205
2021-08-26,613,45,568,1262.22,1205
2021-08-27,548,11,537,4881.82,1205
2021-08-28,208,11,197,1790.91,1205
2021-08-29,124,11,113,1027.27,1205
2021-08-30,600,49,551,1124.49,1205
2021-08-31,613,51,562,1101.96,1205
2021-09-01,708,58,650,1120.69,1205
2021-09-02,708,58,650,1120.69,1205
2021-09-03,612,28,584,2085.71,1205
2021-09-04,251,28,223,796.43,1205
2021-09-05,138,28,110,392.86,1205
2021-09-06,694,54,640,1185.19,1205
2021-09-07,708,59,649,1100.0,1205
2021-09-08,708,66,642,972.73,1205
2021-09-09,708,75,633,844.0,1205
2021-09-10,612,34,578,1700.0,1205
2021-09-11,251,34,217,638.24,1205
2021-09-12,138,34,104,305.88,1205
2021-09-13,694,60,634,1056.67,1205
2021-09-14,708,70,638,911.43,1205
2021-09-15,708,67,641,956.72,1205
2021-09-16,708,67,641,956.72,1205
2021-09-17,612,35,577,1648.57,1205
2021-09-18,251,35,216,617.14,1205
2021-09-19,138,35,103,294.29,1205
2021-09-20,694,66,628,951.52,1205
2021-09-21,708,63,645,1023.81,1205
2021-09-22,708,67,641,956.72,1205
2021-09-23,708,66,642,972.73,1205
2021-09-24,612,38,574,1510.53,1205
2021-09-25,251,38,213,560.53,1205
2021-09-26,138,38,100,263.16,1205
2021-09-27,694,62,632,1019.35,1205
2021-09-28,708,60,648,1080.0,1205
2021-09-29,708,69,639,926.09,1205
2021-09-30,708,65,643,989.23,1205
2021-10-01,658,35,623,1780.0,1205
2021-10-02,283,35,248,708.57,1205
2021-10-03,151,35,116,331.43,1205
2021-10-04,695,61,634,1039.34,1205
2021-10-05,720,66,654,990.91,1205
2021-10-06,720,69,651,943.48,1205
2021-10-07,720,68,652,958.82,1205
2021-10-08,658,40,618,1545.0,1205
2021-10-09,283,40,243,607.5,1205
2021-10-10,151,40,111,277.5,1205
2021-10-11,695,58,637,1098.28,1205
2021-10-12,720,68,652,958.82,1205
2021-10-13,720,68,652,958.82,1205
2021-10-14,720,71,649,914.08,1205
2021-10-15,658,39,619,1587.18,1205
2021-10-16,283,39,244,625.64,1205
2021-10-17,151,39,112,287.18,1205
2021-10-18,695,65,630,969.23,1205
2021-10-19,720,63,657,1042.86,1205
2021-10-20,720,70,650,928.57,1205
2021-10-21,720,64,656,1025.0,1205
2021-10-22,658,43,615,1430.23,1205
2021-10-23,283,43,240,558.14,1205
2021-10-24,151,43,108,251.16,1205
2021-10-25,695,55,640,1163.64,1205
2021-10-26,720,65,655,1007.69,1205
2021-10-27,720,62,658,1061.29,1205
2021-10-28,720,62,658,1061.29,1205
2021-10-29,658,31,627,2022.58,1205
2021-10-30,283,31,252,812.9,1205
2021-10-31,151,31,120,387.1,1205
2021-11-01,664,55,609,1107.27,1205
2021-11-02,700,60,640,1066.67,1205
2021-11-03,700,61,639,1047.54,1205
2021-11-04,700,65,635,976.92,1205
2021-11-05,624,39,585,1500.0,1205
2021-11-06,271,39,232,594.87,1205
2021-11-07,151,39,112,287.18,1205
2021-11-08,664,54,610,1129.63,1205
2021-11-09,700,64,636,993.75,1205
2021-11-10,700,61,639,1047.54,1205
2021-11-11,700,70,630,900.0,1205
2021-11-12,624,37,587,1586.49,1205
2021-11-13,271,37,234,632.43,1205
2021-11-14,151,37,114,308.11,1205
2021-11-15,664,54,610,1129.63,1205
2021-11-16,700,68,632,929.41,1205
2021-11-17,700,63,637,1011.11,1205
2021-11-18,700,65,635,976.92,1205
2021-11-19,624,30,594,1980.0,1205
2021-11-20,271,30,241,803.33,1205
2021-11-21,151,30,121,403.33,1205
2021-11-22,664,54,610,1129.63,1205
2021-11-23,700,59,641,1086.44,1205
2021-11-24,700,56,644,1150.0,1205
2021-11-25,700,60,640,1066.67,1205
2021-11-26,624,28,596,2128.57,1205
2021-11-27,271,28,243,867.86,1205
2021-11-28,151,28,123,439.29,1205
2021-11-29,664,46,618,1343.48,1205
2021-11-30,700,42,658,1566.67,1205
2021-12-01,558,48,510,1062.5,1205
2021-12-02,558,48,510,1062.5,1205
2021-12-03,455,12,443,3691.67,1205
2021-12-04,274,12,262,2183.33,1205
2021-12-05,118,12,106,883.33,1205
2021-12-06,569,36,533,1480.56,1205
2021-12-07,558,41,517,1260.98,1205
2021-12-08,558,33,525,1590.91,1205
2021-12-09,558,34,524,1541.18,1205
2021-12-10,455,4,451,11275.0,1205
2021-12-11,274,4,270,6750.0,1205
2021-12-12,118,4,114,2850.0,1205
2021-12-13,569,27,542,2007.41,1205
2021-12-14,558,35,523,1494.29,1205
2021-12-15,558,32,526,1643.75,1205
2021-12-16,558,29,529,1824.14,1205
2021-12-17,455,4,451,11275.0,1205
2021-12-18,274,4,270,6750.0,1205
2021-12-19,118,4,114,2850.0,1205
2021-12-20,569,34,535,1573.53,1205
2021-12-21,558,27,531,1966.67,1205
2021-12-22,558,32,526,1643.75,1205
2021-12-23,558,36,522,1450.0,1205
2021-12-24,455,36,419,1163.89,1205
2021-12-25,274,36,238,661.11,1205
2021-12-26,118,36,82,227.78,1205
2021-12-27,569,28,541,1932.14,1205
2021-12-28,558,35,523,1494.29,1205
2021-12-29,558,35,523,1494.29,1205
2021-12-30,558,35,523,1494.29,1205
2021-12-31,455,3,452,15066.67,1205
2022-01-01,241,3,238,7933.33,1205
2022-01-02,107,3,104,3466.67,1205
2022-01-03,585,25,560,2240.0,1205
2022-01-04,596,29,567,1955.17,1205
2022-01-05,596,31,565,1822.58,1205
2022-01-06,596,34,562,1652.94,1205
2022-01-07,541,2,539,26950.0,1205
2022-01-08,241,2,239,11950.0,1205
2022-01-09,107,2,105,5250.0,1205
2022-01-10,585,27,558,2066.67,1205
2022-01-11,596,31,565,1822.58,1205
2022-01-12,596,42,554,1319.05,1205
2022-01-13,596,36,560,1555.56,1205
2022-01-14,541,0,541,inf,1205
2022-01-15,241,0,241,inf,1205
2022-01-16,107,0,107,inf,1205
2022-01-17,585,27,558,2066.67,1205
2022-01-18,596,30,566,1886.67,1205
2022-01-19,596,31,565,1822.58,1205
2022-01-20,596,31,565,1822.58,1205
2022-01-21,541,2,539,26950.0,1205
2022-01-22,241,2,239,11950.0,1205
2022-01-23,107,2,105,5250.0,1205
2022-01-24,585,24,561,2337.5,1205
2022-01-25,596,32,564,1762.5,1205
2022-01-26,596,37,559,1510.81,1205
2022-01-27,596,30,566,1886.67,1205
2022-01-28,541,30,511,1703.33,1205
2022-01-29,241,30,211,703.33,1205
2022-01-30,107,30,77,256.67,1205
2020-02-01,988,1087,-99,-9.11,1616
2020-02-02,717,872,-155,-17.78,1616
2020-02-03,1738,1793,-55,-3.07,1616
2020-02-04,1802,1799,3,0.17,1616
2020-02-05,1802,1794,8,0.45,1616
2020-02-06,1802,1793,9,0.5,1616
2020-02-07,1813,1669,144,8.63,1616
2020-02-08,988,1057,-69,-6.53,1616
2020-02-09,717,841,-124,-14.74,1616
2020-02-10,1738,1760,-22,-1.25,1616
2020-02-11,1802,1767,35,1.98,1616
2020-02-12,1802,1762,40,2.27,1616
2020-02-13,1802,1762,40,2.27,1616
2020-02-14,1813,1641,172,10.48,1616
2020-02-15,988,1033,-45,-4.36,1616
2020-02-16,717,820,-103,-12.56,1616
2020-02-17,1738,1744,-6,-0.34,1616
2020-02-18,1802,1756,46,2.62,1616
2020-02-19,1802,1758,44,2.5,1616
2020-02-20,1802,1764,38,2.15,1616
2020-02-21,1813,1649,164,9.95,1616
2020-02-22,988,1047,-59,-5.64,1616
2020-02-23,717,841,-124,-14.74,1616
2020-02-24,1738,1771,-33,-1.86,1616
2020-02-25,1802,1788,14,0.78,1616
2020-02-26,1802,1794,8,0.45,1616
2020-02-27,1802,1805,-3,-0.17,1616
2020-02-28,1813,1693,120,7.09,1616
2020-02-29,988,1094,-106,-9.69,1616
2020-03-01,637,890,-253,-28.43,1616
2020-03-02,1435,1820,-385,-21.15,1616
2020-03-03,1487,1838,-351,-19.1,1616
2020-03-04,1487,1843,-356,-19.32,1616
2020-03-05,1487,1852,-365,-19.71,1616
2020-03-06,1325,1738,-413,-23.76,1616
2020-03-07,822,1135,-313,-27.58,1616
2020-03-08,637,927,-290,-31.28,1616
2020-03-09,1435,1853,-418,-22.56,1616
2020-03-10,1487,1866,-379,-20.31,1616
2020-03-11,1487,1866,-379,-20.31,1616
2020-03-12,1487,1870,-383,-20.48,1616
2020-03-13,1325,1750,-425,-24.29,1616
2020-03-14,822,1142,-320,-28.02,1616
2020-03-15,637,929,-292,-31.43,1616
2020-03-16,1435,1851,-416,-22.47,1616
2020-03-17,1487,1859,-372,-20.01,1616
2020-03-18,1487,1856,-369,-19.88,1616
2020-03-19,1487,1856,-369,-19.88,1616
2020-03-20,1325,1734,-409,-23.59,1616
2020-03-21,822,1124,-302,-26.87,1616
2020-03-22,637,909,-272,-29.92,1616
2020-03-23,1435,1830,-395,-21.58,1616
2020-03-24,1487,1838,-351,-19.1,1616
2020-03-25,1487,1835,-348,-18.96,1616
2020-03-26,1487,1836,-349,-19.01,1616
2020-03-27,1325,1715,-390,-22.74,1616
2020-03-28,822,1107,-285,-25.75,1616
2020-03-29,637,895,-258,-28.83,1616
2020-03-30,1435,1818,-383,-21.07,1616
2020-03-31,1487,1828,-341,-18.65,1616
2020-04-01,1413,1827,-414,-22.66,1616
2020-04-02,1413,1830,-417,-22.79,1616
2020-04-03,1186,1711,-525,-30.68,1616
2020-04-04,716,1104,-388,-35.14,1616
2020-04-05,500,893,-393,-44.01,1616
2020-04-06,1413,1817,-404,-22.23,1616
2020-04-07,1413,1827,-414,-22.66,1616
2020-04-08,1413,1827,-414,-22.66,1616
2020-04-09,1413,1829,-416,-22.74,1616
2020-04-10,1186,1709,-523,-30.6,1616
2020-04-11,716,1102,-386,-35.03,1616
2020-04-12,500,889,-389,-43.76,1616
2020-04-13,1413,1811,-398,-21.98,1616
2020-04-14,1413,1820,-407,-22.36,1616
2020-04-15,1413,1817,-404,-22.23,1616
2020-04-16,1413,1818,-405,-22.28,1616
2020-04-17,1186,1696,-510,-30.07,1616
2020-04-18,716,1086,-370,-34.07,1616
2020-04-19,500,872,-372,-42.66,1616
2020-04-20,1413,1792,-379,-21.15,1616
2020-04-21,1413,1800,-387,-21.5,1616
2020-04-22,1413,1796,-383,-21.33,1616
2020-04-23,1413,1796,-383,-21.33,1616
2020-04-24,1186,1674,-488,-29.15,1616
2020-04-25,716,1064,-348,-32.71,1616
2020-04-26,500,850,-350,-41.18,1616
2020-04-27,1413,1771,-358,-20.21,1616
2020-04-28,1413,1780,-367,-20.62,1616
2020-04-29,1413,1777,-364,-20.48,1616
2020-04-30,1413,1779,-366,-20.57,1616
2020-05-01,1474,1658,-184,-11.1,1616
2020-05-02,882,1050,-168,-16.0,1616
2020-05-03,618,838,-220,-26.25,1616
2020-05-04,1534,1761,-227,-12.89,1616
2020-05-05,1645,1771,-126,-7.11,1616
2020-05-06,1645,1770,-125,-7.06,1616
2020-05-07,1645,1773,-128,-7.22,1616
2020-05-08,1474,1653,-179,-10.83,1616
2020-05-09,882,1046,-164,-15.68,1616
2020-05-10,618,834,-216,-25.9,1616
2020-05-11,1534,1757,-223,-12.69,1616
2020-05-12,1645,1767,-122,-6.9,1616
2020-05-13,1645,1765,-120,-6.8,1616
2020-05-14,1645,1767,-122,-6.9,1616
2020-05-15,1474,1646,-172,-10.45,1616
2020-05-16,882,1037,-155,-14.95,1616
2020-05-17,618,823,-205,-24.91,1616
2020-05-18,1534,1744,-210,-12.04,1616
2020-05-19,1645,1752,-107,-6.11,1616
2020-05-20,1645,1748,-103,-5.89,1616
2020-05-21,1645,1748,-103,-5.89,1616
2020-05-22,1474,1625,-151,-9.29,1616
2020-05-23,882,1014,-132,-13.02,1616
2020-05-24,618,799,-181,-22.65,1616
2020-05-25,1534,1719,-185,-10.76,1616
2020-05-26,1645,1727,-82,-4.75,1616
2020-05-27,1645,1722,-77,-4.47,1616
2020-05-28,1645,1722,-77,-4.47,1616
2020-05-29,1474,1600,-126,-7.88,1616
2020-05-30,882,991,-109,-11.0,1616
2020-05-31,618,777,-159,-20.46,1616
2020-06-01,1530,1698,-168,-9.89,1616
2020-06-02,1563,1707,-144,-8.44,1616
2020-06-03,1563,1705,-142,-8.33,1616
2020-06-04,1563,1708,-145,-8.49,1616
2020-06-05,1263,1588,-325,-20.47,1616
2020-06-06,745,980,-235,-23.98,1616
2020-06-07,612,768,-156,-20.31,1616
2020-06-08,1530,1692,-162,-9.57,1616
2020-06-09,1563,1702,-139,-8.17,1616
2020-06-10,1563,1701,-138,-8.11,1616
2020-06-11,1563,1704,-141,-8.27,1616
2020-06-12,1263,1585,-322,-20.32,1616
2020-06-13,745,977,-232,-23.75,1616
2020-06-14,612,764,-152,-19.9,1616
2020-06-15,1530,1687,-157,-9.31,1616
2020-06-16,1563,1696,-133,-7.84,1616
2020-06-17,1563,1693,-130,-7.68,1616
2020-06-18,1563,1693,-130,-7.68,1616
2020-06-19,1263,1570,-307,-19.55,1616
2020-06-20,745,959,-214,-22.31,1616
2020-06-21,612,743,-131,-17.63,1616
2020-06-22,1530,1662,-132,-7.94,1616
2020-06-23,1563,1668,-105,-6.29,1616
2020-06-24,1563,1661,-98,-5.9,1616
2020-06-25,1563,1658,-95,-5.73,1616
2020-06-26,1263,1533,-270,-17.61,1616
2020-06-27,745,919,-174,-18.93,1616
2020-06-28,612,701,-89,-12.7,1616
2020-06-29,1530,1619,-89,-5.5,1616
2020-06-30,1563,1623,-60,-3.7,1616
2020-07-01,1461,1617,-156,-9.65,1616
2020-07-02,1461,1614,-153,-9.48,1616
2020-07-03,1373,1490,-117,-7.85,1616
2020-07-04,737,878,-141,-16.06,1616
2020-07-05,582,662,-80,-12.08,1616
2020-07-06,1376,1582,-206,-13.02,1616
2020-07-07,1461,1590,-129,-8.11,1616
2020-07-08,1461,1587,-126,-7.94,1616
2020-07-09,1461,1588,-127,-8.0,1616
2020-07-10,1373,1467,-94,-6.41,1616
2020-07-11,737,859,-122,-14.2,1616
2020-07-12,582,646,-64,-9.91,1616
2020-07-13,1376,1569,-193,-12.3,1616
2020-07-14,1461,1579,-118,-7.47,1616
2020-07-15,1461,1578,-117,-7.41,1616
2020-07-16,1461,1579,-118,-7.47,1616
2020-07-17,1373,1459,-86,-5.89,1616
2020-07-18,737,850,-113,-13.29,1616
2020-07-19,582,635,-53,-8.35,1616
2020-07-20,1376,1555,-179,-11.51,1616
2020-07-21,1461,1561,-100,-6.41,1616
2020-07-22,1461,1555,-94,-6.05,1616
2020-07-23,1461,1551,-90,-5.8,1616
2020-07-24,1373,1423,-50,-3.51,1616
2020-07-25,737,807,-70,-8.67,1616
2020-07-26,582,584,-2,-0.34,1616
2020-07-27,1376,1496,-120,-8.02,1616
2020-07-28,1461,1493,-32,-2.14,1616
2020-07-29,1461,1478,-17,-1.15,1616
2020-07-30,1461,1466,-5,-0.34,1616
2020-07-31,1373,1330,43,3.23,1616
2020-08-01,710,706,4,0.57,1616
2020-08-02,565,477,88,18.45,1616
2020-08-03,1311,1383,-72,-5.21,1616
2020-08-04,1434,1376,58,4.22,1616
2020-08-05,1434,1358,76,5.6,1616
2020-08-06,1434,1344,90,6.7,1616
2020-08-07,1226,1208,18,1.49,1616
2020-08-08,710,586,124,21.16,1616
2020-08-09,565,361,204,56.51,1616
2020-08-10,1311,1272,39,3.07,1616
2020-08-11,1434,1272,162,12.74,1616
2020-08-12,1434,1262,172,13.63,1616
2020-08-13,1434,1259,175,13.9,1616
2020-08-14,1226,1135,91,8.02,1616
2020-08-15,710,525,185,35.24,1616
2020-08-16,565,313,252,80.51,1616
2020-08-17,1311,1239,72,5.81,1616
2020-08-18,1434,1254,180,14.35,1616
2020-08-19,1434,1260,174,13.81,1616
2020-08-20,1434,1272,162,12.74,1616
2020-08-21,1226,1163,63,5.42,1616
2020-08-22,710,568,142,25.0,1616
2020-08-23,565,370,195,52.7,1616
2020-08-24,1311,1309,2,0.15,1616
2020-08-25,1434,1336,98,7.34,1616
2020-08-26,1434,1352,82,6.07,1616
2020-08-27,1434,1373,61,4.44,1616
2020-08-28,1226,1272,-46,-3.62,1616
2020-08-29,710,683,27,3.95,1616
2020-08-30,565,489,76,15.54,1616
2020-08-31,1311,1431,-120,-8.39,1616
2020-09-01,1505,1458,47,3.22,1616
2020-09-02,1505,1474,31,2.1,1616
2020-09-03,1505,1492,13,0.87,1616
2020-09-04,1378,1387,-9,-0.65,1616
2020-09-05,865,794,71,8.94,1616
2020-09-06,620,594,26,4.38,1616
2020-09-07,1462,1529,-67,-4.38,1616
2020-09-08,1505,1549,-44,-2.84,1616
2020-09-09,1505,1557,-52,-3.34,1616
2020-09-10,1505,1567,-62,-3.96,1616
2020-09-11,1378,1454,-76,-5.23,1616
2020-09-12,865,852,13,1.53,1616
2020-09-13,620,645,-25,-3.88,1616
2020-09-14,1462,1573,-111,-7.06,1616
2020-09-15,1505,1587,-82,-5.17,1616
2020-09-16,1505,1589,-84,-5.29,1616
2020-09-17,1505,1595,-90,-5.64,1616
2020-09-18,1378,1478,-100,-6.77,1616
2020-09-19,865,874,-9,-1.03,1616
2020-09-20,620,665,-45,-6.77,1616
2020-09-21,1462,1592,-130,-8.17,1616
2020-09-22,1505,1606,-101,-6.29,1616
2020-09-23,1505,1609,-104,-6.46,1616
2020-09-24,1505,1616,-111,-6.87,1616
2020-09-25,1378,1502,-124,-8.26,1616
2020-09-26,865,900,-35,-3.89,1616
2020-09-27,620,694,-74,-10.66,1616
2020-09-28,1462,1624,-162,-9.98,1616
2020-09-29,1505,1641,-136,-8.29,1616
2020-09-30,1505,1647,-142,-8.62,1616
2020-10-01,1598,1657,-59,-3.56,1616
2020-10-02,1397,1545,-148,-9.58,1616
2020-10-03,817,945,-128,-13.54,1616
2020-10-04,589,740,-151,-20.41,1616
2020-10-05,1766,1671,95,5.69,1616
2020-10-06,1598,1688,-90,-5.33,1616
2020-10-07,1598,1693,-95,-5.61,1616
2020-10-08,1598,1702,-104,-6.11,1616
2020-10-09,1397,1588,-191,-12.03,1616
2020-10-10,817,986,-169,-17.14,1616
2020-10-11,589,779,-190,-24.39,1616
2020-10-12,1766,1707,59,3.46,1616
2020-10-13,1598,1721,-123,-7.15,1616
2020-10-14,1598,1723,-125,-7.25,1616
2020-10-15,1598,1729,-131,-7.58,1616
2020-10-16,1397,1613,-216,-13.39,1616
2020-10-17,817,1008,-191,-18.95,1616
2020-10-18,589,799,-210,-26.28,1616
2020-10-19,1766,1725,41,2.38,1616
2020-10-20,1598,1738,-140,-8.06,1616
2020-10-21,1598,1740,-142,-8.16,1616
2020-10-22,1598,1746,-148,-8.48,1616
2020-10-23,1397,1630,-233,-14.29,1616
2020-10-24,817,1027,-210,-20.45,1616
2020-10-25,589,820,-231,-28.17,1616
2020-10-26,1766,1749,17,0.97,1616
2020-10-27,1598,1766,-168,-9.51,1616
2020-10-28,1598,1772,-174,-9.82,1616
2020-10-29,1598,1782,-184,-10.33,1616
2020-10-30,1397,1671,-274,-16.4,1616
2020-10-31,817,1073,-256,-23.86,1616
2020-11-01,645,870,-225,-25.86,1616
2020-11-02,1750,1804,-54,-2.99,1616
2020-11-03,1785,1824,-39,-2.14,1616
2020-11-04,1785,1834,-49,-2.67,1616
2020-11-05,1785,1847,-62,-3.36,1616
2020-11-06,1686,1738,-52,-2.99,1616
2020-11-07,976,1141,-165,-14.46,1616
2020-11-08,645,939,-294,-31.31,1616
2020-11-09,1750,1872,-122,-6.52,1616
2020-11-10,1785,1891,-106,-5.61,1616
2020-11-11,1785,1898,-113,-5.95,1616
2020-11-12,1785,1907,-122,-6.4,1616
2020-11-13,1686,1794,-108,-6.02,1616
2020-11-14,976,1191,-215,-18.05,1616
2020-11-15,645,983,-338,-34.38,1616
2020-11-16,1750,1909,-159,-8.33,1616
2020-11-17,1785,1920,-135,-7.03,1616
2020-11-18,1785,1919,-134,-6.98,1616
2020-11-19,1785,1920,-135,-7.03,1616
2020-11-20,1686,1798,-112,-6.23,1616
2020-11-21,976,1187,-211,-17.78,1616
2020-11-22,645,971,-326,-33.57,1616
2020-11-23,1750,1890,-140,-7.41,1616
2020-11-24,1785,1894,-109,-5.76,1616
2020-11-25,1785,1887,-102,-5.41,1616
2020-11-26,1785,1883,-98,-5.2,1616
2020-11-27,1686,1757,-71,-4.04,1616
2020-11-28,976,1143,-167,-14.61,1616
2020-11-29,645,925,-280,-30.27,1616
2020-11-30,1750,1842,-92,-4.99,1616
2020-12-01,1509,1846,-337,-18.26,1616
2020-12-02,1509,1840,-331,-17.99,1616
2020-12-03,1509,1838,-329,-17.9,1616
2020-12-04,1765,1715,50,2.92,1616
2020-12-05,959,1104,-145,-13.13,1616
2020-12-06,615,890,-275,-30.9,1616
2020-12-07,1619,1812,-193,-10.65,1616
2020-12-08,1509,1821,-312,-17.13,1616
2020-12-09,1509,1820,-311,-17.09,1616
2020-12-10,1509,1823,-314,-17.22,1616
2020-12-11,1765,1705,60,3.52,1616
2020-12-12,959,1099,-140,-12.74,1616
2020-12-13,615,889,-274,-30.82,1616
2020-12-14,1619,1814,-195,-10.75,1616
2020-12-15,1509,1826,-317,-17.36,1616
2020-12-16,1509,1827,-318,-17.41,1616
2020-12-17,1509,1831,-322,-17.59,1616
2020-12-18,1765,1713,52,3.04,1616
2020-12-19,959,1106,-147,-13.29,1616
2020-12-20,615,894,-279,-31.21,1616
2020-12-21,1619,1817,-198,-10.9,1616
2020-12-22,1509,1826,-317,-17.36,1616
2020-12-23,1509,1823,-314,-17.22,1616
2020-12-24,1509,1823,-314,-17.22,1616
2020-12-25,1765,1700,65,3.82,1616
2020-12-26,959,1088,-129,-11.86,1616
2020-12-27,615,871,-256,-29.39,1616
2020-12-28,1619,1789,-170,-9.5,1616
2020-12-29,1509,1793,-284,-15.84,1616
2020-12-30,1509,1785,-276,-15.46,1616
2020-12-31,1509,1781,-272,-15.27,1616
2021-01-01,1510,1655,-145,-8.76,1616
2021-01-02,959,1040,-81,-7.79,1616
2021-01-03,708,821,-113,-13.76,1616
2021-01-04,1626,1738,-112,-6.44,1616
2021-01-05,1617,1742,-125,-7.18,1616
2021-01-06,1617,1735,-118,-6.8,1616
2021-01-07,1617,1732,-115,-6.64,1616
2021-01-08,1510,1608,-98,-6.09,1616
2021-01-09,959,997,-38,-3.81,1616
2021-01-10,708,782,-74,-9.46,1616
2021-01-11,1626,1703,-77,-4.52,1616
2021-01-12,1617,1711,-94,-5.49,1616
2021-01-13,1617,1710,-93,-5.44,1616
2021-01-14,1617,1712,-95,-5.55,1616
2021-01-15,1510,1594,-84,-5.27,1616
2021-01-16,959,988,-29,-2.94,1616
2021-01-17,708,778,-70,-9.0,1616
2021-01-18,1626,1704,-78,-4.58,1616
2021-01-19,1617,1717,-100,-5.82,1616
2021-01-20,1617,1719,-102,-5.93,1616
2021-01-21,1617,1724,-107,-6.21,1616
2021-01-22,1510,1608,-98,-6.09,1616
2021-01-23,959,1003,-44,-4.39,1616
2021-01-24,708,793,-85,-10.72,1616
2021-01-25,1626,1719,-93,-5.41,1616
2021-01-26,1617,1731,-114,-6.59,1616
2021-01-27,1617,1730,-113,-6.53,1616
2021-01-28,1617,1733,-116,-6.69,1616
2021-01-29,1510,1614,-104,-6.44,1616
2021-01-30,959,1005,-46,-4.58,1616
2021-01-31,708,791,-83,-10.49,1616
2021-02-01,1780,1712,68,3.97,1616
2021-02-02,1659,1720,-61,-3.55,1616
2021-02-03,1659,1715,-56,-3.27,1616
2021-02-04,1659,1714,-55,-3.21,1616
2021-02-05,1559,1590,-31,-1.95,1616
2021-02-06,976,979,-3,-0.31,1616
2021-02-07,619,762,-143,-18.77,1616
2021-02-08,1780,1681,99,5.89,1616
2021-02-09,1659,1687,-28,-1.66,1616
2021-02-10,1659,1682,-23,-1.37,1616
2021-02-11,1659,1682,-23,-1.37,1616
2021-02-12,1559,1559,0,0.0,1616
2021-02-13,976,950,26,2.74,1616
2021-02-14,619,737,-118,-16.01,1616
2021-02-15,1780,1660,120,7.23,1616
2021-02-16,1659,1670,-11,-0.66,1616
2021-02-17,1659,1671,-12,-0.72,1616
2021-02-18,1659,1676,-17,-1.01,1616
2021-02-19,1559,1560,-1,-0.06,1616
2021-02-20,976,956,20,2.09,1616
2021-02-21,619,749,-130,-17.36,1616
2021-02-22,1780,1679,101,6.02,1616
2021-02-23,1659,1695,-36,-2.12,1616
2021-02-24,1659,1701,-42,-2.47,1616
2021-02-25,1659,1711,-52,-3.04,1616
2021-02-26,1559,1599,-40,-2.5,1616
2021-02-27,976,1000,-24,-2.4,1616
2021-02-28,619,796,-177,-22.24,1616
2021-03-01,1722,1727,-5,-0.29,1616
2021-03-02,1717,1745,-28,-1.6,1616
2021-03-03,1717,1751,-34,-1.94,1616
2021-03-04,1717,1760,-43,-2.44,1616
2021-03-05,1481,1647,-166,-10.08,1616
2021-03-06,1012,1045,-33,-3.16,1616
2021-03-07,668,838,-170,-20.29,1616
2021-03-08,1722,1765,-43,-2.44,1616
2021-03-09,1717,1779,-62,-3.49,1616
2021-03-10,1717,1780,-63,-3.54,1616
2021-03-11,1717,1785,-68,-3.81,1616
2021-03-12,1481,1666,-185,-11.1,1616
2021-03-13,1012,1059,-47,-4.44,1616
2021-03-14,668,846,-178,-21.04,1616
2021-03-15,1722,1769,-47,-2.66,1616
2021-03-16,1717,1777,-60,-3.38,1616
2021-03-17,1717,1774,-57,-3.21,1616
2021-03-18,1717,1775,-58,-3.27,1616
2021-03-19,1481,1653,-172,-10.41,1616
2021-03-20,1012,1043,-31,-2.97,1616
2021-03-21,668,828,-160,-19.32,1616
2021-03-22,1722,1749,-27,-1.54,1616
2021-03-23,1717,1757,-40,-2.28,1616
2021-03-24,1717,1754,-37,-2.11,1616
2021-03-25,1717,1754,-37,-2.11,1616
2021-03-26,1481,1633,-152,-9.31,1616
2021-03-27,1012,1024,-12,-1.17,1616
2021-03-28,668,811,-143,-17.63,1616
2021-03-29,1722,1734,-12,-0.69,1616
2021-03-30,1717,1744,-27,-1.55,1616
2021-03-31,1717,1743,-26,-1.49,1616
2021-04-01,1688,1746,-58,-3.32,1616
2021-04-02,1491,1626,-135,-8.3,1616
2021-04-03,894,1019,-125,-12.27,1616
2021-04-04,620,808,-188,-23.27,1616
2021-04-05,1612,1732,-120,-6.93,1616
2021-04-06,1688,1743,-55,-3.16,1616
2021-04-07,1688,1742,-54,-3.1,1616
2021-04-08,1688,1745,-57,-3.27,1616
2021-04-09,1491,1626,-135,-8.3,1616
2021-04-10,894,1018,-124,-12.18,1616
2021-04-11,620,806,-186,-23.08,1616
2021-04-12,1612,1728,-116,-6.71,1616
2021-04-13,1688,1738,-50,-2.88,1616
2021-04-14,1688,1735,-47,-2.71,1616
2021-04-15,1688,1736,-48,-2.76,1616
2021-04-16,1491,1615,-124,-7.68,1616
2021-04-17,894,1005,-111,-11.04,1616
2021-04-18,620,791,-171,-21.62,1616
2021-04-19,1612,1712,-100,-5.84,1616
2021-04-20,1688,1719,-31,-1.8,1616
2021-04-21,1688,1715,-27,-1.57,1616
2021-04-22,1688,1715,-27,-1.57,1616
2021-04-23,1491,1593,-102,-6.4,1616
2021-04-24,894,983,-89,-9.05,1616
2021-04-25,620,769,-149,-19.38,1616
2021-04-26,1612,1690,-78,-4.62,1616
2021-04-27,1688,1698,-10,-0.59,1616
2021-04-28,1688,1695,-7,-0.41,1616
2021-04-29,1688,1696,-8,-0.47,1616
2021-04-30,1491,1575,-84,-5.33,1616
2021-05-01,837,967,-130,-13.44,1616
2021-05-02,566,754,-188,-24.93,1616
2021-05-03,1524,1677,-153,-9.12,1616
2021-05-04,1574,1687,-113,-6.7,1616
2021-05-05,1574,1686,-112,-6.64,1616
2021-05-06,1574,1689,-115,-6.81,1616
2021-05-07,1360,1569,-209,-13.32,1616
2021-05-08,837,962,-125,-12.99,1616
2021-05-09,566,750,-184,-24.53,1616
2021-05-10,1524,1673,-149,-8.91,1616
2021-05-11,1574,1683,-109,-6.48,1616
2021-05-12,1574,1682,-108,-6.42,1616
2021-05-13,1574,1684,-110,-6.53,1616
2021-05-14,1360,1563,-203,-12.99,1616
2021-05-15,837,955,-118,-12.36,1616
2021-05-16,566,741,-175,-23.62,1616
2021-05-17,1524,1663,-139,-8.36,1616
2021-05-18,1574,1671,-97,-5.8,1616
2021-05-19,1574,1667,-93,-5.58,1616
2021-05-20,1574,1667,-93,-5.58,1616
2021-05-21,1360,1545,-185,-11.97,1616
2021-05-22,837,934,-97,-10.39,1616
2021-05-23,566,719,-153,-21.28,1616
2021-05-24,1524,1639,-115,-7.02,1616
2021-05-25,1574,1646,-72,-4.37,1616
2021-05-26,1574,1642,-68,-4.14,1616
2021-05-27,1574,1642,-68,-4.14,1616
2021-05-28,1360,1519,-159,-10.47,1616
2021-05-29,837,909,-72,-7.92,1616
2021-05-30,566,695,-129,-18.56,1616
2021-05-31,1524,1617,-93,-5.75,1616
2021-06-01,1339,1625,-286,-17.6,1616
2021-06-02,1339,1623,-284,-17.5,1616
2021-06-03,1339,1624,-285,-17.55,1616
2021-06-04,1181,1504,-323,-21.48,1616
2021-06-05,684,896,-212,-23.66,1616
2021-06-06,567,684,-117,-17.11,1616
2021-06-07,1320,1608,-288,-17.91,1616
2021-06-08,1339,1618,-279,-17.24,1616
2021-06-09,1339,1617,-278,-17.19,1616
2021-06-10,1339,1620,-281,-17.35,1616
2021-06-11,1181,1501,-320,-21.32,1616
2021-06-12,684,893,-209,-23.4,1616
2021-06-13,567,681,-114,-16.74,1616
2021-06-14,1320,1604,-284,-17.71,1616
2021-06-15,1339,1613,-274,-16.99,1616
2021-06-16,1339,1611,-272,-16.88,1616
2021-06-17,1339,1612,-273,-16.94,1616
2021-06-18,1181,1490,-309,-20.74,1616
2021-06-19,684,880,-196,-22.27,1616
2021-06-20,567,664,-97,-14.61,1616
2021-06-21,1320,1584,-264,-16.67,1616
2021-06-22,1339,1590,-251,-15.79,1616
2021-06-23,1339,1584,-245,-15.47,1616
2021-06-24,1339,1581,-242,-15.31,1616
2021-06-25,1181,1456,-275,-18.89,1616
2021-06-26,684,843,-159,-18.86,1616
2021-06-27,567,625,-58,-9.28,1616
2021-06-28,1320,1542,-222,-14.4,1616
2021-06-29,1339,1547,-208,-13.45,1616
2021-06-30,1339,1540,-201,-13.05,1616
2021-07-01,1235,1537,-302,-19.65,1616
2021-07-02,1169,1412,-243,-17.21,1616
2021-07-03,612,799,-187,-23.4,1616
2021-07-04,461,583,-122,-20.93,1616
2021-07-05,1220,1503,-283,-18.83,1616
2021-07-06,1235,1509,-274,-18.16,1616
2021-07-07,1235,1505,-270,-17.94,1616
2021-07-08,1235,1506,-271,-17.99,1616
2021-07-09,1169,1385,-216,-15.6,1616
2021-07-10,612,776,-164,-21.13,1616
2021-07-11,461,563,-102,-18.12,1616
2021-07-12,1220,1486,-266,-17.9,1616
2021-07-13,1235,1496,-261,-17.45,1616
2021-07-14,1235,1494,-259,-17.34,1616
2021-07-15,1235,1496,-261,-17.45,1616
2021-07-16,1169,1376,-207,-15.04,1616
2021-07-17,612,768,-156,-20.31,1616
2021-07-18,461,554,-93,-16.79,1616
2021-07-19,1220,1475,-255,-17.29,1616
2021-07-20,1235,1482,-247,-16.67,1616
2021-07-21,1235,1477,-242,-16.38,1616
2021-07-22,1235,1475,-240,-16.27,1616
2021-07-23,1169,1349,-180,-13.34,1616
2021-07-24,612,734,-122,-16.62,1616
2021-07-25,461,513,-52,-10.14,1616
2021-07-26,1220,1426,-206,-14.45,1616
2021-07-27,1235,1425,-190,-13.33,1616
2021-07-28,1235,1411,-176,-12.47,1616
2021-07-29,1235,1400,-165,-11.79,1616
2021-07-30,1169,1266,-97,-7.66,1616
2021-07-31,612,643,-31,-4.82,1616
2021-08-01,466,414,52,12.56,1616
2021-08-02,1084,1321,-237,-17.94,1616
2021-08-03,1193,1314,-121,-9.21,1616
2021-08-04,1193,1295,-102,-7.88,1616
2021-08-05,1193,1281,-88,-6.87,1616
2021-08-06,1012,1144,-132,-11.54,1616
2021-08-07,599,521,78,14.97,1616
2021-08-08,466,294,172,58.5,1616
2021-08-09,1084,1203,-119,-9.89,1616
2021-08-10,1193,1201,-8,-0.67,1616
2021-08-11,1193,1189,4,0.34,1616
2021-08-12,1193,1183,10,0.85,1616
2021-08-13,1012,1056,-44,-4.17,1616
2021-08-14,599,444,155,34.91,1616
2021-08-15,466,230,236,102.61,1616
2021-08-16,1084,1153,-69,-5.98,1616
2021-08-17,1193,1165,28,2.4,1616
2021-08-18,1193,1168,25,2.14,1616
2021-08-19,1193,1177,16,1.36,1616
2021-08-20,1012,1066,-54,-5.07,1616
2021-08-21,599,468,131,27.99,1616
2021-08-22,466,269,197,73.23,1616
2021-08-23,1084,1206,-122,-10.12,1616
2021-08-24,1193,1231,-38,-3.09,1616
2021-08-25,1193,1247,-54,-4.33,1616
2021-08-26,1193,1267,-74,-5.84,1616
2021-08-27,1012,1165,-153,-13.13,1616
2021-08-28,599,576,23,3.99,1616
2021-08-29,466,382,84,21.99,1616
2021-08-30,1084,1324,-240,-18.13,1616
2021-08-31,1193,1352,-159,-11.76,1616
2021-09-01,1329,1369,-40,-2.92,1616
2021-09-02,1329,1388,-59,-4.25,1616
2021-09-03,1176,1285,-109,-8.48,1616
2021-09-04,662,692,-30,-4.34,1616
2021-09-05,513,494,19,3.85,1616
2021-09-06,1332,1430,-98,-6.85,1616
2021-09-07,1329,1452,-123,-8.47,1616
2021-09-08,1329,1461,-132,-9.03,1616
2021-09-09,1329,1473,-144,-9.78,1616
2021-09-10,1176,1361,-185,-13.59,1616
2021-09-11,662,761,-99,-13.01,1616
2021-09-12,513,555,-42,-7.57,1616
2021-09-13,1332,1483,-151,-10.18,1616
2021-09-14,1329,1498,-169,-11.28,1616
2021-09-15,1329,1501,-172,-11.46,1616
2021-09-16,1329,1507,-178,-11.81,1616
2021-09-17,1176,1391,-215,-15.46,1616
2021-09-18,662,786,-124,-15.78,1616
2021-09-19,513,577,-64,-11.09,1616
2021-09-20,1332,1504,-172,-11.44,1616
2021-09-21,1329,1517,-188,-12.39,1616
2021-09-22,1329,1520,-191,-12.57,1616
2021-09-23,1329,1527,-198,-12.97,1616
2021-09-24,1176,1412,-236,-16.71,1616
2021-09-25,662,809,-147,-18.17,1616
2021-09-26,513,603,-90,-14.93,1616
2021-09-27,1332,1532,-200,-13.05,1616
2021-09-28,1329,1549,-220,-14.2,1616
2021-09-29,1329,1554,-225,-14.48,1616
2021-09-30,1329,1564,-235,-15.03,1616
2021-10-01,1304,1451,-147,-10.13,1616
2021-10-02,850,851,-1,-0.12,1616
2021-10-03,646,647,-1,-0.15,1616
2021-10-04,1446,1578,-132,-8.37,1616
2021-10-05,1464,1595,-131,-8.21,1616
2021-10-06,1464,1601,-137,-8.56,1616
2021-10-07,1464,1610,-146,-9.07,1616
2021-10-08,1304,1497,-193,-12.89,1616
2021-10-09,850,895,-45,-5.03,1616
2021-10-10,646,689,-43,-6.24,1616
2021-10-11,1446,1617,-171,-10.58,1616
2021-10-12,1464,1632,-168,-10.29,1616
2021-10-13,1464,1635,-171,-10.46,1616
2021-10-14,1464,1641,-177,-10.79,1616
2021-10-15,1304,1525,-221,-14.49,1616
2021-10-16,850,920,-70,-7.61,1616
2021-10-17,646,711,-65,-9.14,1616
2021-10-18,1446,1637,-191,-11.67,1616
2021-10-19,1464,1650,-186,-11.27,1616
2021-10-20,1464,1652,-188,-11.38,1616
2021-10-21,1464,1658,-194,-11.7,1616
2021-10-22,1304,1541,-237,-15.38,1616
2021-10-23,850,938,-88,-9.38,1616
2021-10-24,646,730,-84,-11.51,1616
2021-10-25,1446,1658,-212,-12.79,1616
2021-10-26,1464,1674,-210,-12.54,1616
2021-10-27,1464,1679,-215,-12.81,1616
2021-10-28,1464,1689,-225,-13.32,1616
2021-10-29,1304,1577,-273,-17.31,1616
2021-10-30,850,977,-127,-13.0,1616
2021-10-31,646,774,-128,-16.54,1616
2021-11-01,1673,1707,-34,-1.99,1616
2021-11-02,1682,1727,-45,-2.61,1616
2021-11-03,1682,1737,-55,-3.17,1616
2021-11-04,1682,1750,-68,-3.89,1616
2021-11-05,1433,1641,-208,-12.68,1616
2021-11-06,911,1044,-133,-12.74,1616
2021-11-07,657,843,-186,-22.06,1616
2021-11-08,1673,1776,-103,-5.8,1616
2021-11-09,1682,1796,-114,-6.35,1616
2021-11-10,1682,1804,-122,-6.76,1616
2021-11-11,1682,1815,-133,-7.33,1616
2021-11-12,1433,1702,-269,-15.8,1616
2021-11-13,911,1101,-190,-17.26,1616
2021-11-14,657,894,-237,-26.51,1616
2021-11-15,1673,1821,-148,-8.13,1616
2021-11-16,1682,1834,-152,-8.29,1616
2021-11-17,1682,1835,-153,-8.34,1616
2021-11-18,1682,1838,-156,-8.49,1616
2021-11-19,1433,1717,-284,-16.54,1616
2021-11-20,911,1107,-196,-17.71,1616
2021-11-21,657,892,-235,-26.35,1616
2021-11-22,1673,1812,-139,-7.67,1616
2021-11-23,1682,1817,-135,-7.43,1616
2021-11-24,1682,1811,-129,-7.12,1616
2021-11-25,1682,1807,-125,-6.92,1616
2021-11-26,1433,1681,-248,-14.75,1616
2021-11-27,911,1067,-156,-14.62,1616
2021-11-28,657,849,-192,-22.61,1616
2021-11-29,1673,1766,-93,-5.27,1616
2021-11-30,1682,1770,-88,-4.97,1616
2021-12-01,1570,1763,-193,-10.95,1616
2021-12-02,1570,1760,-190,-10.8,1616
2021-12-03,1476,1636,-160,-9.78,1616
2021-12-04,1045,1024,21,2.05,1616
2021-12-05,752,809,-57,-7.05,1616
2021-12-06,1626,1730,-104,-6.01,1616
2021-12-07,1570,1739,-169,-9.72,1616
2021-12-08,1570,1736,-166,-9.56,1616
2021-12-09,1570,1739,-169,-9.72,1616
2021-12-10,1476,1620,-144,-8.89,1616
2021-12-11,1045,1013,32,3.16,1616
2021-12-12,752,802,-50,-6.23,1616
2021-12-13,1626,1727,-101,-5.85,1616
2021-12-14,1570,1740,-170,-9.77,1616
2021-12-15,1570,1740,-170,-9.77,1616
2021-12-16,1570,1745,-175,-10.03,1616
2021-12-17,1476,1627,-151,-9.28,1616
2021-12-18,1045,1021,24,2.35,1616
2021-12-19,752,810,-58,-7.16,1616
2021-12-20,1626,1733,-107,-6.17,1616
2021-12-21,1570,1743,-173,-9.93,1616
2021-12-22,1570,1741,-171,-9.82,1616
2021-12-23,1570,1742,-172,-9.87,1616
2021-12-24,1476,1620,-144,-8.89,1616
2021-12-25,1045,1009,36,3.57,1616
2021-12-26,752,793,-41,-5.17,1616
2021-12-27,1626,1712,-86,-5.02,1616
2021-12-28,1570,1717,-147,-8.56,1616
2021-12-29,1570,1709,-139,-8.13,1616
2021-12-30,1570,1706,-136,-7.97,1616
2021-12-31,1476,1579,-103,-6.52,1616
2022-01-01,952,965,-13,-1.35,1616
2022-01-02,668,746,-78,-10.46,1616
2022-01-03,1562,1662,-100,-6.02,1616
2022-01-04,1676,1666,10,0.6,1616
2022-01-05,1676,1658,18,1.09,1616
2022-01-06,1676,1655,21,1.27,1616
2022-01-07,1758,1530,228,14.9,1616
2022-01-08,952,918,34,3.7,1616
2022-01-09,668,702,-34,-4.84,1616
2022-01-10,1562,1622,-60,-3.7,1616
2022-01-11,1676,1629,47,2.89,1616
2022-01-12,1676,1627,49,3.01,1616
2022-01-13,1676,1628,48,2.95,1616
2022-01-14,1758,1509,249,16.5,1616
2022-01-15,952,902,50,5.54,1616
2022-01-16,668,691,-23,-3.33,1616
2022-01-17,1562,1617,-55,-3.4,1616
2022-01-18,1676,1629,47,2.89,1616
2022-01-19,1676,1631,45,2.76,1616
2022-01-20,1676,1636,40,2.44,1616
2022-01-21,1758,1520,238,15.66,1616
2022-01-22,952,915,37,4.04,1616
2022-01-23,668,706,-38,-5.38,1616
2022-01-24,1562,1632,-70,-4.29,1616
2022-01-25,1676,1645,31,1.88,1616
2022-01-26,1676,1645,31,1.88,1616
2022-01-27,1676,1649,27,1.64,1616
2022-01-28,1758,1530,228,14.9,1616
2022-01-29,952,922,30,3.25,1616
2022-01-30,668,709,-41,-5.78,1616
2020-02-01,551,339,212,62.54,1193
2020-02-02,286,97,189,194.85,1193
2020-02-03,1750,1633,117,7.16,1193
2020-02-04,1762,1675,87,5.19,1193
2020-02-05,1762,1681,81,4.82,1193
2020-02-06,1762,1687,75,4.45,1193
2020-02-07,1572,1445,127,8.79,1193
2020-02-08,551,388,163,42.01,1193
2020-02-09,286,142,144,101.41,1193
2020-02-10,1750,1675,75,4.48,1193
2020-02-11,1762,1712,50,2.92,1193
2020-02-12,1762,1716,46,2.68,1193
2020-02-13,1762,1719,43,2.5,1193
2020-02-14,1572,1475,97,6.58,1193
2020-02-15,551,417,134,32.13,1193
2020-02-16,286,170,116,68.24,1193
2020-02-17,1750,1702,48,2.82,1193
2020-02-18,1762,1740,22,1.26,1193
2020-02-19,1762,1744,18,1.03,1193
2020-02-20,1762,1748,14,0.8,1193
2020-02-21,1572,1506,66,4.38,1193
2020-02-22,551,449,102,22.72,1193
2020-02-23,286,204,82,40.2,1193
2020-02-24,1750,1739,11,0.63,1193
2020-02-25,1762,1779,-17,-0.96,1193
2020-02-26,1762,1786,-24,-1.34,1193
2020-02-27,1762,1793,-31,-1.73,1193
2020-02-28,1572,1552,20,1.29,1193
2020-02-29,551,497,54,10.87,1193
2020-03-01,274,254,20,7.87,1193
2020-03-02,1548,1789,-241,-13.47,1193
2020-03-03,1522,1830,-308,-16.83,1193
2020-03-04,1522,1837,-315,-17.15,1193
2020-03-05,1522,1843,-321,-17.42,1193
2020-03-06,1344,1601,-257,-16.05,1193
2020-03-07,484,545,-61,-11.19,1193
2020-03-08,274,300,-26,-8.67,1193
2020-03-09,1548,1833,-285,-15.55,1193
2020-03-10,1522,1871,-349,-18.65,1193
2020-03-11,1522,1875,-353,-18.83,1193
2020-03-12,1522,1879,-357,-19.0,1193
2020-03-13,1344,1634,-290,-17.75,1193
2020-03-14,484,575,-91,-15.83,1193
2020-03-15,274,327,-53,-16.21,1193
2020-03-16,1548,1858,-310,-16.68,1193
2020-03-17,1522,1894,-372,-19.64,1193
2020-03-18,1522,1897,-375,-19.77,1193
2020-03-19,1522,1899,-377,-19.85,1193
2020-03-20,1344,1654,-310,-18.74,1193
2020-03-21,484,595,-111,-18.66,1193
2020-03-22,274,347,-73,-21.04,1193
2020-03-23,1548,1879,-331,-17.62,1193
2020-03-24,1522,1916,-394,-20.56,1193
2020-03-25,1522,1921,-399,-20.77,1193
2020-03-26,1522,1925,-403,-20.94,1193
2020-03-27,1344,1682,-338,-20.1,1193
2020-03-28,484,626,-142,-22.68,1193
2020-03-29,274,381,-107,-28.08,1193
2020-03-30,1548,1916,-368,-19.21,1193
2020-03-31,1522,1956,-434,-22.19,1193
2020-04-01,1760,1963,-203,-10.34,1193
2020-04-02,1760,1970,-210,-10.66,1193
2020-04-03,1484,1730,-246,-14.22,1193
2020-04-04,507,675,-168,-24.89,1193
2020-04-05,236,432,-196,-45.37,1193
2020-04-06,1817,1967,-150,-7.63,1193
2020-04-07,1760,2008,-248,-12.35,1193
2020-04-08,1760,2015,-255,-12.66,1193
2020-04-09,1760,2021,-261,-12.91,1193
2020-04-10,1484,1779,-295,-16.58,1193
2020-04-11,507,723,-216,-29.88,1193
2020-04-12,236,477,-241,-50.52,1193
2020-04-13,1817,2010,-193,-9.6,1193
2020-04-14,1760,2047,-287,-14.02,1193
2020-04-15,1760,2050,-290,-14.15,1193
2020-04-16,1760,2053,-293,-14.27,1193
2020-04-17,1484,1807,-323,-17.87,1193
2020-04-18,507,747,-240,-32.13,1193
2020-04-19,236,497,-261,-52.52,1193
2020-04-20,1817,2026,-209,-10.32,1193
2020-04-21,1760,2061,-301,-14.6,1193
2020-04-22,1760,2061,-301,-14.6,1193
2020-04-23,1760,2061,-301,-14.6,1193
2020-04-24,1484,1813,-329,-18.15,1193
2020-04-25,507,751,-244,-32.49,1193
2020-04-26,236,500,-264,-52.8,1193
2020-04-27,1817,2029,-212,-10.45,1193
2020-04-28,1760,2063,-303,-14.69,1193
2020-04-29,1760,2064,-304,-14.73,1193
2020-04-30,1760,2064,-304,-14.73,1193
2020-05-01,1672,1818,-146,-8.03,1193
2020-05-02,632,757,-125,-16.51,1193
2020-05-03,308,509,-201,-39.49,1193
2020-05-04,2018,2039,-21,-1.03,1193
2020-05-05,1925,2075,-150,-7.23,1193
2020-05-06,1925,2078,-153,-7.36,1193
2020-05-07,1925,2081,-156,-7.5,1193
2020-05-08,1672,1836,-164,-8.93,1193
2020-05-09,632,777,-145,-18.66,1193
2020-05-10,308,530,-222,-41.89,1193
2020-05-11,2018,2061,-43,-2.09,1193
2020-05-12,1925,2098,-173,-8.25,1193
2020-05-13,1925,2101,-176,-8.38,1193
2020-05-14,1925,2103,-178,-8.46,1193
2020-05-15,1672,1858,-186,-10.01,1193
2020-05-16,632,798,-166,-20.8,1193
2020-05-17,308,549,-241,-43.9,1193
2020-05-18,2018,2078,-60,-2.89,1193
2020-05-19,1925,2113,-188,-8.9,1193
2020-05-20,1925,2114,-189,-8.94,1193
2020-05-21,1925,2113,-188,-8.9,1193
2020-05-22,1672,1865,-193,-10.35,1193
2020-05-23,632,803,-171,-21.3,1193
2020-05-24,308,551,-243,-44.1,1193
2020-05-25,2018,2078,-60,-2.89,1193
2020-05-26,1925,2111,-186,-8.81,1193
2020-05-27,1925,2109,-184,-8.72,1193
2020-05-28,1925,2108,-183,-8.68,1193
2020-05-29,1672,1859,-187,-10.06,1193
2020-05-30,632,796,-164,-20.6,1193
2020-05-31,308,544,-236,-43.38,1193
2020-06-01,2071,2071,0,0.0,1193
2020-06-02,2139,2105,34,1.62,1193
2020-06-03,2139,2104,35,1.66,1193
2020-06-04,2139,2104,35,1.66,1193
2020-06-05,1784,1857,-73,-3.93,1193
2020-06-06,660,796,-136,-17.09,1193
2020-06-07,352,546,-194,-35.53,1193
2020-06-08,2071,2076,-5,-0.24,1193
2020-06-09,2139,2111,28,1.33,1193
2020-06-10,2139,2113,26,1.23,1193
2020-06-11,2139,2114,25,1.18,1193
2020-06-12,1784,1868,-84,-4.5,1193
2020-06-13,660,808,-148,-18.32,1193
2020-06-14,352,559,-207,-37.03,1193
2020-06-15,2071,2088,-17,-0.81,1193
2020-06-16,2139,2122,17,0.8,1193
2020-06-17,2139,2122,17,0.8,1193
2020-06-18,2139,2121,18,0.85,1193
2020-06-19,1784,1872,-88,-4.7,1193
2020-06-20,660,808,-148,-18.32,1193
2020-06-21,352,555,-203,-36.58,1193
2020-06-22,2071,2079,-8,-0.38,1193
2020-06-23,2139,2109,30,1.42,1193
2020-06-24,2139,2103,36,1.71,1193
2020-06-25,2139,2097,42,2.0,1193
2020-06-26,1784,1842,-58,-3.15,1193
2020-06-27,660,773,-113,-14.62,1193
2020-06-28,352,514,-162,-31.52,1193
2020-06-29,2071,2034,37,1.82,1193
2020-06-30,2139,2059,80,3.89,1193
2020-07-01,2135,2050,85,4.15,1193
2020-07-02,2135,2040,95,4.66,1193
2020-07-03,1865,1783,82,4.6,1193
2020-07-04,594,712,-118,-16.57,1193
2020-07-05,350,453,-103,-22.74,1193
2020-07-06,2149,1973,176,8.92,1193
2020-07-07,2135,1999,136,6.8,1193
2020-07-08,2135,1992,143,7.18,1193
2020-07-09,2135,1986,149,7.5,1193
2020-07-10,1865,1732,133,7.68,1193
2020-07-11,594,666,-72,-10.81,1193
2020-07-12,350,412,-62,-15.05,1193
2020-07-13,2149,1937,212,10.94,1193
2020-07-14,2135,1969,166,8.43,1193
2020-07-15,2135,1968,167,8.49,1193
2020-07-16,2135,1967,168,8.54,1193
2020-07-17,1865,1719,146,8.49,1193
2020-07-18,594,658,-64,-9.73,1193
2020-07-19,350,409,-59,-14.43,1193
2020-07-20,2149,1939,210,10.83,1193
2020-07-21,2135,1974,161,8.16,1193
2020-07-22,2135,1976,159,8.05,1193
2020-07-23,2135,1977,158,7.99,1193
2020-07-24,1865,1731,134,7.74,1193
2020-07-25,594,671,-77,-11.48,1193
2020-07-26,350,421,-71,-16.86,1193
2020-07-27,2149,1949,200,10.26,1193
2020-07-28,2135,1982,153,7.72,1193
2020-07-29,2135,1981,154,7.77,1193
2020-07-30,2135,1979,156,7.88,1193
2020-07-31,1865,1728,137,7.93,1193
2020-08-01,600,663,-63,-9.5,1193
2020-08-02,338,408,-70,-17.16,1193
2020-08-03,1941,1932,9,0.47,1193
2020-08-04,1962,1960,2,0.1,1193
2020-08-05,1962,1954,8,0.41,1193
2020-08-06,1962,1948,14,0.72,1193
2020-08-07,1771,1694,77,4.55,1193
2020-08-08,600,625,-25,-4.0,1193
2020-08-09,338,368,-30,-8.15,1193
2020-08-10,1941,1890,51,2.7,1193
2020-08-11,1962,1918,44,2.29,1193
2020-08-12,1962,1913,49,2.56,1193
2020-08-13,1962,1908,54,2.83,1193
2020-08-14,1771,1657,114,6.88,1193
2020-08-15,600,592,8,1.35,1193
2020-08-16,338,339,-1,-0.29,1193
2020-08-17,1941,1866,75,4.02,1193
2020-08-18,1962,1900,62,3.26,1193
2020-08-19,1962,1902,60,3.15,1193
2020-08-20,1962,1903,59,3.1,1193
2020-08-21,1771,1659,112,6.75,1193
2020-08-22,600,602,-2,-0.33,1193
2020-08-23,338,356,-18,-5.06,1193
2020-08-24,1941,1891,50,2.64,1193
2020-08-25,1962,1931,31,1.61,1193
2020-08-26,1962,1939,23,1.19,1193
2020-08-27,1962,1946,16,0.82,1193
2020-08-28,1771,1706,65,3.81,1193
2020-08-29,600,653,-53,-8.12,1193
2020-08-30,338,410,-72,-17.56,1193
2020-08-31,1941,1946,-5,-0.26,1193
2020-09-01,2073,1987,86,4.33,1193
2020-09-02,2073,1994,79,3.96,1193
2020-09-03,2073,2000,73,3.65,1193
2020-09-04,1779,1758,21,1.19,1193
2020-09-05,619,701,-82,-11.7,1193
2020-09-06,358,455,-97,-21.32,1193
2020-09-07,1958,1986,-28,-1.41,1193
2020-09-08,2073,2022,51,2.52,1193
2020-09-09,2073,2024,49,2.42,1193
2020-09-10,2073,2024,49,2.42,1193
2020-09-11,1779,1776,3,0.17,1193
2020-09-12,619,713,-94,-13.18,1193
2020-09-13,358,461,-103,-22.34,1193
2020-09-14,1958,1987,-29,-1.46,1193
2020-09-15,2073,2019,54,2.67,1193
2020-09-16,2073,2016,57,2.83,1193
2020-09-17,2073,2013,60,2.98,1193
2020-09-18,1779,1762,17,0.96,1193
2020-09-19,619,697,-78,-11.19,1193
2020-09-20,358,444,-86,-19.37,1193
2020-09-21,1958,1970,-12,-0.61,1193
2020-09-22,2073,2002,71,3.55,1193
2020-09-23,2073,2000,73,3.65,1193
2020-09-24,2073,1998,75,3.75,1193
2020-09-25,1779,1750,29,1.66,1193
2020-09-26,619,688,-69,-10.03,1193
2020-09-27,358,438,-80,-18.26,1193
2020-09-28,1958,1967,-9,-0.46,1193
2020-09-29,2073,2002,71,3.55,1193
2020-09-30,2073,2003,70,3.49,1193
2020-10-01,2067,2005,62,3.09,1193
2020-10-02,1789,1759,30,1.71,1193
2020-10-03,684,699,-15,-2.15,1193
2020-10-04,386,450,-64,-14.22,1193
2020-10-05,2144,1981,163,8.23,1193
2020-10-06,2067,2016,51,2.53,1193
2020-10-07,2067,2017,50,2.48,1193
2020-10-08,2067,2018,49,2.43,1193
2020-10-09,1789,1771,18,1.02,1193
2020-10-10,684,709,-25,-3.53,1193
2020-10-11,386,457,-71,-15.54,1193
2020-10-12,2144,1984,160,8.06,1193
2020-10-13,2067,2016,51,2.53,1193
2020-10-14,2067,2014,53,2.63,1193
2020-10-15,2067,2010,57,2.84,1193
2020-10-16,1789,1759,30,1.71,1193
2020-10-17,684,694,-10,-1.44,1193
2020-10-18,386,439,-53,-12.07,1193
2020-10-19,2144,1963,181,9.22,1193
2020-10-20,2067,1992,75,3.77,1193
2020-10-21,2067,1988,79,3.97,1193
2020-10-22,2067,1983,84,4.24,1193
2020-10-23,1789,1731,58,3.35,1193
2020-10-24,684,666,18,2.7,1193
2020-10-25,386,412,-26,-6.31,1193
2020-10-26,2144,1937,207,10.69,1193
2020-10-27,2067,1969,98,4.98,1193
2020-10-28,2067,1967,100,5.08,1193
2020-10-29,2067,1966,101,5.14,1193
2020-10-30,1789,1718,71,4.13,1193
2020-10-31,684,657,27,4.11,1193
2020-11-01,299,407,-108,-26.54,1193
2020-11-02,2072,1937,135,6.97,1193
2020-11-03,2084,1973,111,5.63,1193
2020-11-04,2084,1976,108,5.47,1193
2020-11-05,2084,1978,106,5.36,1193
2020-11-06,1804,1734,70,4.04,1193
2020-11-07,583,675,-92,-13.63,1193
2020-11-08,299,427,-128,-29.98,1193
2020-11-09,2072,1958,114,5.82,1193
2020-11-10,2084,1993,91,4.57,1193
2020-11-11,2084,1995,89,4.46,1193
2020-11-12,2084,1995,89,4.46,1193
2020-11-13,1804,1746,58,3.32,1193
2020-11-14,583,683,-100,-14.64,1193
2020-11-15,299,429,-130,-30.3,1193
2020-11-16,2072,1954,118,6.04,1193
2020-11-17,2084,1982,102,5.15,1193
2020-11-18,2084,1976,108,5.47,1193
2020-11-19,2084,1968,116,5.89,1193
2020-11-20,1804,1711,93,5.44,1193
2020-11-21,583,639,-56,-8.76,1193
2020-11-22,299,377,-78,-20.69,1193
2020-11-23,2072,1893,179,9.46,1193
2020-11-24,2084,1913,171,8.94,1193
2020-11-25,2084,1899,185,9.74,1193
2020-11-26,2084,1885,199,10.56,1193
2020-11-27,1804,1622,182,11.22,1193
2020-11-28,583,545,38,6.97,1193
2020-11-29,299,280,19,6.79,1193
2020-11-30,2072,1793,279,15.56,1193
2020-12-01,1563,1813,-250,-13.79,1193
2020-12-02,1563,1799,-236,-13.12,1193
2020-12-03,1563,1785,-222,-12.44,1193
2020-12-04,1796,1525,271,17.77,1193
2020-12-05,582,452,130,28.76,1193
2020-12-06,274,191,83,43.46,1193
2020-12-07,1663,1709,-46,-2.69,1193
2020-12-08,1563,1735,-172,-9.91,1193
2020-12-09,1563,1727,-164,-9.5,1193
2020-12-10,1563,1720,-157,-9.13,1193
2020-12-11,1796,1467,329,22.43,1193
2020-12-12,582,400,182,45.5,1193
2020-12-13,274,146,128,87.67,1193
2020-12-14,1663,1670,-7,-0.42,1193
2020-12-15,1563,1701,-138,-8.11,1193
2020-12-16,1563,1698,-135,-7.95,1193
2020-12-17,1563,1695,-132,-7.79,1193
2020-12-18,1796,1445,351,24.29,1193
2020-12-19,582,380,202,53.16,1193
2020-12-20,274,126,148,117.46,1193
2020-12-21,1663,1651,12,0.73,1193
2020-12-22,1563,1681,-118,-7.02,1193
2020-12-23,1563,1676,-113,-6.74,1193
2020-12-24,1563,1670,-107,-6.41,1193
2020-12-25,1796,1415,381,26.93,1193
2020-12-26,582,346,236,68.21,1193
2020-12-27,274,87,187,214.94,1193
2020-12-28,1663,1606,57,3.55,1193
2020-12-29,1563,1631,-68,-4.17,1193
2020-12-30,1563,1620,-57,-3.52,1193
2020-12-31,1563,1609,-46,-2.86,1193
2021-01-01,1323,1350,-27,-2.0,1193
2021-01-02,455,276,179,64.86,1193
2021-01-03,257,14,243,1735.71,1193
2021-01-04,1424,1530,-106,-6.93,1193
2021-01-05,1556,1553,3,0.19,1193
2021-01-06,1556,1541,15,0.97,1193
2021-01-07,1556,1531,25,1.63,1193
2021-01-08,1323,1273,50,3.93,1193
2021-01-09,455,203,252,124.14,1193
2021-01-10,257,41,216,526.83,1193
2021-01-11,1424,1466,-42,-2.86,1193
2021-01-12,1556,1494,62,4.15,1193
2021-01-13,1556,1490,66,4.43,1193
2021-01-14,1556,1488,68,4.57,1193
2021-01-15,1323,1239,84,6.78,1193
2021-01-16,455,177,278,157.06,1193
2021-01-17,257,31,226,729.03,1193
2021-01-18,1424,1460,-36,-2.47,1193
2021-01-19,1556,1498,58,3.87,1193
2021-01-20,1556,1504,52,3.46,1193
2021-01-21,1556,1510,46,3.05,1193
2021-01-22,1323,1270,53,4.17,1193
2021-01-23,455,216,239,110.65,1193
2021-01-24,257,53,204,384.91,1193
2021-01-25,1424,1512,-88,-5.82,1193
2021-01-26,1556,1556,0,0.0,1193
2021-01-27,1556,1565,-9,-0.58,1193
2021-01-28,1556,1575,-19,-1.21,1193
2021-01-29,1323,1337,-14,-1.05,1193
2021-01-30,455,284,171,60.21,1193
2021-01-31,257,42,215,511.9,1193
2021-02-01,1700,1579,121,7.66,1193
2021-02-02,1692,1621,71,4.38,1193
2021-02-03,1692,1629,63,3.87,1193
2021-02-04,1692,1635,57,3.49,1193
2021-02-05,1492,1394,98,7.03,1193
2021-02-06,508,338,170,50.3,1193
2021-02-07,276,92,184,200.0,1193
2021-02-08,1700,1625,75,4.62,1193
2021-02-09,1692,1663,29,1.74,1193
2021-02-10,1692,1667,25,1.5,1193
2021-02-11,1692,1671,21,1.26,1193
2021-02-12,1492,1426,66,4.63,1193
2021-02-13,508,368,140,38.04,1193
2021-02-14,276,121,155,128.1,1193
2021-02-15,1700,1653,47,2.84,1193
2021-02-16,1692,1690,2,0.12,1193
2021-02-17,1692,1694,-2,-0.12,1193
2021-02-18,1692,1698,-6,-0.35,1193
2021-02-19,1492,1455,37,2.54,1193
2021-02-20,508,398,110,27.64,1193
2021-02-21,276,153,123,80.39,1193
2021-02-22,1700,1687,13,0.77,1193
2021-02-23,1692,1727,-35,-2.03,1193
2021-02-24,1692,1734,-42,-2.42,1193
2021-02-25,1692,1740,-48,-2.76,1193
2021-02-26,1492,1499,-7,-0.47,1193
2021-02-27,508,444,64,14.41,1193
2021-02-28,276,201,75,37.31,1193
2021-03-01,2043,1736,307,17.68,1193
2021-03-02,2014,1777,237,13.34,1193
2021-03-03,2014,1784,230,12.89,1193
2021-03-04,2014,1791,223,12.45,1193
2021-03-05,1764,1550,214,13.81,1193
2021-03-06,578,494,84,17.0,1193
2021-03-07,302,249,53,21.29,1193
2021-03-08,2043,1783,260,14.58,1193
2021-03-09,2014,1822,192,10.54,1193
2021-03-10,2014,1826,188,10.3,1193
2021-03-11,2014,1830,184,10.05,1193
2021-03-12,1764,1586,178,11.22,1193
2021-03-13,578,527,51,9.68,1193
2021-03-14,302,280,22,7.86,1193
2021-03-15,2043,1811,232,12.81,1193
2021-03-16,2014,1847,167,9.04,1193
2021-03-17,2014,1850,164,8.86,1193
2021-03-18,2014,1852,162,8.75,1193
2021-03-19,1764,1606,158,9.84,1193
2021-03-20,578,547,31,5.67,1193
2021-03-21,302,299,3,1.0,1193
2021-03-22,2043,1830,213,11.64,1193
2021-03-23,2014,1868,146,7.82,1193
2021-03-24,2014,1871,143,7.64,1193
2021-03-25,2014,1875,139,7.41,1193
2021-03-26,1764,1632,132,8.09,1193
2021-03-27,578,575,3,0.52,1193
2021-03-28,302,330,-28,-8.48,1193
2021-03-29,2043,1864,179,9.6,1193
2021-03-30,2014,1904,110,5.78,1193
2021-03-31,2014,1910,104,5.45,1193
2021-04-01,2065,1917,148,7.72,1193
2021-04-02,1842,1676,166,9.9,1193
2021-04-03,620,622,-2,-0.32,1193
2021-04-04,272,378,-106,-28.04,1193
2021-04-05,2068,1914,154,8.05,1193
2021-04-06,2065,1955,110,5.63,1193
2021-04-07,2065,1962,103,5.25,1193
2021-04-08,2065,1969,96,4.88,1193
2021-04-09,1842,1728,114,6.6,1193
2021-04-10,620,672,-52,-7.74,1193
2021-04-11,272,427,-155,-36.3,1193
2021-04-12,2068,1960,108,5.51,1193
2021-04-13,2065,1998,67,3.35,1193
2021-04-14,2065,2002,63,3.15,1193
2021-04-15,2065,2005,60,2.99,1193
2021-04-16,1842,1760,82,4.66,1193
2021-04-17,620,701,-81,-11.55,1193
2021-04-18,272,452,-180,-39.82,1193
2021-04-19,2068,1981,87,4.39,1193
2021-04-20,2065,2016,49,2.43,1193
2021-04-21,2065,2017,48,2.38,1193
2021-04-22,2065,2016,49,2.43,1193
2021-04-23,1842,1769,73,4.13,1193
2021-04-24,620,707,-87,-12.31,1193
2021-04-25,272,456,-184,-40.35,1193
2021-04-26,2068,1985,83,4.18,1193
2021-04-27,2065,2019,46,2.28,1193
2021-04-28,2065,2019,46,2.28,1193
2021-04-29,2065,2019,46,2.28,1193
2021-04-30,1842,1772,70,3.95,1193
2021-05-01,697,711,-14,-1.97,1193
2021-05-02,332,462,-130,-28.14,1193
2021-05-03,2037,1992,45,2.26,1193
2021-05-04,2115,2028,87,4.29,1193
2021-05-05,2115,2031,84,4.14,1193
2021-05-06,2115,2033,82,4.03,1193
2021-05-07,1842,1788,54,3.02,1193
2021-05-08,697,729,-32,-4.39,1193
2021-05-09,332,482,-150,-31.12,1193
2021-05-10,2037,2013,24,1.19,1193
2021-05-11,2115,2050,65,3.17,1193
2021-05-12,2115,2053,62,3.02,1193
2021-05-13,2115,2056,59,2.87,1193
2021-05-14,1842,1811,31,1.71,1193
2021-05-15,697,751,-54,-7.19,1193
2021-05-16,332,503,-171,-34.0,1193
2021-05-17,2037,2033,4,0.2,1193
2021-05-18,2115,2068,47,2.27,1193
2021-05-19,2115,2069,46,2.22,1193
2021-05-20,2115,2069,46,2.22,1193
2021-05-21,1842,1821,21,1.15,1193
2021-05-22,697,759,-62,-8.17,1193
2021-05-23,332,508,-176,-34.65,1193
2021-05-24,2037,2035,2,0.1,1193
2021-05-25,2115,2068,47,2.27,1193
2021-05-26,2115,2067,48,2.32,1193
2021-05-27,2115,2065,50,2.42,1193
2021-05-28,1842,1816,26,1.43,1193
2021-05-29,697,753,-56,-7.44,1193
2021-05-30,332,501,-169,-33.73,1193
2021-05-31,2037,2028,9,0.44,1193
2021-06-01,2128,2061,67,3.25,1193
2021-06-02,2128,2061,67,3.25,1193
2021-06-03,2128,2060,68,3.3,1193
2021-06-04,1842,1812,30,1.66,1193
2021-06-05,642,751,-109,-14.51,1193
2021-06-06,368,501,-133,-26.55,1193
2021-06-07,2113,2030,83,4.09,1193
2021-06-08,2128,2065,63,3.05,1193
2021-06-09,2128,2067,61,2.95,1193
2021-06-10,2128,2068,60,2.9,1193
2021-06-11,1842,1822,20,1.1,1193
2021-06-12,642,762,-120,-15.75,1193
2021-06-13,368,513,-145,-28.27,1193
2021-06-14,2113,2043,70,3.43,1193
2021-06-15,2128,2077,51,2.46,1193
2021-06-16,2128,2078,50,2.41,1193
2021-06-17,2128,2078,50,2.41,1193
2021-06-18,1842,1830,12,0.66,1193
2021-06-19,642,767,-125,-16.3,1193
2021-06-20,368,514,-146,-28.4,1193
2021-06-21,2113,2040,73,3.58,1193
2021-06-22,2128,2070,58,2.8,1193
2021-06-23,2128,2066,62,3.0,1193
2021-06-24,2128,2060,68,3.3,1193
2021-06-25,1842,1807,35,1.94,1193
2021-06-26,642,738,-96,-13.01,1193
2021-06-27,368,480,-112,-23.33,1193
2021-06-28,2113,2000,113,5.65,1193
2021-06-29,2128,2026,102,5.03,1193
2021-06-30,2128,2017,111,5.5,1193
2021-07-01,1978,2007,-29,-1.44,1193
2021-07-02,1723,1751,-28,-1.6,1193
2021-07-03,576,680,-104,-15.29,1193
2021-07-04,352,420,-68,-16.19,1193
2021-07-05,1959,1939,20,1.03,1193
2021-07-06,1978,1965,13,0.66,1193
2021-07-07,1978,1957,21,1.07,1193
2021-07-08,1978,1949,29,1.49,1193
2021-07-09,1723,1695,28,1.65,1193
2021-07-10,576,628,-52,-8.28,1193
2021-07-11,352,372,-20,-5.38,1193
2021-07-12,1959,1897,62,3.27,1193
2021-07-13,1978,1927,51,2.65,1193
2021-07-14,1978,1925,53,2.75,1193
2021-07-15,1978,1923,55,2.86,1193
2021-07-16,1723,1675,48,2.87,1193
2021-07-17,576,613,-37,-6.04,1193
2021-07-18,352,363,-11,-3.03,1193
2021-07-19,1959,1893,66,3.49,1193
2021-07-20,1978,1928,50,2.59,1193
2021-07-21,1978,1930,48,2.49,1193
2021-07-22,1978,1931,47,2.43,1193
2021-07-23,1723,1685,38,2.26,1193
2021-07-24,576,625,-49,-7.84,1193
2021-07-25,352,376,-24,-6.38,1193
2021-07-26,1959,1905,54,2.83,1193
2021-07-27,1978,1939,39,2.01,1193
2021-07-28,1978,1938,40,2.06,1193
2021-07-29,1978,1937,41,2.12,1193
2021-07-30,1723,1688,35,2.07,1193
2021-07-31,576,623,-47,-7.54,1193
2021-08-01,340,369,-29,-7.86,1193
2021-08-02,1832,1893,-61,-3.22,1193
2021-08-03,1813,1923,-110,-5.72,1193
2021-08-04,1813,1917,-104,-5.43,1193
2021-08-05,1813,1911,-98,-5.13,1193
2021-08-06,1530,1658,-128,-7.72,1193
2021-08-07,585,589,-4,-0.68,1193
2021-08-08,340,332,8,2.41,1193
2021-08-09,1832,1854,-22,-1.19,1193
2021-08-10,1813,1882,-69,-3.67,1193
2021-08-11,1813,1876,-63,-3.36,1193
2021-08-12,1813,1870,-57,-3.05,1193
2021-08-13,1530,1617,-87,-5.38,1193
2021-08-14,585,551,34,6.17,1193
2021-08-15,340,298,42,14.09,1193
2021-08-16,1832,1824,8,0.44,1193
2021-08-17,1813,1856,-43,-2.32,1193
2021-08-18,1813,1856,-43,-2.32,1193
2021-08-19,1813,1857,-44,-2.37,1193
2021-08-20,1530,1611,-81,-5.03,1193
2021-08-21,585,552,33,5.98,1193
2021-08-22,340,306,34,11.11,1193
2021-08-23,1832,1839,-7,-0.38,1193
2021-08-24,1813,1879,-66,-3.51,1193
2021-08-25,1813,1885,-72,-3.82,1193
2021-08-26,1813,1892,-79,-4.18,1193
2021-08-27,1530,1652,-122,-7.38,1193
2021-08-28,585,598,-13,-2.17,1193
2021-08-29,340,356,-16,-4.49,1193
2021-08-30,1832,1892,-60,-3.17,1193
2021-08-31,1813,1934,-121,-6.26,1193
2021-09-01,2022,1941,81,4.17,1193
2021-09-02,2022,1948,74,3.8,1193
2021-09-03,1788,1707,81,4.75,1193
2021-09-04,645,651,-6,-0.92,1193
2021-09-05,383,405,-22,-5.43,1193
2021-09-06,1972,1938,34,1.75,1193
2021-09-07,2022,1975,47,2.38,1193
2021-09-08,2022,1978,44,2.22,1193
2021-09-09,2022,1979,43,2.17,1193
2021-09-10,1788,1732,56,3.23,1193
2021-09-11,645,670,-25,-3.73,1193
2021-09-12,383,419,-36,-8.59,1193
2021-09-13,1972,1946,26,1.34,1193
2021-09-14,2022,1978,44,2.22,1193
2021-09-15,2022,1975,47,2.38,1193
2021-09-16,2022,1972,50,2.54,1193
2021-09-17,1788,1722,66,3.83,1193
2021-09-18,645,657,-12,-1.83,1193
2021-09-19,383,403,-20,-4.96,1193
2021-09-20,1972,1929,43,2.23,1193
2021-09-21,2022,1960,62,3.16,1193
2021-09-22,2022,1958,64,3.27,1193
2021-09-23,2022,1956,66,3.37,1193
2021-09-24,1788,1707,81,4.75,1193
2021-09-25,645,644,1,0.16,1193
2021-09-26,383,393,-10,-2.54,1193
2021-09-27,1972,1922,50,2.6,1193
2021-09-28,2022,1956,66,3.37,1193
2021-09-29,2022,1957,65,3.32,1193
2021-09-30,2022,1958,64,3.27,1193
2021-10-01,1856,1712,144,8.41,1193
2021-10-02,650,653,-3,-0.46,1193
2021-10-03,345,404,-59,-14.6,1193
2021-10-04,1890,1934,-44,-2.28,1193
2021-10-05,1989,1970,19,0.96,1193
2021-10-06,1989,1971,18,0.91,1193
2021-10-07,1989,1972,17,0.86,1193
2021-10-08,1856,1726,130,7.53,1193
2021-10-09,650,665,-15,-2.26,1193
2021-10-10,345,414,-69,-16.67,1193
2021-10-11,1890,1942,-52,-2.68,1193
2021-10-12,1989,1974,15,0.76,1193
2021-10-13,1989,1973,16,0.81,1193
2021-10-14,1989,1970,19,0.96,1193
2021-10-15,1856,1719,137,7.97,1193
2021-10-16,650,654,-4,-0.61,1193
2021-10-17,345,400,-55,-13.75,1193
2021-10-18,1890,1924,-34,-1.77,1193
2021-10-19,1989,1954,35,1.79,1193
2021-10-20,1989,1949,40,2.05,1193
2021-10-21,1989,1944,45,2.31,1193
2021-10-22,1856,1692,164,9.69,1193
2021-10-23,650,626,24,3.83,1193
2021-10-24,345,372,-27,-7.26,1193
2021-10-25,1890,1896,-6,-0.32,1193
2021-10-26,1989,1928,61,3.16,1193
2021-10-27,1989,1925,64,3.32,1193
2021-10-28,1989,1923,66,3.43,1193
2021-10-29,1856,1674,182,10.87,1193
2021-10-30,650,612,38,6.21,1193
2021-10-31,345,362,-17,-4.7,1193
2021-11-01,1919,1891,28,1.48,1193
2021-11-02,1971,1927,44,2.28,1193
2021-11-03,1971,1929,42,2.18,1193
2021-11-04,1971,1931,40,2.07,1193
2021-11-05,1649,1686,-37,-2.19,1193
2021-11-06,606,627,-21,-3.35,1193
2021-11-07,307,379,-72,-19.0,1193
2021-11-08,1919,1910,9,0.47,1193
2021-11-09,1971,1947,24,1.23,1193
2021-11-10,1971,1949,22,1.13,1193
2021-11-11,1971,1950,21,1.08,1193
2021-11-12,1649,1703,-54,-3.17,1193
2021-11-13,606,641,-35,-5.46,1193
2021-11-14,307,389,-82,-21.08,1193
2021-11-15,1919,1914,5,0.26,1193
2021-11-16,1971,1945,26,1.34,1193
2021-11-17,1971,1940,31,1.6,1193
2021-11-18,1971,1933,38,1.97,1193
2021-11-19,1649,1678,-29,-1.73,1193
2021-11-20,606,607,-1,-0.16,1193
2021-11-21,307,347,-40,-11.53,1193
2021-11-22,1919,1864,55,2.95,1193
2021-11-23,1971,1886,85,4.51,1193
2021-11-24,1971,1873,98,5.23,1193
2021-11-25,1971,1858,113,6.08,1193
2021-11-26,1649,1596,53,3.32,1193
2021-11-27,606,520,86,16.54,1193
2021-11-28,307,254,53,20.87,1193
2021-11-29,1919,1768,151,8.54,1193
2021-11-30,1971,1787,184,10.3,1193
2021-12-01,1482,1772,-290,-16.37,1193
2021-12-02,1482,1758,-276,-15.7,1193
2021-12-03,1144,1497,-353,-23.58,1193
2021-12-04,551,422,129,30.57,1193
2021-12-05,257,160,97,60.62,1193
2021-12-06,1580,1677,-97,-5.78,1193
2021-12-07,1482,1701,-219,-12.87,1193
2021-12-08,1482,1693,-211,-12.46,1193
2021-12-09,1482,1684,-202,-12.0,1193
2021-12-10,1144,1430,-286,-20.0,1193
2021-12-11,551,362,189,52.21,1193
2021-12-12,257,107,150,140.19,1193
2021-12-13,1580,1631,-51,-3.13,1193
2021-12-14,1482,1661,-179,-10.78,1193
2021-12-15,1482,1658,-176,-10.62,1193
2021-12-16,1482,1655,-173,-10.45,1193
2021-12-17,1144,1404,-260,-18.52,1193
2021-12-18,551,340,211,62.06,1193
2021-12-19,257,86,171,198.84,1193
2021-12-20,1580,1611,-31,-1.92,1193
2021-12-21,1482,1642,-160,-9.74,1193
2021-12-22,1482,1638,-156,-9.52,1193
2021-12-23,1482,1632,-150,-9.19,1193
2021-12-24,1144,1379,-235,-17.04,1193
2021-12-25,551,311,240,77.17,1193
2021-12-26,257,53,204,384.91,1193
2021-12-27,1580,1573,7,0.45,1193
2021-12-28,1482,1599,-117,-7.32,1193
2021-12-29,1482,1589,-107,-6.73,1193
2021-12-30,1482,1578,-96,-6.08,1193
2021-12-31,1144,1320,-176,-13.33,1193
2022-01-01,460,247,213,86.23,1193
2022-01-02,247,61,186,304.92,1193
2022-01-03,1375,1501,-126,-8.39,1193
2022-01-04,1478,1523,-45,-2.95,1193
2022-01-05,1478,1511,-33,-2.18,1193
2022-01-06,1478,1500,-22,-1.47,1193
2022-01-07,1206,1241,-35,-2.82,1193
2022-01-08,460,170,290,170.59,1193
2022-01-09,247,32,215,671.88,1193
2022-01-10,1375,1430,-55,-3.85,1193
2022-01-11,1478,1457,21,1.44,1193
2022-01-12,1478,1451,27,1.86,1193
2022-01-13,1478,1447,31,2.14,1193
2022-01-14,1206,1196,10,0.84,1193
2022-01-15,460,133,327,245.86,1193
2022-01-16,247,15,232,1546.67,1193
2022-01-17,1375,1412,-37,-2.62,1193
2022-01-18,1478,1449,29,2.0,1193
2022-01-19,1478,1453,25,1.72,1193
2022-01-20,1478,1458,20,1.37,1193
2022-01-21,1206,1216,-10,-0.82,1193
2022-01-22,460,162,298,183.95,1193
2022-01-23,247,31,216,696.77,1193
2022-01-24,1375,1456,-81,-5.56,1193
2022-01-25,1478,1499,-21,-1.4,1193
2022-01-26,1478,1509,-31,-2.05,1193
2022-01-27,1478,1518,-40,-2.64,1193
2022-01-28,1206,1280,-74,-5.78,1193
2022-01-29,460,228,232,101.75,1193
2022-01-30,247,68,179,263.24,1193
2020-02-01,597,533,64,12.01,1219
2020-02-02,470,413,57,13.8,1219
2020-02-03,1156,1193,-37,-3.1,1219
2020-02-04,1186,1226,-40,-3.26,1219
2020-02-05,1186,1226,-40,-3.26,1219
2020-02-06,1186,1226,-40,-3.26,1219
2020-02-07,1121,1103,18,1.63,1219
2020-02-08,597,544,53,9.74,1219
2020-02-09,470,424,46,10.85,1219
2020-02-10,1156,1205,-49,-4.07,1219
2020-02-11,1186,1239,-53,-4.28,1219
2020-02-12,1186,1240,-54,-4.35,1219
2020-02-13,1186,1243,-57,-4.59,1219
2020-02-14,1121,1121,0,0.0,1219
2020-02-15,597,566,31,5.48,1219
2020-02-16,470,449,21,4.68,1219
2020-02-17,1156,1234,-78,-6.32,1219
2020-02-18,1186,1271,-85,-6.69,1219
2020-02-19,1186,1278,-92,-7.2,1219
2020-02-20,1186,1285,-99,-7.7,1219
2020-02-21,1121,1169,-48,-4.11,1219
2020-02-22,597,618,-21,-3.4,1219
2020-02-23,470,507,-37,-7.3,1219
2020-02-24,1156,1297,-141,-10.87,1219
2020-02-25,1186,1339,-153,-11.43,1219
2020-02-26,1186,1350,-164,-12.15,1219
2020-02-27,1186,1362,-176,-12.92,1219
2020-02-28,1121,1250,-129,-10.32,1219
2020-02-29,597,703,-106,-15.08,1219
2020-03-01,456,594,-138,-23.23,1219
2020-03-02,1054,1386,-332,-23.95,1219
2020-03-03,1073,1430,-357,-24.97,1219
2020-03-04,1073,1442,-369,-25.59,1219
2020-03-05,1073,1453,-380,-26.15,1219
2020-03-06,971,1340,-369,-27.54,1219
2020-03-07,538,791,-253,-31.98,1219
2020-03-08,456,680,-224,-32.94,1219
2020-03-09,1054,1469,-415,-28.25,1219
2020-03-10,1073,1510,-437,-28.94,1219
2020-03-11,1073,1517,-444,-29.27,1219
2020-03-12,1073,1524,-451,-29.59,1219
2020-03-13,971,1406,-435,-30.94,1219
2020-03-14,538,852,-314,-36.85,1219
2020-03-15,456,735,-279,-37.96,1219
2020-03-16,1054,1519,-465,-30.61,1219
2020-03-17,1073,1553,-480,-30.91,1219
2020-03-18,1073,1555,-482,-31.0,1219
2020-03-19,1073,1556,-483,-31.04,1219
2020-03-20,971,1433,-462,-32.24,1219
2020-03-21,538,874,-336,-38.44,1219
2020-03-22,456,753,-297,-39.44,1219
2020-03-23,1054,1532,-478,-31.2,1219
2020-03-24,1073,1563,-490,-31.35,1219
2020-03-25,1073,1562,-489,-31.31,1219
2020-03-26,1073,1561,-488,-31.26,1219
2020-03-27,971,1435,-464,-32.33,1219
2020-03-28,538,875,-337,-38.51,1219
2020-03-29,456,753,-297,-39.44,1219
2020-03-30,1054,1532,-478,-31.2,1219
2020-03-31,1073,1563,-490,-31.35,1219
2020-04-01,1064,1562,-498,-31.88,1219
2020-04-02,1064,1562,-498,-31.88,1219
2020-04-03,966,1438,-472,-32.82,1219
2020-04-04,531,879,-348,-39.59,1219
2020-04-05,440,759,-319,-42.03,1219
2020-04-06,1097,1539,-442,-28.72,1219
2020-04-07,1064,1572,-508,-32.32,1219
2020-04-08,1064,1573,-509,-32.36,1219
2020-04-09,1064,1574,-510,-32.4,1219
2020-04-10,966,1451,-485,-33.43,1219
2020-04-11,531,893,-362,-40.54,1219
2020-04-12,440,774,-334,-43.15,1219
2020-04-13,1097,1555,-458,-29.45,1219
2020-04-14,1064,1588,-524,-33.0,1219
2020-04-15,1064,1588,-524,-33.0,1219
2020-04-16,1064,1589,-525,-33.04,1219
2020-04-17,966,1465,-499,-34.06,1219
2020-04-18,531,906,-375,-41.39,1219
2020-04-19,440,785,-345,-43.95,1219
2020-04-20,1097,1564,-467,-29.86,1219
2020-04-21,1064,1595,-531,-33.29,1219
2020-04-22,1064,1594,-530,-33.25,1219
2020-04-23,1064,1592,-528,-33.17,1219
2020-04-24,966,1467,-501,-34.15,1219
2020-04-25,531,905,-374,-41.33,1219
2020-04-26,440,782,-342,-43.73,1219
2020-04-27,1097,1560,-463,-29.68,1219
2020-04-28,1064,1590,-526,-33.08,1219
2020-04-29,1064,1587,-523,-32.96,1219
2020-04-30,1064,1584,-520,-32.83,1219
2020-05-01,1076,1458,-382,-26.2,1219
2020-05-02,577,896,-319,-35.6,1219
2020-05-03,466,773,-307,-39.72,1219
2020-05-04,1205,1550,-345,-22.26,1219
2020-05-05,1247,1580,-333,-21.08,1219
2020-05-06,1247,1578,-331,-20.98,1219
2020-05-07,1247,1577,-330,-20.93,1219
2020-05-08,1076,1451,-375,-25.84,1219
2020-05-09,577,891,-314,-35.24,1219
2020-05-10,466,769,-303,-39.4,1219
2020-05-11,1205,1549,-344,-22.21,1219
2020-05-12,1247,1581,-334,-21.13,1219
2020-05-13,1247,1580,-333,-21.08,1219
2020-05-14,1247,1581,-334,-21.13,1219
2020-05-15,1076,1457,-381,-26.15,1219
2020-05-16,577,898,-321,-35.75,1219
2020-05-17,466,778,-312,-40.1,1219
2020-05-18,1205,1559,-354,-22.71,1219
2020-05-19,1247,1591,-344,-21.62,1219
2020-05-20,1247,1592,-345,-21.67,1219
2020-05-21,1247,1592,-345,-21.67,1219
2020-05-22,1076,1468,-392,-26.7,1219
2020-05-23,577,909,-332,-36.52,1219
2020-05-24,466,788,-322,-40.86,1219
2020-05-25,1205,1568,-363,-23.15,1219
2020-05-26,1247,1599,-352,-22.01,1219
2020-05-27,1247,1598,-351,-21.96,1219
2020-05-28,1247,1596,-349,-21.87,1219
2020-05-29,1076,1471,-395,-26.85,1219
2020-05-30,577,909,-332,-36.52,1219
2020-05-31,466,786,-320,-40.71,1219
2020-06-01,1280,1564,-284,-18.16,1219
2020-06-02,1319,1593,-274,-17.2,1219
2020-06-03,1319,1590,-271,-17.04,1219
2020-06-04,1319,1587,-268,-16.89,1219
2020-06-05,1175,1460,-285,-19.52,1219
2020-06-06,636,897,-261,-29.1,1219
2020-06-07,489,773,-284,-36.74,1219
2020-06-08,1280,1550,-270,-17.42,1219
2020-06-09,1319,1580,-261,-16.52,1219
2020-06-10,1319,1577,-258,-16.36,1219
2020-06-11,1319,1575,-256,-16.25,1219
2020-06-12,1175,1449,-274,-18.91,1219
2020-06-13,636,888,-252,-28.38,1219
2020-06-14,489,767,-278,-36.25,1219
2020-06-15,1280,1546,-266,-17.21,1219
2020-06-16,1319,1579,-260,-16.47,1219
2020-06-17,1319,1579,-260,-16.47,1219
2020-06-18,1319,1581,-262,-16.57,1219
2020-06-19,1175,1459,-284,-19.47,1219
2020-06-20,636,902,-266,-29.49,1219
2020-06-21,489,785,-296,-37.71,1219
2020-06-22,1280,1569,-289,-18.42,1219
2020-06-23,1319,1605,-286,-17.82,1219
2020-06-24,1319,1610,-291,-18.07,1219
2020-06-25,1319,1616,-297,-18.38,1219
2020-06-26,1175,1497,-322,-21.51,1219
2020-06-27,636,944,-308,-32.63,1219
2020-06-28,489,830,-341,-41.08,1219
2020-06-29,1280,1616,-336,-20.79,1219
2020-06-30,1319,1655,-336,-20.3,1219
2020-07-01,1259,1661,-402,-24.2,1219
2020-07-02,1259,1668,-409,-24.52,1219
2020-07-03,1157,1550,-393,-25.35,1219
2020-07-04,612,997,-385,-38.62,1219
2020-07-05,486,882,-396,-44.9,1219
2020-07-06,1242,1668,-426,-25.54,1219
2020-07-07,1259,1705,-446,-26.16,1219
2020-07-08,1259,1709,-450,-26.33,1219
2020-07-09,1259,1713,-454,-26.5,1219
2020-07-10,1157,1592,-435,-27.32,1219
2020-07-11,612,1035,-423,-40.87,1219
2020-07-12,486,916,-430,-46.94,1219
2020-07-13,1242,1697,-455,-26.81,1219
2020-07-14,1259,1730,-471,-27.23,1219
2020-07-15,1259,1730,-471,-27.23,1219
2020-07-16,1259,1729,-470,-27.18,1219
2020-07-17,1157,1604,-447,-27.87,1219
2020-07-18,612,1043,-431,-41.32,1219
2020-07-19,486,920,-434,-47.17,1219
2020-07-20,1242,1697,-455,-26.81,1219
2020-07-21,1259,1726,-467,-27.06,1219
2020-07-22,1259,1722,-463,-26.89,1219
2020-07-23,1259,1718,-459,-26.72,1219
2020-07-24,1157,1590,-433,-27.23,1219
2020-07-25,612,1027,-415,-40.41,1219
2020-07-26,486,902,-416,-46.12,1219
2020-07-27,1242,1678,-436,-25.98,1219
2020-07-28,1259,1706,-447,-26.2,1219
2020-07-29,1259,1702,-443,-26.03,1219
2020-07-30,1259,1699,-440,-25.9,1219
2020-07-31,1157,1571,-414,-26.35,1219
2020-08-01,603,1009,-406,-40.24,1219
2020-08-02,482,885,-403,-45.54,1219
2020-08-03,1120,1663,-543,-32.65,1219
2020-08-04,1129,1692,-563,-33.27,1219
2020-08-05,1129,1690,-561,-33.2,1219
2020-08-06,1129,1689,-560,-33.16,1219
2020-08-07,1070,1564,-494,-31.59,1219
2020-08-08,603,1004,-401,-39.94,1219
2020-08-09,482,882,-400,-45.35,1219
2020-08-10,1120,1662,-542,-32.61,1219
2020-08-11,1129,1693,-564,-33.31,1219
2020-08-12,1129,1693,-564,-33.31,1219
2020-08-13,1129,1693,-564,-33.31,1219
2020-08-14,1070,1569,-499,-31.8,1219
2020-08-15,603,1009,-406,-40.24,1219
2020-08-16,482,888,-406,-45.72,1219
2020-08-17,1120,1667,-547,-32.81,1219
2020-08-18,1129,1698,-569,-33.51,1219
2020-08-19,1129,1696,-567,-33.43,1219
2020-08-20,1129,1695,-566,-33.39,1219
2020-08-21,1070,1569,-499,-31.8,1219
2020-08-22,603,1007,-404,-40.12,1219
2020-08-23,482,883,-401,-45.41,1219
2020-08-24,1120,1659,-539,-32.49,1219
2020-08-25,1129,1687,-558,-33.08,1219
2020-08-26,1129,1682,-553,-32.88,1219
2020-08-27,1129,1677,-548,-32.68,1219
2020-08-28,1070,1548,-478,-30.88,1219
2020-08-29,603,982,-379,-38.59,1219
2020-08-30,482,855,-373,-43.63,1219
2020-08-31,1120,1628,-508,-31.2,1219
2020-09-01,1408,1654,-246,-14.87,1219
2020-09-02,1408,1646,-238,-14.46,1219
2020-09-03,1408,1639,-231,-14.09,1219
2020-09-04,1225,1508,-283,-18.77,1219
2020-09-05,633,942,-309,-32.8,1219
2020-09-06,491,814,-323,-39.68,1219
2020-09-07,1390,1587,-197,-12.41,1219
2020-09-08,1408,1613,-205,-12.71,1219
2020-09-09,1408,1607,-199,-12.38,1219
2020-09-10,1408,1602,-194,-12.11,1219
2020-09-11,1225,1473,-248,-16.84,1219
2020-09-12,633,910,-277,-30.44,1219
2020-09-13,491,785,-294,-37.45,1219
2020-09-14,1390,1562,-172,-11.01,1219
2020-09-15,1408,1592,-184,-11.56,1219
2020-09-16,1408,1591,-183,-11.5,1219
2020-09-17,1408,1590,-182,-11.45,1219
2020-09-18,1225,1467,-242,-16.5,1219
2020-09-19,633,908,-275,-30.29,1219
2020-09-20,491,789,-298,-37.77,1219
2020-09-21,1390,1571,-181,-11.52,1219
2020-09-22,1408,1606,-198,-12.33,1219
2020-09-23,1408,1609,-201,-12.49,1219
2020-09-24,1408,1613,-205,-12.71,1219
2020-09-25,1225,1493,-268,-17.95,1219
2020-09-26,633,938,-305,-32.52,1219
2020-09-27,491,821,-330,-40.19,1219
2020-09-28,1390,1606,-216,-13.45,1219
2020-09-29,1408,1642,-234,-14.25,1219
2020-09-30,1408,1646,-238,-14.46,1219
2020-10-01,1389,1650,-261,-15.82,1219
2020-10-02,1282,1530,-248,-16.21,1219
2020-10-03,650,974,-324,-33.26,1219
2020-10-04,494,856,-362,-42.29,1219
2020-10-05,1302,1638,-336,-20.51,1219
2020-10-06,1389,1673,-284,-16.98,1219
2020-10-07,1389,1674,-285,-17.03,1219
2020-10-08,1389,1675,-286,-17.07,1219
2020-10-09,1282,1551,-269,-17.34,1219
2020-10-10,650,992,-342,-34.48,1219
2020-10-11,494,871,-377,-43.28,1219
2020-10-12,1302,1649,-347,-21.04,1219
2020-10-13,1389,1680,-291,-17.32,1219
2020-10-14,1389,1678,-289,-17.22,1219
2020-10-15,1389,1676,-287,-17.12,1219
2020-10-16,1282,1550,-268,-17.29,1219
2020-10-17,650,988,-338,-34.21,1219
2020-10-18,494,865,-371,-42.89,1219
2020-10-19,1302,1642,-340,-20.71,1219
2020-10-20,1389,1672,-283,-16.93,1219
2020-10-21,1389,1670,-281,-16.83,1219
2020-10-22,1389,1668,-279,-16.73,1219
2020-10-23,1282,1542,-260,-16.86,1219
2020-10-24,650,981,-331,-33.74,1219
2020-10-25,494,860,-366,-42.56,1219
2020-10-26,1302,1639,-337,-20.56,1219
2020-10-27,1389,1670,-281,-16.83,1219
2020-10-28,1389,1670,-281,-16.83,1219
2020-10-29,1389,1671,-282,-16.88,1219
2020-10-30,1282,1547,-265,-17.13,1219
2020-10-31,650,989,-339,-34.28,1219
2020-11-01,480,870,-390,-44.83,1219
2020-11-02,1339,1651,-312,-18.9,1219
2020-11-03,1342,1685,-343,-20.36,1219
2020-11-04,1342,1686,-344,-20.4,1219
2020-11-05,1342,1688,-346,-20.5,1219
2020-11-06,1287,1566,-279,-17.82,1219
2020-11-07,664,1008,-344,-34.13,1219
2020-11-08,480,888,-408,-45.95,1219
2020-11-09,1339,1669,-330,-19.77,1219
2020-11-10,1342,1702,-360,-21.15,1219
2020-11-11,1342,1701,-359,-21.11,1219
2020-11-12,1342,1701,-359,-21.11,1219
2020-11-13,1287,1576,-289,-18.34,1219
2020-11-14,664,1015,-351,-34.58,1219
2020-11-15,480,892,-412,-46.19,1219
2020-11-16,1339,1670,-331,-19.82,1219
2020-11-17,1342,1698,-356,-20.97,1219
2020-11-18,1342,1694,-352,-20.78,1219
2020-11-19,1342,1690,-348,-20.59,1219
2020-11-20,1287,1561,-274,-17.55,1219
2020-11-21,664,996,-332,-33.33,1219
2020-11-22,480,870,-390,-44.83,1219
2020-11-23,1339,1643,-304,-18.5,1219
2020-11-24,1342,1669,-327,-19.59,1219
2020-11-25,1342,1662,-320,-19.25,1219
2020-11-26,1342,1655,-313,-18.91,1219
2020-11-27,1287,1524,-237,-15.55,1219
2020-11-28,664,958,-294,-30.69,1219
2020-11-29,480,831,-351,-42.24,1219
2020-11-30,1339,1604,-265,-16.52,1219
2020-12-01,1183,1630,-447,-27.42,1219
2020-12-02,1183,1624,-441,-27.16,1219
2020-12-03,1183,1618,-435,-26.89,1219
2020-12-04,1257,1489,-232,-15.58,1219
2020-12-05,619,925,-306,-33.08,1219
2020-12-06,466,800,-334,-41.75,1219
2020-12-07,1170,1576,-406,-25.76,1219
2020-12-08,1183,1604,-421,-26.25,1219
2020-12-09,1183,1601,-418,-26.11,1219
2020-12-10,1183,1598,-415,-25.97,1219
2020-12-11,1257,1471,-214,-14.55,1219
2020-12-12,619,910,-291,-31.98,1219
2020-12-13,466,787,-321,-40.79,1219
2020-12-14,1170,1565,-395,-25.24,1219
2020-12-15,1183,1595,-412,-25.83,1219
2020-12-16,1183,1593,-410,-25.74,1219
2020-12-17,1183,1591,-408,-25.64,1219
2020-12-18,1257,1465,-208,-14.2,1219
2020-12-19,619,904,-285,-31.53,1219
2020-12-20,466,780,-314,-40.26,1219
2020-12-21,1170,1558,-388,-24.9,1219
2020-12-22,1183,1587,-404,-25.46,1219
2020-12-23,1183,1583,-400,-25.27,1219
2020-12-24,1183,1580,-397,-25.13,1219
2020-12-25,1257,1452,-195,-13.43,1219
2020-12-26,619,888,-269,-30.29,1219
2020-12-27,466,763,-297,-38.93,1219
2020-12-28,1170,1538,-368,-23.93,1219
2020-12-29,1183,1565,-382,-24.41,1219
2020-12-30,1183,1559,-376,-24.12,1219
2020-12-31,1183,1554,-371,-23.87,1219
2021-01-01,992,1424,-432,-30.34,1219
2021-01-02,549,860,-311,-36.16,1219
2021-01-03,454,733,-279,-38.06,1219
2021-01-04,1032,1508,-476,-31.56,1219
2021-01-05,1096,1535,-439,-28.6,1219
2021-01-06,1096,1530,-434,-28.37,1219
2021-01-07,1096,1526,-430,-28.18,1219
2021-01-08,992,1397,-405,-28.99,1219
2021-01-09,549,834,-285,-34.17,1219
2021-01-10,454,710,-256,-36.06,1219
2021-01-11,1032,1488,-456,-30.65,1219
2021-01-12,1096,1517,-421,-27.75,1219
2021-01-13,1096,1515,-419,-27.66,1219
2021-01-14,1096,1514,-418,-27.61,1219
2021-01-15,992,1390,-398,-28.63,1219
2021-01-16,549,830,-281,-33.86,1219
2021-01-17,454,709,-255,-35.97,1219
2021-01-18,1032,1490,-458,-30.74,1219
2021-01-19,1096,1523,-427,-28.04,1219
2021-01-20,1096,1524,-428,-28.08,1219
2021-01-21,1096,1525,-429,-28.13,1219
2021-01-22,992,1403,-411,-29.29,1219
2021-01-23,549,845,-296,-35.03,1219
2021-01-24,454,726,-272,-37.47,1219
2021-01-25,1032,1508,-476,-31.56,1219
2021-01-26,1096,1542,-446,-28.92,1219
2021-01-27,1096,1543,-447,-28.97,1219
2021-01-28,1096,1545,-449,-29.06,1219
2021-01-29,992,1422,-430,-30.24,1219
2021-01-30,549,864,-315,-36.46,1219
2021-01-31,454,744,-290,-38.98,1219
2021-02-01,1184,1525,-341,-22.36,1219
2021-02-02,1185,1558,-373,-23.94,1219
2021-02-03,1185,1558,-373,-23.94,1219
2021-02-04,1185,1558,-373,-23.94,1219
2021-02-05,1106,1435,-329,-22.93,1219
2021-02-06,565,876,-311,-35.5,1219
2021-02-07,456,756,-300,-39.68,1219
2021-02-08,1184,1536,-352,-22.92,1219
2021-02-09,1185,1570,-385,-24.52,1219
2021-02-10,1185,1571,-386,-24.57,1219
2021-02-11,1185,1572,-387,-24.62,1219
2021-02-12,1106,1451,-345,-23.78,1219
2021-02-13,565,894,-329,-36.8,1219
2021-02-14,456,776,-320,-41.24,1219
2021-02-15,1184,1560,-376,-24.1,1219
2021-02-16,1185,1597,-412,-25.8,1219
2021-02-17,1185,1602,-417,-26.03,1219
2021-02-18,1185,1609,-424,-26.35,1219
2021-02-19,1106,1492,-386,-25.87,1219
2021-02-20,565,940,-375,-39.89,1219
2021-02-21,456,828,-372,-44.93,1219
2021-02-22,1184,1617,-433,-26.78,1219
2021-02-23,1185,1659,-474,-28.57,1219
2021-02-24,1185,1669,-484,-29.0,1219
2021-02-25,1185,1680,-495,-29.46,1219
2021-02-26,1106,1568,-462,-29.46,1219
2021-02-27,565,1020,-455,-44.61,1219
2021-02-28,456,911,-455,-49.95,1219
2021-03-01,1296,1703,-407,-23.9,1219
2021-03-02,1329,1748,-419,-23.97,1219
2021-03-03,1329,1759,-430,-24.45,1219
2021-03-04,1329,1771,-442,-24.96,1219
2021-03-05,1209,1659,-450,-27.12,1219
2021-03-06,657,1111,-454,-40.86,1219
2021-03-07,508,1001,-493,-49.25,1219
2021-03-08,1296,1790,-494,-27.6,1219
2021-03-09,1329,1832,-503,-27.46,1219
2021-03-10,1329,1840,-511,-27.77,1219
2021-03-11,1329,1848,-519,-28.08,1219
2021-03-12,1209,1731,-522,-30.16,1219
2021-03-13,657,1178,-521,-44.23,1219
2021-03-14,508,1062,-554,-52.17,1219
2021-03-15,1296,1847,-551,-29.83,1219
2021-03-16,1329,1882,-553,-29.38,1219
2021-03-17,1329,1885,-556,-29.5,1219
2021-03-18,1329,1887,-558,-29.57,1219
2021-03-19,1209,1765,-556,-31.5,1219
2021-03-20,657,1206,-549,-45.52,1219
2021-03-21,508,1086,-578,-53.22,1219
2021-03-22,1296,1865,-569,-30.51,1219
2021-03-23,1329,1897,-568,-29.94,1219
2021-03-24,1329,1896,-567,-29.91,1219
2021-03-25,1329,1895,-566,-29.87,1219
2021-03-26,1209,1770,-561,-31.69,1219
2021-03-27,657,1209,-552,-45.66,1219
2021-03-28,508,1087,-579,-53.27,1219
2021-03-29,1296,1866,-570,-30.55,1219
2021-03-30,1329,1897,-568,-29.94,1219
2021-03-31,1329,1896,-567,-29.91,1219
2021-04-01,1357,1895,-538,-28.39,1219
2021-04-02,1259,1771,-512,-28.91,1219
2021-04-03,664,1211,-547,-45.17,1219
2021-04-04,440,1091,-651,-59.67,1219
2021-04-05,1384,1871,-487,-26.03,1219
2021-04-06,1357,1904,-547,-28.73,1219
2021-04-07,1357,1904,-547,-28.73,1219
2021-04-08,1357,1905,-548,-28.77,1219
2021-04-09,1259,1782,-523,-29.35,1219
2021-04-10,664,1224,-560,-45.75,1219
2021-04-11,440,1105,-665,-60.18,1219
2021-04-12,1384,1886,-502,-26.62,1219
2021-04-13,1357,1919,-562,-29.29,1219
2021-04-14,1357,1920,-563,-29.32,1219
2021-04-15,1357,1921,-564,-29.36,1219
2021-04-16,1259,1797,-538,-29.94,1219
2021-04-17,664,1238,-574,-46.37,1219
2021-04-18,440,1118,-678,-60.64,1219
2021-04-19,1384,1897,-513,-27.04,1219
2021-04-20,1357,1929,-572,-29.65,1219
2021-04-21,1357,1928,-571,-29.62,1219
2021-04-22,1357,1927,-570,-29.58,1219
2021-04-23,1259,1801,-542,-30.09,1219
2021-04-24,664,1240,-576,-46.45,1219
2021-04-25,440,1118,-678,-60.64,1219
2021-04-26,1384,1895,-511,-26.97,1219
2021-04-27,1357,1925,-568,-29.51,1219
2021-04-28,1357,1923,-566,-29.43,1219
2021-04-29,1357,1920,-563,-29.32,1219
2021-04-30,1259,1793,-534,-29.78,1219
2021-05-01,691,1232,-541,-43.91,1219
2021-05-02,452,1108,-656,-59.21,1219
2021-05-03,1369,1886,-517,-27.41,1219
2021-05-04,1429,1915,-486,-25.38,1219
2021-05-05,1429,1913,-484,-25.3,1219
2021-05-06,1429,1911,-482,-25.22,1219
2021-05-07,1326,1786,-460,-25.76,1219
2021-05-08,691,1225,-534,-43.59,1219
2021-05-09,452,1103,-651,-59.02,1219
2021-05-10,1369,1882,-513,-27.26,1219
2021-05-11,1429,1914,-485,-25.34,1219
2021-05-12,1429,1913,-484,-25.3,1219
2021-05-13,1429,1913,-484,-25.3,1219
2021-05-14,1326,1789,-463,-25.88,1219
2021-05-15,691,1230,-539,-43.82,1219
2021-05-16,452,1110,-658,-59.28,1219
2021-05-17,1369,1890,-521,-27.57,1219
2021-05-18,1429,1923,-494,-25.69,1219
2021-05-19,1429,1923,-494,-25.69,1219
2021-05-20,1429,1924,-495,-25.73,1219
2021-05-21,1326,1800,-474,-26.33,1219
2021-05-22,691,1242,-551,-44.36,1219
2021-05-23,452,1121,-669,-59.68,1219
2021-05-24,1369,1901,-532,-27.99,1219
2021-05-25,1429,1932,-503,-26.04,1219
2021-05-26,1429,1931,-502,-26.0,1219
2021-05-27,1429,1930,-501,-25.96,1219
2021-05-28,1326,1805,-479,-26.54,1219
2021-05-29,691,1244,-553,-44.45,1219
2021-05-30,452,1122,-670,-59.71,1219
2021-05-31,1369,1899,-530,-27.91,1219
2021-07-01,1179,1992,-813,-40.81,1219
2021-07-02,1059,1875,-816,-43.52,1219
2021-07-03,589,1322,-733,-55.45,1219
2021-07-04,469,1208,-739,-61.18,1219
2021-07-05,1172,1993,-821,-41.19,1219
2021-07-06,1179,2031,-852,-41.95,1219
2021-07-07,1179,2036,-857,-42.09,1219
2021-07-08,1179,2040,-861,-42.21,1219
2021-07-09,1059,1920,-861,-44.84,1219
2021-07-10,589,1364,-775,-56.82,1219
2021-07-11,469,1246,-777,-62.36,1219
2021-07-12,1172,2028,-856,-42.21,1219
2021-07-13,1179,2062,-883,-42.82,1219
2021-07-14,1179,2062,-883,-42.82,1219
2021-07-15,1179,2063,-884,-42.85,1219
2021-07-16,1059,1938,-879,-45.36,1219
2021-07-17,589,1378,-789,-57.26,1219
2021-07-18,469,1255,-786,-62.63,1219
2021-07-19,1172,2033,-861,-42.35,1219
2021-07-20,1179,2062,-883,-42.82,1219
2021-07-21,1179,2059,-880,-42.74,1219
2021-07-22,1179,2056,-877,-42.66,1219
2021-07-23,1059,1928,-869,-45.07,1219
2021-07-24,589,1365,-776,-56.85,1219
2021-07-25,469,1240,-771,-62.18,1219
2021-07-26,1172,2016,-844,-41.87,1219
2021-07-27,1179,2044,-865,-42.32,1219
2021-07-28,1179,2040,-861,-42.21,1219
2021-07-29,1179,2036,-857,-42.09,1219
2021-07-30,1059,1908,-849,-44.5,1219
2021-07-31,589,1345,-756,-56.21,1219
2021-08-01,469,1221,-752,-61.59,1219
2021-08-02,1131,1998,-867,-43.39,1219
2021-08-03,1102,2028,-926,-45.66,1219
2021-08-04,1102,2025,-923,-45.58,1219
2021-08-05,1102,2023,-921,-45.53,1219
2021-08-06,1032,1898,-866,-45.63,1219
2021-08-07,592,1337,-745,-55.72,1219
2021-08-08,469,1216,-747,-61.43,1219
2021-08-09,1131,1995,-864,-43.31,1219
2021-08-10,1102,2026,-924,-45.61,1219
2021-08-11,1102,2026,-924,-45.61,1219
2021-08-12,1102,2026,-924,-45.61,1219
2021-08-13,1032,1901,-869,-45.71,1219
2021-08-14,592,1342,-750,-55.89,1219
2021-08-15,469,1221,-752,-61.59,1219
2021-08-16,1131,2000,-869,-43.45,1219
2021-08-17,1102,2032,-930,-45.77,1219
2021-08-18,1102,2031,-929,-45.74,1219
2021-08-19,1102,2029,-927,-45.69,1219
2021-08-20,1032,1904,-872,-45.8,1219
2021-08-21,592,1342,-750,-55.89,1219
2021-08-22,469,1219,-750,-61.53,1219
2021-08-23,1131,1996,-865,-43.34,1219
2021-08-24,1102,2025,-923,-45.58,1219
2021-08-25,1102,2020,-918,-45.45,1219
2021-08-26,1102,2016,-914,-45.34,1219
2021-08-27,1032,1887,-855,-45.31,1219
2021-08-28,592,1322,-730,-55.22,1219
2021-08-29,469,1196,-727,-60.79,1219
2021-08-30,1131,1969,-838,-42.56,1219
2021-08-31,1102,1995,-893,-44.76,1219
2021-09-01,1288,1988,-700,-35.21,1219
2021-09-02,1288,1981,-693,-34.98,1219
2021-09-03,1150,1850,-700,-37.84,1219
2021-09-04,642,1283,-641,-49.96,1219
2021-09-05,500,1155,-655,-56.71,1219
2021-09-06,1267,1928,-661,-34.28,1219
2021-09-07,1288,1954,-666,-34.08,1219
2021-09-08,1288,1947,-659,-33.85,1219
2021-09-09,1288,1941,-653,-33.64,1219
2021-09-10,1150,1812,-662,-36.53,1219
2021-09-11,642,1247,-605,-48.52,1219
2021-09-12,500,1122,-622,-55.44,1219
2021-09-13,1267,1899,-632,-33.28,1219
2021-09-14,1288,1928,-640,-33.2,1219
2021-09-15,1288,1925,-637,-33.09,1219
2021-09-16,1288,1924,-636,-33.06,1219
2021-09-17,1150,1799,-649,-36.08,1219
2021-09-18,642,1240,-598,-48.23,1219
2021-09-19,500,1120,-620,-55.36,1219
2021-09-20,1267,1901,-634,-33.35,1219
2021-09-21,1288,1935,-647,-33.44,1219
2021-09-22,1288,1938,-650,-33.54,1219
2021-09-23,1288,1941,-653,-33.64,1219
2021-09-24,1150,1820,-670,-36.81,1219
2021-09-25,642,1265,-623,-49.25,1219
2021-09-26,500,1148,-648,-56.45,1219
2021-09-27,1267,1933,-666,-34.45,1219
2021-09-28,1288,1969,-681,-34.59,1219
2021-09-29,1288,1973,-685,-34.72,1219
2021-09-30,1288,1978,-690,-34.88,1219
2021-10-01,1172,1858,-686,-36.92,1219
2021-10-02,662,1302,-640,-49.16,1219
2021-10-03,498,1185,-687,-57.97,1219
2021-10-04,1278,1968,-690,-35.06,1219
2021-10-05,1322,2003,-681,-34.0,1219
2021-10-06,1322,2004,-682,-34.03,1219
2021-10-07,1322,2006,-684,-34.1,1219
2021-10-08,1172,1883,-711,-37.76,1219
2021-10-09,662,1325,-663,-50.04,1219
2021-10-10,498,1204,-706,-58.64,1219
2021-10-11,1278,1983,-705,-35.55,1219
2021-10-12,1322,2014,-692,-34.36,1219
2021-10-13,1322,2013,-691,-34.33,1219
2021-10-14,1322,2011,-689,-34.26,1219
2021-10-15,1172,1885,-713,-37.82,1219
2021-10-16,662,1324,-662,-50.0,1219
2021-10-17,498,1201,-703,-58.53,1219
2021-10-18,1278,1978,-700,-35.39,1219
2021-10-19,1322,2008,-686,-34.16,1219
2021-10-20,1322,2005,-683,-34.06,1219
2021-10-21,1322,2003,-681,-34.0,1219
2021-10-22,1172,1877,-705,-37.56,1219
2021-10-23,662,1316,-654,-49.7,1219
2021-10-24,498,1193,-695,-58.26,1219
2021-10-25,1278,1972,-694,-35.19,1219
2021-10-26,1322,2003,-681,-34.0,1219
2021-10-27,1322,2003,-681,-34.0,1219
2021-10-28,1322,2003,-681,-34.0,1219
2021-10-29,1172,1879,-707,-37.63,1219
2021-10-30,662,1320,-658,-49.85,1219
2021-10-31,498,1201,-703,-58.53,1219
2021-11-01,1265,1982,-717,-36.18,1219
2021-11-02,1305,2015,-710,-35.24,1219
2021-11-03,1305,2017,-712,-35.3,1219
2021-11-04,1305,2018,-713,-35.33,1219
2021-11-05,1165,1896,-731,-38.55,1219
2021-11-06,660,1338,-678,-50.67,1219
2021-11-07,493,1219,-726,-59.56,1219
2021-11-08,1265,2000,-735,-36.75,1219
2021-11-09,1305,2033,-728,-35.81,1219
2021-11-10,1305,2034,-729,-35.84,1219
2021-11-11,1305,2034,-729,-35.84,1219
2021-11-12,1165,1910,-745,-39.01,1219
2021-11-13,660,1350,-690,-51.11,1219
2021-11-14,493,1228,-735,-59.85,1219
2021-11-15,1265,2006,-741,-36.94,1219
2021-11-16,1305,2035,-730,-35.87,1219
2021-11-17,1305,2032,-727,-35.78,1219
2021-11-18,1305,2028,-723,-35.65,1219
2021-11-19,1165,1900,-735,-38.68,1219
2021-11-20,660,1336,-676,-50.6,1219
2021-11-21,493,1209,-716,-59.22,1219
2021-11-22,1265,1984,-719,-36.24,1219
2021-11-23,1305,2010,-705,-35.07,1219
2021-11-24,1305,2003,-698,-34.85,1219
2021-11-25,1305,1996,-691,-34.62,1219
2021-11-26,1165,1866,-701,-37.57,1219
2021-11-27,660,1299,-639,-49.19,1219
2021-11-28,493,1172,-679,-57.94,1219
2021-11-29,1265,1945,-680,-34.96,1219
2021-11-30,1305,1971,-666,-33.79,1219
2021-12-01,1106,1964,-858,-43.69,1219
2021-12-02,1106,1958,-852,-43.51,1219
2021-12-03,918,1828,-910,-49.78,1219
2021-12-04,643,1264,-621,-49.13,1219
2021-12-05,455,1138,-683,-60.02,1219
2021-12-06,1180,1913,-733,-38.32,1219
2021-12-07,1106,1941,-835,-43.02,1219
2021-12-08,1106,1937,-831,-42.9,1219
2021-12-09,1106,1934,-828,-42.81,1219
2021-12-10,918,1807,-889,-49.2,1219
2021-12-11,643,1245,-602,-48.35,1219
2021-12-12,455,1122,-667,-59.45,1219
2021-12-13,1180,1900,-720,-37.89,1219
2021-12-14,1106,1930,-824,-42.69,1219
2021-12-15,1106,1928,-822,-42.63,1219
2021-12-16,1106,1926,-820,-42.58,1219
2021-12-17,918,1800,-882,-49.0,1219
2021-12-18,643,1239,-596,-48.1,1219
2021-12-19,455,1116,-661,-59.23,1219
2021-12-20,1180,1893,-713,-37.67,1219
2021-12-21,1106,1923,-817,-42.49,1219
2021-12-22,1106,1920,-814,-42.4,1219
2021-12-23,1106,1917,-811,-42.31,1219
2021-12-24,918,1789,-871,-48.69,1219
2021-12-25,643,1226,-583,-47.55,1219
2021-12-26,455,1101,-646,-58.67,1219
2021-12-27,1180,1876,-696,-37.1,1219
2021-12-28,1106,1904,-798,-41.91,1219
2021-12-29,1106,1898,-792,-41.73,1219
2021-12-30,1106,1893,-787,-41.57,1219
2021-12-31,918,1764,-846,-47.96,1219
2022-01-01,612,1199,-587,-48.96,1219
2022-01-02,458,1073,-615,-57.32,1219
2022-01-03,1068,1847,-779,-42.18,1219
2022-01-04,1077,1874,-797,-42.53,1219
2022-01-05,1077,1869,-792,-42.38,1219
2022-01-06,1077,1864,-787,-42.22,1219
2022-01-07,976,1735,-759,-43.75,1219
2022-01-08,612,1172,-560,-47.78,1219
2022-01-09,458,1047,-589,-56.26,1219
2022-01-10,1068,1824,-756,-41.45,1219
2022-01-11,1077,1853,-776,-41.88,1219
2022-01-12,1077,1850,-773,-41.78,1219
2022-01-13,1077,1848,-771,-41.72,1219
2022-01-14,976,1723,-747,-43.35,1219
2022-01-15,612,1163,-551,-47.38,1219
2022-01-16,458,1042,-584,-56.05,1219
2022-01-17,1068,1822,-754,-41.38,1219
2022-01-18,1077,1854,-777,-41.91,1219
2022-01-19,1077,1855,-778,-41.94,1219
2022-01-20,1077,1856,-779,-41.97,1219
2022-01-21,976,1734,-758,-43.71,1219
2022-01-22,612,1176,-564,-47.96,1219
2022-01-23,458,1057,-599,-56.67,1219
2022-01-24,1068,1838,-770,-41.89,1219
2022-01-25,1077,1872,-795,-42.47,1219
2022-01-26,1077,1874,-797,-42.53,1219
2022-01-27,1077,1875,-798,-42.56,1219
2022-01-28,976,1753,-777,-44.32,1219
2022-01-29,612,1195,-583,-48.79,1219
2022-01-30,458,1076,-618,-57.43,1219
2020-02-01,297,144,153,106.25,1089
2020-02-02,176,33,143,433.33,1089
2020-02-03,808,787,21,2.67,1089
2020-02-04,845,805,40,4.97,1089
2020-02-05,845,804,41,5.1,1089
2020-02-06,845,802,43,5.36,1089
2020-02-07,756,689,67,9.72,1089
2020-02-08,297,134,163,121.64,1089
2020-02-09,176,27,149,551.85,1089
2020-02-10,808,774,34,4.39,1089
2020-02-11,845,792,53,6.69,1089
2020-02-12,845,791,54,6.83,1089
2020-02-13,845,791,54,6.83,1089
2020-02-14,756,680,76,11.18,1089
2020-02-15,297,127,170,133.86,1089
2020-02-16,176,25,151,604.0,1089
2020-02-17,808,774,34,4.39,1089
2020-02-18,845,796,49,6.16,1089
2020-02-19,845,800,45,5.62,1089
2020-02-20,845,805,40,4.97,1089
2020-02-21,756,698,58,8.31,1089
2020-02-22,297,150,147,98.0,1089
2020-02-23,176,2,174,8700.0,1089
2020-02-24,808,806,2,0.25,1089
2020-02-25,845,832,13,1.56,1089
2020-02-26,845,840,5,0.6,1089
2020-02-27,845,848,-3,-0.35,1089
2020-02-28,756,744,12,1.61,1089
2020-02-29,297,198,99,50.0,1089
2020-03-01,134,51,83,162.75,1089
2020-03-02,684,856,-172,-20.09,1089
2020-03-03,689,882,-193,-21.88,1089
2020-03-04,689,889,-200,-22.5,1089
2020-03-05,689,895,-206,-23.02,1089
2020-03-06,635,789,-154,-19.52,1089
2020-03-07,237,240,-3,-1.25,1089
2020-03-08,134,91,43,47.25,1089
2020-03-09,684,892,-208,-23.32,1089
2020-03-10,689,915,-226,-24.7,1089
2020-03-11,689,918,-229,-24.95,1089
2020-03-12,689,920,-231,-25.11,1089
2020-03-13,635,810,-175,-21.6,1089
2020-03-14,237,257,-20,-7.78,1089
2020-03-15,134,104,30,28.85,1089
2020-03-16,684,902,-218,-24.17,1089
2020-03-17,689,921,-232,-25.19,1089
2020-03-18,689,921,-232,-25.19,1089
2020-03-19,689,922,-233,-25.27,1089
2020-03-20,635,810,-175,-21.6,1089
2020-03-21,237,256,-19,-7.42,1089
2020-03-22,134,102,32,31.37,1089
2020-03-23,684,900,-216,-24.0,1089
2020-03-24,689,920,-231,-25.11,1089
2020-03-25,689,921,-232,-25.19,1089
2020-03-26,689,923,-234,-25.35,1089
2020-03-27,635,813,-178,-21.89,1089
2020-03-28,237,261,-24,-9.2,1089
2020-03-29,134,110,24,21.82,1089
2020-03-30,684,910,-226,-24.84,1089
2020-03-31,689,932,-243,-26.07,1089
2020-04-01,656,935,-279,-29.84,1089
2020-04-02,656,939,-283,-30.14,1089
2020-04-03,513,831,-318,-38.27,1089
2020-04-04,204,281,-77,-27.4,1089
2020-04-05,87,130,-43,-33.08,1089
2020-04-06,680,931,-251,-26.96,1089
2020-04-07,656,954,-298,-31.24,1089
2020-04-08,656,957,-301,-31.45,1089
2020-04-09,656,961,-305,-31.74,1089
2020-04-10,513,852,-339,-39.79,1089
2020-04-11,204,300,-96,-32.0,1089
2020-04-12,87,148,-61,-41.22,1089
2020-04-13,680,947,-267,-28.19,1089
2020-04-14,656,968,-312,-32.23,1089
2020-04-15,656,969,-313,-32.3,1089
2020-04-16,656,970,-314,-32.37,1089
2020-04-17,513,858,-345,-40.21,1089
2020-04-18,204,304,-100,-32.89,1089
2020-04-19,87,150,-63,-42.0,1089
2020-04-20,680,947,-267,-28.19,1089
2020-04-21,656,966,-310,-32.09,1089
2020-04-22,656,965,-309,-32.02,1089
2020-04-23,656,964,-308,-31.95,1089
2020-04-24,513,852,-339,-39.79,1089
2020-04-25,204,297,-93,-31.31,1089
2020-04-26,87,143,-56,-39.16,1089
2020-04-27,680,939,-259,-27.58,1089
2020-04-28,656,958,-302,-31.52,1089
2020-04-29,656,958,-302,-31.52,1089
2020-04-30,656,959,-303,-31.6,1089
2020-05-01,693,847,-154,-18.18,1089
2020-05-02,274,294,-20,-6.8,1089
2020-05-03,138,141,-3,-2.13,1089
2020-05-04,783,939,-156,-16.61,1089
2020-05-05,836,959,-123,-12.83,1089
2020-05-06,836,961,-125,-13.01,1089
2020-05-07,836,962,-126,-13.1,1089
2020-05-08,693,852,-159,-18.66,1089
2020-05-09,274,300,-26,-8.67,1089
2020-05-10,138,147,-9,-6.12,1089
2020-05-11,783,946,-163,-17.23,1089
2020-05-12,836,966,-130,-13.46,1089
2020-05-13,836,967,-131,-13.55,1089
2020-05-14,836,969,-133,-13.73,1089
2020-05-15,693,858,-165,-19.23,1089
2020-05-16,274,304,-30,-9.87,1089
2020-05-17,138,151,-13,-8.61,1089
2020-05-18,783,948,-165,-17.41,1089
2020-05-19,836,967,-131,-13.55,1089
2020-05-20,836,967,-131,-13.55,1089
2020-05-21,836,967,-131,-13.55,1089
2020-05-22,693,855,-162,-18.95,1089
2020-05-23,274,300,-26,-8.67,1089
2020-05-24,138,146,-8,-5.48,1089
2020-05-25,783,943,-160,-16.97,1089
2020-05-26,836,962,-126,-13.1,1089
2020-05-27,836,962,-126,-13.1,1089
2020-05-28,836,962,-126,-13.1,1089
2020-05-29,693,850,-157,-18.47,1089
2020-05-30,274,297,-23,-7.74,1089
2020-05-31,138,144,-6,-4.17,1089
2020-06-01,873,943,-70,-7.42,1089
2020-06-02,897,964,-67,-6.95,1089
2020-06-03,897,966,-69,-7.14,1089
2020-06-04,897,968,-71,-7.33,1089
2020-06-05,770,859,-89,-10.36,1089
2020-06-06,306,308,-2,-0.65,1089
2020-06-07,182,156,26,16.67,1089
2020-06-08,873,957,-84,-8.78,1089
2020-06-09,897,979,-82,-8.38,1089
2020-06-10,897,982,-85,-8.66,1089
2020-06-11,897,984,-87,-8.84,1089
2020-06-12,770,875,-105,-12.0,1089
2020-06-13,306,323,-17,-5.26,1089
2020-06-14,182,171,11,6.43,1089
2020-06-15,873,969,-96,-9.91,1089
2020-06-16,897,988,-91,-9.21,1089
2020-06-17,897,988,-91,-9.21,1089
2020-06-18,897,987,-90,-9.12,1089
2020-06-19,770,873,-103,-11.8,1089
2020-06-20,306,316,-10,-3.16,1089
2020-06-21,182,158,24,15.19,1089
2020-06-22,873,950,-77,-8.11,1089
2020-06-23,897,964,-67,-6.95,1089
2020-06-24,897,957,-60,-6.27,1089
2020-06-25,897,950,-53,-5.58,1089
2020-06-26,770,830,-60,-7.23,1089
2020-06-27,306,268,38,14.18,1089
2020-06-28,182,105,77,73.33,1089
2020-06-29,873,893,-20,-2.24,1089
2020-06-30,897,903,-6,-0.66,1089
2020-07-01,1062,893,169,18.92,1089
2020-07-02,1062,884,178,20.14,1089
2020-07-03,913,762,151,19.82,1089
2020-07-04,435,199,236,118.59,1089
2020-07-05,392,37,355,959.46,1089
2020-07-06,1056,826,230,27.85,1089
2020-07-07,1062,838,224,26.73,1089
2020-07-08,1062,831,231,27.8,1089
2020-07-09,1062,825,237,28.73,1089
2020-07-10,913,709,204,28.77,1089
2020-07-11,435,151,284,188.08,1089
2020-07-12,392,33,359,1087.88,1089
2020-07-13,1056,789,267,33.84,1089
2020-07-14,1062,807,255,31.6,1089
2020-07-15,1062,806,256,31.76,1089
2020-07-16,1062,807,255,31.6,1089
2020-07-17,913,696,217,31.18,1089
2020-07-18,435,143,292,204.2,1089
2020-07-19,392,34,358,1052.94,1089
2020-07-20,1056,791,265,33.5,1089
2020-07-21,1062,812,250,30.79,1089
2020-07-22,1062,815,247,30.31,1089
2020-07-23,1062,817,245,29.99,1089
2020-07-24,913,707,206,29.14,1089
2020-07-25,435,156,279,178.85,1089
2020-07-26,392,3,389,12966.67,1089
2020-07-27,1056,801,255,31.84,1089
2020-07-28,1062,821,241,29.35,1089
2020-07-29,1062,821,241,29.35,1089
2020-07-30,1062,820,242,29.51,1089
2020-07-31,913,707,206,29.14,1089
2020-08-01,294,151,143,94.7,1089
2020-08-02,180,36,144,400.0,1089
2020-08-03,740,788,-48,-6.09,1089
2020-08-04,811,804,7,0.87,1089
2020-08-05,811,800,11,1.38,1089
2020-08-06,811,796,15,1.88,1089
2020-08-07,701,680,21,3.09,1089
2020-08-08,294,122,172,140.98,1089
2020-08-09,180,22,158,718.18,1089
2020-08-10,740,757,-17,-2.25,1089
2020-08-11,811,772,39,5.05,1089
2020-08-12,811,769,42,5.46,1089
2020-08-13,811,767,44,5.74,1089
2020-08-14,701,653,48,7.35,1089
2020-08-15,294,99,195,196.97,1089
2020-08-16,180,10,170,1700.0,1089
2020-08-17,740,742,-2,-0.27,1089
2020-08-18,811,763,48,6.29,1089
2020-08-19,811,766,45,5.87,1089
2020-08-20,811,770,41,5.32,1089
2020-08-21,701,662,39,5.89,1089
2020-08-22,294,114,180,157.89,1089
2020-08-23,180,20,160,800.0,1089
2020-08-24,740,769,-29,-3.77,1089
2020-08-25,811,796,15,1.88,1089
2020-08-26,811,803,8,1.0,1089
2020-08-27,811,812,-1,-0.12,1089
2020-08-28,701,708,-7,-0.99,1089
2020-08-29,294,162,132,81.48,1089
2020-08-30,180,17,163,958.82,1089
2020-08-31,740,822,-82,-9.98,1089
2020-09-01,925,849,76,8.95,1089
2020-09-02,925,856,69,8.06,1089
2020-09-03,925,863,62,7.18,1089
2020-09-04,791,758,33,4.35,1089
2020-09-05,327,210,117,55.71,1089
2020-09-06,203,61,142,232.79,1089
2020-09-07,926,862,64,7.42,1089
2020-09-08,925,885,40,4.52,1089
2020-09-09,925,888,37,4.17,1089
2020-09-10,925,891,34,3.82,1089
2020-09-11,791,781,10,1.28,1089
2020-09-12,327,228,99,43.42,1089
2020-09-13,203,75,128,170.67,1089
2020-09-14,926,873,53,6.07,1089
2020-09-15,925,892,33,3.7,1089
2020-09-16,925,892,33,3.7,1089
2020-09-17,925,892,33,3.7,1089
2020-09-18,791,780,11,1.41,1089
2020-09-19,327,227,100,44.05,1089
2020-09-20,203,73,130,178.08,1089
2020-09-21,926,871,55,6.31,1089
2020-09-22,925,890,35,3.93,1089
2020-09-23,925,892,33,3.7,1089
2020-09-24,925,893,32,3.58,1089
2020-09-25,791,783,8,1.02,1089
2020-09-26,327,232,95,40.95,1089
2020-09-27,203,80,123,153.75,1089
2020-09-28,926,881,45,5.11,1089
2020-09-29,925,903,22,2.44,1089
2020-09-30,925,907,18,1.98,1089
2020-10-01,918,910,8,0.88,1089
2020-10-02,759,802,-43,-5.36,1089
2020-10-03,324,252,72,28.57,1089
2020-10-04,169,102,67,65.69,1089
2020-10-05,883,903,-20,-2.21,1089
2020-10-06,918,926,-8,-0.86,1089
2020-10-07,918,929,-11,-1.18,1089
2020-10-08,918,932,-14,-1.5,1089
2020-10-09,759,823,-64,-7.78,1089
2020-10-10,324,271,53,19.56,1089
2020-10-11,169,119,50,42.02,1089
2020-10-12,883,917,-34,-3.71,1089
2020-10-13,918,937,-19,-2.03,1089
2020-10-14,918,938,-20,-2.13,1089
2020-10-15,918,938,-20,-2.13,1089
2020-10-16,759,825,-66,-8.0,1089
2020-10-17,324,271,53,19.56,1089
2020-10-18,169,115,54,46.96,1089
2020-10-19,883,911,-28,-3.07,1089
2020-10-20,918,929,-11,-1.18,1089
2020-10-21,918,928,-10,-1.08,1089
2020-10-22,918,926,-8,-0.86,1089
2020-10-23,759,813,-54,-6.64,1089
2020-10-24,324,258,66,25.58,1089
2020-10-25,169,103,66,64.08,1089
2020-10-26,883,900,-17,-1.89,1089
2020-10-27,918,919,-1,-0.11,1089
2020-10-28,918,919,-1,-0.11,1089
2020-10-29,918,920,-2,-0.22,1089
2020-10-30,759,809,-50,-6.18,1089
2020-10-31,324,256,68,26.56,1089
2020-11-01,169,104,65,62.5,1089
2020-11-02,875,903,-28,-3.1,1089
2020-11-03,836,925,-89,-9.62,1089
2020-11-04,836,927,-91,-9.82,1089
2020-11-05,836,930,-94,-10.11,1089
2020-11-06,730,821,-91,-11.08,1089
2020-11-07,304,270,34,12.59,1089
2020-11-08,169,119,50,42.02,1089
2020-11-09,875,918,-43,-4.68,1089
2020-11-10,836,940,-104,-11.06,1089
2020-11-11,836,942,-106,-11.25,1089
2020-11-12,836,943,-107,-11.35,1089
2020-11-13,730,832,-102,-12.26,1089
2020-11-14,304,279,25,8.96,1089
2020-11-15,169,125,44,35.2,1089
2020-11-16,875,921,-46,-4.99,1089
2020-11-17,836,939,-103,-10.97,1089
2020-11-18,836,937,-101,-10.78,1089
2020-11-19,836,934,-98,-10.49,1089
2020-11-20,730,819,-89,-10.87,1089
2020-11-21,304,261,43,16.48,1089
2020-11-22,169,103,66,64.08,1089
2020-11-23,875,895,-20,-2.23,1089
2020-11-24,836,909,-73,-8.03,1089
2020-11-25,836,904,-68,-7.52,1089
2020-11-26,836,899,-63,-7.01,1089
2020-11-27,730,781,-51,-6.53,1089
2020-11-28,304,222,82,36.94,1089
2020-11-29,169,63,106,168.25,1089
2020-11-30,875,855,20,2.34,1089
2020-12-01,754,870,-116,-13.33,1089
2020-12-02,754,865,-111,-12.83,1089
2020-12-03,754,862,-108,-12.53,1089
2020-12-04,796,746,50,6.7,1089
2020-12-05,324,189,135,71.43,1089
2020-12-06,170,33,137,415.15,1089
2020-12-07,739,828,-89,-10.75,1089
2020-12-08,754,846,-92,-10.87,1089
2020-12-09,754,845,-91,-10.77,1089
2020-12-10,754,844,-90,-10.66,1089
2020-12-11,796,731,65,8.89,1089
2020-12-12,324,177,147,83.05,1089
2020-12-13,170,23,147,639.13,1089
2020-12-14,739,820,-81,-9.88,1089
2020-12-15,754,839,-85,-10.13,1089
2020-12-16,754,838,-84,-10.02,1089
2020-12-17,754,838,-84,-10.02,1089
2020-12-18,796,724,72,9.94,1089
2020-12-19,324,169,155,91.72,1089
2020-12-20,170,13,157,1207.69,1089
2020-12-21,739,807,-68,-8.43,1089
2020-12-22,754,823,-69,-8.38,1089
2020-12-23,754,819,-65,-7.94,1089
2020-12-24,754,815,-61,-7.48,1089
2020-12-25,796,698,98,14.04,1089
2020-12-26,324,138,186,134.78,1089
2020-12-27,170,29,141,486.21,1089
2020-12-28,739,769,-30,-3.9,1089
2020-12-29,754,781,-27,-3.46,1089
2020-12-30,754,774,-20,-2.58,1089
2020-12-31,754,766,-12,-1.57,1089
2021-01-01,652,647,5,0.77,1089
2021-01-02,273,85,188,221.18,1089
2021-01-03,166,1,165,16500.0,1089
2021-01-04,718,714,4,0.56,1089
2021-01-05,746,727,19,2.61,1089
2021-01-06,746,720,26,3.61,1089
2021-01-07,746,715,31,4.34,1089
2021-01-08,652,598,54,9.03,1089
2021-01-09,273,40,233,582.5,1089
2021-01-10,166,40,126,315.0,1089
2021-01-11,718,676,42,6.21,1089
2021-01-12,746,693,53,7.65,1089
2021-01-13,746,692,54,7.8,1089
2021-01-14,746,692,54,7.8,1089
2021-01-15,652,580,72,12.41,1089
2021-01-16,273,27,246,911.11,1089
2021-01-17,166,27,139,514.81,1089
2021-01-18,718,674,44,6.53,1089
2021-01-19,746,695,51,7.34,1089
2021-01-20,746,698,48,6.88,1089
2021-01-21,746,701,45,6.42,1089
2021-01-22,652,592,60,10.14,1089
2021-01-23,273,41,232,565.85,1089
2021-01-24,166,41,125,304.88,1089
2021-01-25,718,690,28,4.06,1089
2021-01-26,746,712,34,4.78,1089
2021-01-27,746,714,32,4.48,1089
2021-01-28,746,715,31,4.34,1089
2021-01-29,652,605,47,7.77,1089
2021-01-30,273,52,221,425.0,1089
2021-01-31,166,52,114,219.23,1089
2021-02-01,852,695,157,22.59,1089
2021-02-02,861,714,147,20.59,1089
2021-02-03,861,713,148,20.76,1089
2021-02-04,861,712,149,20.93,1089
2021-02-05,724,599,125,20.87,1089
2021-02-06,283,43,240,558.14,1089
2021-02-07,159,43,116,269.77,1089
2021-02-08,852,683,169,24.74,1089
2021-02-09,861,701,160,22.82,1089
2021-02-10,861,700,161,23.0,1089
2021-02-11,861,699,162,23.18,1089
2021-02-12,724,587,137,23.34,1089
2021-02-13,283,33,250,757.58,1089
2021-02-14,159,33,126,381.82,1089
2021-02-15,852,679,173,25.48,1089
2021-02-16,861,700,161,23.0,1089
2021-02-17,861,703,158,22.48,1089
2021-02-18,861,707,154,21.78,1089
2021-02-19,724,599,125,20.87,1089
2021-02-20,283,50,233,466.0,1089
2021-02-21,159,50,109,218.0,1089
2021-02-22,852,705,147,20.85,1089
2021-02-23,861,731,130,17.78,1089
2021-02-24,861,738,123,16.67,1089
2021-02-25,861,746,115,15.42,1089
2021-02-26,724,641,83,12.95,1089
2021-02-27,283,95,188,197.89,1089
2021-02-28,159,13,146,1123.08,1089
2021-03-01,946,754,192,25.46,1089
2021-03-02,898,781,117,14.98,1089
2021-03-03,898,788,110,13.96,1089
2021-03-04,898,795,103,12.96,1089
2021-03-05,798,689,109,15.82,1089
2021-03-06,341,141,200,141.84,1089
2021-03-07,168,35,133,380.0,1089
2021-03-08,946,795,151,18.99,1089
2021-03-09,898,818,80,9.78,1089
2021-03-10,898,822,76,9.25,1089
2021-03-11,898,825,73,8.85,1089
2021-03-12,798,715,83,11.61,1089
2021-03-13,341,163,178,109.2,1089
2021-03-14,168,10,158,1580.0,1089
2021-03-15,946,809,137,16.93,1089
2021-03-16,898,828,70,8.45,1089
2021-03-17,898,829,69,8.32,1089
2021-03-18,898,829,69,8.32,1089
2021-03-19,798,717,81,11.3,1089
2021-03-20,341,164,177,107.93,1089
2021-03-21,168,10,158,1580.0,1089
2021-03-22,946,807,139,17.22,1089
2021-03-23,898,827,71,8.59,1089
2021-03-24,898,828,70,8.45,1089
2021-03-25,898,829,69,8.32,1089
2021-03-26,798,718,80,11.14,1089
2021-03-27,341,166,175,105.42,1089
2021-03-28,168,14,154,1100.0,1089
2021-03-29,946,814,132,16.22,1089
2021-03-30,898,836,62,7.42,1089
2021-03-31,898,839,59,7.03,1089
2021-04-01,864,842,22,2.61,1089
2021-04-02,783,734,49,6.68,1089
2021-04-03,276,184,92,50.0,1089
2021-04-04,145,33,112,339.39,1089
2021-04-05,855,834,21,2.52,1089
2021-04-06,864,857,7,0.82,1089
2021-04-07,864,861,3,0.35,1089
2021-04-08,864,864,0,0.0,1089
2021-04-09,783,756,27,3.57,1089
2021-04-10,276,205,71,34.63,1089
2021-04-11,145,53,92,173.58,1089
2021-04-12,855,853,2,0.23,1089
2021-04-13,864,874,-10,-1.14,1089
2021-04-14,864,875,-11,-1.26,1089
2021-04-15,864,876,-12,-1.37,1089
2021-04-16,783,765,18,2.35,1089
2021-04-17,276,212,64,30.19,1089
2021-04-18,145,58,87,150.0,1089
2021-04-19,855,855,0,0.0,1089
2021-04-20,864,874,-10,-1.14,1089
2021-04-21,864,873,-9,-1.03,1089
2021-04-22,864,873,-9,-1.03,1089
2021-04-23,783,760,23,3.03,1089
2021-04-24,276,206,70,33.98,1089
2021-04-25,145,51,94,184.31,1089
2021-04-26,855,848,7,0.83,1089
2021-04-27,864,866,-2,-0.23,1089
2021-04-28,864,866,-2,-0.23,1089
2021-04-29,864,866,-2,-0.23,1089
2021-04-30,783,754,29,3.85,1089
2021-05-01,299,201,98,48.76,1089
2021-05-02,162,47,115,244.68,1089
2021-05-03,986,845,141,16.69,1089
2021-05-04,986,865,121,13.99,1089
2021-05-05,986,867,119,13.73,1089
2021-05-06,986,868,118,13.59,1089
2021-05-07,799,758,41,5.41,1089
2021-05-08,299,205,94,45.85,1089
2021-05-09,162,53,109,205.66,1089
2021-05-10,986,852,134,15.73,1089
2021-05-11,986,872,114,13.07,1089
2021-05-12,986,874,112,12.81,1089
2021-05-13,986,875,111,12.69,1089
2021-05-14,799,764,35,4.58,1089
2021-05-15,299,211,88,41.71,1089
2021-05-16,162,58,104,179.31,1089
2021-05-17,986,855,131,15.32,1089
2021-05-18,986,875,111,12.69,1089
2021-05-19,986,875,111,12.69,1089
2021-05-20,986,875,111,12.69,1089
2021-05-21,799,763,36,4.72,1089
2021-05-22,299,209,90,43.06,1089
2021-05-23,162,54,108,200.0,1089
2021-05-24,986,851,135,15.86,1089
2021-05-25,986,870,116,13.33,1089
2021-05-26,986,869,117,13.46,1089
2021-05-27,986,869,117,13.46,1089
2021-05-28,799,758,41,5.41,1089
2021-05-29,299,204,95,46.57,1089
2021-05-30,162,51,111,217.65,1089
2021-05-31,986,849,137,16.14,1089
2021-06-01,1031,869,162,18.64,1089
2021-06-02,1031,871,160,18.37,1089
2021-06-03,1031,873,158,18.1,1089
2021-06-04,804,763,41,5.37,1089
2021-06-05,324,212,112,52.83,1089
2021-06-06,196,60,136,226.67,1089
2021-06-07,961,861,100,11.61,1089
2021-06-08,1031,883,148,16.76,1089
2021-06-09,1031,886,145,16.37,1089
2021-06-10,1031,889,142,15.97,1089
2021-06-11,804,779,25,3.21,1089
2021-06-12,324,228,96,42.11,1089
2021-06-13,196,76,120,157.89,1089
2021-06-14,961,875,86,9.83,1089
2021-06-15,1031,895,136,15.2,1089
2021-06-16,1031,896,135,15.07,1089
2021-06-17,1031,896,135,15.07,1089
2021-06-18,804,783,21,2.68,1089
2021-06-19,324,227,97,42.73,1089
2021-06-20,196,70,126,180.0,1089
2021-06-21,961,864,97,11.23,1089
2021-06-22,1031,878,153,17.43,1089
2021-06-23,1031,873,158,18.1,1089
2021-06-24,1031,867,164,18.92,1089
2021-06-25,804,748,56,7.49,1089
2021-06-26,324,186,138,74.19,1089
2021-06-27,196,24,172,716.67,1089
2021-06-28,961,812,149,18.35,1089
2021-06-29,1031,822,209,25.43,1089
2021-06-30,1031,813,218,26.81,1089
2021-07-01,844,803,41,5.11,1089
2021-07-02,801,682,119,17.45,1089
2021-07-03,437,118,319,270.34,1089
2021-07-04,190,20,170,850.0,1089
2021-07-05,835,744,91,12.23,1089
2021-07-06,844,755,89,11.79,1089
2021-07-07,844,747,97,12.99,1089
2021-07-08,844,740,104,14.05,1089
2021-07-09,801,623,178,28.57,1089
2021-07-10,437,64,373,582.81,1089
2021-07-11,190,64,126,196.88,1089
2021-07-12,835,699,136,19.46,1089
2021-07-13,844,716,128,17.88,1089
2021-07-14,844,715,129,18.04,1089
2021-07-15,844,714,130,18.21,1089
2021-07-16,801,602,199,33.06,1089
2021-07-17,437,49,388,791.84,1089
2021-07-18,190,49,141,287.76,1089
2021-07-19,835,696,139,19.97,1089
2021-07-20,844,717,127,17.71,1089
2021-07-21,844,719,125,17.39,1089
2021-07-22,844,722,122,16.9,1089
2021-07-23,801,612,189,30.88,1089
2021-07-24,437,61,376,616.39,1089
2021-07-25,190,61,129,211.48,1089
2021-07-26,835,708,127,17.94,1089
2021-07-27,844,728,116,15.93,1089
2021-07-28,844,728,116,15.93,1089
2021-07-29,844,729,115,15.78,1089
2021-07-30,801,616,185,30.03,1089
2021-07-31,437,61,376,616.39,1089
2021-08-01,191,61,130,213.11,1089
2021-08-02,800,700,100,14.29,1089
2021-08-03,809,716,93,12.99,1089
2021-08-04,809,712,97,13.62,1089
2021-08-05,809,709,100,14.1,1089
2021-08-06,716,593,123,20.74,1089
2021-08-07,307,35,272,777.14,1089
2021-08-08,191,35,156,445.71,1089
2021-08-09,800,669,131,19.58,1089
2021-08-10,809,684,125,18.27,1089
2021-08-11,809,681,128,18.8,1089
2021-08-12,809,678,131,19.32,1089
2021-08-13,716,563,153,27.18,1089
2021-08-14,307,7,300,4285.71,1089
2021-08-15,191,7,184,2628.57,1089
2021-08-16,800,649,151,23.27,1089
2021-08-17,809,669,140,20.93,1089
2021-08-18,809,670,139,20.75,1089
2021-08-19,809,673,136,20.21,1089
2021-08-20,716,564,152,26.95,1089
2021-08-21,307,15,292,1946.67,1089
2021-08-22,191,15,176,1173.33,1089
2021-08-23,800,669,131,19.58,1089
2021-08-24,809,694,115,16.57,1089
2021-08-25,809,701,108,15.41,1089
2021-08-26,809,709,100,14.1,1089
2021-08-27,716,605,111,18.35,1089
2021-08-28,307,60,247,411.67,1089
2021-08-29,191,60,131,218.33,1089
2021-08-30,800,719,81,11.27,1089
2021-08-31,809,747,62,8.3,1089
2021-09-01,1021,755,266,35.23,1089
2021-09-02,1021,762,259,33.99,1089
2021-09-03,899,657,242,36.83,1089
2021-09-04,347,110,237,215.45,1089
2021-09-05,226,26,200,769.23,1089
2021-09-06,1048,764,284,37.17,1089
2021-09-07,1021,788,233,29.57,1089
2021-09-08,1021,792,229,28.91,1089
2021-09-09,1021,795,226,28.43,1089
2021-09-10,899,686,213,31.05,1089
2021-09-11,347,134,213,158.96,1089
2021-09-12,226,33,193,584.85,1089
2021-09-13,1048,780,268,34.36,1089
2021-09-14,1021,799,222,27.78,1089
2021-09-15,1021,800,221,27.62,1089
2021-09-16,1021,800,221,27.62,1089
2021-09-17,899,688,211,30.67,1089
2021-09-18,347,134,213,158.96,1089
2021-09-19,226,33,193,584.85,1089
2021-09-20,1048,778,270,34.7,1089
2021-09-21,1021,797,224,28.11,1089
2021-09-22,1021,798,223,27.94,1089
2021-09-23,1021,799,222,27.78,1089
2021-09-24,899,689,210,30.48,1089
2021-09-25,347,136,211,155.15,1089
2021-09-26,226,32,194,606.25,1089
2021-09-27,1048,784,264,33.67,1089
2021-09-28,1021,807,214,26.52,1089
2021-09-29,1021,810,211,26.05,1089
2021-09-30,1021,813,208,25.58,1089
2021-10-01,889,705,184,26.1,1089
2021-10-02,580,155,425,274.19,1089
2021-10-03,273,5,268,5360.0,1089
2021-10-04,1006,806,200,24.81,1089
2021-10-05,1083,829,254,30.64,1089
2021-10-06,1083,833,250,30.01,1089
2021-10-07,1083,836,247,29.55,1089
2021-10-08,889,727,162,22.28,1089
2021-10-09,580,176,404,229.55,1089
2021-10-10,273,24,249,1037.5,1089
2021-10-11,1006,823,183,22.24,1089
2021-10-12,1083,844,239,28.32,1089
2021-10-13,1083,845,238,28.17,1089
2021-10-14,1083,845,238,28.17,1089
2021-10-15,889,733,156,21.28,1089
2021-10-16,580,179,401,224.02,1089
2021-10-17,273,24,249,1037.5,1089
2021-10-18,1006,821,185,22.53,1089
2021-10-19,1083,839,244,29.08,1089
2021-10-20,1083,837,246,29.39,1089
2021-10-21,1083,836,247,29.55,1089
2021-10-22,889,722,167,23.13,1089
2021-10-23,580,167,413,247.31,1089
2021-10-24,273,12,261,2175.0,1089
2021-10-25,1006,808,198,24.5,1089
2021-10-26,1083,827,256,30.96,1089
2021-10-27,1083,826,257,31.11,1089
2021-10-28,1083,827,256,30.96,1089
2021-10-29,889,715,174,24.34,1089
2021-10-30,580,162,418,258.02,1089
2021-10-31,273,9,264,2933.33,1089
2021-11-01,943,808,135,16.71,1089
2021-11-02,1004,829,175,21.11,1089
2021-11-03,1004,832,172,20.67,1089
2021-11-04,1004,834,170,20.38,1089
2021-11-05,910,725,185,25.52,1089
2021-11-06,340,174,166,95.4,1089
2021-11-07,222,23,199,865.22,1089
2021-11-08,943,823,120,14.58,1089
2021-11-09,1004,845,159,18.82,1089
2021-11-10,1004,847,157,18.54,1089
2021-11-11,1004,849,155,18.26,1089
2021-11-12,910,739,171,23.14,1089
2021-11-13,340,186,154,82.8,1089
2021-11-14,222,32,190,593.75,1089
2021-11-15,943,830,113,13.61,1089
2021-11-16,1004,848,156,18.4,1089
2021-11-17,1004,847,157,18.54,1089
2021-11-18,1004,845,159,18.82,1089
2021-11-19,910,730,180,24.66,1089
2021-11-20,340,173,167,96.53,1089
2021-11-21,222,16,206,1287.5,1089
2021-11-22,943,809,134,16.56,1089
2021-11-23,1004,823,181,21.99,1089
2021-11-24,1004,818,186,22.74,1089
2021-11-25,1004,813,191,23.49,1089
2021-11-26,910,696,214,30.75,1089
2021-11-27,340,137,203,148.18,1089
2021-11-28,222,34,188,552.94,1089
2021-11-29,943,769,174,22.63,1089
2021-11-30,1004,783,221,28.22,1089
2021-12-01,749,778,-29,-3.73,1089
2021-12-02,749,774,-25,-3.23,1089
2021-12-03,556,658,-102,-15.5,1089
2021-12-04,299,101,198,196.04,1089
2021-12-05,152,13,139,1069.23,1089
2021-12-06,790,738,52,7.05,1089
2021-12-07,749,755,-6,-0.79,1089
2021-12-08,749,754,-5,-0.66,1089
2021-12-09,749,753,-4,-0.53,1089
2021-12-10,556,640,-84,-13.12,1089
2021-12-11,299,85,214,251.76,1089
2021-12-12,152,11,141,1281.82,1089
2021-12-13,790,728,62,8.52,1089
2021-12-14,749,747,2,0.27,1089
2021-12-15,749,746,3,0.4,1089
2021-12-16,749,746,3,0.4,1089
2021-12-17,556,633,-77,-12.16,1089
2021-12-18,299,79,220,278.48,1089
2021-12-19,152,5,147,2940.0,1089
2021-12-20,790,718,72,10.03,1089
2021-12-21,749,735,14,1.9,1089
2021-12-22,749,732,17,2.32,1089
2021-12-23,749,728,21,2.88,1089
2021-12-24,556,612,-56,-9.15,1089
2021-12-25,299,53,246,464.15,1089
2021-12-26,152,53,99,186.79,1089
2021-12-27,790,685,105,15.33,1089
2021-12-28,749,697,52,7.46,1089
2021-12-29,749,690,59,8.55,1089
2021-12-30,749,683,66,9.66,1089
2021-12-31,556,564,-8,-1.42,1089
2022-01-01,270,2,268,13400.0,1089
2022-01-02,137,2,135,6750.0,1089
2022-01-03,673,631,42,6.66,1089
2022-01-04,675,643,32,4.98,1089
2022-01-05,675,636,39,6.13,1089
2022-01-06,675,630,45,7.14,1089
2022-01-07,592,512,80,15.62,1089
2022-01-08,270,22,248,1127.27,1089
2022-01-09,137,22,115,522.73,1089
2022-01-10,673,588,85,14.46,1089
2022-01-11,675,604,71,11.75,1089
2022-01-12,675,601,74,12.31,1089
2022-01-13,675,600,75,12.5,1089
2022-01-14,592,488,104,21.31,1089
2022-01-15,270,10,260,2600.0,1089
2022-01-16,137,10,127,1270.0,1089
2022-01-17,673,579,94,16.23,1089
2022-01-18,675,600,75,12.5,1089
2022-01-19,675,602,73,12.13,1089
2022-01-20,675,605,70,11.57,1089
2022-01-21,592,496,96,19.35,1089
2022-01-22,270,17,253,1488.24,1089
2022-01-23,137,17,120,705.88,1089
2022-01-24,673,594,79,13.3,1089
2022-01-25,675,616,59,9.58,1089
2022-01-26,675,619,56,9.05,1089
2022-01-27,675,621,54,8.7,1089
2022-01-28,592,511,81,15.85,1089
2022-01-29,270,25,245,980.0,1089
2022-01-30,137,25,112,448.0,1089
2020-02-01,310,255,55,21.57,1096
2020-02-02,112,125,-13,-10.4,1096
2020-02-03,1045,1044,1,0.1,1096
2020-02-04,1148,1061,87,8.2,1096
2020-02-05,1148,1065,83,7.79,1096
2020-02-06,1148,1067,81,7.59,1096
2020-02-07,1038,952,86,9.03,1096
2020-02-08,310,272,38,13.97,1096
2020-02-09,112,141,-29,-20.57,1096
2020-02-10,1045,1059,-14,-1.32,1096
2020-02-11,1148,1075,73,6.79,1096
2020-02-12,1148,1079,69,6.39,1096
2020-02-13,1148,1080,68,6.3,1096
2020-02-14,1038,964,74,7.68,1096
2020-02-15,310,284,26,9.15,1096
2020-02-16,112,153,-41,-26.8,1096
2020-02-17,1045,1071,-26,-2.43,1096
2020-02-18,1148,1087,61,5.61,1096
2020-02-19,1148,1090,58,5.32,1096
2020-02-20,1148,1091,57,5.22,1096
2020-02-21,1038,975,63,6.46,1096
2020-02-22,310,295,15,5.08,1096
2020-02-23,112,164,-52,-31.71,1096
2020-02-24,1045,1082,-37,-3.42,1096
2020-02-25,1148,1098,50,4.55,1096
2020-02-26,1148,1102,46,4.17,1096
2020-02-27,1148,1103,45,4.08,1096
2020-02-28,1038,987,51,5.17,1096
2020-02-29,310,307,3,0.98,1096
2020-03-01,71,175,-104,-59.43,1096
2020-03-02,979,1093,-114,-10.43,1096
2020-03-03,945,1109,-164,-14.79,1096
2020-03-04,945,1112,-167,-15.02,1096
2020-03-05,945,1113,-168,-15.09,1096
2020-03-06,752,996,-244,-24.5,1096
2020-03-07,158,316,-158,-50.0,1096
2020-03-08,71,184,-113,-61.41,1096
2020-03-09,979,1101,-122,-11.08,1096
2020-03-10,945,1117,-172,-15.4,1096
2020-03-11,945,1119,-174,-15.55,1096
2020-03-12,945,1120,-175,-15.62,1096
2020-03-13,752,1004,-252,-25.1,1096
2020-03-14,158,323,-165,-51.08,1096
2020-03-15,71,192,-121,-63.02,1096
2020-03-16,979,1109,-130,-11.72,1096
2020-03-17,945,1125,-180,-16.0,1096
2020-03-18,945,1129,-184,-16.3,1096
2020-03-19,945,1130,-185,-16.37,1096
2020-03-20,752,1015,-263,-25.91,1096
2020-03-21,158,335,-177,-52.84,1096
2020-03-22,71,205,-134,-65.37,1096
2020-03-23,979,1124,-145,-12.9,1096
2020-03-24,945,1141,-196,-17.18,1096
2020-03-25,945,1146,-201,-17.54,1096
2020-03-26,945,1149,-204,-17.75,1096
2020-03-27,752,1035,-283,-27.34,1096
2020-03-28,158,356,-198,-55.62,1096
2020-03-29,71,227,-156,-68.72,1096
2020-03-30,979,1148,-169,-14.72,1096
2020-03-31,945,1166,-221,-18.95,1096
2020-04-01,724,1172,-448,-38.23,1096
2020-04-02,724,1175,-451,-38.38,1096
2020-04-03,590,1062,-472,-44.44,1096
2020-04-04,136,384,-248,-64.58,1096
2020-04-05,41,255,-214,-83.92,1096
2020-04-06,751,1175,-424,-36.09,1096
2020-04-07,724,1193,-469,-39.31,1096
2020-04-08,724,1198,-474,-39.57,1096
2020-04-09,724,1201,-477,-39.72,1096
2020-04-10,590,1086,-496,-45.67,1096
2020-04-11,136,407,-271,-66.58,1096
2020-04-12,41,277,-236,-85.2,1096
2020-04-13,751,1196,-445,-37.21,1096
2020-04-14,724,1213,-489,-40.31,1096
2020-04-15,724,1216,-492,-40.46,1096
2020-04-16,724,1218,-494,-40.56,1096
2020-04-17,590,1102,-512,-46.46,1096
2020-04-18,136,421,-285,-67.7,1096
2020-04-19,41,290,-249,-85.86,1096
2020-04-20,751,1208,-457,-37.83,1096
2020-04-21,724,1223,-499,-40.8,1096
2020-04-22,724,1226,-502,-40.95,1096
2020-04-23,724,1226,-502,-40.95,1096
2020-04-24,590,1110,-520,-46.85,1096
2020-04-25,136,429,-293,-68.3,1096
2020-04-26,41,297,-256,-86.2,1096
2020-04-27,751,1214,-463,-38.14,1096
2020-04-28,724,1230,-506,-41.14,1096
2020-04-29,724,1233,-509,-41.28,1096
2020-04-30,724,1233,-509,-41.28,1096
2020-05-01,787,1117,-330,-29.54,1096
2020-05-02,193,436,-243,-55.73,1096
2020-05-03,62,305,-243,-79.67,1096
2020-05-04,909,1223,-314,-25.67,1096
2020-05-05,937,1239,-302,-24.37,1096
2020-05-06,937,1242,-305,-24.56,1096
2020-05-07,937,1243,-306,-24.62,1096
2020-05-08,787,1127,-340,-30.17,1096
2020-05-09,193,447,-254,-56.82,1096
2020-05-10,62,316,-254,-80.38,1096
2020-05-11,909,1234,-325,-26.34,1096
2020-05-12,937,1249,-312,-24.98,1096
2020-05-13,937,1253,-316,-25.22,1096
2020-05-14,937,1253,-316,-25.22,1096
2020-05-15,787,1137,-350,-30.78,1096
2020-05-16,193,457,-264,-57.77,1096
2020-05-17,62,326,-264,-80.98,1096
2020-05-18,909,1243,-334,-26.87,1096
2020-05-19,937,1259,-322,-25.58,1096
2020-05-20,937,1262,-325,-25.75,1096
2020-05-21,937,1263,-326,-25.81,1096
2020-05-22,787,1147,-360,-31.39,1096
2020-05-23,193,467,-274,-58.67,1096
2020-05-24,62,335,-273,-81.49,1096
2020-05-25,909,1253,-344,-27.45,1096
2020-05-26,937,1270,-333,-26.22,1096
2020-05-27,937,1273,-336,-26.39,1096
2020-05-28,937,1275,-338,-26.51,1096
2020-05-29,787,1160,-373,-32.16,1096
2020-05-30,193,480,-287,-59.79,1096
2020-05-31,62,350,-288,-82.29,1096
2020-06-01,978,1270,-292,-22.99,1096
2020-06-02,1044,1287,-243,-18.88,1096
2020-06-03,1044,1292,-248,-19.2,1096
2020-06-04,1044,1294,-250,-19.32,1096
2020-06-05,873,1180,-307,-26.02,1096
2020-06-06,225,502,-277,-55.18,1096
2020-06-07,86,372,-286,-76.88,1096
2020-06-08,978,1292,-314,-24.3,1096
2020-06-09,1044,1310,-266,-20.31,1096
2020-06-10,1044,1314,-270,-20.55,1096
2020-06-11,1044,1317,-273,-20.73,1096
2020-06-12,873,1202,-329,-27.37,1096
2020-06-13,225,522,-297,-56.9,1096
2020-06-14,86,391,-305,-78.01,1096
2020-06-15,978,1309,-331,-25.29,1096
2020-06-16,1044,1325,-281,-21.21,1096
2020-06-17,1044,1327,-283,-21.33,1096
2020-06-18,1044,1326,-282,-21.27,1096
2020-06-19,873,1209,-336,-27.79,1096
2020-06-20,225,526,-301,-57.22,1096
2020-06-21,86,391,-305,-78.01,1096
2020-06-22,978,1306,-328,-25.11,1096
2020-06-23,1044,1318,-274,-20.79,1096
2020-06-24,1044,1316,-272,-20.67,1096
2020-06-25,1044,1313,-269,-20.49,1096
2020-06-26,873,1191,-318,-26.7,1096
2020-06-27,225,505,-280,-55.45,1096
2020-06-28,86,368,-282,-76.63,1096
2020-06-29,978,1280,-302,-23.59,1096
2020-06-30,1044,1290,-246,-19.07,1096
2020-07-01,1058,1287,-229,-17.79,1096
2020-07-02,1058,1282,-224,-17.47,1096
2020-07-03,913,1160,-247,-21.29,1096
2020-07-04,214,474,-260,-54.85,1096
2020-07-05,81,337,-256,-75.96,1096
2020-07-06,984,1250,-266,-21.28,1096
2020-07-07,1058,1261,-203,-16.1,1096
2020-07-08,1058,1260,-202,-16.03,1096
2020-07-09,1058,1257,-199,-15.83,1096
2020-07-10,913,1138,-225,-19.77,1096
2020-07-11,214,454,-240,-52.86,1096
2020-07-12,81,321,-240,-74.77,1096
2020-07-13,984,1237,-253,-20.45,1096
2020-07-14,1058,1251,-193,-15.43,1096
2020-07-15,1058,1253,-195,-15.56,1096
2020-07-16,1058,1254,-196,-15.63,1096
2020-07-17,913,1138,-225,-19.77,1096
2020-07-18,214,457,-243,-53.17,1096
2020-07-19,81,326,-245,-75.15,1096
2020-07-20,984,1245,-261,-20.96,1096
2020-07-21,1058,1261,-203,-16.1,1096
2020-07-22,1058,1265,-207,-16.36,1096
2020-07-23,1058,1267,-209,-16.5,1096
2020-07-24,913,1151,-238,-20.68,1096
2020-07-25,214,471,-257,-54.56,1096
2020-07-26,81,340,-259,-76.18,1096
2020-07-27,984,1258,-274,-21.78,1096
2020-07-28,1058,1273,-215,-16.89,1096
2020-07-29,1058,1276,-218,-17.08,1096
2020-07-30,1058,1275,-217,-17.02,1096
2020-07-31,913,1158,-245,-21.16,1096
2020-08-01,222,476,-254,-53.36,1096
2020-08-02,94,342,-248,-72.51,1096
2020-08-03,985,1258,-273,-21.7,1096
2020-08-04,1047,1271,-224,-17.62,1096
2020-08-05,1047,1271,-224,-17.62,1096
2020-08-06,1047,1269,-222,-17.49,1096
2020-08-07,900,1150,-250,-21.74,1096
2020-08-08,222,466,-244,-52.36,1096
2020-08-09,94,332,-238,-71.69,1096
2020-08-10,985,1247,-262,-21.01,1096
2020-08-11,1047,1259,-212,-16.84,1096
2020-08-12,1047,1260,-213,-16.9,1096
2020-08-13,1047,1258,-211,-16.77,1096
2020-08-14,900,1140,-240,-21.05,1096
2020-08-15,222,458,-236,-51.53,1096
2020-08-16,94,326,-232,-71.17,1096
2020-08-17,985,1243,-258,-20.76,1096
2020-08-18,1047,1259,-212,-16.84,1096
2020-08-19,1047,1262,-215,-17.04,1096
2020-08-20,1047,1264,-217,-17.17,1096
2020-08-21,900,1150,-250,-21.74,1096
2020-08-22,222,471,-249,-52.87,1096
2020-08-23,94,342,-248,-72.51,1096
2020-08-24,985,1263,-278,-22.01,1096
2020-08-25,1047,1282,-235,-18.33,1096
2020-08-26,1047,1288,-241,-18.71,1096
2020-08-27,1047,1293,-246,-19.03,1096
2020-08-28,900,1181,-281,-23.79,1096
2020-08-29,222,505,-283,-56.04,1096
2020-08-30,94,378,-284,-75.13,1096
2020-08-31,985,1299,-314,-24.17,1096
2020-09-01,1082,1319,-237,-17.97,1096
2020-09-02,1082,1326,-244,-18.4,1096
2020-09-03,1082,1330,-248,-18.65,1096
2020-09-04,906,1218,-312,-25.62,1096
2020-09-05,206,540,-334,-61.85,1096
2020-09-06,102,411,-309,-75.18,1096
2020-09-07,991,1331,-340,-25.54,1096
2020-09-08,1082,1348,-266,-19.73,1096
2020-09-09,1082,1353,-271,-20.03,1096
2020-09-10,1082,1354,-272,-20.09,1096
2020-09-11,906,1238,-332,-26.82,1096
2020-09-12,206,558,-352,-63.08,1096
2020-09-13,102,426,-324,-76.06,1096
2020-09-14,991,1343,-352,-26.21,1096
2020-09-15,1082,1357,-275,-20.27,1096
2020-09-16,1082,1358,-276,-20.32,1096
2020-09-17,1082,1357,-275,-20.27,1096
2020-09-18,906,1239,-333,-26.88,1096
2020-09-19,206,557,-351,-63.02,1096
2020-09-20,102,423,-321,-75.89,1096
2020-09-21,991,1338,-347,-25.93,1096
2020-09-22,1082,1352,-270,-19.97,1096
2020-09-23,1082,1352,-270,-19.97,1096
2020-09-24,1082,1351,-269,-19.91,1096
2020-09-25,906,1233,-327,-26.52,1096
2020-09-26,206,551,-345,-62.61,1096
2020-09-27,102,418,-316,-75.6,1096
2020-09-28,991,1334,-343,-25.71,1096
2020-09-29,1082,1348,-266,-19.73,1096
2020-09-30,1082,1350,-268,-19.85,1096
2020-10-01,1115,1350,-235,-17.41,1096
2020-10-02,925,1233,-308,-24.98,1096
2020-10-03,230,552,-322,-58.33,1096
2020-10-04,86,420,-334,-79.52,1096
2020-10-05,997,1337,-340,-25.43,1096
2020-10-06,1115,1352,-237,-17.53,1096
2020-10-07,1115,1354,-239,-17.65,1096
2020-10-08,1115,1355,-240,-17.71,1096
2020-10-09,925,1238,-313,-25.28,1096
2020-10-10,230,557,-327,-58.71,1096
2020-10-11,86,424,-338,-79.72,1096
2020-10-12,997,1341,-344,-25.65,1096
2020-10-13,1115,1356,-241,-17.77,1096
2020-10-14,1115,1357,-242,-17.83,1096
2020-10-15,1115,1356,-241,-17.77,1096
2020-10-16,925,1239,-314,-25.34,1096
2020-10-17,230,556,-326,-58.63,1096
2020-10-18,86,422,-336,-79.62,1096
2020-10-19,997,1337,-340,-25.43,1096
2020-10-20,1115,1350,-235,-17.41,1096
2020-10-21,1115,1351,-236,-17.47,1096
2020-10-22,1115,1348,-233,-17.28,1096
2020-10-23,925,1229,-304,-24.74,1096
2020-10-24,230,545,-315,-57.8,1096
2020-10-25,86,410,-324,-79.02,1096
2020-10-26,997,1325,-328,-24.75,1096
2020-10-27,1115,1337,-222,-16.6,1096
2020-10-28,1115,1336,-221,-16.54,1096
2020-10-29,1115,1334,-219,-16.42,1096
2020-10-30,925,1214,-289,-23.81,1096
2020-10-31,230,530,-300,-56.6,1096
2020-11-01,87,395,-308,-77.97,1096
2020-11-02,995,1310,-315,-24.05,1096
2020-11-03,995,1323,-328,-24.79,1096
2020-11-04,995,1323,-328,-24.79,1096
2020-11-05,995,1321,-326,-24.68,1096
2020-11-06,867,1202,-335,-27.87,1096
2020-11-07,220,519,-299,-57.61,1096
2020-11-08,87,385,-298,-77.4,1096
2020-11-09,995,1300,-305,-23.46,1096
2020-11-10,995,1313,-318,-24.22,1096
2020-11-11,995,1314,-319,-24.28,1096
2020-11-12,995,1313,-318,-24.22,1096
2020-11-13,867,1194,-327,-27.39,1096
2020-11-14,220,512,-292,-57.03,1096
2020-11-15,87,378,-291,-76.98,1096
2020-11-16,995,1294,-299,-23.11,1096
2020-11-17,995,1307,-312,-23.87,1096
2020-11-18,995,1308,-313,-23.93,1096
2020-11-19,995,1307,-312,-23.87,1096
2020-11-20,867,1189,-322,-27.08,1096
2020-11-21,220,506,-286,-56.52,1096
2020-11-22,87,373,-286,-76.68,1096
2020-11-23,995,1289,-294,-22.81,1096
2020-11-24,995,1302,-307,-23.58,1096
2020-11-25,995,1303,-308,-23.64,1096
2020-11-26,995,1302,-307,-23.58,1096
2020-11-27,867,1185,-318,-26.84,1096
2020-11-28,220,502,-282,-56.18,1096
2020-11-29,87,369,-282,-76.42,1096
2020-11-30,995,1285,-290,-22.57,1096
2020-12-01,869,1300,-431,-33.15,1096
2020-12-02,869,1301,-432,-33.21,1096
2020-12-03,869,1301,-432,-33.21,1096
2020-12-04,996,1183,-187,-15.81,1096
2020-12-05,210,502,-292,-58.17,1096
2020-12-06,104,369,-265,-71.82,1096
2020-12-07,856,1286,-430,-33.44,1096
2020-12-08,869,1301,-432,-33.21,1096
2020-12-09,869,1303,-434,-33.31,1096
2020-12-10,869,1303,-434,-33.31,1096
2020-12-11,996,1185,-189,-15.95,1096
2020-12-12,210,504,-294,-58.33,1096
2020-12-13,104,371,-267,-71.97,1096
2020-12-14,856,1287,-431,-33.49,1096
2020-12-15,869,1302,-433,-33.26,1096
2020-12-16,869,1303,-434,-33.31,1096
2020-12-17,869,1302,-433,-33.26,1096
2020-12-18,996,1183,-187,-15.81,1096
2020-12-19,210,500,-290,-58.0,1096
2020-12-20,104,366,-262,-71.58,1096
2020-12-21,856,1280,-424,-33.12,1096
2020-12-22,869,1293,-424,-32.79,1096
2020-12-23,869,1292,-423,-32.74,1096
2020-12-24,869,1289,-420,-32.58,1096
2020-12-25,996,1168,-172,-14.73,1096
2020-12-26,210,483,-273,-56.52,1096
2020-12-27,104,347,-243,-70.03,1096
2020-12-28,856,1259,-403,-32.01,1096
2020-12-29,869,1270,-401,-31.57,1096
2020-12-30,869,1267,-398,-31.41,1096
2020-12-31,869,1263,-394,-31.2,1096
2021-01-01,798,1141,-343,-30.06,1096
2021-01-02,230,455,-225,-49.45,1096
2021-01-03,124,319,-195,-61.13,1096
2021-01-04,819,1231,-412,-33.47,1096
2021-01-05,858,1242,-384,-30.92,1096
2021-01-06,858,1240,-382,-30.81,1096
2021-01-07,858,1237,-379,-30.64,1096
2021-01-08,798,1117,-319,-28.56,1096
2021-01-09,230,433,-203,-46.88,1096
2021-01-10,124,298,-174,-58.39,1096
2021-01-11,819,1213,-394,-32.48,1096
2021-01-12,858,1226,-368,-30.02,1096
2021-01-13,858,1227,-369,-30.07,1096
2021-01-14,858,1226,-368,-30.02,1096
2021-01-15,798,1109,-311,-28.04,1096
2021-01-16,230,428,-198,-46.26,1096
2021-01-17,124,296,-172,-58.11,1096
2021-01-18,819,1214,-395,-32.54,1096
2021-01-19,858,1230,-372,-30.24,1096
2021-01-20,858,1234,-376,-30.47,1096
2021-01-21,858,1236,-378,-30.58,1096
2021-01-22,798,1121,-323,-28.81,1096
2021-01-23,230,442,-212,-47.96,1096
2021-01-24,124,313,-189,-60.38,1096
2021-01-25,819,1232,-413,-33.52,1096
2021-01-26,858,1250,-392,-31.36,1096
2021-01-27,858,1254,-396,-31.58,1096
2021-01-28,858,1257,-399,-31.74,1096
2021-01-29,798,1143,-345,-30.18,1096
2021-01-30,230,464,-234,-50.43,1096
2021-01-31,124,334,-210,-62.87,1096
2021-02-01,907,1254,-347,-27.67,1096
2021-02-02,907,1271,-364,-28.64,1096
2021-02-03,907,1275,-368,-28.86,1096
2021-02-04,907,1277,-370,-28.97,1096
2021-02-05,843,1162,-319,-27.45,1096
2021-02-06,202,482,-280,-58.09,1096
2021-02-07,95,352,-257,-73.01,1096
2021-02-08,907,1270,-363,-28.58,1096
2021-02-09,907,1286,-379,-29.47,1096
2021-02-10,907,1290,-383,-29.69,1096
2021-02-11,907,1291,-384,-29.74,1096
2021-02-12,843,1175,-332,-28.26,1096
2021-02-13,202,495,-293,-59.19,1096
2021-02-14,95,364,-269,-73.9,1096
2021-02-15,907,1282,-375,-29.25,1096
2021-02-16,907,1298,-391,-30.12,1096
2021-02-17,907,1301,-394,-30.28,1096
2021-02-18,907,1302,-395,-30.34,1096
2021-02-19,843,1187,-344,-28.98,1096
2021-02-20,202,506,-304,-60.08,1096
2021-02-21,95,375,-280,-74.67,1096
2021-02-22,907,1293,-386,-29.85,1096
2021-02-23,907,1309,-402,-30.71,1096
2021-02-24,907,1313,-406,-30.92,1096
2021-02-25,907,1314,-407,-30.97,1096
2021-02-26,843,1198,-355,-29.63,1096
2021-02-27,202,518,-316,-61.0,1096
2021-02-28,95,387,-292,-75.45,1096
2021-03-01,1116,1305,-189,-14.48,1096
2021-03-02,1110,1320,-210,-15.91,1096
2021-03-03,1110,1323,-213,-16.1,1096
2021-03-04,1110,1324,-214,-16.16,1096
2021-03-05,964,1208,-244,-20.2,1096
2021-03-06,237,527,-290,-55.03,1096
2021-03-07,112,396,-284,-71.72,1096
2021-03-08,1116,1313,-197,-15.0,1096
2021-03-09,1110,1329,-219,-16.48,1096
2021-03-10,1110,1331,-221,-16.6,1096
2021-03-11,1110,1332,-222,-16.67,1096
2021-03-12,964,1216,-252,-20.72,1096
2021-03-13,237,535,-298,-55.7,1096
2021-03-14,112,403,-291,-72.21,1096
2021-03-15,1116,1321,-205,-15.52,1096
2021-03-16,1110,1337,-227,-16.98,1096
2021-03-17,1110,1340,-230,-17.16,1096
2021-03-18,1110,1341,-231,-17.23,1096
2021-03-19,964,1225,-261,-21.31,1096
2021-03-20,237,545,-308,-56.51,1096
2021-03-21,112,415,-303,-73.01,1096
2021-03-22,1116,1334,-218,-16.34,1096
2021-03-23,1110,1351,-241,-17.84,1096
2021-03-24,1110,1355,-245,-18.08,1096
2021-03-25,1110,1358,-248,-18.26,1096
2021-03-26,964,1244,-280,-22.51,1096
2021-03-27,237,565,-328,-58.05,1096
2021-03-28,112,436,-324,-74.31,1096
2021-03-29,1116,1356,-240,-17.7,1096
2021-03-30,1110,1374,-264,-19.21,1096
2021-03-31,1110,1380,-270,-19.57,1096
2021-04-01,1241,1383,-142,-10.27,1096
2021-04-02,1018,1270,-252,-19.84,1096
2021-04-03,214,592,-378,-63.85,1096
2021-04-04,65,463,-398,-85.96,1096
2021-04-05,1209,1384,-175,-12.64,1096
2021-04-06,1241,1402,-161,-11.48,1096
2021-04-07,1241,1407,-166,-11.8,1096
2021-04-08,1241,1410,-169,-11.99,1096
2021-04-09,1018,1296,-278,-21.45,1096
2021-04-10,214,617,-403,-65.32,1096
2021-04-11,65,487,-422,-86.65,1096
2021-04-12,1209,1406,-197,-14.01,1096
2021-04-13,1241,1423,-182,-12.79,1096
2021-04-14,1241,1427,-186,-13.03,1096
2021-04-15,1241,1429,-188,-13.16,1096
2021-04-16,1018,1313,-295,-22.47,1096
2021-04-17,214,633,-419,-66.19,1096
2021-04-18,65,502,-437,-87.05,1096
2021-04-19,1209,1419,-210,-14.8,1096
2021-04-20,1241,1435,-194,-13.52,1096
2021-04-21,1241,1438,-197,-13.7,1096
2021-04-22,1241,1438,-197,-13.7,1096
2021-04-23,1018,1322,-304,-23.0,1096
2021-04-24,214,641,-427,-66.61,1096
2021-04-25,65,509,-444,-87.23,1096
2021-04-26,1209,1426,-217,-15.22,1096
2021-04-27,1241,1442,-201,-13.94,1096
2021-04-28,1241,1444,-203,-14.06,1096
2021-04-29,1241,1445,-204,-14.12,1096
2021-04-30,1018,1329,-311,-23.4,1096
2021-05-01,244,648,-404,-62.35,1096
2021-05-02,88,517,-429,-82.98,1096
2021-05-03,1278,1434,-156,-10.88,1096
2021-05-04,1282,1450,-168,-11.59,1096
2021-05-05,1282,1453,-171,-11.77,1096
2021-05-06,1282,1454,-172,-11.83,1096
2021-05-07,1087,1338,-251,-18.76,1096
2021-05-08,244,658,-414,-62.92,1096
2021-05-09,88,527,-439,-83.3,1096
2021-05-10,1278,1445,-167,-11.56,1096
2021-05-11,1282,1461,-179,-12.25,1096
2021-05-12,1282,1464,-182,-12.43,1096
2021-05-13,1282,1465,-183,-12.49,1096
2021-05-14,1087,1349,-262,-19.42,1096
2021-05-15,244,669,-425,-63.53,1096
2021-05-16,88,537,-449,-83.61,1096
2021-05-17,1278,1455,-177,-12.16,1096
2021-05-18,1282,1471,-189,-12.85,1096
2021-05-19,1282,1474,-192,-13.03,1096
2021-05-20,1282,1474,-192,-13.03,1096
2021-05-21,1087,1358,-271,-19.96,1096
2021-05-22,244,678,-434,-64.01,1096
2021-05-23,88,547,-459,-83.91,1096
2021-05-24,1278,1465,-187,-12.76,1096
2021-05-25,1282,1481,-199,-13.44,1096
2021-05-26,1282,1484,-202,-13.61,1096
2021-05-27,1282,1486,-204,-13.73,1096
2021-05-28,1087,1370,-283,-20.66,1096
2021-05-29,244,691,-447,-64.69,1096
2021-05-30,88,560,-472,-84.29,1096
2021-05-31,1278,1479,-201,-13.59,1096
2021-06-01,1197,1497,-300,-20.04,1096
2021-06-02,1197,1501,-304,-20.25,1096
2021-06-03,1197,1504,-307,-20.41,1096
2021-06-04,1002,1389,-387,-27.86,1096
2021-06-05,250,711,-461,-64.84,1096
2021-06-06,102,581,-479,-82.44,1096
2021-06-07,1250,1501,-251,-16.72,1096
2021-06-08,1197,1519,-322,-21.2,1096
2021-06-09,1197,1524,-327,-21.46,1096
2021-06-10,1197,1526,-329,-21.56,1096
2021-06-11,1002,1412,-410,-29.04,1096
2021-06-12,250,733,-483,-65.89,1096
2021-06-13,102,602,-500,-83.06,1096
2021-06-14,1250,1521,-271,-17.82,1096
2021-06-15,1197,1536,-339,-22.07,1096
2021-06-16,1197,1539,-342,-22.22,1096
2021-06-17,1197,1540,-343,-22.27,1096
2021-06-18,1002,1422,-420,-29.54,1096
2021-06-19,250,740,-490,-66.22,1096
2021-06-20,102,607,-505,-83.2,1096
2021-06-21,1250,1522,-272,-17.87,1096
2021-06-22,1197,1534,-337,-21.97,1096
2021-06-23,1197,1533,-336,-21.92,1096
2021-06-24,1197,1530,-333,-21.76,1096
2021-06-25,1002,1409,-407,-28.89,1096
2021-06-26,250,724,-474,-65.47,1096
2021-06-27,102,587,-485,-82.62,1096
2021-06-28,1250,1499,-249,-16.61,1096
2021-06-29,1197,1509,-312,-20.68,1096
2021-06-30,1197,1506,-309,-20.52,1096
2021-07-01,1095,1501,-406,-27.05,1096
2021-07-02,1008,1379,-371,-26.9,1096
2021-07-03,258,693,-435,-62.77,1096
2021-07-04,120,556,-436,-78.42,1096
2021-07-05,1055,1468,-413,-28.13,1096
2021-07-06,1095,1479,-384,-25.96,1096
2021-07-07,1095,1477,-382,-25.86,1096
2021-07-08,1095,1473,-378,-25.66,1096
2021-07-09,1008,1353,-345,-25.5,1096
2021-07-10,258,670,-412,-61.49,1096
2021-07-11,120,535,-415,-77.57,1096
2021-07-12,1055,1451,-396,-27.29,1096
2021-07-13,1095,1464,-369,-25.2,1096
2021-07-14,1095,1466,-371,-25.31,1096
2021-07-15,1095,1466,-371,-25.31,1096
2021-07-16,1008,1349,-341,-25.28,1096
2021-07-17,258,669,-411,-61.43,1096
2021-07-18,120,537,-417,-77.65,1096
2021-07-19,1055,1456,-401,-27.54,1096
2021-07-20,1095,1472,-377,-25.61,1096
2021-07-21,1095,1476,-381,-25.81,1096
2021-07-22,1095,1477,-382,-25.86,1096
2021-07-23,1008,1362,-354,-25.99,1096
2021-07-24,258,682,-424,-62.17,1096
2021-07-25,120,551,-431,-78.22,1096
2021-07-26,1055,1469,-414,-28.18,1096
2021-07-27,1095,1485,-390,-26.26,1096
2021-07-28,1095,1488,-393,-26.41,1096
2021-07-29,1095,1488,-393,-26.41,1096
2021-07-30,1008,1371,-363,-26.48,1096
2021-07-31,258,689,-431,-62.55,1096
2021-08-01,117,557,-440,-78.99,1096
2021-08-02,1020,1472,-452,-30.71,1096
2021-08-03,1024,1486,-462,-31.09,1096
2021-08-04,1024,1486,-462,-31.09,1096
2021-08-05,1024,1484,-460,-31.0,1096
2021-08-06,881,1365,-484,-35.46,1096
2021-08-07,234,682,-448,-65.69,1096
2021-08-08,117,547,-430,-78.61,1096
2021-08-09,1020,1462,-442,-30.23,1096
2021-08-10,1024,1475,-451,-30.58,1096
2021-08-11,1024,1475,-451,-30.58,1096
2021-08-12,1024,1473,-449,-30.48,1096
2021-08-13,881,1355,-474,-34.98,1096
2021-08-14,234,672,-438,-65.18,1096
2021-08-15,117,539,-422,-78.29,1096
2021-08-16,1020,1456,-436,-29.95,1096
2021-08-17,1024,1471,-447,-30.39,1096
2021-08-18,1024,1473,-449,-30.48,1096
2021-08-19,1024,1475,-451,-30.58,1096
2021-08-20,881,1359,-478,-35.17,1096
2021-08-21,234,680,-446,-65.59,1096
2021-08-22,117,551,-434,-78.77,1096
2021-08-23,1020,1471,-451,-30.66,1096
2021-08-24,1024,1489,-465,-31.23,1096
2021-08-25,1024,1496,-472,-31.55,1096
2021-08-26,1024,1500,-476,-31.73,1096
2021-08-27,881,1388,-507,-36.53,1096
2021-08-28,234,711,-477,-67.09,1096
2021-08-29,117,584,-467,-79.97,1096
2021-08-30,1020,1506,-486,-32.27,1096
2021-08-31,1024,1526,-502,-32.9,1096
2021-09-01,1190,1533,-343,-22.37,1096
2021-09-02,1190,1538,-348,-22.63,1096
2021-09-03,1052,1425,-373,-26.18,1096
2021-09-04,258,748,-490,-65.51,1096
2021-09-05,136,620,-484,-78.06,1096
2021-09-06,1182,1540,-358,-23.25,1096
2021-09-07,1190,1558,-368,-23.62,1096
2021-09-08,1190,1563,-373,-23.86,1096
2021-09-09,1190,1565,-375,-23.96,1096
2021-09-10,1052,1450,-398,-27.45,1096
2021-09-11,258,769,-511,-66.45,1096
2021-09-12,136,638,-502,-78.68,1096
2021-09-13,1182,1555,-373,-23.99,1096
2021-09-14,1190,1570,-380,-24.2,1096
2021-09-15,1190,1572,-382,-24.3,1096
2021-09-16,1190,1571,-381,-24.25,1096
2021-09-17,1052,1453,-401,-27.6,1096
2021-09-18,258,771,-513,-66.54,1096
2021-09-19,136,637,-501,-78.65,1096
2021-09-20,1182,1553,-371,-23.89,1096
2021-09-21,1190,1566,-376,-24.01,1096
2021-09-22,1190,1567,-377,-24.06,1096
2021-09-23,1190,1565,-375,-23.96,1096
2021-09-24,1052,1447,-395,-27.3,1096
2021-09-25,258,765,-507,-66.27,1096
2021-09-26,136,631,-495,-78.45,1096
2021-09-27,1182,1547,-365,-23.59,1096
2021-09-28,1190,1561,-371,-23.77,1096
2021-09-29,1190,1563,-373,-23.86,1096
2021-09-30,1190,1563,-373,-23.86,1096
2021-10-01,1017,1446,-429,-29.67,1096
2021-10-02,308,764,-456,-59.69,1096
2021-10-03,135,632,-497,-78.64,1096
2021-10-04,1075,1549,-474,-30.6,1096
2021-10-05,1193,1564,-371,-23.72,1096
2021-10-06,1193,1567,-374,-23.87,1096
2021-10-07,1193,1567,-374,-23.87,1096
2021-10-08,1017,1450,-433,-29.86,1096
2021-10-09,308,769,-461,-59.95,1096
2021-10-10,135,637,-502,-78.81,1096
2021-10-11,1075,1554,-479,-30.82,1096
2021-10-12,1193,1569,-376,-23.96,1096
2021-10-13,1193,1571,-378,-24.06,1096
2021-10-14,1193,1570,-377,-24.01,1096
2021-10-15,1017,1452,-435,-29.96,1096
2021-10-16,308,770,-462,-60.0,1096
2021-10-17,135,637,-502,-78.81,1096
2021-10-18,1075,1552,-477,-30.73,1096
2021-10-19,1193,1565,-372,-23.77,1096
2021-10-20,1193,1566,-373,-23.82,1096
2021-10-21,1193,1564,-371,-23.72,1096
2021-10-22,1017,1445,-428,-29.62,1096
2021-10-23,308,761,-453,-59.53,1096
2021-10-24,135,626,-491,-78.43,1096
2021-10-25,1075,1540,-465,-30.19,1096
2021-10-26,1193,1553,-360,-23.18,1096
2021-10-27,1193,1552,-359,-23.13,1096
2021-10-28,1193,1550,-357,-23.03,1096
2021-10-29,1017,1430,-413,-28.88,1096
2021-10-30,308,746,-438,-58.71,1096
2021-10-31,135,611,-476,-77.91,1096
2021-11-01,1112,1526,-414,-27.13,1096
2021-11-02,1169,1538,-369,-23.99,1096
2021-11-03,1169,1538,-369,-23.99,1096
2021-11-04,1169,1536,-367,-23.89,1096
2021-11-05,1052,1417,-365,-25.76,1096
2021-11-06,251,733,-482,-65.76,1096
2021-11-07,115,599,-484,-80.8,1096
2021-11-08,1112,1515,-403,-26.6,1096
2021-11-09,1169,1528,-359,-23.49,1096
2021-11-10,1169,1528,-359,-23.49,1096
2021-11-11,1169,1527,-358,-23.44,1096
2021-11-12,1052,1409,-357,-25.34,1096
2021-11-13,251,726,-475,-65.43,1096
2021-11-14,115,592,-477,-80.57,1096
2021-11-15,1112,1508,-396,-26.26,1096
2021-11-16,1169,1522,-353,-23.19,1096
2021-11-17,1169,1522,-353,-23.19,1096
2021-11-18,1169,1521,-352,-23.14,1096
2021-11-19,1052,1403,-351,-25.02,1096
2021-11-20,251,721,-470,-65.19,1096
2021-11-21,115,587,-472,-80.41,1096
2021-11-22,1112,1503,-391,-26.01,1096
2021-11-23,1169,1516,-347,-22.89,1096
2021-11-24,1169,1517,-348,-22.94,1096
2021-11-25,1169,1516,-347,-22.89,1096
2021-11-26,1052,1398,-346,-24.75,1096
2021-11-27,251,716,-465,-64.94,1096
2021-11-28,115,583,-468,-80.27,1096
2021-11-29,1112,1499,-387,-25.82,1096
2021-11-30,1169,1513,-344,-22.74,1096
2021-12-01,864,1515,-651,-42.97,1096
2021-12-02,864,1514,-650,-42.93,1096
2021-12-03,671,1397,-726,-51.97,1096
2021-12-04,279,715,-436,-60.98,1096
2021-12-05,132,582,-450,-77.32,1096
2021-12-06,926,1499,-573,-38.23,1096
2021-12-07,864,1514,-650,-42.93,1096
2021-12-08,864,1516,-652,-43.01,1096
2021-12-09,864,1515,-651,-42.97,1096
2021-12-10,671,1398,-727,-52.0,1096
2021-12-11,279,717,-438,-61.09,1096
2021-12-12,132,584,-452,-77.4,1096
2021-12-13,926,1501,-575,-38.31,1096
2021-12-14,864,1515,-651,-42.97,1096
2021-12-15,864,1517,-653,-43.05,1096
2021-12-16,864,1516,-652,-43.01,1096
2021-12-17,671,1398,-727,-52.0,1096
2021-12-18,279,715,-436,-60.98,1096
2021-12-19,132,581,-449,-77.28,1096
2021-12-20,926,1496,-570,-38.1,1096
2021-12-21,864,1509,-645,-42.74,1096
2021-12-22,864,1508,-644,-42.71,1096
2021-12-23,864,1505,-641,-42.59,1096
2021-12-24,671,1385,-714,-51.55,1096
2021-12-25,279,700,-421,-60.14,1096
2021-12-26,132,564,-432,-76.6,1096
2021-12-27,926,1477,-551,-37.31,1096
2021-12-28,864,1488,-624,-41.94,1096
2021-12-29,864,1486,-622,-41.86,1096
2021-12-30,864,1481,-617,-41.66,1096
2021-12-31,671,1360,-689,-50.66,1096
2022-01-01,238,674,-436,-64.69,1096
2022-01-02,102,537,-435,-81.01,1096
2022-01-03,863,1449,-586,-40.44,1096
2022-01-04,877,1460,-583,-39.93,1096
2022-01-05,877,1458,-581,-39.85,1096
2022-01-06,877,1454,-577,-39.68,1096
2022-01-07,787,1333,-546,-40.96,1096
2022-01-08,238,649,-411,-63.33,1096
2022-01-09,102,514,-412,-80.16,1096
2022-01-10,863,1428,-565,-39.57,1096
2022-01-11,877,1441,-564,-39.14,1096
2022-01-12,877,1441,-564,-39.14,1096
2022-01-13,877,1440,-563,-39.1,1096
2022-01-14,787,1322,-535,-40.47,1096
2022-01-15,238,640,-402,-62.81,1096
2022-01-16,102,508,-406,-79.92,1096
2022-01-17,863,1426,-563,-39.48,1096
2022-01-18,877,1441,-564,-39.14,1096
2022-01-19,877,1445,-568,-39.31,1096
2022-01-20,877,1446,-569,-39.35,1096
2022-01-21,787,1331,-544,-40.87,1096
2022-01-22,238,652,-414,-63.5,1096
2022-01-23,102,522,-420,-80.46,1096
2022-01-24,863,1441,-578,-40.11,1096
2022-01-25,877,1459,-582,-39.89,1096
2022-01-26,877,1464,-587,-40.1,1096
2022-01-27,877,1466,-589,-40.18,1096
2022-01-28,787,1352,-565,-41.79,1096
2022-01-29,238,673,-435,-64.64,1096
2022-01-30,102,544,-442,-81.25,1096
2020-02-01,289,240,49,20.42,1223
2020-02-02,230,139,91,65.47,1223
2020-02-03,607,576,31,5.38,1223
2020-02-04,634,588,46,7.82,1223
2020-02-05,634,576,58,10.07,1223
2020-02-06,634,568,66,11.62,1223
2020-02-07,572,486,86,17.7,1223
2020-02-08,289,176,113,64.2,1223
2020-02-09,230,74,156,210.81,1223
2020-02-10,607,512,95,18.55,1223
2020-02-11,634,525,109,20.76,1223
2020-02-12,634,516,118,22.87,1223
2020-02-13,634,512,122,23.83,1223
2020-02-14,572,436,136,31.19,1223
2020-02-15,289,132,157,118.94,1223
2020-02-16,230,38,192,505.26,1223
2020-02-17,607,485,122,25.15,1223
2020-02-18,634,508,126,24.8,1223
2020-02-19,634,508,126,24.8,1223
2020-02-20,634,514,120,23.35,1223
2020-02-21,572,448,124,27.68,1223
2020-02-22,289,155,134,86.45,1223
2020-02-23,230,70,160,228.57,1223
2020-02-24,607,525,82,15.62,1223
2020-02-25,634,556,78,14.03,1223
2020-02-26,634,564,70,12.41,1223
2020-02-27,634,575,59,10.26,1223
2020-02-28,572,513,59,11.5,1223
2020-02-29,289,222,67,30.18,1223
2020-03-01,208,139,69,49.64,1223
2020-03-02,522,593,-71,-11.97,1223
2020-03-03,598,622,-24,-3.86,1223
2020-03-04,598,625,-27,-4.32,1223
2020-03-05,598,632,-34,-5.38,1223
2020-03-06,510,563,-53,-9.41,1223
2020-03-07,261,264,-3,-1.14,1223
2020-03-08,208,171,37,21.64,1223
2020-03-09,522,616,-94,-15.26,1223
2020-03-10,598,633,-35,-5.53,1223
2020-03-11,598,626,-28,-4.47,1223
2020-03-12,598,621,-23,-3.7,1223
2020-03-13,510,541,-31,-5.73,1223
2020-03-14,261,232,29,12.5,1223
2020-03-15,208,129,79,61.24,1223
2020-03-16,522,565,-43,-7.61,1223
2020-03-17,598,575,23,4.0,1223
2020-03-18,598,561,37,6.6,1223
2020-03-19,598,551,47,8.53,1223
2020-03-20,510,468,42,8.97,1223
2020-03-21,261,157,104,66.24,1223
2020-03-22,208,54,154,285.19,1223
2020-03-23,522,491,31,6.31,1223
2020-03-24,598,504,94,18.65,1223
2020-03-25,598,495,103,20.81,1223
2020-03-26,598,491,107,21.79,1223
2020-03-27,510,414,96,23.19,1223
2020-03-28,261,111,150,135.14,1223
2020-03-29,208,17,191,1123.53,1223
2020-03-30,522,464,58,12.5,1223
2020-03-31,598,486,112,23.05,1223
2020-04-01,545,486,59,12.14,1223
2020-04-02,545,492,53,10.77,1223
2020-04-03,460,424,36,8.49,1223
2020-04-04,266,129,137,106.2,1223
2020-04-05,204,42,162,385.71,1223
2020-04-06,550,494,56,11.34,1223
2020-04-07,545,521,24,4.61,1223
2020-04-08,545,525,20,3.81,1223
2020-04-09,545,532,13,2.44,1223
2020-04-10,460,464,-4,-0.86,1223
2020-04-11,266,168,98,58.33,1223
2020-04-12,204,78,126,161.54,1223
2020-04-13,550,526,24,4.56,1223
2020-04-14,545,548,-3,-0.55,1223
2020-04-15,545,546,-1,-0.18,1223
2020-04-16,545,545,0,0.0,1223
2020-04-17,460,470,-10,-2.13,1223
2020-04-18,266,165,101,61.21,1223
2020-04-19,204,67,137,204.48,1223
2020-04-20,550,507,43,8.48,1223
2020-04-21,545,521,24,4.61,1223
2020-04-22,545,511,34,6.65,1223
2020-04-23,545,504,41,8.13,1223
2020-04-24,460,422,38,9.0,1223
2020-04-25,266,113,153,135.4,1223
2020-04-26,204,11,193,1754.55,1223
2020-04-27,550,448,102,22.77,1223
2020-04-28,545,461,84,18.22,1223
2020-04-29,545,451,94,20.84,1223
2020-04-30,545,445,100,22.47,1223
2020-05-01,607,367,240,65.4,1223
2020-05-02,304,61,243,398.36,1223
2020-05-03,223,61,162,265.57,1223
2020-05-04,633,408,225,55.15,1223
2020-05-05,667,428,239,55.84,1223
2020-05-06,667,425,242,56.94,1223
2020-05-07,667,427,240,56.21,1223
2020-05-08,607,357,250,70.03,1223
2020-05-09,304,59,245,415.25,1223
2020-05-10,223,59,164,277.97,1223
2020-05-11,633,420,213,50.71,1223
2020-05-12,667,445,222,49.89,1223
2020-05-13,667,447,220,49.22,1223
2020-05-14,667,454,213,46.92,1223
2020-05-15,607,386,221,57.25,1223
2020-05-16,304,89,215,241.57,1223
2020-05-17,223,0,223,inf,1223
2020-05-18,633,450,183,40.67,1223
2020-05-19,667,473,194,41.01,1223
2020-05-20,667,472,195,41.31,1223
2020-05-21,667,473,194,41.01,1223
2020-05-22,607,400,207,51.75,1223
2020-05-23,304,98,206,210.2,1223
2020-05-24,223,2,221,11050.0,1223
2020-05-25,633,444,189,42.57,1223
2020-05-26,667,460,207,45.0,1223
2020-05-27,667,451,216,47.89,1223
2020-05-28,667,446,221,49.55,1223
2020-05-29,607,366,241,65.85,1223
2020-05-30,304,58,246,424.14,1223
2020-05-31,223,58,165,284.48,1223
2020-06-01,690,395,295,74.68,1223
2020-06-02,690,408,282,69.12,1223
2020-06-03,690,398,292,73.37,1223
2020-06-04,690,392,298,76.02,1223
2020-06-05,596,312,284,91.03,1223
2020-06-06,322,6,316,5266.67,1223
2020-06-07,248,6,242,4033.33,1223
2020-06-08,690,350,340,97.14,1223
2020-06-09,690,368,322,87.5,1223
2020-06-10,690,363,327,90.08,1223
2020-06-11,690,364,326,89.56,1223
2020-06-12,596,291,305,104.81,1223
2020-06-13,322,9,313,3477.78,1223
2020-06-14,248,9,239,2655.56,1223
2020-06-15,690,350,340,97.14,1223
2020-06-16,690,374,316,84.49,1223
2020-06-17,690,375,315,84.0,1223
2020-06-18,690,381,309,81.1,1223
2020-06-19,596,313,283,90.42,1223
2020-06-20,322,16,306,1912.5,1223
2020-06-21,248,16,232,1450.0,1223
2020-06-22,690,378,312,82.54,1223
2020-06-23,690,401,289,72.07,1223
2020-06-24,690,401,289,72.07,1223
2020-06-25,690,404,286,70.79,1223
2020-06-26,596,333,263,78.98,1223
2020-06-27,322,32,290,906.25,1223
2020-06-28,248,32,216,675.0,1223
2020-06-29,690,381,309,81.1,1223
2020-06-30,690,399,291,72.93,1223
2020-07-01,646,392,254,64.8,1223
2020-07-02,646,388,258,66.49,1223
2020-07-03,620,309,311,100.65,1223
2020-07-04,314,1,313,31300.0,1223
2020-07-05,246,1,245,24500.0,1223
2020-07-06,624,340,284,83.53,1223
2020-07-07,646,353,293,83.0,1223
2020-07-08,646,342,304,88.89,1223
2020-07-09,646,336,310,92.26,1223
2020-07-10,620,256,364,142.19,1223
2020-07-11,314,256,58,22.66,1223
2020-07-12,246,256,-10,-3.91,1223
2020-07-13,624,290,334,115.17,1223
2020-07-14,646,306,340,111.11,1223
2020-07-15,646,300,346,115.33,1223
2020-07-16,646,299,347,116.05,1223
2020-07-17,620,225,395,175.56,1223
2020-07-18,314,225,89,39.56,1223
2020-07-19,246,225,21,9.33,1223
2020-07-20,624,279,345,123.66,1223
2020-07-21,646,302,344,113.91,1223
2020-07-22,646,303,343,113.2,1223
2020-07-23,646,308,338,109.74,1223
2020-07-24,620,239,381,159.41,1223
2020-07-25,314,239,75,31.38,1223
2020-07-26,246,239,7,2.93,1223
2020-07-27,624,305,319,104.59,1223
2020-07-28,646,330,316,95.76,1223
2020-07-29,646,332,314,94.58,1223
2020-07-30,646,336,310,92.26,1223
2020-07-31,620,266,354,133.08,1223
2020-08-01,295,266,29,10.9,1223
2020-08-02,253,266,-13,-4.89,1223
2020-08-03,625,320,305,95.31,1223
2020-08-04,669,339,330,97.35,1223
2020-08-05,669,334,335,100.3,1223
2020-08-06,669,331,338,102.11,1223
2020-08-07,614,254,360,141.73,1223
2020-08-08,295,254,41,16.14,1223
2020-08-09,253,254,-1,-0.39,1223
2020-08-10,625,287,338,117.77,1223
2020-08-11,669,300,369,123.0,1223
2020-08-12,669,289,380,131.49,1223
2020-08-13,669,282,387,137.23,1223
2020-08-14,614,201,413,205.47,1223
2020-08-15,295,201,94,46.77,1223
2020-08-16,253,201,52,25.87,1223
2020-08-17,625,230,395,171.74,1223
2020-08-18,669,245,424,173.06,1223
2020-08-19,669,236,433,183.47,1223
2020-08-20,669,233,436,187.12,1223
2020-08-21,614,157,457,291.08,1223
2020-08-22,295,157,138,87.9,1223
2020-08-23,253,157,96,61.15,1223
2020-08-24,625,205,420,204.88,1223
2020-08-25,669,227,442,194.71,1223
2020-08-26,669,226,443,196.02,1223
2020-08-27,669,230,439,190.87,1223
2020-08-28,614,162,452,279.01,1223
2020-08-29,295,162,133,82.1,1223
2020-08-30,253,162,91,56.17,1223
2020-08-31,625,229,396,172.93,1223
2020-09-01,674,255,419,164.31,1223
2020-09-02,674,258,416,161.24,1223
2020-09-03,674,264,410,155.3,1223
2020-09-04,611,197,414,210.15,1223
2020-09-05,315,197,118,59.9,1223
2020-09-06,256,197,59,29.95,1223
2020-09-07,694,259,435,167.95,1223
2020-09-08,674,281,393,139.86,1223
2020-09-09,674,279,395,141.58,1223
2020-09-10,674,279,395,141.58,1223
2020-09-11,611,204,407,199.51,1223
2020-09-12,315,204,111,54.41,1223
2020-09-13,256,204,52,25.49,1223
2020-09-14,694,241,453,187.97,1223
2020-09-15,674,254,420,165.35,1223
2020-09-16,674,243,431,177.37,1223
2020-09-17,674,234,440,188.03,1223
2020-09-18,611,151,460,304.64,1223
2020-09-19,315,151,164,108.61,1223
2020-09-20,256,151,105,69.54,1223
2020-09-21,694,168,526,313.1,1223
2020-09-22,674,177,497,280.79,1223
2020-09-23,674,162,512,316.05,1223
2020-09-24,674,151,523,346.36,1223
2020-09-25,611,67,544,811.94,1223
2020-09-26,315,67,248,370.15,1223
2020-09-27,256,67,189,282.09,1223
2020-09-28,694,88,606,688.64,1223
2020-09-29,674,100,574,574.0,1223
2020-09-30,674,89,585,657.3,1223
2020-10-01,668,84,584,695.24,1223
2020-10-02,598,5,593,11860.0,1223
2020-10-03,316,5,311,6220.0,1223
2020-10-04,233,5,228,4560.0,1223
2020-10-05,648,46,602,1308.7,1223
2020-10-06,668,65,603,927.69,1223
2020-10-07,668,61,607,995.08,1223
2020-10-08,668,62,606,977.42,1223
2020-10-09,598,8,590,7375.0,1223
2020-10-10,316,8,308,3850.0,1223
2020-10-11,233,8,225,2812.5,1223
2020-10-12,648,44,604,1372.73,1223
2020-10-13,668,66,602,912.12,1223
2020-10-14,668,65,603,927.69,1223
2020-10-15,668,68,600,882.35,1223
2020-10-16,598,10,588,5880.0,1223
2020-10-17,316,10,306,3060.0,1223
2020-10-18,233,10,223,2230.0,1223
2020-10-19,648,52,596,1146.15,1223
2020-10-20,668,73,595,815.07,1223
2020-10-21,668,70,598,854.29,1223
2020-10-22,668,71,597,840.85,1223
2020-10-23,598,11,587,5336.36,1223
2020-10-24,316,11,305,2772.73,1223
2020-10-25,233,11,222,2018.18,1223
2020-10-26,648,47,601,1278.72,1223
2020-10-27,668,66,602,912.12,1223
2020-10-28,668,62,606,977.42,1223
2020-10-29,668,62,606,977.42,1223
2020-10-30,598,6,592,9866.67,1223
2020-10-31,316,6,310,5166.67,1223
2020-11-01,237,6,231,3850.0,1223
2020-11-02,619,37,582,1572.97,1223
2020-11-03,617,57,560,982.46,1223
2020-11-04,617,53,564,1064.15,1223
2020-11-05,617,54,563,1042.59,1223
2020-11-06,554,4,550,13750.0,1223
2020-11-07,291,4,287,7175.0,1223
2020-11-08,237,4,233,5825.0,1223
2020-11-09,619,35,584,1668.57,1223
2020-11-10,617,56,561,1001.79,1223
2020-11-11,617,54,563,1042.59,1223
2020-11-12,617,56,561,1001.79,1223
2020-11-13,554,4,550,13750.0,1223
2020-11-14,291,4,287,7175.0,1223
2020-11-15,237,4,233,5825.0,1223
2020-11-16,619,39,580,1487.18,1223
2020-11-17,617,59,558,945.76,1223
2020-11-18,617,57,560,982.46,1223
2020-11-19,617,58,559,963.79,1223
2020-11-20,554,5,549,10980.0,1223
2020-11-21,291,5,286,5720.0,1223
2020-11-22,237,5,232,4640.0,1223
2020-11-23,619,34,585,1720.59,1223
2020-11-24,617,53,564,1064.15,1223
2020-11-25,617,48,569,1185.42,1223
2020-11-26,617,48,569,1185.42,1223
2020-11-27,554,0,554,inf,1223
2020-11-28,291,0,291,inf,1223
2020-11-29,237,0,237,inf,1223
2020-11-30,619,20,599,2995.0,1223
2020-12-01,543,38,505,1328.95,1223
2020-12-02,543,34,509,1497.06,1223
2020-12-03,543,34,509,1497.06,1223
2020-12-04,576,34,542,1594.12,1223
2020-12-05,297,34,263,773.53,1223
2020-12-06,236,34,202,594.12,1223
2020-12-07,509,11,498,4527.27,1223
2020-12-08,543,31,512,1651.61,1223
2020-12-09,543,29,514,1772.41,1223
2020-12-10,543,31,512,1651.61,1223
2020-12-11,576,31,545,1758.06,1223
2020-12-12,297,31,266,858.06,1223
2020-12-13,236,31,205,661.29,1223
2020-12-14,509,14,495,3535.71,1223
2020-12-15,543,36,507,1408.33,1223
2020-12-16,543,34,509,1497.06,1223
2020-12-17,543,36,507,1408.33,1223
2020-12-18,576,36,540,1500.0,1223
2020-12-19,297,36,261,725.0,1223
2020-12-20,236,36,200,555.56,1223
2020-12-21,509,15,494,3293.33,1223
2020-12-22,543,34,509,1497.06,1223
2020-12-23,543,30,513,1710.0,1223
2020-12-24,543,29,514,1772.41,1223
2020-12-25,576,29,547,1886.21,1223
2020-12-26,297,29,268,924.14,1223
2020-12-27,236,29,207,713.79,1223
2020-12-28,509,10,499,4990.0,1223
2020-12-29,543,12,531,4425.0,1223
2020-12-30,543,5,538,10760.0,1223
2020-12-31,543,2,541,27050.0,1223
2021-01-01,518,2,516,25800.0,1223
2021-01-02,267,2,265,13250.0,1223
2021-01-03,225,2,223,11150.0,1223
2021-01-04,525,2,523,26150.0,1223
2021-01-05,551,4,547,13675.0,1223
2021-01-06,551,0,551,inf,1223
2021-01-07,551,0,551,inf,1223
2021-01-08,518,0,518,inf,1223
2021-01-09,267,0,267,inf,1223
2021-01-10,225,0,225,inf,1223
2021-01-11,525,0,525,inf,1223
2021-01-12,551,0,551,inf,1223
2021-01-13,551,0,551,inf,1223
2021-01-14,551,0,551,inf,1223
2021-01-15,518,0,518,inf,1223
2021-01-16,267,0,267,inf,1223
2021-01-17,225,0,225,inf,1223
2021-01-18,525,0,525,inf,1223
2021-01-19,551,1,550,55000.0,1223
2021-01-20,551,0,551,inf,1223
2021-01-21,551,2,549,27450.0,1223
2021-01-22,518,2,516,25800.0,1223
2021-01-23,267,2,265,13250.0,1223
2021-01-24,225,2,223,11150.0,1223
2021-01-25,525,2,523,26150.0,1223
2021-01-26,551,0,551,inf,1223
2021-01-27,551,0,551,inf,1223
2021-01-28,551,0,551,inf,1223
2021-01-29,518,0,518,inf,1223
2021-01-30,267,0,267,inf,1223
2021-01-31,225,0,225,inf,1223
2021-02-01,634,0,634,inf,1223
2021-02-02,621,0,621,inf,1223
2021-02-03,621,0,621,inf,1223
2021-02-04,621,0,621,inf,1223
2021-02-05,580,0,580,inf,1223
2021-02-06,297,0,297,inf,1223
2021-02-07,238,0,238,inf,1223
2021-02-08,634,0,634,inf,1223
2021-02-09,621,0,621,inf,1223
2021-02-10,621,0,621,inf,1223
2021-02-11,621,0,621,inf,1223
2021-02-12,580,0,580,inf,1223
2021-02-13,297,0,297,inf,1223
2021-02-14,238,0,238,inf,1223
2021-02-15,634,0,634,inf,1223
2021-02-16,621,0,621,inf,1223
2021-02-17,621,0,621,inf,1223
2021-02-18,621,0,621,inf,1223
2021-02-19,580,0,580,inf,1223
2021-02-20,297,0,297,inf,1223
2021-02-21,238,0,238,inf,1223
2021-02-22,634,0,634,inf,1223
2021-02-23,621,0,621,inf,1223
2021-02-24,621,0,621,inf,1223
2021-02-25,621,0,621,inf,1223
2021-02-26,580,0,580,inf,1223
2021-02-27,297,0,297,inf,1223
2021-02-28,238,0,238,inf,1223
2021-03-01,642,0,642,inf,1223
2021-03-02,640,0,640,inf,1223
2021-03-03,640,0,640,inf,1223
2021-03-04,640,0,640,inf,1223
2021-03-05,592,0,592,inf,1223
2021-03-06,320,0,320,inf,1223
2021-03-07,238,0,238,inf,1223
2021-03-08,642,0,642,inf,1223
2021-03-09,640,0,640,inf,1223
2021-03-10,640,0,640,inf,1223
2021-03-11,640,0,640,inf,1223
2021-03-12,592,0,592,inf,1223
2021-03-13,320,0,320,inf,1223
2021-03-14,238,0,238,inf,1223
2021-03-15,642,0,642,inf,1223
2021-03-16,640,0,640,inf,1223
2021-03-17,640,0,640,inf,1223
2021-03-18,640,0,640,inf,1223
2021-03-19,592,0,592,inf,1223
2021-03-20,320,0,320,inf,1223
2021-03-21,238,0,238,inf,1223
2021-03-22,642,0,642,inf,1223
2021-03-23,640,0,640,inf,1223
2021-03-24,640,0,640,inf,1223
2021-03-25,640,0,640,inf,1223
2021-03-26,592,0,592,inf,1223
2021-03-27,320,0,320,inf,1223
2021-03-28,238,0,238,inf,1223
2021-03-29,642,0,642,inf,1223
2021-03-30,640,0,640,inf,1223
2021-03-31,640,0,640,inf,1223
2021-04-01,650,0,650,inf,1223
2021-04-02,585,0,585,inf,1223
2021-04-03,321,0,321,inf,1223
2021-04-04,220,0,220,inf,1223
2021-04-05,631,0,631,inf,1223
2021-04-06,650,0,650,inf,1223
2021-04-07,650,0,650,inf,1223
2021-04-08,650,0,650,inf,1223
2021-04-09,585,0,585,inf,1223
2021-04-10,321,0,321,inf,1223
2021-04-11,220,0,220,inf,1223
2021-04-12,631,0,631,inf,1223
2021-04-13,650,0,650,inf,1223
2021-04-14,650,0,650,inf,1223
2021-04-15,650,0,650,inf,1223
2021-04-16,585,0,585,inf,1223
2021-04-17,321,0,321,inf,1223
2021-04-18,220,0,220,inf,1223
2021-04-19,631,0,631,inf,1223
2021-04-20,650,0,650,inf,1223
2021-04-21,650,0,650,inf,1223
2021-04-22,650,0,650,inf,1223
2021-04-23,585,0,585,inf,1223
2021-04-24,321,0,321,inf,1223
2021-04-25,220,0,220,inf,1223
2021-04-26,631,0,631,inf,1223
2021-04-27,650,0,650,inf,1223
2021-04-28,650,0,650,inf,1223
2021-04-29,650,0,650,inf,1223
2021-04-30,585,0,585,inf,1223
2021-05-01,327,0,327,inf,1223
2021-05-02,228,0,228,inf,1223
2021-05-03,728,0,728,inf,1223
2021-05-04,707,0,707,inf,1223
2021-05-05,707,0,707,inf,1223
2021-05-06,707,0,707,inf,1223
2021-05-07,610,0,610,inf,1223
2021-05-08,327,0,327,inf,1223
2021-05-09,228,0,228,inf,1223
2021-05-10,728,0,728,inf,1223
2021-05-11,707,0,707,inf,1223
2021-05-12,707,0,707,inf,1223
2021-05-13,707,0,707,inf,1223
2021-05-14,610,0,610,inf,1223
2021-05-15,327,0,327,inf,1223
2021-05-16,228,0,228,inf,1223
2021-05-17,728,0,728,inf,1223
2021-05-18,707,0,707,inf,1223
2021-05-19,707,0,707,inf,1223
2021-05-20,707,0,707,inf,1223
2021-05-21,610,0,610,inf,1223
2021-05-22,327,0,327,inf,1223
2021-05-23,228,0,228,inf,1223
2021-05-24,728,0,728,inf,1223
2021-05-25,707,0,707,inf,1223
2021-05-26,707,0,707,inf,1223
2021-05-27,707,0,707,inf,1223
2021-05-28,610,0,610,inf,1223
2021-05-29,327,0,327,inf,1223
2021-05-30,228,0,228,inf,1223
2021-05-31,728,0,728,inf,1223
2021-06-01,763,0,763,inf,1223
2021-06-02,763,0,763,inf,1223
2021-06-03,763,0,763,inf,1223
2021-06-04,622,0,622,inf,1223
2021-06-05,320,0,320,inf,1223
2021-06-06,247,0,247,inf,1223
2021-06-07,728,0,728,inf,1223
2021-06-08,763,0,763,inf,1223
2021-06-09,763,0,763,inf,1223
2021-06-10,763,0,763,inf,1223
2021-06-11,622,0,622,inf,1223
2021-06-12,320,0,320,inf,1223
2021-06-13,247,0,247,inf,1223
2021-06-14,728,0,728,inf,1223
2021-06-15,763,0,763,inf,1223
2021-06-16,763,0,763,inf,1223
2021-06-17,763,0,763,inf,1223
2021-06-18,622,0,622,inf,1223
2021-06-19,320,0,320,inf,1223
2021-06-20,247,0,247,inf,1223
2021-06-21,728,0,728,inf,1223
2021-06-22,763,0,763,inf,1223
2021-06-23,763,0,763,inf,1223
2021-06-24,763,0,763,inf,1223
2021-06-25,622,0,622,inf,1223
2021-06-26,320,0,320,inf,1223
2021-06-27,247,0,247,inf,1223
2021-06-28,728,0,728,inf,1223
2021-06-29,763,0,763,inf,1223
2021-06-30,763,0,763,inf,1223
2021-07-01,765,0,765,inf,1223
2021-07-02,639,0,639,inf,1223
2021-07-03,294,0,294,inf,1223
2021-07-04,207,0,207,inf,1223
2021-07-05,717,0,717,inf,1223
2021-07-06,765,0,765,inf,1223
2021-07-07,765,0,765,inf,1223
2021-07-08,765,0,765,inf,1223
2021-07-09,639,0,639,inf,1223
2021-07-10,294,0,294,inf,1223
2021-07-11,207,0,207,inf,1223
2021-07-12,717,0,717,inf,1223
2021-07-13,765,0,765,inf,1223
2021-07-14,765,0,765,inf,1223
2021-07-15,765,0,765,inf,1223
2021-07-16,639,0,639,inf,1223
2021-07-17,294,0,294,inf,1223
2021-07-18,207,0,207,inf,1223
2021-07-19,717,0,717,inf,1223
2021-07-20,765,0,765,inf,1223
2021-07-21,765,0,765,inf,1223
2021-07-22,765,0,765,inf,1223
2021-07-23,639,0,639,inf,1223
2021-07-24,294,0,294,inf,1223
2021-07-25,207,0,207,inf,1223
2021-07-26,717,0,717,inf,1223
2021-07-27,765,0,765,inf,1223
2021-07-28,765,0,765,inf,1223
2021-07-29,765,0,765,inf,1223
2021-07-30,639,0,639,inf,1223
2021-07-31,294,0,294,inf,1223
2021-08-01,206,0,206,inf,1223
2021-08-02,673,0,673,inf,1223
2021-08-03,695,0,695,inf,1223
2021-08-04,695,0,695,inf,1223
2021-08-05,695,0,695,inf,1223
2021-08-06,561,0,561,inf,1223
2021-08-07,255,0,255,inf,1223
2021-08-08,206,0,206,inf,1223
2021-08-09,673,0,673,inf,1223
2021-08-10,695,0,695,inf,1223
2021-08-11,695,0,695,inf,1223
2021-08-12,695,0,695,inf,1223
2021-08-13,561,0,561,inf,1223
2021-08-14,255,0,255,inf,1223
2021-08-15,206,0,206,inf,1223
2021-08-16,673,0,673,inf,1223
2021-08-17,695,0,695,inf,1223
2021-08-18,695,0,695,inf,1223
2021-08-19,695,0,695,inf,1223
2021-08-20,561,0,561,inf,1223
2021-08-21,255,0,255,inf,1223
2021-08-22,206,0,206,inf,1223
2021-08-23,673,0,673,inf,1223
2021-08-24,695,0,695,inf,1223
2021-08-25,695,0,695,inf,1223
2021-08-26,695,0,695,inf,1223
2021-08-27,561,0,561,inf,1223
2021-08-28,255,0,255,inf,1223
2021-08-29,206,0,206,inf,1223
2021-08-30,673,0,673,inf,1223
2021-08-31,695,0,695,inf,1223
2021-09-01,766,0,766,inf,1223
2021-09-02,766,0,766,inf,1223
2021-09-03,700,0,700,inf,1223
2021-09-04,326,0,326,inf,1223
2021-09-05,244,0,244,inf,1223
2021-09-06,812,0,812,inf,1223
2021-09-07,766,0,766,inf,1223
2021-09-08,766,0,766,inf,1223
2021-09-09,766,0,766,inf,1223
2021-09-10,700,0,700,inf,1223
2021-09-11,326,0,326,inf,1223
2021-09-12,244,0,244,inf,1223
2021-09-13,812,0,812,inf,1223
2021-09-14,766,0,766,inf,1223
2021-09-15,766,0,766,inf,1223
2021-09-16,766,0,766,inf,1223
2021-09-17,700,0,700,inf,1223
2021-09-18,326,0,326,inf,1223
2021-09-19,244,0,244,inf,1223
2021-09-20,812,0,812,inf,1223
2021-09-21,766,0,766,inf,1223
2021-09-22,766,0,766,inf,1223
2021-09-23,766,0,766,inf,1223
2021-09-24,700,0,700,inf,1223
2021-09-25,326,0,326,inf,1223
2021-09-26,244,0,244,inf,1223
2021-09-27,812,0,812,inf,1223
2021-09-28,766,0,766,inf,1223
2021-09-29,766,0,766,inf,1223
2021-09-30,766,0,766,inf,1223
2021-10-01,719,0,719,inf,1223
2021-10-02,463,0,463,inf,1223
2021-10-03,257,0,257,inf,1223
2021-10-04,726,0,726,inf,1223
2021-10-05,780,0,780,inf,1223
2021-10-06,780,0,780,inf,1223
2021-10-07,780,0,780,inf,1223
2021-10-08,719,0,719,inf,1223
2021-10-09,463,0,463,inf,1223
2021-10-10,257,0,257,inf,1223
2021-10-11,726,0,726,inf,1223
2021-10-12,780,0,780,inf,1223
2021-10-13,780,0,780,inf,1223
2021-10-14,780,0,780,inf,1223
2021-10-15,719,0,719,inf,1223
2021-10-16,463,0,463,inf,1223
2021-10-17,257,0,257,inf,1223
2021-10-18,726,0,726,inf,1223
2021-10-19,780,0,780,inf,1223
2021-10-20,780,0,780,inf,1223
2021-10-21,780,0,780,inf,1223
2021-10-22,719,0,719,inf,1223
2021-10-23,463,0,463,inf,1223
2021-10-24,257,0,257,inf,1223
2021-10-25,726,0,726,inf,1223
2021-10-26,780,0,780,inf,1223
2021-10-27,780,0,780,inf,1223
2021-10-28,780,0,780,inf,1223
2021-10-29,719,0,719,inf,1223
2021-10-30,463,0,463,inf,1223
2021-10-31,257,0,257,inf,1223
2021-11-01,676,0,676,inf,1223
2021-11-02,715,0,715,inf,1223
2021-11-03,715,0,715,inf,1223
2021-11-04,715,0,715,inf,1223
2021-11-05,658,0,658,inf,1223
2021-11-06,305,0,305,inf,1223
2021-11-07,253,0,253,inf,1223
2021-11-08,676,0,676,inf,1223
2021-11-09,715,0,715,inf,1223
2021-11-10,715,0,715,inf,1223
2021-11-11,715,0,715,inf,1223
2021-11-12,658,0,658,inf,1223
2021-11-13,305,0,305,inf,1223
2021-11-14,253,0,253,inf,1223
2021-11-15,676,0,676,inf,1223
2021-11-16,715,0,715,inf,1223
2021-11-17,715,0,715,inf,1223
2021-11-18,715,0,715,inf,1223
2021-11-19,658,0,658,inf,1223
2021-11-20,305,0,305,inf,1223
2021-11-21,253,0,253,inf,1223
2021-11-22,676,0,676,inf,1223
2021-11-23,715,0,715,inf,1223
2021-11-24,715,0,715,inf,1223
2021-11-25,715,0,715,inf,1223
2021-11-26,658,0,658,inf,1223
2021-11-27,305,0,305,inf,1223
2021-11-28,253,0,253,inf,1223
2021-11-29,676,0,676,inf,1223
2021-11-30,715,0,715,inf,1223
2021-12-01,587,0,587,inf,1223
2021-12-02,587,0,587,inf,1223
2021-12-03,481,0,481,inf,1223
2021-12-04,333,0,333,inf,1223
2021-12-05,221,0,221,inf,1223
2021-12-06,639,0,639,inf,1223
2021-12-07,587,0,587,inf,1223
2021-12-08,587,0,587,inf,1223
2021-12-09,587,0,587,inf,1223
2021-12-10,481,0,481,inf,1223
2021-12-11,333,0,333,inf,1223
2021-12-12,221,0,221,inf,1223
2021-12-13,639,0,639,inf,1223
2021-12-14,587,0,587,inf,1223
2021-12-15,587,0,587,inf,1223
2021-12-16,587,0,587,inf,1223
2021-12-17,481,0,481,inf,1223
2021-12-18,333,0,333,inf,1223
2021-12-19,221,0,221,inf,1223
2021-12-20,639,0,639,inf,1223
2021-12-21,587,0,587,inf,1223
2021-12-22,587,0,587,inf,1223
2021-12-23,587,0,587,inf,1223
2021-12-24,481,0,481,inf,1223
2021-12-25,333,0,333,inf,1223
2021-12-26,221,0,221,inf,1223
2021-12-27,639,0,639,inf,1223
2021-12-28,587,0,587,inf,1223
2021-12-29,587,0,587,inf,1223
2021-12-30,587,0,587,inf,1223
2021-12-31,481,0,481,inf,1223
2022-01-01,294,0,294,inf,1223
2022-01-02,193,0,193,inf,1223
2022-01-03,517,0,517,inf,1223
2022-01-04,511,0,511,inf,1223
2022-01-05,511,0,511,inf,1223
2022-01-06,511,0,511,inf,1223
2022-01-07,515,0,515,inf,1223
2022-01-08,294,0,294,inf,1223
2022-01-09,193,0,193,inf,1223
2022-01-10,517,0,517,inf,1223
2022-01-11,511,0,511,inf,1223
2022-01-12,511,0,511,inf,1223
2022-01-13,511,0,511,inf,1223
2022-01-14,515,0,515,inf,1223
2022-01-15,294,0,294,inf,1223
2022-01-16,193,0,193,inf,1223
2022-01-17,517,0,517,inf,1223
2022-01-18,511,0,511,inf,1223
2022-01-19,511,0,511,inf,1223
2022-01-20,511,0,511,inf,1223
2022-01-21,515,0,515,inf,1223
2022-01-22,294,0,294,inf,1223
2022-01-23,193,0,193,inf,1223
2022-01-24,517,0,517,inf,1223
2022-01-25,511,0,511,inf,1223
2022-01-26,511,0,511,inf,1223
2022-01-27,511,0,511,inf,1223
2022-01-28,515,0,515,inf,1223
2022-01-29,294,0,294,inf,1223
2022-01-30,193,0,193,inf,1223
2020-02-01,295,166,129,77.71,1189
2020-02-02,152,35,117,334.29,1189
2020-02-03,1192,1227,-35,-2.85,1189
2020-02-04,1186,1196,-10,-0.84,1189
2020-02-05,1186,1200,-14,-1.17,1189
2020-02-06,1186,1202,-16,-1.33,1189
2020-02-07,986,968,18,1.86,1189
2020-02-08,295,184,111,60.33,1189
2020-02-09,152,51,101,198.04,1189
2020-02-10,1192,1241,-49,-3.95,1189
2020-02-11,1186,1210,-24,-1.98,1189
2020-02-12,1186,1212,-26,-2.15,1189
2020-02-13,1186,1214,-28,-2.31,1189
2020-02-14,986,979,7,0.72,1189
2020-02-15,295,195,100,51.28,1189
2020-02-16,152,64,88,137.5,1189
2020-02-17,1192,1255,-63,-5.02,1189
2020-02-18,1186,1225,-39,-3.18,1189
2020-02-19,1186,1229,-43,-3.5,1189
2020-02-20,1186,1233,-47,-3.81,1189
2020-02-21,986,1000,-14,-1.4,1189
2020-02-22,295,219,76,34.7,1189
2020-02-23,152,90,62,68.89,1189
2020-02-24,1192,1283,-91,-7.09,1189
2020-02-25,1186,1255,-69,-5.5,1189
2020-02-26,1186,1262,-76,-6.02,1189
2020-02-27,1186,1267,-81,-6.39,1189
2020-02-28,986,1037,-51,-4.92,1189
2020-02-29,295,256,39,15.23,1189
2020-03-01,148,128,20,15.62,1189
2020-03-02,1007,1322,-315,-23.83,1189
2020-03-03,989,1294,-305,-23.57,1189
2020-03-04,989,1301,-312,-23.98,1189
2020-03-05,989,1306,-317,-24.27,1189
2020-03-06,854,1074,-220,-20.48,1189
2020-03-07,235,292,-57,-19.52,1189
2020-03-08,148,163,-15,-9.2,1189
2020-03-09,1007,1355,-348,-25.68,1189
2020-03-10,989,1325,-336,-25.36,1189
2020-03-11,989,1329,-340,-25.58,1189
2020-03-12,989,1331,-342,-25.69,1189
2020-03-13,854,1097,-243,-22.15,1189
2020-03-14,235,313,-78,-24.92,1189
2020-03-15,148,181,-33,-18.23,1189
2020-03-16,1007,1371,-364,-26.55,1189
2020-03-17,989,1339,-350,-26.14,1189
2020-03-18,989,1342,-353,-26.3,1189
2020-03-19,989,1343,-354,-26.36,1189
2020-03-20,854,1108,-254,-22.92,1189
2020-03-21,235,324,-89,-27.47,1189
2020-03-22,148,192,-44,-22.92,1189
2020-03-23,1007,1383,-376,-27.19,1189
2020-03-24,989,1352,-363,-26.85,1189
2020-03-25,989,1356,-367,-27.06,1189
2020-03-26,989,1359,-370,-27.23,1189
2020-03-27,854,1126,-272,-24.16,1189
2020-03-28,235,345,-110,-31.88,1189
2020-03-29,148,215,-67,-31.16,1189
2020-03-30,1007,1408,-401,-28.48,1189
2020-03-31,989,1380,-391,-28.33,1189
2020-04-01,1050,1386,-336,-24.24,1189
2020-04-02,1050,1391,-341,-24.51,1189
2020-04-03,805,1160,-355,-30.6,1189
2020-04-04,222,380,-158,-41.58,1189
2020-04-05,121,252,-131,-51.98,1189
2020-04-06,1074,1446,-372,-25.73,1189
2020-04-07,1050,1418,-368,-25.95,1189
2020-04-08,1050,1424,-374,-26.26,1189
2020-04-09,1050,1429,-379,-26.52,1189
2020-04-10,805,1197,-392,-32.75,1189
2020-04-11,222,415,-193,-46.51,1189
2020-04-12,121,285,-164,-57.54,1189
2020-04-13,1074,1477,-403,-27.29,1189
2020-04-14,1050,1447,-397,-27.44,1189
2020-04-15,1050,1450,-400,-27.59,1189
2020-04-16,1050,1452,-402,-27.69,1189
2020-04-17,805,1217,-412,-33.85,1189
2020-04-18,222,432,-210,-48.61,1189
2020-04-19,121,299,-178,-59.53,1189
2020-04-20,1074,1487,-413,-27.77,1189
2020-04-21,1050,1454,-404,-27.79,1189
2020-04-22,1050,1455,-405,-27.84,1189
2020-04-23,1050,1454,-404,-27.79,1189
2020-04-24,805,1217,-412,-33.85,1189
2020-04-25,222,430,-208,-48.37,1189
2020-04-26,121,295,-174,-58.98,1189
2020-04-27,1074,1482,-408,-27.53,1189
2020-04-28,1050,1448,-398,-27.49,1189
2020-04-29,1050,1448,-398,-27.49,1189
2020-04-30,1050,1448,-398,-27.49,1189
2020-05-01,1101,1211,-110,-9.08,1189
2020-05-02,327,424,-97,-22.88,1189
2020-05-03,150,290,-140,-48.28,1189
2020-05-04,1388,1479,-91,-6.15,1189
2020-05-05,1420,1446,-26,-1.8,1189
2020-05-06,1420,1448,-28,-1.93,1189
2020-05-07,1420,1449,-29,-2.0,1189
2020-05-08,1101,1213,-112,-9.23,1189
2020-05-09,327,428,-101,-23.6,1189
2020-05-10,150,295,-145,-49.15,1189
2020-05-11,1388,1485,-97,-6.53,1189
2020-05-12,1420,1453,-33,-2.27,1189
2020-05-13,1420,1456,-36,-2.47,1189
2020-05-14,1420,1457,-37,-2.54,1189
2020-05-15,1101,1222,-121,-9.9,1189
2020-05-16,327,437,-110,-25.17,1189
2020-05-17,150,304,-154,-50.66,1189
2020-05-18,1388,1494,-106,-7.1,1189
2020-05-19,1420,1461,-41,-2.81,1189
2020-05-20,1420,1463,-43,-2.94,1189
2020-05-21,1420,1464,-44,-3.01,1189
2020-05-22,1101,1228,-127,-10.34,1189
2020-05-23,327,442,-115,-26.02,1189
2020-05-24,150,308,-158,-51.3,1189
2020-05-25,1388,1497,-109,-7.28,1189
2020-05-26,1420,1463,-43,-2.94,1189
2020-05-27,1420,1465,-45,-3.07,1189
2020-05-28,1420,1465,-45,-3.07,1189
2020-05-29,1101,1228,-127,-10.34,1189
2020-05-30,327,443,-116,-26.19,1189
2020-05-31,150,309,-159,-51.46,1189
2020-06-01,1502,1498,4,0.27,1189
2020-06-02,1547,1465,82,5.6,1189
2020-06-03,1547,1467,80,5.45,1189
2020-06-04,1547,1468,79,5.38,1189
2020-06-05,1176,1232,-56,-4.55,1189
2020-06-06,347,447,-100,-22.37,1189
2020-06-07,170,315,-145,-46.03,1189
2020-06-08,1502,1504,-2,-0.13,1189
2020-06-09,1547,1472,75,5.1,1189
2020-06-10,1547,1475,72,4.88,1189
2020-06-11,1547,1477,70,4.74,1189
2020-06-12,1176,1241,-65,-5.24,1189
2020-06-13,347,456,-109,-23.9,1189
2020-06-14,170,324,-154,-47.53,1189
2020-06-15,1502,1513,-11,-0.73,1189
2020-06-16,1547,1480,67,4.53,1189
2020-06-17,1547,1481,66,4.46,1189
2020-06-18,1547,1481,66,4.46,1189
2020-06-19,1176,1243,-67,-5.39,1189
2020-06-20,347,456,-109,-23.9,1189
2020-06-21,170,320,-150,-46.88,1189
2020-06-22,1502,1506,-4,-0.27,1189
2020-06-23,1547,1470,77,5.24,1189
2020-06-24,1547,1468,79,5.38,1189
2020-06-25,1547,1464,83,5.67,1189
2020-06-26,1176,1224,-48,-3.92,1189
2020-06-27,347,433,-86,-19.86,1189
2020-06-28,170,295,-125,-42.37,1189
2020-06-29,1502,1478,24,1.62,1189
2020-06-30,1547,1439,108,7.51,1189
2020-07-01,1435,1435,0,0.0,1189
2020-07-02,1435,1430,5,0.35,1189
2020-07-03,1192,1188,4,0.34,1189
2020-07-04,329,397,-68,-17.13,1189
2020-07-05,172,259,-87,-33.59,1189
2020-07-06,1488,1443,45,3.12,1189
2020-07-07,1435,1405,30,2.14,1189
2020-07-08,1435,1403,32,2.28,1189
2020-07-09,1435,1399,36,2.57,1189
2020-07-10,1192,1160,32,2.76,1189
2020-07-11,329,372,-43,-11.56,1189
2020-07-12,172,237,-65,-27.43,1189
2020-07-13,1488,1424,64,4.49,1189
2020-07-14,1435,1390,45,3.24,1189
2020-07-15,1435,1391,44,3.16,1189
2020-07-16,1435,1391,44,3.16,1189
2020-07-17,1192,1155,37,3.2,1189
2020-07-18,329,370,-41,-11.08,1189
2020-07-19,172,238,-66,-27.73,1189
2020-07-20,1488,1427,61,4.27,1189
2020-07-21,1435,1395,40,2.87,1189
2020-07-22,1435,1397,38,2.72,1189
2020-07-23,1435,1398,37,2.65,1189
2020-07-24,1192,1163,29,2.49,1189
2020-07-25,329,377,-48,-12.73,1189
2020-07-26,172,243,-71,-29.22,1189
2020-07-27,1488,1431,57,3.98,1189
2020-07-28,1435,1397,38,2.72,1189
2020-07-29,1435,1397,38,2.72,1189
2020-07-30,1435,1395,40,2.87,1189
2020-07-31,1192,1156,36,3.11,1189
2020-08-01,328,367,-39,-10.63,1189
2020-08-02,177,230,-53,-23.04,1189
2020-08-03,1459,1414,45,3.18,1189
2020-08-04,1401,1377,24,1.74,1189
2020-08-05,1401,1374,27,1.97,1189
2020-08-06,1401,1369,32,2.34,1189
2020-08-07,1101,1128,-27,-2.39,1189
2020-08-08,328,337,-9,-2.67,1189
2020-08-09,177,199,-22,-11.06,1189
2020-08-10,1459,1383,76,5.5,1189
2020-08-11,1401,1346,55,4.09,1189
2020-08-12,1401,1344,57,4.24,1189
2020-08-13,1401,1341,60,4.47,1189
2020-08-14,1101,1102,-1,-0.09,1189
2020-08-15,328,315,13,4.13,1189
2020-08-16,177,180,-3,-1.67,1189
2020-08-17,1459,1369,90,6.57,1189
2020-08-18,1401,1336,65,4.87,1189
2020-08-19,1401,1339,62,4.63,1189
2020-08-20,1401,1342,59,4.4,1189
2020-08-21,1101,1109,-8,-0.72,1189
2020-08-22,328,327,1,0.31,1189
2020-08-23,177,198,-21,-10.61,1189
2020-08-24,1459,1392,67,4.81,1189
2020-08-25,1401,1365,36,2.64,1189
2020-08-26,1401,1373,28,2.04,1189
2020-08-27,1401,1380,21,1.52,1189
2020-08-28,1101,1150,-49,-4.26,1189
2020-08-29,328,372,-44,-11.83,1189
2020-08-30,177,245,-68,-27.76,1189
2020-08-31,1459,1441,18,1.25,1189
2020-09-01,1568,1414,154,10.89,1189
2020-09-02,1568,1422,146,10.27,1189
2020-09-03,1568,1428,140,9.8,1189
2020-09-04,1240,1197,43,3.59,1189
2020-09-05,318,416,-98,-23.56,1189
2020-09-06,180,287,-107,-37.28,1189
2020-09-07,1476,1479,-3,-0.2,1189
2020-09-08,1568,1449,119,8.21,1189
2020-09-09,1568,1453,115,7.91,1189
2020-09-10,1568,1455,113,7.77,1189
2020-09-11,1240,1219,21,1.72,1189
2020-09-12,318,434,-116,-26.73,1189
2020-09-13,180,300,-120,-40.0,1189
2020-09-14,1476,1488,-12,-0.81,1189
2020-09-15,1568,1454,114,7.84,1189
2020-09-16,1568,1454,114,7.84,1189
2020-09-17,1568,1453,115,7.91,1189
2020-09-18,1240,1215,25,2.06,1189
2020-09-19,318,428,-110,-25.7,1189
2020-09-20,180,293,-113,-38.57,1189
2020-09-21,1476,1480,-4,-0.27,1189
2020-09-22,1568,1445,123,8.51,1189
2020-09-23,1568,1445,123,8.51,1189
2020-09-24,1568,1444,124,8.59,1189
2020-09-25,1240,1207,33,2.73,1189
2020-09-26,318,421,-103,-24.47,1189
2020-09-27,180,287,-107,-37.28,1189
2020-09-28,1476,1476,0,0.0,1189
2020-09-29,1568,1443,125,8.66,1189
2020-09-30,1568,1445,123,8.51,1189
2020-10-01,1512,1446,66,4.56,1189
2020-10-02,1233,1211,22,1.82,1189
2020-10-03,339,426,-87,-20.42,1189
2020-10-04,182,293,-111,-37.88,1189
2020-10-05,1585,1483,102,6.88,1189
2020-10-06,1512,1451,61,4.2,1189
2020-10-07,1512,1453,59,4.06,1189
2020-10-08,1512,1454,58,3.99,1189
2020-10-09,1233,1218,15,1.23,1189
2020-10-10,339,432,-93,-21.53,1189
2020-10-11,182,298,-116,-38.93,1189
2020-10-12,1585,1486,99,6.66,1189
2020-10-13,1512,1453,59,4.06,1189
2020-10-14,1512,1453,59,4.06,1189
2020-10-15,1512,1452,60,4.13,1189
2020-10-16,1233,1214,19,1.57,1189
2020-10-17,339,426,-87,-20.42,1189
2020-10-18,182,291,-109,-37.46,1189
2020-10-19,1585,1477,108,7.31,1189
2020-10-20,1512,1442,70,4.85,1189
2020-10-21,1512,1441,71,4.93,1189
2020-10-22,1512,1440,72,5.0,1189
2020-10-23,1233,1202,31,2.58,1189
2020-10-24,339,414,-75,-18.12,1189
2020-10-25,182,280,-98,-35.0,1189
2020-10-26,1585,1467,118,8.04,1189
2020-10-27,1512,1434,78,5.44,1189
2020-10-28,1512,1435,77,5.37,1189
2020-10-29,1512,1436,76,5.29,1189
2020-10-30,1233,1200,33,2.75,1189
2020-10-31,339,416,-77,-18.51,1189
2020-11-01,173,283,-110,-38.87,1189
2020-11-02,1434,1474,-40,-2.71,1189
2020-11-03,1434,1443,-9,-0.62,1189
2020-11-04,1434,1447,-13,-0.9,1189
2020-11-05,1434,1450,-16,-1.1,1189
2020-11-06,1205,1216,-11,-0.9,1189
2020-11-07,321,433,-112,-25.87,1189
2020-11-08,173,301,-128,-42.52,1189
2020-11-09,1434,1492,-58,-3.89,1189
2020-11-10,1434,1461,-27,-1.85,1189
2020-11-11,1434,1463,-29,-1.98,1189
2020-11-12,1434,1464,-30,-2.05,1189
2020-11-13,1205,1228,-23,-1.87,1189
2020-11-14,321,442,-121,-27.38,1189
2020-11-15,173,307,-134,-43.65,1189
2020-11-16,1434,1493,-59,-3.95,1189
2020-11-17,1434,1457,-23,-1.58,1189
2020-11-18,1434,1454,-20,-1.38,1189
2020-11-19,1434,1450,-16,-1.1,1189
2020-11-20,1205,1208,-3,-0.25,1189
2020-11-21,321,416,-95,-22.84,1189
2020-11-22,173,275,-102,-37.09,1189
2020-11-23,1434,1456,-22,-1.51,1189
2020-11-24,1434,1414,20,1.41,1189
2020-11-25,1434,1407,27,1.92,1189
2020-11-26,1434,1398,36,2.58,1189
2020-11-27,1205,1152,53,4.6,1189
2020-11-28,321,357,-36,-10.08,1189
2020-11-29,173,214,-41,-19.16,1189
2020-11-30,1434,1393,41,2.94,1189
2020-12-01,1112,1351,-239,-17.69,1189
2020-12-02,1112,1343,-231,-17.2,1189
2020-12-03,1112,1335,-223,-16.7,1189
2020-12-04,1206,1091,115,10.54,1189
2020-12-05,346,297,49,16.5,1189
2020-12-06,172,157,15,9.55,1189
2020-12-07,1090,1339,-249,-18.6,1189
2020-12-08,1112,1301,-189,-14.53,1189
2020-12-09,1112,1297,-185,-14.26,1189
2020-12-10,1112,1294,-182,-14.06,1189
2020-12-11,1206,1054,152,14.42,1189
2020-12-12,346,265,81,30.57,1189
2020-12-13,172,129,43,33.33,1189
2020-12-14,1090,1315,-225,-17.11,1189
2020-12-15,1112,1281,-169,-13.19,1189
2020-12-16,1112,1281,-169,-13.19,1189
2020-12-17,1112,1280,-168,-13.12,1189
2020-12-18,1206,1042,164,15.74,1189
2020-12-19,346,255,91,35.69,1189
2020-12-20,172,120,52,43.33,1189
2020-12-21,1090,1307,-217,-16.6,1189
2020-12-22,1112,1272,-160,-12.58,1189
2020-12-23,1112,1272,-160,-12.58,1189
2020-12-24,1112,1269,-157,-12.37,1189
2020-12-25,1206,1030,176,17.09,1189
2020-12-26,346,241,105,43.57,1189
2020-12-27,172,103,69,66.99,1189
2020-12-28,1090,1288,-198,-15.37,1189
2020-12-29,1112,1250,-138,-11.04,1189
2020-12-30,1112,1246,-134,-10.75,1189
2020-12-31,1112,1241,-129,-10.39,1189
2021-01-01,931,999,-68,-6.81,1189
2021-01-02,272,208,64,30.77,1189
2021-01-03,159,68,91,133.82,1189
2021-01-04,999,1251,-252,-20.14,1189
2021-01-05,1120,1212,-92,-7.59,1189
2021-01-06,1120,1208,-88,-7.28,1189
2021-01-07,1120,1203,-83,-6.9,1189
2021-01-08,931,962,-31,-3.22,1189
2021-01-09,272,172,100,58.14,1189
2021-01-10,159,34,125,367.65,1189
2021-01-11,999,1220,-221,-18.11,1189
2021-01-12,1120,1184,-64,-5.41,1189
2021-01-13,1120,1184,-64,-5.41,1189
2021-01-14,1120,1183,-63,-5.33,1189
2021-01-15,931,946,-15,-1.59,1189
2021-01-16,272,161,111,68.94,1189
2021-01-17,159,28,131,467.86,1189
2021-01-18,999,1218,-219,-17.98,1189
2021-01-19,1120,1187,-67,-5.64,1189
2021-01-20,1120,1192,-72,-6.04,1189
2021-01-21,1120,1195,-75,-6.28,1189
2021-01-22,931,962,-31,-3.22,1189
2021-01-23,272,181,91,50.28,1189
2021-01-24,159,51,108,211.76,1189
2021-01-25,999,1244,-245,-19.69,1189
2021-01-26,1120,1215,-95,-7.82,1189
2021-01-27,1120,1221,-101,-8.27,1189
2021-01-28,1120,1225,-105,-8.57,1189
2021-01-29,931,993,-62,-6.24,1189
2021-01-30,272,211,61,28.91,1189
2021-01-31,159,81,78,96.3,1189
2021-02-01,1284,1273,11,0.86,1189
2021-02-02,1259,1243,16,1.29,1189
2021-02-03,1259,1247,12,0.96,1189
2021-02-04,1259,1249,10,0.8,1189
2021-02-05,1049,1015,34,3.35,1189
2021-02-06,310,231,79,34.2,1189
2021-02-07,166,99,67,67.68,1189
2021-02-08,1284,1289,-5,-0.39,1189
2021-02-09,1259,1258,1,0.08,1189
2021-02-10,1259,1260,-1,-0.08,1189
2021-02-11,1259,1262,-3,-0.24,1189
2021-02-12,1049,1027,22,2.14,1189
2021-02-13,310,243,67,27.57,1189
2021-02-14,166,111,55,49.55,1189
2021-02-15,1284,1302,-18,-1.38,1189
2021-02-16,1259,1271,-12,-0.94,1189
2021-02-17,1259,1275,-16,-1.25,1189
2021-02-18,1259,1278,-19,-1.49,1189
2021-02-19,1049,1045,4,0.38,1189
2021-02-20,310,263,47,17.87,1189
2021-02-21,166,134,32,23.88,1189
2021-02-22,1284,1327,-43,-3.24,1189
2021-02-23,1259,1298,-39,-3.0,1189
2021-02-24,1259,1305,-46,-3.52,1189
2021-02-25,1259,1310,-51,-3.89,1189
2021-02-26,1049,1079,-30,-2.78,1189
2021-02-27,310,299,11,3.68,1189
2021-02-28,166,171,-5,-2.92,1189
2021-03-01,1382,1365,17,1.25,1189
2021-03-02,1385,1338,47,3.51,1189
2021-03-03,1385,1344,41,3.05,1189
2021-03-04,1385,1350,35,2.59,1189
2021-03-05,1161,1118,43,3.85,1189
2021-03-06,324,337,-13,-3.86,1189
2021-03-07,177,208,-31,-14.9,1189
2021-03-08,1382,1400,-18,-1.29,1189
2021-03-09,1385,1370,15,1.09,1189
2021-03-10,1385,1375,10,0.73,1189
2021-03-11,1385,1378,7,0.51,1189
2021-03-12,1161,1144,17,1.49,1189
2021-03-13,324,360,-36,-10.0,1189
2021-03-14,177,229,-52,-22.71,1189
2021-03-15,1382,1419,-37,-2.61,1189
2021-03-16,1385,1387,-2,-0.14,1189
2021-03-17,1385,1390,-5,-0.36,1189
2021-03-18,1385,1391,-6,-0.43,1189
2021-03-19,1161,1156,5,0.43,1189
2021-03-20,324,372,-48,-12.9,1189
2021-03-21,177,240,-63,-26.25,1189
2021-03-22,1382,1430,-48,-3.36,1189
2021-03-23,1385,1399,-14,-1.0,1189
2021-03-24,1385,1403,-18,-1.28,1189
2021-03-25,1385,1405,-20,-1.42,1189
2021-03-26,1161,1172,-11,-0.94,1189
2021-03-27,324,390,-66,-16.92,1189
2021-03-28,177,260,-83,-31.92,1189
2021-03-29,1382,1452,-70,-4.82,1189
2021-03-30,1385,1423,-38,-2.67,1189
2021-03-31,1385,1429,-44,-3.08,1189
2021-04-01,1469,1435,34,2.37,1189
2021-04-02,1172,1203,-31,-2.58,1189
2021-04-03,355,423,-68,-16.08,1189
2021-04-04,161,295,-134,-45.42,1189
2021-04-05,1521,1489,32,2.15,1189
2021-04-06,1469,1461,8,0.55,1189
2021-04-07,1469,1467,2,0.14,1189
2021-04-08,1469,1473,-4,-0.27,1189
2021-04-09,1172,1241,-69,-5.56,1189
2021-04-10,355,460,-105,-22.83,1189
2021-04-11,161,330,-169,-51.21,1189
2021-04-12,1521,1523,-2,-0.13,1189
2021-04-13,1469,1493,-24,-1.61,1189
2021-04-14,1469,1497,-28,-1.87,1189
2021-04-15,1469,1500,-31,-2.07,1189
2021-04-16,1172,1265,-93,-7.35,1189
2021-04-17,355,481,-126,-26.2,1189
2021-04-18,161,348,-187,-53.74,1189
2021-04-19,1521,1537,-16,-1.04,1189
2021-04-20,1469,1504,-35,-2.33,1189
2021-04-21,1469,1505,-36,-2.39,1189
2021-04-22,1469,1505,-36,-2.39,1189
2021-04-23,1172,1268,-96,-7.57,1189
2021-04-24,355,481,-126,-26.2,1189
2021-04-25,161,346,-185,-53.47,1189
2021-04-26,1521,1534,-13,-0.85,1189
2021-04-27,1469,1499,-30,-2.0,1189
2021-04-28,1469,1499,-30,-2.0,1189
2021-04-29,1469,1499,-30,-2.0,1189
2021-04-30,1172,1261,-89,-7.06,1189
2021-05-01,379,475,-96,-20.21,1189
2021-05-02,175,341,-166,-48.68,1189
2021-05-03,1566,1529,37,2.42,1189
2021-05-04,1513,1496,17,1.14,1189
2021-05-05,1513,1497,16,1.07,1189
2021-05-06,1513,1498,15,1.0,1189
2021-05-07,1196,1262,-66,-5.23,1189
2021-05-08,379,477,-98,-20.55,1189
2021-05-09,175,344,-169,-49.13,1189
2021-05-10,1566,1533,33,2.15,1189
2021-05-11,1513,1501,12,0.8,1189
2021-05-12,1513,1504,9,0.6,1189
2021-05-13,1513,1505,8,0.53,1189
2021-05-14,1196,1270,-74,-5.83,1189
2021-05-15,379,486,-107,-22.02,1189
2021-05-16,175,353,-178,-50.42,1189
2021-05-17,1566,1542,24,1.56,1189
2021-05-18,1513,1510,3,0.2,1189
2021-05-19,1513,1512,1,0.07,1189
2021-05-20,1513,1513,0,0.0,1189
2021-05-21,1196,1277,-81,-6.34,1189
2021-05-22,379,492,-113,-22.97,1189
2021-05-23,175,358,-183,-51.12,1189
2021-05-24,1566,1547,19,1.23,1189
2021-05-25,1513,1513,0,0.0,1189
2021-05-26,1513,1515,-2,-0.13,1189
2021-05-27,1513,1515,-2,-0.13,1189
2021-05-28,1196,1278,-82,-6.42,1189
2021-05-29,379,492,-113,-22.97,1189
2021-05-30,175,359,-184,-51.25,1189
2021-05-31,1566,1547,19,1.23,1189
2021-06-01,1504,1514,-10,-0.66,1189
2021-06-02,1504,1516,-12,-0.79,1189
2021-06-03,1504,1517,-13,-0.86,1189
2021-06-04,1198,1281,-83,-6.48,1189
2021-06-05,332,496,-164,-33.06,1189
2021-06-06,184,363,-179,-49.31,1189
2021-06-07,1490,1553,-63,-4.06,1189
2021-06-08,1504,1521,-17,-1.12,1189
2021-06-09,1504,1523,-19,-1.25,1189
2021-06-10,1504,1525,-21,-1.38,1189
2021-06-11,1198,1289,-91,-7.06,1189
2021-06-12,332,505,-173,-34.26,1189
2021-06-13,184,372,-188,-50.54,1189
2021-06-14,1490,1562,-72,-4.61,1189
2021-06-15,1504,1529,-25,-1.64,1189
2021-06-16,1504,1531,-27,-1.76,1189
2021-06-17,1504,1531,-27,-1.76,1189
2021-06-18,1198,1294,-96,-7.42,1189
2021-06-19,332,507,-175,-34.52,1189
2021-06-20,184,372,-188,-50.54,1189
2021-06-21,1490,1559,-69,-4.43,1189
2021-06-22,1504,1524,-20,-1.31,1189
2021-06-23,1504,1522,-18,-1.18,1189
2021-06-24,1504,1519,-15,-0.99,1189
2021-06-25,1198,1279,-81,-6.33,1189
2021-06-26,332,489,-157,-32.11,1189
2021-06-27,184,351,-167,-47.58,1189
2021-06-28,1490,1534,-44,-2.87,1189
2021-06-29,1504,1496,8,0.53,1189
2021-06-30,1504,1492,12,0.8,1189
2021-07-01,1450,1487,-37,-2.49,1189
2021-07-02,1163,1245,-82,-6.59,1189
2021-07-03,303,454,-151,-33.26,1189
2021-07-04,168,315,-147,-46.67,1189
2021-07-05,1478,1498,-20,-1.34,1189
2021-07-06,1450,1460,-10,-0.68,1189
2021-07-07,1450,1457,-7,-0.48,1189
2021-07-08,1450,1454,-4,-0.28,1189
2021-07-09,1163,1214,-51,-4.2,1189
2021-07-10,303,425,-122,-28.71,1189
2021-07-11,168,289,-121,-41.87,1189
2021-07-12,1478,1475,3,0.2,1189
2021-07-13,1450,1441,9,0.62,1189
2021-07-14,1450,1441,9,0.62,1189
2021-07-15,1450,1441,9,0.62,1189
2021-07-16,1163,1205,-42,-3.49,1189
2021-07-17,303,419,-116,-27.68,1189
2021-07-18,168,286,-118,-41.26,1189
2021-07-19,1478,1476,2,0.14,1189
2021-07-20,1450,1443,7,0.49,1189
2021-07-21,1450,1446,4,0.28,1189
2021-07-22,1450,1447,3,0.21,1189
2021-07-23,1163,1212,-49,-4.04,1189
2021-07-24,303,426,-123,-28.87,1189
2021-07-25,168,293,-125,-42.66,1189
2021-07-26,1478,1482,-4,-0.27,1189
2021-07-27,1450,1448,2,0.14,1189
2021-07-28,1450,1448,2,0.14,1189
2021-07-29,1450,1447,3,0.21,1189
2021-07-30,1163,1209,-46,-3.8,1189
2021-07-31,303,421,-118,-28.03,1189
2021-08-01,176,284,-108,-38.03,1189
2021-08-02,1347,1469,-122,-8.3,1189
2021-08-03,1331,1432,-101,-7.05,1189
2021-08-04,1331,1429,-98,-6.86,1189
2021-08-05,1331,1425,-94,-6.6,1189
2021-08-06,1066,1184,-118,-9.97,1189
2021-08-07,294,393,-99,-25.19,1189
2021-08-08,176,255,-79,-30.98,1189
2021-08-09,1347,1438,-91,-6.33,1189
2021-08-10,1331,1401,-70,-5.0,1189
2021-08-11,1331,1398,-67,-4.79,1189
2021-08-12,1331,1395,-64,-4.59,1189
2021-08-13,1066,1155,-89,-7.71,1189
2021-08-14,294,367,-73,-19.89,1189
2021-08-15,176,231,-55,-23.81,1189
2021-08-16,1347,1419,-72,-5.07,1189
2021-08-17,1331,1385,-54,-3.9,1189
2021-08-18,1331,1387,-56,-4.04,1189
2021-08-19,1331,1389,-58,-4.18,1189
2021-08-20,1066,1155,-89,-7.71,1189
2021-08-21,294,372,-78,-20.97,1189
2021-08-22,176,242,-66,-27.27,1189
2021-08-23,1347,1435,-88,-6.13,1189
2021-08-24,1331,1407,-76,-5.4,1189
2021-08-25,1331,1415,-84,-5.94,1189
2021-08-26,1331,1421,-90,-6.33,1189
2021-08-27,1066,1191,-125,-10.5,1189
2021-08-28,294,413,-119,-28.81,1189
2021-08-29,176,286,-110,-38.46,1189
2021-08-30,1347,1482,-135,-9.11,1189
2021-08-31,1331,1456,-125,-8.59,1189
2021-09-01,1500,1464,36,2.46,1189
2021-09-02,1500,1470,30,2.04,1189
2021-09-03,1222,1240,-18,-1.45,1189
2021-09-04,325,460,-135,-29.35,1189
2021-09-05,188,331,-143,-43.2,1189
2021-09-06,1570,1524,46,3.02,1189
2021-09-07,1500,1495,5,0.33,1189
2021-09-08,1500,1500,0,0.0,1189
2021-09-09,1500,1502,-2,-0.13,1189
2021-09-10,1222,1268,-46,-3.63,1189
2021-09-11,325,483,-158,-32.71,1189
2021-09-12,188,350,-162,-46.29,1189
2021-09-13,1570,1539,31,2.01,1189
2021-09-14,1500,1505,-5,-0.33,1189
2021-09-15,1500,1506,-6,-0.4,1189
2021-09-16,1500,1505,-5,-0.33,1189
2021-09-17,1222,1267,-45,-3.55,1189
2021-09-18,325,480,-155,-32.29,1189
2021-09-19,188,344,-156,-45.35,1189
2021-09-20,1570,1531,39,2.55,1189
2021-09-21,1500,1496,4,0.27,1189
2021-09-22,1500,1496,4,0.27,1189
2021-09-23,1500,1495,5,0.33,1189
2021-09-24,1222,1258,-36,-2.86,1189
2021-09-25,325,471,-146,-31.0,1189
2021-09-26,188,337,-149,-44.21,1189
2021-09-27,1570,1526,44,2.88,1189
2021-09-28,1500,1493,7,0.47,1189
2021-09-29,1500,1494,6,0.4,1189
2021-09-30,1500,1495,5,0.33,1189
2021-10-01,1242,1259,-17,-1.35,1189
2021-10-02,337,475,-138,-29.05,1189
2021-10-03,175,342,-167,-48.83,1189
2021-10-04,1395,1531,-136,-8.88,1189
2021-10-05,1479,1499,-20,-1.33,1189
2021-10-06,1479,1502,-23,-1.53,1189
2021-10-07,1479,1503,-24,-1.6,1189
2021-10-08,1242,1267,-25,-1.97,1189
2021-10-09,337,482,-145,-30.08,1189
2021-10-10,175,348,-173,-49.71,1189
2021-10-11,1395,1537,-142,-9.24,1189
2021-10-12,1479,1503,-24,-1.6,1189
2021-10-13,1479,1504,-25,-1.66,1189
2021-10-14,1479,1503,-24,-1.6,1189
2021-10-15,1242,1265,-23,-1.82,1189
2021-10-16,337,478,-141,-29.5,1189
2021-10-17,175,343,-168,-48.98,1189
2021-10-18,1395,1529,-134,-8.76,1189
2021-10-19,1479,1494,-15,-1.0,1189
2021-10-20,1479,1494,-15,-1.0,1189
2021-10-21,1479,1492,-13,-0.87,1189
2021-10-22,1242,1254,-12,-0.96,1189
2021-10-23,337,466,-129,-27.68,1189
2021-10-24,175,331,-156,-47.13,1189
2021-10-25,1395,1518,-123,-8.1,1189
2021-10-26,1479,1484,-5,-0.34,1189
2021-10-27,1479,1485,-6,-0.4,1189
2021-10-28,1479,1485,-6,-0.4,1189
2021-10-29,1242,1249,-7,-0.56,1189
2021-10-30,337,464,-127,-27.37,1189
2021-10-31,175,331,-156,-47.13,1189
2021-11-01,1410,1521,-111,-7.3,1189
2021-11-02,1401,1490,-89,-5.97,1189
2021-11-03,1401,1494,-93,-6.22,1189
2021-11-04,1401,1496,-95,-6.35,1189
2021-11-05,1134,1262,-128,-10.14,1189
2021-11-06,324,479,-155,-32.36,1189
2021-11-07,164,348,-184,-52.87,1189
2021-11-08,1410,1539,-129,-8.38,1189
2021-11-09,1401,1508,-107,-7.1,1189
2021-11-10,1401,1511,-110,-7.28,1189
2021-11-11,1401,1513,-112,-7.4,1189
2021-11-12,1134,1277,-143,-11.2,1189
2021-11-13,324,492,-168,-34.15,1189
2021-11-14,164,358,-194,-54.19,1189
2021-11-15,1410,1545,-135,-8.74,1189
2021-11-16,1401,1510,-109,-7.22,1189
2021-11-17,1401,1509,-108,-7.16,1189
2021-11-18,1401,1505,-104,-6.91,1189
2021-11-19,1134,1264,-130,-10.28,1189
2021-11-20,324,473,-149,-31.5,1189
2021-11-21,164,334,-170,-50.9,1189
2021-11-22,1410,1515,-105,-6.93,1189
2021-11-23,1401,1474,-73,-4.95,1189
2021-11-24,1401,1468,-67,-4.56,1189
2021-11-25,1401,1459,-58,-3.98,1189
2021-11-26,1134,1214,-80,-6.59,1189
2021-11-27,324,419,-95,-22.67,1189
2021-11-28,164,276,-112,-40.58,1189
2021-11-29,1410,1455,-45,-3.09,1189
2021-11-30,1401,1412,-11,-0.78,1189
2021-12-01,1027,1404,-377,-26.85,1189
2021-12-02,1027,1395,-368,-26.38,1189
2021-12-03,789,1150,-361,-31.39,1189
2021-12-04,296,356,-60,-16.85,1189
2021-12-05,152,215,-63,-29.3,1189
2021-12-06,1160,1397,-237,-16.96,1189
2021-12-07,1027,1357,-330,-24.32,1189
2021-12-08,1027,1353,-326,-24.09,1189
2021-12-09,1027,1349,-322,-23.87,1189
2021-12-10,789,1108,-319,-28.79,1189
2021-12-11,296,318,-22,-6.92,1189
2021-12-12,152,182,-30,-16.48,1189
2021-12-13,1160,1368,-208,-15.2,1189
2021-12-14,1027,1332,-305,-22.9,1189
2021-12-15,1027,1332,-305,-22.9,1189
2021-12-16,1027,1331,-304,-22.84,1189
2021-12-17,789,1093,-304,-27.81,1189
2021-12-18,296,306,-10,-3.27,1189
2021-12-19,152,172,-20,-11.63,1189
2021-12-20,1160,1359,-199,-14.64,1189
2021-12-21,1027,1324,-297,-22.43,1189
2021-12-22,1027,1324,-297,-22.43,1189
2021-12-23,1027,1322,-295,-22.31,1189
2021-12-24,789,1083,-294,-27.15,1189
2021-12-25,296,295,1,0.34,1189
2021-12-26,152,158,-6,-3.8,1189
2021-12-27,1160,1343,-183,-13.63,1189
2021-12-28,1027,1305,-278,-21.3,1189
2021-12-29,1027,1302,-275,-21.12,1189
2021-12-30,1027,1297,-270,-20.82,1189
2021-12-31,789,1056,-267,-25.28,1189
2022-01-01,273,264,9,3.41,1189
2022-01-02,145,125,20,16.0,1189
2022-01-03,1073,1308,-235,-17.97,1189
2022-01-04,1044,1269,-225,-17.73,1189
2022-01-05,1044,1264,-220,-17.41,1189
2022-01-06,1044,1259,-215,-17.08,1189
2022-01-07,918,1018,-100,-9.82,1189
2022-01-08,273,227,46,20.26,1189
2022-01-09,145,89,56,62.92,1189
2022-01-10,1073,1273,-200,-15.71,1189
2022-01-11,1044,1237,-193,-15.6,1189
2022-01-12,1044,1236,-192,-15.53,1189
2022-01-13,1044,1234,-190,-15.4,1189
2022-01-14,918,996,-78,-7.83,1189
2022-01-15,273,210,63,30.0,1189
2022-01-16,145,77,68,88.31,1189
2022-01-17,1073,1266,-193,-15.24,1189
2022-01-18,1044,1234,-190,-15.4,1189
2022-01-19,1044,1238,-194,-15.67,1189
2022-01-20,1044,1241,-197,-15.87,1189
2022-01-21,918,1008,-90,-8.93,1189
2022-01-22,273,225,48,21.33,1189
2022-01-23,145,96,49,51.04,1189
2022-01-24,1073,1288,-215,-16.69,1189
2022-01-25,1044,1259,-215,-17.08,1189
2022-01-26,1044,1265,-221,-17.47,1189
2022-01-27,1044,1270,-226,-17.8,1189
2022-01-28,918,1038,-120,-11.56,1189
2022-01-29,273,256,17,6.64,1189
2022-01-30,145,126,19,15.08,1189
2020-02-01,141,77,64,83.12,1190
2020-02-02,63,1,62,6200.0,1190
2020-02-03,532,519,13,2.5,1190
2020-02-04,545,529,16,3.02,1190
2020-02-05,545,531,14,2.64,1190
2020-02-06,545,532,13,2.44,1190
2020-02-07,474,453,21,4.64,1190
2020-02-08,141,88,53,60.23,1190
2020-02-09,63,11,52,472.73,1190
2020-02-10,532,528,4,0.76,1190
2020-02-11,545,537,8,1.49,1190
2020-02-12,545,539,6,1.11,1190
2020-02-13,545,539,6,1.11,1190
2020-02-14,474,460,14,3.04,1190
2020-02-15,141,94,47,50.0,1190
2020-02-16,63,16,47,293.75,1190
2020-02-17,532,534,-2,-0.37,1190
2020-02-18,545,543,2,0.37,1190
2020-02-19,545,544,1,0.18,1190
2020-02-20,545,545,0,0.0,1190
2020-02-21,474,466,8,1.72,1190
2020-02-22,141,101,40,39.6,1190
2020-02-23,63,23,40,173.91,1190
2020-02-24,532,541,-9,-1.66,1190
2020-02-25,545,551,-6,-1.09,1190
2020-02-26,545,552,-7,-1.27,1190
2020-02-27,545,554,-9,-1.62,1190
2020-02-28,474,475,-1,-0.21,1190
2020-02-29,141,110,31,28.18,1190
2020-03-01,62,33,29,87.88,1190
2020-03-02,436,551,-115,-20.87,1190
2020-03-03,429,561,-132,-23.53,1190
2020-03-04,429,562,-133,-23.67,1190
2020-03-05,429,563,-134,-23.8,1190
2020-03-06,381,484,-103,-21.28,1190
2020-03-07,120,119,1,0.84,1190
2020-03-08,62,41,21,51.22,1190
2020-03-09,436,559,-123,-22.0,1190
2020-03-10,429,568,-139,-24.47,1190
2020-03-11,429,569,-140,-24.6,1190
2020-03-12,429,569,-140,-24.6,1190
2020-03-13,381,490,-109,-22.24,1190
2020-03-14,120,124,-4,-3.23,1190
2020-03-15,62,46,16,34.78,1190
2020-03-16,436,563,-127,-22.56,1190
2020-03-17,429,572,-143,-25.0,1190
2020-03-18,429,572,-143,-25.0,1190
2020-03-19,429,573,-144,-25.13,1190
2020-03-20,381,493,-112,-22.72,1190
2020-03-21,120,127,-7,-5.51,1190
2020-03-22,62,49,13,26.53,1190
2020-03-23,436,567,-131,-23.1,1190
2020-03-24,429,576,-147,-25.52,1190
2020-03-25,429,577,-148,-25.65,1190
2020-03-26,429,578,-149,-25.78,1190
2020-03-27,381,499,-118,-23.65,1190
2020-03-28,120,134,-14,-10.45,1190
2020-03-29,62,57,5,8.77,1190
2020-03-30,436,575,-139,-24.17,1190
2020-03-31,429,585,-156,-26.67,1190
2020-04-01,420,587,-167,-28.45,1190
2020-04-02,420,589,-169,-28.69,1190
2020-04-03,366,510,-144,-28.24,1190
2020-04-04,104,146,-42,-28.77,1190
2020-04-05,53,69,-16,-23.19,1190
2020-04-06,434,587,-153,-26.06,1190
2020-04-07,420,597,-177,-29.65,1190
2020-04-08,420,599,-179,-29.88,1190
2020-04-09,420,601,-181,-30.12,1190
2020-04-10,366,522,-156,-29.89,1190
2020-04-11,104,157,-53,-33.76,1190
2020-04-12,53,79,-26,-32.91,1190
2020-04-13,434,597,-163,-27.3,1190
2020-04-14,420,606,-186,-30.69,1190
2020-04-15,420,607,-187,-30.81,1190
2020-04-16,420,607,-187,-30.81,1190
2020-04-17,366,528,-162,-30.68,1190
2020-04-18,104,162,-58,-35.8,1190
2020-04-19,53,84,-31,-36.9,1190
2020-04-20,434,600,-166,-27.67,1190
2020-04-21,420,609,-189,-31.03,1190
2020-04-22,420,609,-189,-31.03,1190
2020-04-23,420,609,-189,-31.03,1190
2020-04-24,366,529,-163,-30.81,1190
2020-04-25,104,163,-59,-36.2,1190
2020-04-26,53,85,-32,-37.65,1190
2020-04-27,434,601,-167,-27.79,1190
2020-04-28,420,610,-190,-31.15,1190
2020-04-29,420,611,-191,-31.26,1190
2020-04-30,420,611,-191,-31.26,1190
2020-05-01,589,531,58,10.92,1190
2020-05-02,222,166,56,33.73,1190
2020-05-03,126,88,38,43.18,1190
2020-05-04,675,605,70,11.57,1190
2020-05-05,748,615,133,21.63,1190
2020-05-06,748,616,132,21.43,1190
2020-05-07,748,616,132,21.43,1190
2020-05-08,589,537,52,9.68,1190
2020-05-09,222,172,50,29.07,1190
2020-05-10,126,94,32,34.04,1190
2020-05-11,675,611,64,10.47,1190
2020-05-12,748,621,127,20.45,1190
2020-05-13,748,622,126,20.26,1190
2020-05-14,748,622,126,20.26,1190
2020-05-15,589,543,46,8.47,1190
2020-05-16,222,177,45,25.42,1190
2020-05-17,126,98,28,28.57,1190
2020-05-18,675,615,60,9.76,1190
2020-05-19,748,623,125,20.06,1190
2020-05-20,748,623,125,20.06,1190
2020-05-21,748,623,125,20.06,1190
2020-05-22,589,542,47,8.67,1190
2020-05-23,222,176,46,26.14,1190
2020-05-24,126,96,30,31.25,1190
2020-05-25,675,612,63,10.29,1190
2020-05-26,748,620,128,20.65,1190
2020-05-27,748,620,128,20.65,1190
2020-05-28,748,619,129,20.84,1190
2020-05-29,589,538,51,9.48,1190
2020-05-30,222,171,51,29.82,1190
2020-05-31,126,92,34,36.96,1190
2020-06-01,822,608,214,35.2,1190
2020-06-02,871,616,255,41.4,1190
2020-06-03,871,616,255,41.4,1190
2020-06-04,871,616,255,41.4,1190
2020-06-05,716,535,181,33.83,1190
2020-06-06,335,169,166,98.22,1190
2020-06-07,175,91,84,92.31,1190
2020-06-08,822,608,214,35.2,1190
2020-06-09,871,616,255,41.4,1190
2020-06-10,871,617,254,41.17,1190
2020-06-11,871,617,254,41.17,1190
2020-06-12,716,537,179,33.33,1190
2020-06-13,335,172,163,94.77,1190
2020-06-14,175,93,82,88.17,1190
2020-06-15,822,610,212,34.75,1190
2020-06-16,871,618,253,40.94,1190
2020-06-17,871,619,252,40.71,1190
2020-06-18,871,618,253,40.94,1190
2020-06-19,716,538,178,33.09,1190
2020-06-20,335,171,164,95.91,1190
2020-06-21,175,91,84,92.31,1190
2020-06-22,822,606,216,35.64,1190
2020-06-23,871,614,257,41.86,1190
2020-06-24,871,612,259,42.32,1190
2020-06-25,871,610,261,42.79,1190
2020-06-26,716,528,188,35.61,1190
2020-06-27,335,159,176,110.69,1190
2020-06-28,175,78,97,124.36,1190
2020-06-29,822,592,230,38.85,1190
2020-06-30,871,598,273,45.65,1190
2020-07-01,657,596,61,10.23,1190
2020-07-02,657,593,64,10.79,1190
2020-07-03,649,510,139,27.25,1190
2020-07-04,320,141,179,126.95,1190
2020-07-05,201,59,142,240.68,1190
2020-07-06,614,573,41,7.16,1190
2020-07-07,657,580,77,13.28,1190
2020-07-08,657,578,79,13.67,1190
2020-07-09,657,575,82,14.26,1190
2020-07-10,649,494,155,31.38,1190
2020-07-11,320,126,194,153.97,1190
2020-07-12,201,46,155,336.96,1190
2020-07-13,614,562,52,9.25,1190
2020-07-14,657,570,87,15.26,1190
2020-07-15,657,569,88,15.47,1190
2020-07-16,657,569,88,15.47,1190
2020-07-17,649,489,160,32.72,1190
2020-07-18,320,123,197,160.16,1190
2020-07-19,201,45,156,346.67,1190
2020-07-20,614,562,52,9.25,1190
2020-07-21,657,571,86,15.06,1190
2020-07-22,657,572,85,14.86,1190
2020-07-23,657,572,85,14.86,1190
2020-07-24,649,493,156,31.64,1190
2020-07-25,320,127,193,151.97,1190
2020-07-26,201,49,152,310.2,1190
2020-07-27,614,566,48,8.48,1190
2020-07-28,657,574,83,14.46,1190
2020-07-29,657,575,82,14.26,1190
2020-07-30,657,574,83,14.46,1190
2020-07-31,649,494,155,31.38,1190
2020-08-01,219,127,92,72.44,1190
2020-08-02,146,47,99,210.64,1190
2020-08-03,685,563,122,21.67,1190
2020-08-04,642,570,72,12.63,1190
2020-08-05,642,569,73,12.83,1190
2020-08-06,642,568,74,13.03,1190
2020-08-07,544,486,58,11.93,1190
2020-08-08,219,119,100,84.03,1190
2020-08-09,146,39,107,274.36,1190
2020-08-10,685,554,131,23.65,1190
2020-08-11,642,561,81,14.44,1190
2020-08-12,642,560,82,14.64,1190
2020-08-13,642,559,83,14.85,1190
2020-08-14,544,478,66,13.81,1190
2020-08-15,219,111,108,97.3,1190
2020-08-16,146,33,113,342.42,1190
2020-08-17,685,549,136,24.77,1190
2020-08-18,642,558,84,15.05,1190
2020-08-19,642,558,84,15.05,1190
2020-08-20,642,559,83,14.85,1190
2020-08-21,544,480,64,13.33,1190
2020-08-22,219,115,104,90.43,1190
2020-08-23,146,38,108,284.21,1190
2020-08-24,685,556,129,23.2,1190
2020-08-25,642,567,75,13.23,1190
2020-08-26,642,569,73,12.83,1190
2020-08-27,642,571,71,12.43,1190
2020-08-28,544,493,51,10.34,1190
2020-08-29,219,129,90,69.77,1190
2020-08-30,146,53,93,175.47,1190
2020-08-31,685,572,113,19.76,1190
2020-09-01,531,582,-51,-8.76,1190
2020-09-02,531,585,-54,-9.23,1190
2020-09-03,531,586,-55,-9.39,1190
2020-09-04,456,508,-52,-10.24,1190
2020-09-05,158,143,15,10.49,1190
2020-09-06,75,66,9,13.64,1190
2020-09-07,548,583,-35,-6.0,1190
2020-09-08,531,593,-62,-10.46,1190
2020-09-09,531,594,-63,-10.61,1190
2020-09-10,531,594,-63,-10.61,1190
2020-09-11,456,514,-58,-11.28,1190
2020-09-12,158,148,10,6.76,1190
2020-09-13,75,69,6,8.7,1190
2020-09-14,548,585,-37,-6.32,1190
2020-09-15,531,593,-62,-10.46,1190
2020-09-16,531,593,-62,-10.46,1190
2020-09-17,531,593,-62,-10.46,1190
2020-09-18,456,512,-56,-10.94,1190
2020-09-19,158,146,12,8.22,1190
2020-09-20,75,67,8,11.94,1190
2020-09-21,548,584,-36,-6.16,1190
2020-09-22,531,592,-61,-10.3,1190
2020-09-23,531,593,-62,-10.46,1190
2020-09-24,531,593,-62,-10.46,1190
2020-09-25,456,513,-57,-11.11,1190
2020-09-26,158,148,10,6.76,1190
2020-09-27,75,70,5,7.14,1190
2020-09-28,548,588,-40,-6.8,1190
2020-09-29,531,597,-66,-11.06,1190
2020-09-30,531,599,-68,-11.35,1190
2020-10-01,444,600,-156,-26.0,1190
2020-10-02,381,521,-140,-26.87,1190
2020-10-03,110,157,-47,-29.94,1190
2020-10-04,47,80,-33,-41.25,1190
2020-10-05,452,597,-145,-24.29,1190
2020-10-06,444,607,-163,-26.85,1190
2020-10-07,444,609,-165,-27.09,1190
2020-10-08,444,609,-165,-27.09,1190
2020-10-09,381,530,-149,-28.11,1190
2020-10-10,110,165,-55,-33.33,1190
2020-10-11,47,86,-39,-45.35,1190
2020-10-12,452,603,-151,-25.04,1190
2020-10-13,444,612,-168,-27.45,1190
2020-10-14,444,612,-168,-27.45,1190
2020-10-15,444,611,-167,-27.33,1190
2020-10-16,381,530,-149,-28.11,1190
2020-10-17,110,163,-53,-32.52,1190
2020-10-18,47,84,-37,-44.05,1190
2020-10-19,452,599,-147,-24.54,1190
2020-10-20,444,607,-163,-26.85,1190
2020-10-21,444,606,-162,-26.73,1190
2020-10-22,444,604,-160,-26.49,1190
2020-10-23,381,523,-142,-27.15,1190
2020-10-24,110,155,-45,-29.03,1190
2020-10-25,47,76,-29,-38.16,1190
2020-10-26,452,591,-139,-23.52,1190
2020-10-27,444,599,-155,-25.88,1190
2020-10-28,444,598,-154,-25.75,1190
2020-10-29,444,597,-153,-25.63,1190
2020-10-30,381,517,-136,-26.31,1190
2020-10-31,110,150,-40,-26.67,1190
2020-11-01,54,72,-18,-25.0,1190
2020-11-02,439,588,-149,-25.34,1190
2020-11-03,430,597,-167,-27.97,1190
2020-11-04,430,598,-168,-28.09,1190
2020-11-05,430,598,-168,-28.09,1190
2020-11-06,393,519,-126,-24.28,1190
2020-11-07,93,153,-60,-39.22,1190
2020-11-08,54,75,-21,-28.0,1190
2020-11-09,439,592,-153,-25.84,1190
2020-11-10,430,601,-171,-28.45,1190
2020-11-11,430,602,-172,-28.57,1190
2020-11-12,430,602,-172,-28.57,1190
2020-11-13,393,522,-129,-24.71,1190
2020-11-14,93,156,-63,-40.38,1190
2020-11-15,54,77,-23,-29.87,1190
2020-11-16,439,593,-154,-25.97,1190
2020-11-17,430,600,-170,-28.33,1190
2020-11-18,430,599,-169,-28.21,1190
2020-11-19,430,597,-167,-27.97,1190
2020-11-20,393,515,-122,-23.69,1190
2020-11-21,93,147,-54,-36.73,1190
2020-11-22,54,66,-12,-18.18,1190
2020-11-23,439,579,-140,-24.18,1190
2020-11-24,430,585,-155,-26.5,1190
2020-11-25,430,582,-152,-26.12,1190
2020-11-26,430,578,-148,-25.61,1190
2020-11-27,393,495,-102,-20.61,1190
2020-11-28,93,125,-32,-25.6,1190
2020-11-29,54,43,11,25.58,1190
2020-11-30,439,556,-117,-21.04,1190
2020-12-01,352,561,-209,-37.25,1190
2020-12-02,352,558,-206,-36.92,1190
2020-12-03,352,554,-202,-36.46,1190
2020-12-04,379,471,-92,-19.53,1190
2020-12-05,102,102,0,0.0,1190
2020-12-06,49,21,28,133.33,1190
2020-12-07,348,535,-187,-34.95,1190
2020-12-08,352,542,-190,-35.06,1190
2020-12-09,352,540,-188,-34.81,1190
2020-12-10,352,538,-186,-34.57,1190
2020-12-11,379,457,-78,-17.07,1190
2020-12-12,102,89,13,14.61,1190
2020-12-13,49,10,39,390.0,1190
2020-12-14,348,526,-178,-33.84,1190
2020-12-15,352,534,-182,-34.08,1190
2020-12-16,352,533,-181,-33.96,1190
2020-12-17,352,533,-181,-33.96,1190
2020-12-18,379,452,-73,-16.15,1190
2020-12-19,102,86,16,18.6,1190
2020-12-20,49,7,42,600.0,1190
2020-12-21,348,523,-175,-33.46,1190
2020-12-22,352,530,-178,-33.58,1190
2020-12-23,352,530,-178,-33.58,1190
2020-12-24,352,529,-177,-33.46,1190
2020-12-25,379,447,-68,-15.21,1190
2020-12-26,102,80,22,27.5,1190
2020-12-27,49,0,49,inf,1190
2020-12-28,348,514,-166,-32.3,1190
2020-12-29,352,521,-169,-32.44,1190
2020-12-30,352,519,-167,-32.18,1190
2020-12-31,352,517,-165,-31.91,1190
2021-01-01,290,434,-144,-33.18,1190
2021-01-02,87,66,21,31.82,1190
2021-01-03,46,29,17,58.62,1190
2021-01-04,328,499,-171,-34.27,1190
2021-01-05,339,505,-166,-32.87,1190
2021-01-06,339,503,-164,-32.6,1190
2021-01-07,339,500,-161,-32.2,1190
2021-01-08,290,418,-128,-30.62,1190
2021-01-09,87,50,37,74.0,1190
2021-01-10,46,25,21,84.0,1190
2021-01-11,328,485,-157,-32.37,1190
2021-01-12,339,492,-153,-31.1,1190
2021-01-13,339,492,-153,-31.1,1190
2021-01-14,339,491,-152,-30.96,1190
2021-01-15,290,411,-121,-29.44,1190
2021-01-16,87,44,43,97.73,1190
2021-01-17,46,24,22,91.67,1190
2021-01-18,328,483,-155,-32.09,1190
2021-01-19,339,493,-154,-31.24,1190
2021-01-20,339,495,-156,-31.52,1190
2021-01-21,339,496,-157,-31.65,1190
2021-01-22,290,418,-128,-30.62,1190
2021-01-23,87,53,34,64.15,1190
2021-01-24,46,29,17,58.62,1190
2021-01-25,328,496,-168,-33.87,1190
2021-01-26,339,506,-167,-33.0,1190
2021-01-27,339,509,-170,-33.4,1190
2021-01-28,339,511,-172,-33.66,1190
2021-01-29,290,433,-143,-33.03,1190
2021-01-30,87,69,18,26.09,1190
2021-01-31,46,36,10,27.78,1190
2021-02-01,385,511,-126,-24.66,1190
2021-02-02,380,522,-142,-27.2,1190
2021-02-03,380,524,-144,-27.48,1190
2021-02-04,380,525,-145,-27.62,1190
2021-02-05,325,446,-121,-27.13,1190
2021-02-06,89,81,8,9.88,1190
2021-02-07,45,4,41,1025.0,1190
2021-02-08,385,522,-137,-26.25,1190
2021-02-09,380,531,-151,-28.44,1190
2021-02-10,380,532,-152,-28.57,1190
2021-02-11,380,533,-153,-28.71,1190
2021-02-12,325,454,-129,-28.41,1190
2021-02-13,89,88,1,1.14,1190
2021-02-14,45,10,35,350.0,1190
2021-02-15,385,527,-142,-26.94,1190
2021-02-16,380,537,-157,-29.24,1190
2021-02-17,380,538,-158,-29.37,1190
2021-02-18,380,538,-158,-29.37,1190
2021-02-19,325,459,-134,-29.19,1190
2021-02-20,89,94,-5,-5.32,1190
2021-02-21,45,17,28,164.71,1190
2021-02-22,385,534,-149,-27.9,1190
2021-02-23,380,544,-164,-30.15,1190
2021-02-24,380,545,-165,-30.28,1190
2021-02-25,380,547,-167,-30.53,1190
2021-02-26,325,468,-143,-30.56,1190
2021-02-27,89,103,-14,-13.59,1190
2021-02-28,45,26,19,73.08,1190
2021-03-01,416,544,-128,-23.53,1190
2021-03-02,418,554,-136,-24.55,1190
2021-03-03,418,555,-137,-24.68,1190
2021-03-04,418,556,-138,-24.82,1190
2021-03-05,344,477,-133,-27.88,1190
2021-03-06,107,112,-5,-4.46,1190
2021-03-07,48,35,13,37.14,1190
2021-03-08,416,552,-136,-24.64,1190
2021-03-09,418,562,-144,-25.62,1190
2021-03-10,418,563,-145,-25.75,1190
2021-03-11,418,563,-145,-25.75,1190
2021-03-12,344,484,-140,-28.93,1190
2021-03-13,107,118,-11,-9.32,1190
2021-03-14,48,40,8,20.0,1190
2021-03-15,416,557,-141,-25.31,1190
2021-03-16,418,566,-148,-26.15,1190
2021-03-17,418,566,-148,-26.15,1190
2021-03-18,418,567,-149,-26.28,1190
2021-03-19,344,487,-143,-29.36,1190
2021-03-20,107,121,-14,-11.57,1190
2021-03-21,48,43,5,11.63,1190
2021-03-22,416,560,-144,-25.71,1190
2021-03-23,418,570,-152,-26.67,1190
2021-03-24,418,571,-153,-26.8,1190
2021-03-25,418,571,-153,-26.8,1190
2021-03-26,344,492,-148,-30.08,1190
2021-03-27,107,127,-20,-15.75,1190
2021-03-28,48,50,-2,-4.0,1190
2021-03-29,416,568,-152,-26.76,1190
2021-03-30,418,578,-160,-27.68,1190
2021-03-31,418,580,-162,-27.93,1190
2021-04-01,406,581,-175,-30.12,1190
2021-04-02,340,503,-163,-32.41,1190
2021-04-03,105,138,-33,-23.91,1190
2021-04-04,48,62,-14,-22.58,1190
2021-04-05,427,580,-153,-26.38,1190
2021-04-06,406,590,-184,-31.19,1190
2021-04-07,406,592,-186,-31.42,1190
2021-04-08,406,593,-187,-31.53,1190
2021-04-09,340,515,-175,-33.98,1190
2021-04-10,105,150,-45,-30.0,1190
2021-04-11,48,73,-25,-34.25,1190
2021-04-12,427,590,-163,-27.63,1190
2021-04-13,406,600,-194,-32.33,1190
2021-04-14,406,601,-195,-32.45,1190
2021-04-15,406,601,-195,-32.45,1190
2021-04-16,340,522,-182,-34.87,1190
2021-04-17,105,156,-51,-32.69,1190
2021-04-18,48,78,-30,-38.46,1190
2021-04-19,427,595,-168,-28.24,1190
2021-04-20,406,603,-197,-32.67,1190
2021-04-21,406,604,-198,-32.78,1190
2021-04-22,406,604,-198,-32.78,1190
2021-04-23,340,524,-184,-35.11,1190
2021-04-24,105,158,-53,-33.54,1190
2021-04-25,48,79,-31,-39.24,1190
2021-04-26,427,596,-169,-28.36,1190
2021-04-27,406,604,-198,-32.78,1190
2021-04-28,406,605,-199,-32.89,1190
2021-04-29,406,605,-199,-32.89,1190
2021-04-30,340,525,-185,-35.24,1190
2021-05-01,104,160,-56,-35.0,1190
2021-05-02,49,82,-33,-40.24,1190
2021-05-03,476,599,-123,-20.53,1190
2021-05-04,447,608,-161,-26.48,1190
2021-05-05,447,609,-162,-26.6,1190
2021-05-06,447,610,-163,-26.72,1190
2021-05-07,366,531,-165,-31.07,1190
2021-05-08,104,165,-61,-36.97,1190
2021-05-09,49,88,-39,-44.32,1190
2021-05-10,476,605,-129,-21.32,1190
2021-05-11,447,614,-167,-27.2,1190
2021-05-12,447,616,-169,-27.44,1190
2021-05-13,447,616,-169,-27.44,1190
2021-05-14,366,537,-171,-31.84,1190
2021-05-15,104,171,-67,-39.18,1190
2021-05-16,49,93,-44,-47.31,1190
2021-05-17,476,609,-133,-21.84,1190
2021-05-18,447,618,-171,-27.67,1190
2021-05-19,447,618,-171,-27.67,1190
2021-05-20,447,618,-171,-27.67,1190
2021-05-21,366,538,-172,-31.97,1190
2021-05-22,104,171,-67,-39.18,1190
2021-05-23,49,92,-43,-46.74,1190
2021-05-24,476,608,-132,-21.71,1190
2021-05-25,447,616,-169,-27.44,1190
2021-05-26,447,615,-168,-27.32,1190
2021-05-27,447,614,-167,-27.2,1190
2021-05-28,366,533,-167,-31.33,1190
2021-05-29,104,167,-63,-37.72,1190
2021-05-30,49,87,-38,-43.68,1190
2021-05-31,476,603,-127,-21.06,1190
2021-06-01,440,611,-171,-27.99,1190
2021-06-02,440,611,-171,-27.99,1190
2021-06-03,440,611,-171,-27.99,1190
2021-06-04,380,530,-150,-28.3,1190
2021-06-05,110,164,-54,-32.93,1190
2021-06-06,47,85,-38,-44.71,1190
2021-06-07,444,602,-158,-26.25,1190
2021-06-08,440,611,-171,-27.99,1190
2021-06-09,440,611,-171,-27.99,1190
2021-06-10,440,611,-171,-27.99,1190
2021-06-11,380,532,-152,-28.57,1190
2021-06-12,110,166,-56,-33.73,1190
2021-06-13,47,88,-41,-46.59,1190
2021-06-14,444,604,-160,-26.49,1190
2021-06-15,440,613,-173,-28.22,1190
2021-06-16,440,613,-173,-28.22,1190
2021-06-17,440,613,-173,-28.22,1190
2021-06-18,380,533,-153,-28.71,1190
2021-06-19,110,166,-56,-33.73,1190
2021-06-20,47,87,-40,-45.98,1190
2021-06-21,444,603,-159,-26.37,1190
2021-06-22,440,610,-170,-27.87,1190
2021-06-23,440,609,-169,-27.75,1190
2021-06-24,440,607,-167,-27.51,1190
2021-06-25,380,525,-145,-27.62,1190
2021-06-26,110,157,-47,-29.94,1190
2021-06-27,47,76,-29,-38.16,1190
2021-06-28,444,590,-146,-24.75,1190
2021-06-29,440,596,-156,-26.17,1190
2021-06-30,440,594,-154,-25.93,1190
2021-07-01,442,591,-149,-25.21,1190
2021-07-02,362,508,-146,-28.74,1190
2021-07-03,111,139,-28,-20.14,1190
2021-07-04,64,58,6,10.34,1190
2021-07-05,441,571,-130,-22.77,1190
2021-07-06,442,577,-135,-23.4,1190
2021-07-07,442,575,-133,-23.13,1190
2021-07-08,442,573,-131,-22.86,1190
2021-07-09,362,491,-129,-26.27,1190
2021-07-10,111,123,-12,-9.76,1190
2021-07-11,64,42,22,52.38,1190
2021-07-12,441,558,-117,-20.97,1190
2021-07-13,442,565,-123,-21.77,1190
2021-07-14,442,565,-123,-21.77,1190
2021-07-15,442,564,-122,-21.63,1190
2021-07-16,362,484,-122,-25.21,1190
2021-07-17,111,117,-6,-5.13,1190
2021-07-18,64,39,25,64.1,1190
2021-07-19,441,556,-115,-20.68,1190
2021-07-20,442,565,-123,-21.77,1190
2021-07-21,442,566,-124,-21.91,1190
2021-07-22,442,566,-124,-21.91,1190
2021-07-23,362,487,-125,-25.67,1190
2021-07-24,111,121,-10,-8.26,1190
2021-07-25,64,43,21,48.84,1190
2021-07-26,441,560,-119,-21.25,1190
2021-07-27,442,569,-127,-22.32,1190
2021-07-28,442,569,-127,-22.32,1190
2021-07-29,442,569,-127,-22.32,1190
2021-07-30,362,489,-127,-25.97,1190
2021-07-31,111,122,-11,-9.02,1190
2021-08-01,52,43,9,20.93,1190
2021-08-02,409,559,-150,-26.83,1190
2021-08-03,399,566,-167,-29.51,1190
2021-08-04,399,566,-167,-29.51,1190
2021-08-05,399,564,-165,-29.26,1190
2021-08-06,331,483,-152,-31.47,1190
2021-08-07,95,115,-20,-17.39,1190
2021-08-08,52,35,17,48.57,1190
2021-08-09,409,550,-141,-25.64,1190
2021-08-10,399,557,-158,-28.37,1190
2021-08-11,399,556,-157,-28.24,1190
2021-08-12,399,555,-156,-28.11,1190
2021-08-13,331,474,-143,-30.17,1190
2021-08-14,95,107,-12,-11.21,1190
2021-08-15,52,28,24,85.71,1190
2021-08-16,409,544,-135,-24.82,1190
2021-08-17,399,552,-153,-27.72,1190
2021-08-18,399,553,-154,-27.85,1190
2021-08-19,399,553,-154,-27.85,1190
2021-08-20,331,473,-142,-30.02,1190
2021-08-21,95,108,-13,-12.04,1190
2021-08-22,52,31,21,67.74,1190
2021-08-23,409,549,-140,-25.5,1190
2021-08-24,399,559,-160,-28.62,1190
2021-08-25,399,561,-162,-28.88,1190
2021-08-26,399,563,-164,-29.13,1190
2021-08-27,331,485,-154,-31.75,1190
2021-08-28,95,121,-26,-21.49,1190
2021-08-29,52,45,7,15.56,1190
2021-08-30,409,564,-155,-27.48,1190
2021-08-31,399,574,-175,-30.49,1190
2021-09-01,418,577,-159,-27.56,1190
2021-09-02,418,579,-161,-27.81,1190
2021-09-03,348,501,-153,-30.54,1190
2021-09-04,94,136,-42,-30.88,1190
2021-09-05,55,59,-4,-6.78,1190
2021-09-06,436,577,-141,-24.44,1190
2021-09-07,418,586,-168,-28.67,1190
2021-09-08,418,587,-169,-28.79,1190
2021-09-09,418,588,-170,-28.91,1190
2021-09-10,348,508,-160,-31.5,1190
2021-09-11,94,142,-48,-33.8,1190
2021-09-12,55,64,-9,-14.06,1190
2021-09-13,436,580,-144,-24.83,1190
2021-09-14,418,588,-170,-28.91,1190
2021-09-15,418,588,-170,-28.91,1190
2021-09-16,418,588,-170,-28.91,1190
2021-09-17,348,507,-159,-31.36,1190
2021-09-18,94,141,-47,-33.33,1190
2021-09-19,55,62,-7,-11.29,1190
2021-09-20,436,578,-142,-24.57,1190
2021-09-21,418,587,-169,-28.79,1190
2021-09-22,418,587,-169,-28.79,1190
2021-09-23,418,587,-169,-28.79,1190
2021-09-24,348,507,-159,-31.36,1190
2021-09-25,94,142,-48,-33.8,1190
2021-09-26,55,64,-9,-14.06,1190
2021-09-27,436,581,-145,-24.96,1190
2021-09-28,418,591,-173,-29.27,1190
2021-09-29,418,592,-174,-29.39,1190
2021-09-30,418,593,-175,-29.51,1190
2021-10-01,365,514,-149,-28.99,1190
2021-10-02,118,150,-32,-21.33,1190
2021-10-03,51,72,-21,-29.17,1190
2021-10-04,405,590,-185,-31.36,1190
2021-10-05,420,600,-180,-30.0,1190
2021-10-06,420,602,-182,-30.23,1190
2021-10-07,420,603,-183,-30.35,1190
2021-10-08,365,524,-159,-30.34,1190
2021-10-09,118,158,-40,-25.32,1190
2021-10-10,51,81,-30,-37.04,1190
2021-10-11,405,597,-192,-32.16,1190
2021-10-12,420,606,-186,-30.69,1190
2021-10-13,420,607,-187,-30.81,1190
2021-10-14,420,606,-186,-30.69,1190
2021-10-15,365,526,-161,-30.61,1190
2021-10-16,118,159,-41,-25.79,1190
2021-10-17,51,80,-29,-36.25,1190
2021-10-18,405,595,-190,-31.93,1190
2021-10-19,420,603,-183,-30.35,1190
2021-10-20,420,602,-182,-30.23,1190
2021-10-21,420,600,-180,-30.0,1190
2021-10-22,365,519,-154,-29.67,1190
2021-10-23,118,152,-34,-22.37,1190
2021-10-24,51,72,-21,-29.17,1190
2021-10-25,405,587,-182,-31.01,1190
2021-10-26,420,594,-174,-29.29,1190
2021-10-27,420,594,-174,-29.29,1190
2021-10-28,420,593,-173,-29.17,1190
2021-10-29,365,512,-147,-28.71,1190
2021-10-30,118,145,-27,-18.62,1190
2021-10-31,51,67,-16,-23.88,1190
2021-11-01,400,583,-183,-31.39,1190
2021-11-02,419,592,-173,-29.22,1190
2021-11-03,419,592,-173,-29.22,1190
2021-11-04,419,592,-173,-29.22,1190
2021-11-05,347,513,-166,-32.36,1190
2021-11-06,100,147,-47,-31.97,1190
2021-11-07,55,69,-14,-20.29,1190
2021-11-08,400,586,-186,-31.74,1190
2021-11-09,419,595,-176,-29.58,1190
2021-11-10,419,596,-177,-29.7,1190
2021-11-11,419,597,-178,-29.82,1190
2021-11-12,347,517,-170,-32.88,1190
2021-11-13,100,151,-51,-33.77,1190
2021-11-14,55,72,-17,-23.61,1190
2021-11-15,400,588,-188,-31.97,1190
2021-11-16,419,596,-177,-29.7,1190
2021-11-17,419,595,-176,-29.58,1190
2021-11-18,419,594,-175,-29.46,1190
2021-11-19,347,512,-165,-32.23,1190
2021-11-20,100,144,-44,-30.56,1190
2021-11-21,55,63,-8,-12.7,1190
2021-11-22,400,577,-177,-30.68,1190
2021-11-23,419,583,-164,-28.13,1190
2021-11-24,419,581,-162,-27.88,1190
2021-11-25,419,577,-158,-27.38,1190
2021-11-26,347,494,-147,-29.76,1190
2021-11-27,100,124,-24,-19.35,1190
2021-11-28,55,42,13,30.95,1190
2021-11-29,400,555,-155,-27.93,1190
2021-11-30,419,560,-141,-25.18,1190
2021-12-01,328,557,-229,-41.11,1190
2021-12-02,328,553,-225,-40.69,1190
2021-12-03,255,470,-215,-45.74,1190
2021-12-04,103,100,3,3.0,1190
2021-12-05,51,19,32,168.42,1190
2021-12-06,360,533,-173,-32.46,1190
2021-12-07,328,539,-211,-39.15,1190
2021-12-08,328,537,-209,-38.92,1190
2021-12-09,328,535,-207,-38.69,1190
2021-12-10,255,453,-198,-43.71,1190
2021-12-11,103,86,17,19.77,1190
2021-12-12,51,6,45,750.0,1190
2021-12-13,360,521,-161,-30.9,1190
2021-12-14,328,529,-201,-38.0,1190
2021-12-15,328,529,-201,-38.0,1190
2021-12-16,328,528,-200,-37.88,1190
2021-12-17,255,447,-192,-42.95,1190
2021-12-18,103,81,22,27.16,1190
2021-12-19,51,2,49,2450.0,1190
2021-12-20,360,518,-158,-30.5,1190
2021-12-21,328,526,-198,-37.64,1190
2021-12-22,328,526,-198,-37.64,1190
2021-12-23,328,525,-197,-37.52,1190
2021-12-24,255,444,-189,-42.57,1190
2021-12-25,103,76,27,35.53,1190
2021-12-26,51,97,-46,-47.42,1190
2021-12-27,360,511,-151,-29.55,1190
2021-12-28,328,518,-190,-36.68,1190
2021-12-29,328,517,-189,-36.56,1190
2021-12-30,328,514,-186,-36.19,1190
2021-12-31,255,432,-177,-40.97,1190
2022-01-01,86,64,22,34.38,1190
2022-01-02,43,87,-44,-50.57,1190
2022-01-03,321,496,-175,-35.28,1190
2022-01-04,326,503,-177,-35.19,1190
2022-01-05,326,500,-174,-34.8,1190
2022-01-06,326,498,-172,-34.54,1190
2022-01-07,287,415,-128,-30.84,1190
2022-01-08,86,47,39,82.98,1190
2022-01-09,43,81,-38,-46.91,1190
2022-01-10,321,481,-160,-33.26,1190
2022-01-11,326,488,-162,-33.2,1190
2022-01-12,326,487,-161,-33.06,1190
2022-01-13,326,486,-160,-32.92,1190
2022-01-14,287,406,-119,-29.31,1190
2022-01-15,86,39,47,120.51,1190
2022-01-16,43,80,-37,-46.25,1190
2022-01-17,321,477,-156,-32.7,1190
2022-01-18,326,487,-161,-33.06,1190
2022-01-19,326,488,-162,-33.2,1190
2022-01-20,326,489,-163,-33.33,1190
2022-01-21,287,410,-123,-30.0,1190
2022-01-22,86,46,40,86.96,1190
2022-01-23,43,86,-43,-50.0,1190
2022-01-24,321,488,-167,-34.22,1190
2022-01-25,326,498,-172,-34.54,1190
2022-01-26,326,501,-175,-34.93,1190
2022-01-27,326,503,-177,-35.19,1190
2022-01-28,287,425,-138,-32.47,1190
2022-01-29,86,61,25,40.98,1190
2022-01-30,43,94,-51,-54.26,1190
2020-02-01,154,109,45,41.28,1194
2020-02-02,60,15,45,300.0,1194
2020-02-03,413,419,-6,-1.43,1194
2020-02-04,420,429,-9,-2.1,1194
2020-02-05,420,430,-10,-2.33,1194
2020-02-06,420,430,-10,-2.33,1194
2020-02-07,408,384,24,6.25,1194
2020-02-08,154,113,41,36.28,1194
2020-02-09,60,1,59,5900.0,1194
2020-02-10,413,423,-10,-2.36,1194
2020-02-11,420,432,-12,-2.78,1194
2020-02-12,420,433,-13,-3.0,1194
2020-02-13,420,433,-13,-3.0,1194
2020-02-14,408,387,21,5.43,1194
2020-02-15,154,117,37,31.62,1194
2020-02-16,60,4,56,1400.0,1194
2020-02-17,413,427,-14,-3.28,1194
2020-02-18,420,437,-17,-3.89,1194
2020-02-19,420,439,-19,-4.33,1194
2020-02-20,420,440,-20,-4.55,1194
2020-02-21,408,395,13,3.29,1194
2020-02-22,154,126,28,22.22,1194
2020-02-23,60,14,46,328.57,1194
2020-02-24,413,438,-25,-5.71,1194
2020-02-25,420,449,-29,-6.46,1194
2020-02-26,420,452,-32,-7.08,1194
2020-02-27,420,454,-34,-7.49,1194
2020-02-28,408,409,-1,-0.24,1194
2020-02-29,154,141,13,9.22,1194
2020-03-01,57,30,27,90.0,1194
2020-03-02,402,454,-52,-11.45,1194
2020-03-03,405,465,-60,-12.9,1194
2020-03-04,405,467,-62,-13.28,1194
2020-03-05,405,469,-64,-13.65,1194
2020-03-06,382,424,-42,-9.91,1194
2020-03-07,148,155,-7,-4.52,1194
2020-03-08,57,43,14,32.56,1194
2020-03-09,402,466,-64,-13.73,1194
2020-03-10,405,476,-71,-14.92,1194
2020-03-11,405,478,-73,-15.27,1194
2020-03-12,405,479,-74,-15.45,1194
2020-03-13,382,432,-50,-11.57,1194
2020-03-14,148,162,-14,-8.64,1194
2020-03-15,57,49,8,16.33,1194
2020-03-16,402,472,-70,-14.83,1194
2020-03-17,405,481,-76,-15.8,1194
2020-03-18,405,481,-76,-15.8,1194
2020-03-19,405,482,-77,-15.98,1194
2020-03-20,382,435,-53,-12.18,1194
2020-03-21,148,164,-16,-9.76,1194
2020-03-22,57,52,5,9.62,1194
2020-03-23,402,474,-72,-15.19,1194
2020-03-24,405,483,-78,-16.15,1194
2020-03-25,405,484,-79,-16.32,1194
2020-03-26,405,484,-79,-16.32,1194
2020-03-27,382,438,-56,-12.79,1194
2020-03-28,148,168,-20,-11.9,1194
2020-03-29,57,56,1,1.79,1194
2020-03-30,402,478,-76,-15.9,1194
2020-03-31,405,488,-83,-17.01,1194
2020-04-01,423,490,-67,-13.67,1194
2020-04-02,423,491,-68,-13.85,1194
2020-04-03,392,445,-53,-11.91,1194
2020-04-04,143,175,-32,-18.29,1194
2020-04-05,47,64,-17,-26.56,1194
2020-04-06,428,487,-59,-12.11,1194
2020-04-07,423,497,-74,-14.89,1194
2020-04-08,423,498,-75,-15.06,1194
2020-04-09,423,500,-77,-15.4,1194
2020-04-10,392,453,-61,-13.47,1194
2020-04-11,143,184,-41,-22.28,1194
2020-04-12,47,72,-25,-34.72,1194
2020-04-13,428,494,-66,-13.36,1194
2020-04-14,423,504,-81,-16.07,1194
2020-04-15,423,505,-82,-16.24,1194
2020-04-16,423,506,-83,-16.4,1194
2020-04-17,392,459,-67,-14.6,1194
2020-04-18,143,188,-45,-23.94,1194
2020-04-19,47,76,-29,-38.16,1194
2020-04-20,428,498,-70,-14.06,1194
2020-04-21,423,507,-84,-16.57,1194
2020-04-22,423,508,-85,-16.73,1194
2020-04-23,423,508,-85,-16.73,1194
2020-04-24,392,461,-69,-14.97,1194
2020-04-25,143,191,-48,-25.13,1194
2020-04-26,47,78,-31,-39.74,1194
2020-04-27,428,500,-72,-14.4,1194
2020-04-28,423,510,-87,-17.06,1194
2020-04-29,423,510,-87,-17.06,1194
2020-04-30,423,511,-88,-17.22,1194
2020-05-01,472,464,8,1.72,1194
2020-05-02,169,194,-25,-12.89,1194
2020-05-03,57,82,-25,-30.49,1194
2020-05-04,476,504,-28,-5.56,1194
2020-05-05,472,514,-42,-8.17,1194
2020-05-06,472,515,-43,-8.35,1194
2020-05-07,472,516,-44,-8.53,1194
2020-05-08,472,470,2,0.43,1194
2020-05-09,169,200,-31,-15.5,1194
2020-05-10,57,87,-30,-34.48,1194
2020-05-11,476,510,-34,-6.67,1194
2020-05-12,472,520,-48,-9.23,1194
2020-05-13,472,520,-48,-9.23,1194
2020-05-14,472,521,-49,-9.4,1194
2020-05-15,472,474,-2,-0.42,1194
2020-05-16,169,204,-35,-17.16,1194
2020-05-17,57,91,-34,-37.36,1194
2020-05-18,476,513,-37,-7.21,1194
2020-05-19,472,522,-50,-9.58,1194
2020-05-20,472,522,-50,-9.58,1194
2020-05-21,472,523,-51,-9.75,1194
2020-05-22,472,475,-3,-0.63,1194
2020-05-23,169,204,-35,-17.16,1194
2020-05-24,57,91,-34,-37.36,1194
2020-05-25,476,513,-37,-7.21,1194
2020-05-26,472,521,-49,-9.4,1194
2020-05-27,472,521,-49,-9.4,1194
2020-05-28,472,521,-49,-9.4,1194
2020-05-29,472,474,-2,-0.42,1194
2020-05-30,169,203,-34,-16.75,1194
2020-05-31,57,90,-33,-36.67,1194
2020-06-01,494,512,-18,-3.52,1194
2020-06-02,477,521,-44,-8.45,1194
2020-06-03,477,522,-45,-8.62,1194
2020-06-04,477,522,-45,-8.62,1194
2020-06-05,451,475,-24,-5.05,1194
2020-06-06,167,205,-38,-18.54,1194
2020-06-07,70,93,-23,-24.73,1194
2020-06-08,494,515,-21,-4.08,1194
2020-06-09,477,525,-48,-9.14,1194
2020-06-10,477,525,-48,-9.14,1194
2020-06-11,477,526,-49,-9.32,1194
2020-06-12,451,480,-29,-6.04,1194
2020-06-13,167,209,-42,-20.1,1194
2020-06-14,70,97,-27,-27.84,1194
2020-06-15,494,519,-25,-4.82,1194
2020-06-16,477,528,-51,-9.66,1194
2020-06-17,477,528,-51,-9.66,1194
2020-06-18,477,528,-51,-9.66,1194
2020-06-19,451,480,-29,-6.04,1194
2020-06-20,167,208,-41,-19.71,1194
2020-06-21,70,94,-24,-25.53,1194
2020-06-22,494,515,-21,-4.08,1194
2020-06-23,477,523,-46,-8.8,1194
2020-06-24,477,521,-44,-8.45,1194
2020-06-25,477,519,-42,-8.09,1194
2020-06-26,451,470,-19,-4.04,1194
2020-06-27,167,197,-30,-15.23,1194
2020-06-28,70,82,-12,-14.63,1194
2020-06-29,494,501,-7,-1.4,1194
2020-06-30,477,508,-31,-6.1,1194
2020-07-01,451,505,-54,-10.69,1194
2020-07-02,451,503,-52,-10.34,1194
2020-07-03,436,453,-17,-3.75,1194
2020-07-04,152,180,-28,-15.56,1194
2020-07-05,57,65,-8,-12.31,1194
2020-07-06,464,484,-20,-4.13,1194
2020-07-07,451,491,-40,-8.15,1194
2020-07-08,451,490,-39,-7.96,1194
2020-07-09,451,488,-37,-7.58,1194
2020-07-10,436,440,-4,-0.91,1194
2020-07-11,152,168,-16,-9.52,1194
2020-07-12,57,54,3,5.56,1194
2020-07-13,464,475,-11,-2.32,1194
2020-07-14,451,483,-32,-6.63,1194
2020-07-15,451,483,-32,-6.63,1194
2020-07-16,451,483,-32,-6.63,1194
2020-07-17,436,436,0,0.0,1194
2020-07-18,152,165,-13,-7.88,1194
2020-07-19,57,53,4,7.55,1194
2020-07-20,464,475,-11,-2.32,1194
2020-07-21,451,484,-33,-6.82,1194
2020-07-22,451,484,-33,-6.82,1194
2020-07-23,451,485,-34,-7.01,1194
2020-07-24,436,438,-2,-0.46,1194
2020-07-25,152,167,-15,-8.98,1194
2020-07-26,57,54,3,5.56,1194
2020-07-27,464,475,-11,-2.32,1194
2020-07-28,451,484,-33,-6.82,1194
2020-07-29,451,484,-33,-6.82,1194
2020-07-30,451,483,-32,-6.63,1194
2020-07-31,436,435,1,0.23,1194
2020-08-01,158,163,-5,-3.07,1194
2020-08-02,61,48,13,27.08,1194
2020-08-03,414,469,-55,-11.73,1194
2020-08-04,431,476,-45,-9.45,1194
2020-08-05,431,474,-43,-9.07,1194
2020-08-06,431,473,-42,-8.88,1194
2020-08-07,416,424,-8,-1.89,1194
2020-08-08,158,151,7,4.64,1194
2020-08-09,61,37,24,64.86,1194
2020-08-10,414,457,-43,-9.41,1194
2020-08-11,431,464,-33,-7.11,1194
2020-08-12,431,463,-32,-6.91,1194
2020-08-13,431,462,-31,-6.71,1194
2020-08-14,416,414,2,0.48,1194
2020-08-15,158,142,16,11.27,1194
2020-08-16,61,29,32,110.34,1194
2020-08-17,414,451,-37,-8.2,1194
2020-08-18,431,460,-29,-6.3,1194
2020-08-19,431,460,-29,-6.3,1194
2020-08-20,431,461,-30,-6.51,1194
2020-08-21,416,415,1,0.24,1194
2020-08-22,158,146,12,8.22,1194
2020-08-23,61,34,27,79.41,1194
2020-08-24,414,458,-44,-9.61,1194
2020-08-25,431,469,-38,-8.1,1194
2020-08-26,431,471,-40,-8.49,1194
2020-08-27,431,473,-42,-8.88,1194
2020-08-28,416,428,-12,-2.8,1194
2020-08-29,158,160,-2,-1.25,1194
2020-08-30,61,49,12,24.49,1194
2020-08-31,414,473,-59,-12.47,1194
2020-09-01,462,484,-22,-4.55,1194
2020-09-02,462,486,-24,-4.94,1194
2020-09-03,462,488,-26,-5.33,1194
2020-09-04,436,443,-7,-1.58,1194
2020-09-05,177,173,4,2.31,1194
2020-09-06,66,61,5,8.2,1194
2020-09-07,461,484,-23,-4.75,1194
2020-09-08,462,494,-32,-6.48,1194
2020-09-09,462,494,-32,-6.48,1194
2020-09-10,462,495,-33,-6.67,1194
2020-09-11,436,448,-12,-2.68,1194
2020-09-12,177,177,0,0.0,1194
2020-09-13,66,64,2,3.12,1194
2020-09-14,461,485,-24,-4.95,1194
2020-09-15,462,494,-32,-6.48,1194
2020-09-16,462,494,-32,-6.48,1194
2020-09-17,462,494,-32,-6.48,1194
2020-09-18,436,446,-10,-2.24,1194
2020-09-19,177,175,2,1.14,1194
2020-09-20,66,61,5,8.2,1194
2020-09-21,461,483,-22,-4.55,1194
2020-09-22,462,492,-30,-6.1,1194
2020-09-23,462,492,-30,-6.1,1194
2020-09-24,462,492,-30,-6.1,1194
2020-09-25,436,445,-9,-2.02,1194
2020-09-26,177,175,2,1.14,1194
2020-09-27,66,62,4,6.45,1194
2020-09-28,461,485,-24,-4.95,1194
2020-09-29,462,494,-32,-6.48,1194
2020-09-30,462,495,-33,-6.67,1194
2020-10-01,473,496,-23,-4.64,1194
2020-10-02,422,450,-28,-6.22,1194
2020-10-03,171,180,-9,-5.0,1194
2020-10-04,64,68,-4,-5.88,1194
2020-10-05,454,491,-37,-7.54,1194
2020-10-06,473,501,-28,-5.59,1194
2020-10-07,473,502,-29,-5.78,1194
2020-10-08,473,502,-29,-5.78,1194
2020-10-09,422,456,-34,-7.46,1194
2020-10-10,171,185,-14,-7.57,1194
2020-10-11,64,73,-9,-12.33,1194
2020-10-12,454,495,-41,-8.28,1194
2020-10-13,473,503,-30,-5.96,1194
2020-10-14,473,503,-30,-5.96,1194
2020-10-15,473,503,-30,-5.96,1194
2020-10-16,422,456,-34,-7.46,1194
2020-10-17,171,184,-13,-7.07,1194
2020-10-18,64,70,-6,-8.57,1194
2020-10-19,454,491,-37,-7.54,1194
2020-10-20,473,499,-26,-5.21,1194
2020-10-21,473,499,-26,-5.21,1194
2020-10-22,473,498,-25,-5.02,1194
2020-10-23,422,450,-28,-6.22,1194
2020-10-24,171,178,-7,-3.93,1194
2020-10-25,64,65,-1,-1.54,1194
2020-10-26,454,486,-32,-6.58,1194
2020-10-27,473,494,-21,-4.25,1194
2020-10-28,473,494,-21,-4.25,1194
2020-10-29,473,494,-21,-4.25,1194
2020-10-30,422,447,-25,-5.59,1194
2020-10-31,171,176,-5,-2.84,1194
2020-11-01,60,63,-3,-4.76,1194
2020-11-02,447,485,-38,-7.84,1194
2020-11-03,428,495,-67,-13.54,1194
2020-11-04,428,496,-68,-13.71,1194
2020-11-05,428,496,-68,-13.71,1194
2020-11-06,410,450,-40,-8.89,1194
2020-11-07,174,180,-6,-3.33,1194
2020-11-08,60,67,-7,-10.45,1194
2020-11-09,447,490,-43,-8.78,1194
2020-11-10,428,499,-71,-14.23,1194
2020-11-11,428,500,-72,-14.4,1194
2020-11-12,428,500,-72,-14.4,1194
2020-11-13,410,453,-43,-9.49,1194
2020-11-14,174,182,-8,-4.4,1194
2020-11-15,60,69,-9,-13.04,1194
2020-11-16,447,490,-43,-8.78,1194
2020-11-17,428,498,-70,-14.06,1194
2020-11-18,428,497,-69,-13.88,1194
2020-11-19,428,496,-68,-13.71,1194
2020-11-20,410,447,-37,-8.28,1194
2020-11-21,174,175,-1,-0.57,1194
2020-11-22,60,60,0,0.0,1194
2020-11-23,447,479,-32,-6.68,1194
2020-11-24,428,486,-58,-11.93,1194
2020-11-25,428,483,-55,-11.39,1194
2020-11-26,428,481,-53,-11.02,1194
2020-11-27,410,431,-21,-4.87,1194
2020-11-28,174,158,16,10.13,1194
2020-11-29,60,42,18,42.86,1194
2020-11-30,447,461,-14,-3.04,1194
2020-12-01,370,468,-98,-20.94,1194
2020-12-02,370,465,-95,-20.43,1194
2020-12-03,370,463,-93,-20.09,1194
2020-12-04,424,414,10,2.42,1194
2020-12-05,166,141,25,17.73,1194
2020-12-06,56,26,30,115.38,1194
2020-12-07,386,447,-61,-13.65,1194
2020-12-08,370,454,-84,-18.5,1194
2020-12-09,370,453,-83,-18.32,1194
2020-12-10,370,452,-82,-18.14,1194
2020-12-11,424,404,20,4.95,1194
2020-12-12,166,133,33,24.81,1194
2020-12-13,56,19,37,194.74,1194
2020-12-14,386,440,-54,-12.27,1194
2020-12-15,370,449,-79,-17.59,1194
2020-12-16,370,448,-78,-17.41,1194
2020-12-17,370,448,-78,-17.41,1194
2020-12-18,424,401,23,5.74,1194
2020-12-19,166,129,37,28.68,1194
2020-12-20,56,16,40,250.0,1194
2020-12-21,386,437,-51,-11.67,1194
2020-12-22,370,445,-75,-16.85,1194
2020-12-23,370,444,-74,-16.67,1194
2020-12-24,370,443,-73,-16.48,1194
2020-12-25,424,395,29,7.34,1194
2020-12-26,166,122,44,36.07,1194
2020-12-27,56,8,48,600.0,1194
2020-12-28,386,428,-42,-9.81,1194
2020-12-29,370,435,-65,-14.94,1194
2020-12-30,370,433,-63,-14.55,1194
2020-12-31,370,431,-61,-14.15,1194
2021-01-01,366,381,-15,-3.94,1194
2021-01-02,131,108,23,21.3,1194
2021-01-03,55,16,39,243.75,1194
2021-01-04,365,413,-48,-11.62,1194
2021-01-05,393,420,-27,-6.43,1194
2021-01-06,393,418,-25,-5.98,1194
2021-01-07,393,416,-23,-5.53,1194
2021-01-08,366,367,-1,-0.27,1194
2021-01-09,131,95,36,37.89,1194
2021-01-10,55,9,46,511.11,1194
2021-01-11,365,401,-36,-8.98,1194
2021-01-12,393,409,-16,-3.91,1194
2021-01-13,393,409,-16,-3.91,1194
2021-01-14,393,409,-16,-3.91,1194
2021-01-15,366,362,4,1.1,1194
2021-01-16,131,91,40,43.96,1194
2021-01-17,55,8,47,587.5,1194
2021-01-18,365,401,-36,-8.98,1194
2021-01-19,393,411,-18,-4.38,1194
2021-01-20,393,412,-19,-4.61,1194
2021-01-21,393,413,-20,-4.84,1194
2021-01-22,366,367,-1,-0.27,1194
2021-01-23,131,98,33,33.67,1194
2021-01-24,55,12,43,358.33,1194
2021-01-25,365,409,-44,-10.76,1194
2021-01-26,393,420,-27,-6.43,1194
2021-01-27,393,421,-28,-6.65,1194
2021-01-28,393,422,-29,-6.87,1194
2021-01-29,366,376,-10,-2.66,1194
2021-01-30,131,107,24,22.43,1194
2021-01-31,55,17,38,223.53,1194
2021-02-01,426,417,9,2.16,1194
2021-02-02,414,427,-13,-3.04,1194
2021-02-03,414,428,-14,-3.27,1194
2021-02-04,414,429,-15,-3.5,1194
2021-02-05,364,382,-18,-4.71,1194
2021-02-06,151,112,39,34.82,1194
2021-02-07,54,20,34,170.0,1194
2021-02-08,426,421,5,1.19,1194
2021-02-09,414,431,-17,-3.94,1194
2021-02-10,414,431,-17,-3.94,1194
2021-02-11,414,432,-18,-4.17,1194
2021-02-12,364,385,-21,-5.45,1194
2021-02-13,151,115,36,31.3,1194
2021-02-14,54,2,52,2600.0,1194
2021-02-15,426,425,1,0.24,1194
2021-02-16,414,435,-21,-4.83,1194
2021-02-17,414,436,-22,-5.05,1194
2021-02-18,414,437,-23,-5.26,1194
2021-02-19,364,392,-28,-7.14,1194
2021-02-20,151,122,29,23.77,1194
2021-02-21,54,11,43,390.91,1194
2021-02-22,426,435,-9,-2.07,1194
2021-02-23,414,446,-32,-7.17,1194
2021-02-24,414,448,-34,-7.59,1194
2021-02-25,414,450,-36,-8.0,1194
2021-02-26,364,405,-41,-10.12,1194
2021-02-27,151,137,14,10.22,1194
2021-02-28,54,26,28,107.69,1194
2021-03-01,462,450,12,2.67,1194
2021-03-02,443,461,-18,-3.9,1194
2021-03-03,443,464,-21,-4.53,1194
2021-03-04,443,466,-23,-4.94,1194
2021-03-05,426,421,5,1.19,1194
2021-03-06,212,152,60,39.47,1194
2021-03-07,105,40,65,162.5,1194
2021-03-08,462,464,-2,-0.43,1194
2021-03-09,443,474,-31,-6.54,1194
2021-03-10,443,475,-32,-6.74,1194
2021-03-11,443,477,-34,-7.13,1194
2021-03-12,426,430,-4,-0.93,1194
2021-03-13,212,160,52,32.5,1194
2021-03-14,105,48,57,118.75,1194
2021-03-15,462,470,-8,-1.7,1194
2021-03-16,443,480,-37,-7.71,1194
2021-03-17,443,480,-37,-7.71,1194
2021-03-18,443,481,-38,-7.9,1194
2021-03-19,426,434,-8,-1.84,1194
2021-03-20,212,163,49,30.06,1194
2021-03-21,105,50,55,110.0,1194
2021-03-22,462,472,-10,-2.12,1194
2021-03-23,443,482,-39,-8.09,1194
2021-03-24,443,482,-39,-8.09,1194
2021-03-25,443,483,-40,-8.28,1194
2021-03-26,426,436,-10,-2.29,1194
2021-03-27,212,166,46,27.71,1194
2021-03-28,105,54,51,94.44,1194
2021-03-29,462,476,-14,-2.94,1194
2021-03-30,443,486,-43,-8.85,1194
2021-03-31,443,487,-44,-9.03,1194
2021-04-01,446,489,-43,-8.79,1194
2021-04-02,429,442,-13,-2.94,1194
2021-04-03,166,173,-7,-4.05,1194
2021-04-04,58,61,-3,-4.92,1194
2021-04-05,436,484,-48,-9.92,1194
2021-04-06,446,494,-48,-9.72,1194
2021-04-07,446,496,-50,-10.08,1194
2021-04-08,446,497,-51,-10.26,1194
2021-04-09,429,451,-22,-4.88,1194
2021-04-10,166,181,-15,-8.29,1194
2021-04-11,58,69,-11,-15.94,1194
2021-04-12,436,492,-56,-11.38,1194
2021-04-13,446,502,-56,-11.16,1194
2021-04-14,446,503,-57,-11.33,1194
2021-04-15,446,504,-58,-11.51,1194
2021-04-16,429,457,-28,-6.13,1194
2021-04-17,166,187,-21,-11.23,1194
2021-04-18,58,74,-16,-21.62,1194
2021-04-19,436,497,-61,-12.27,1194
2021-04-20,446,506,-60,-11.86,1194
2021-04-21,446,506,-60,-11.86,1194
2021-04-22,446,507,-61,-12.03,1194
2021-04-23,429,460,-31,-6.74,1194
2021-04-24,166,189,-23,-12.17,1194
2021-04-25,58,77,-19,-24.68,1194
2021-04-26,436,499,-63,-12.63,1194
2021-04-27,446,508,-62,-12.2,1194
2021-04-28,446,509,-63,-12.38,1194
2021-04-29,446,509,-63,-12.38,1194
2021-04-30,429,463,-34,-7.34,1194
2021-05-01,184,192,-8,-4.17,1194
2021-05-02,56,80,-24,-30.0,1194
2021-05-03,462,502,-40,-7.97,1194
2021-05-04,476,512,-36,-7.03,1194
2021-05-05,476,513,-37,-7.21,1194
2021-05-06,476,514,-38,-7.39,1194
2021-05-07,459,468,-9,-1.92,1194
2021-05-08,184,198,-14,-7.07,1194
2021-05-09,56,85,-29,-34.12,1194
2021-05-10,462,508,-46,-9.06,1194
2021-05-11,476,518,-42,-8.11,1194
2021-05-12,476,519,-43,-8.29,1194
2021-05-13,476,519,-43,-8.29,1194
2021-05-14,459,473,-14,-2.96,1194
2021-05-15,184,202,-18,-8.91,1194
2021-05-16,56,90,-34,-37.78,1194
2021-05-17,462,512,-50,-9.77,1194
2021-05-18,476,521,-45,-8.64,1194
2021-05-19,476,521,-45,-8.64,1194
2021-05-20,476,522,-46,-8.81,1194
2021-05-21,459,474,-15,-3.16,1194
2021-05-22,184,203,-19,-9.36,1194
2021-05-23,56,90,-34,-37.78,1194
2021-05-24,462,512,-50,-9.77,1194
2021-05-25,476,521,-45,-8.64,1194
2021-05-26,476,521,-45,-8.64,1194
2021-05-27,476,521,-45,-8.64,1194
2021-05-28,459,473,-14,-2.96,1194
2021-05-29,184,202,-18,-8.91,1194
2021-05-30,56,89,-33,-37.08,1194
2021-05-31,462,511,-49,-9.59,1194
2021-06-01,491,520,-29,-5.58,1194
2021-06-02,491,520,-29,-5.58,1194
2021-06-03,491,521,-30,-5.76,1194
2021-06-04,464,474,-10,-2.11,1194
2021-06-05,169,203,-34,-16.75,1194
2021-06-06,55,91,-36,-39.56,1194
2021-06-07,481,513,-32,-6.24,1194
2021-06-08,491,523,-32,-6.12,1194
2021-06-09,491,524,-33,-6.3,1194
2021-06-10,491,524,-33,-6.3,1194
2021-06-11,464,478,-14,-2.93,1194
2021-06-12,169,208,-39,-18.75,1194
2021-06-13,55,95,-40,-42.11,1194
2021-06-14,481,517,-36,-6.96,1194
2021-06-15,491,526,-35,-6.65,1194
2021-06-16,491,527,-36,-6.83,1194
2021-06-17,491,527,-36,-6.83,1194
2021-06-18,464,479,-15,-3.13,1194
2021-06-19,169,208,-39,-18.75,1194
2021-06-20,55,94,-39,-41.49,1194
2021-06-21,481,515,-34,-6.6,1194
2021-06-22,491,523,-32,-6.12,1194
2021-06-23,491,522,-31,-5.94,1194
2021-06-24,491,521,-30,-5.76,1194
2021-06-25,464,472,-8,-1.69,1194
2021-06-26,169,199,-30,-15.08,1194
2021-06-27,55,84,-29,-34.52,1194
2021-06-28,481,503,-22,-4.37,1194
2021-06-29,491,510,-19,-3.73,1194
2021-06-30,491,507,-16,-3.16,1194
2021-07-01,624,505,119,23.56,1194
2021-07-02,539,455,84,18.46,1194
2021-07-03,244,182,62,34.07,1194
2021-07-04,147,67,80,119.4,1194
2021-07-05,621,486,135,27.78,1194
2021-07-06,624,493,131,26.57,1194
2021-07-07,624,491,133,27.09,1194
2021-07-08,624,489,135,27.61,1194
2021-07-09,539,440,99,22.5,1194
2021-07-10,244,168,76,45.24,1194
2021-07-11,147,54,93,172.22,1194
2021-07-12,621,475,146,30.74,1194
2021-07-13,624,483,141,29.19,1194
2021-07-14,624,483,141,29.19,1194
2021-07-15,624,482,142,29.46,1194
2021-07-16,539,435,104,23.91,1194
2021-07-17,244,164,80,48.78,1194
2021-07-18,147,51,96,188.24,1194
2021-07-19,621,473,148,31.29,1194
2021-07-20,624,483,141,29.19,1194
2021-07-21,624,483,141,29.19,1194
2021-07-22,624,483,141,29.19,1194
2021-07-23,539,437,102,23.34,1194
2021-07-24,244,166,78,46.99,1194
2021-07-25,147,53,94,177.36,1194
2021-07-26,621,475,146,30.74,1194
2021-07-27,624,483,141,29.19,1194
2021-07-28,624,483,141,29.19,1194
2021-07-29,624,483,141,29.19,1194
2021-07-30,539,435,104,23.91,1194
2021-07-31,244,163,81,49.69,1194
2021-08-01,144,49,95,193.88,1194
2021-08-02,591,470,121,25.74,1194
2021-08-03,587,477,110,23.06,1194
2021-08-04,587,476,111,23.32,1194
2021-08-05,587,474,113,23.84,1194
2021-08-06,518,425,93,21.88,1194
2021-08-07,239,153,86,56.21,1194
2021-08-08,144,38,106,278.95,1194
2021-08-09,591,458,133,29.04,1194
2021-08-10,587,465,122,26.24,1194
2021-08-11,587,464,123,26.51,1194
2021-08-12,587,462,125,27.06,1194
2021-08-13,518,414,104,25.12,1194
2021-08-14,239,142,97,68.31,1194
2021-08-15,144,28,116,414.29,1194
2021-08-16,591,450,141,31.33,1194
2021-08-17,587,459,128,27.89,1194
2021-08-18,587,459,128,27.89,1194
2021-08-19,587,459,128,27.89,1194
2021-08-20,518,413,105,25.42,1194
2021-08-21,239,143,96,67.13,1194
2021-08-22,144,31,113,364.52,1194
2021-08-23,591,455,136,29.89,1194
2021-08-24,587,465,122,26.24,1194
2021-08-25,587,467,120,25.7,1194
2021-08-26,587,470,117,24.89,1194
2021-08-27,518,425,93,21.88,1194
2021-08-28,239,156,83,53.21,1194
2021-08-29,144,45,99,220.0,1194
2021-08-30,591,469,122,26.01,1194
2021-08-31,587,480,107,22.29,1194
2021-09-01,523,483,40,8.28,1194
2021-09-02,523,485,38,7.84,1194
2021-09-03,496,439,57,12.98,1194
2021-09-04,208,170,38,22.35,1194
2021-09-05,92,59,33,55.93,1194
2021-09-06,509,482,27,5.6,1194
2021-09-07,523,492,31,6.3,1194
2021-09-08,523,493,30,6.09,1194
2021-09-09,523,493,30,6.09,1194
2021-09-10,496,447,49,10.96,1194
2021-09-11,208,176,32,18.18,1194
2021-09-12,92,63,29,46.03,1194
2021-09-13,509,485,24,4.95,1194
2021-09-14,523,493,30,6.09,1194
2021-09-15,523,493,30,6.09,1194
2021-09-16,523,493,30,6.09,1194
2021-09-17,496,445,51,11.46,1194
2021-09-18,208,174,34,19.54,1194
2021-09-19,92,61,31,50.82,1194
2021-09-20,509,482,27,5.6,1194
2021-09-21,523,491,32,6.52,1194
2021-09-22,523,491,32,6.52,1194
2021-09-23,523,491,32,6.52,1194
2021-09-24,496,444,52,11.71,1194
2021-09-25,208,173,35,20.23,1194
2021-09-26,92,61,31,50.82,1194
2021-09-27,509,483,26,5.38,1194
2021-09-28,523,492,31,6.3,1194
2021-09-29,523,493,30,6.09,1194
2021-09-30,523,494,29,5.87,1194
2021-10-01,463,448,15,3.35,1194
2021-10-02,204,178,26,14.61,1194
2021-10-03,88,66,22,33.33,1194
2021-10-04,482,489,-7,-1.43,1194
2021-10-05,500,499,1,0.2,1194
2021-10-06,500,500,0,0.0,1194
2021-10-07,500,501,-1,-0.2,1194
2021-10-08,463,454,9,1.98,1194
2021-10-09,204,184,20,10.87,1194
2021-10-10,88,71,17,23.94,1194
2021-10-11,482,493,-11,-2.23,1194
2021-10-12,500,502,-2,-0.4,1194
2021-10-13,500,503,-3,-0.6,1194
2021-10-14,500,503,-3,-0.6,1194
2021-10-15,463,455,8,1.76,1194
2021-10-16,204,184,20,10.87,1194
2021-10-17,88,70,18,25.71,1194
2021-10-18,482,491,-9,-1.83,1194
2021-10-19,500,499,1,0.2,1194
2021-10-20,500,499,1,0.2,1194
2021-10-21,500,498,2,0.4,1194
2021-10-22,463,450,13,2.89,1194
2021-10-23,204,178,26,14.61,1194
2021-10-24,88,65,23,35.38,1194
2021-10-25,482,486,-4,-0.82,1194
2021-10-26,500,494,6,1.21,1194
2021-10-27,500,494,6,1.21,1194
2021-10-28,500,493,7,1.42,1194
2021-10-29,463,446,17,3.81,1194
2021-10-30,204,175,29,16.57,1194
2021-10-31,88,62,26,41.94,1194
2021-11-01,436,484,-48,-9.92,1194
2021-11-02,448,493,-45,-9.13,1194
2021-11-03,448,494,-46,-9.31,1194
2021-11-04,448,495,-47,-9.49,1194
2021-11-05,424,448,-24,-5.36,1194
2021-11-06,162,178,-16,-8.99,1194
2021-11-07,63,65,-2,-3.08,1194
2021-11-08,436,488,-52,-10.66,1194
2021-11-09,448,498,-50,-10.04,1194
2021-11-10,448,498,-50,-10.04,1194
2021-11-11,448,499,-51,-10.22,1194
2021-11-12,424,452,-28,-6.19,1194
2021-11-13,162,181,-19,-10.5,1194
2021-11-14,63,68,-5,-7.35,1194
2021-11-15,436,490,-54,-11.02,1194
2021-11-16,448,498,-50,-10.04,1194
2021-11-17,448,497,-49,-9.86,1194
2021-11-18,448,497,-49,-9.86,1194
2021-11-19,424,448,-24,-5.36,1194
2021-11-20,162,176,-14,-7.95,1194
2021-11-21,63,61,2,3.28,1194
2021-11-22,436,481,-45,-9.36,1194
2021-11-23,448,488,-40,-8.2,1194
2021-11-24,448,485,-37,-7.63,1194
2021-11-25,448,483,-35,-7.25,1194
2021-11-26,424,433,-9,-2.08,1194
2021-11-27,162,160,2,1.25,1194
2021-11-28,63,44,19,43.18,1194
2021-11-29,436,463,-27,-5.83,1194
2021-11-30,448,470,-22,-4.68,1194
2021-12-01,370,467,-97,-20.77,1194
2021-12-02,370,465,-95,-20.43,1194
2021-12-03,296,416,-120,-28.85,1194
2021-12-04,174,143,31,21.68,1194
2021-12-05,60,28,32,114.29,1194
2021-12-06,393,448,-55,-12.28,1194
2021-12-07,370,455,-85,-18.68,1194
2021-12-08,370,454,-84,-18.5,1194
2021-12-09,370,452,-82,-18.14,1194
2021-12-10,296,404,-108,-26.73,1194
2021-12-11,174,132,42,31.82,1194
2021-12-12,60,19,41,215.79,1194
2021-12-13,393,440,-47,-10.68,1194
2021-12-14,370,448,-78,-17.41,1194
2021-12-15,370,448,-78,-17.41,1194
2021-12-16,370,448,-78,-17.41,1194
2021-12-17,296,400,-104,-26.0,1194
2021-12-18,174,129,45,34.88,1194
2021-12-19,60,15,45,300.0,1194
2021-12-20,393,437,-44,-10.07,1194
2021-12-21,370,445,-75,-16.85,1194
2021-12-22,370,444,-74,-16.67,1194
2021-12-23,370,443,-73,-16.48,1194
2021-12-24,296,395,-99,-25.06,1194
2021-12-25,174,123,51,41.46,1194
2021-12-26,60,9,51,566.67,1194
2021-12-27,393,429,-36,-8.39,1194
2021-12-28,370,436,-66,-15.14,1194
2021-12-29,370,434,-64,-14.75,1194
2021-12-30,370,432,-62,-14.35,1194
2021-12-31,296,383,-87,-22.72,1194
2022-01-01,142,110,32,29.09,1194
2022-01-02,52,32,20,62.5,1194
2022-01-03,374,414,-40,-9.66,1194
2022-01-04,388,421,-33,-7.84,1194
2022-01-05,388,419,-31,-7.4,1194
2022-01-06,388,417,-29,-6.95,1194
2022-01-07,350,368,-18,-4.89,1194
2022-01-08,142,96,46,47.92,1194
2022-01-09,52,23,29,126.09,1194
2022-01-10,374,402,-28,-6.97,1194
2022-01-11,388,409,-21,-5.13,1194
2022-01-12,388,409,-21,-5.13,1194
2022-01-13,388,408,-20,-4.9,1194
2022-01-14,350,361,-11,-3.05,1194
2022-01-15,142,90,52,57.78,1194
2022-01-16,52,23,29,126.09,1194
2022-01-17,374,399,-25,-6.27,1194
2022-01-18,388,409,-21,-5.13,1194
2022-01-19,388,410,-22,-5.37,1194
2022-01-20,388,411,-23,-5.6,1194
2022-01-21,350,365,-15,-4.11,1194
2022-01-22,142,95,47,49.47,1194
2022-01-23,52,26,26,100.0,1194
2022-01-24,374,406,-32,-7.88,1194
2022-01-25,388,417,-29,-6.95,1194
2022-01-26,388,418,-30,-7.18,1194
2022-01-27,388,420,-32,-7.62,1194
2022-01-28,350,374,-24,-6.42,1194
2022-01-29,142,104,38,36.54,1194
2022-01-30,52,31,21,67.74,1194
2020-02-01,362,280,82,29.29,1198
2020-02-02,108,19,89,468.42,1198
2020-02-03,937,939,-2,-0.21,1198
2020-02-04,966,945,21,2.22,1198
2020-02-05,966,947,19,2.01,1198
2020-02-06,966,948,18,1.9,1198
2020-02-07,883,849,34,4.0,1198
2020-02-08,362,293,69,23.55,1198
2020-02-09,108,30,78,260.0,1198
2020-02-10,937,950,-13,-1.37,1198
2020-02-11,966,954,12,1.26,1198
2020-02-12,966,956,10,1.05,1198
2020-02-13,966,957,9,0.94,1198
2020-02-14,883,858,25,2.91,1198
2020-02-15,362,302,60,19.87,1198
2020-02-16,108,40,68,170.0,1198
2020-02-17,937,961,-24,-2.5,1198
2020-02-18,966,967,-1,-0.1,1198
2020-02-19,966,971,-5,-0.51,1198
2020-02-20,966,974,-8,-0.82,1198
2020-02-21,883,877,6,0.68,1198
2020-02-22,362,324,38,11.73,1198
2020-02-23,108,65,43,66.15,1198
2020-02-24,937,988,-51,-5.16,1198
2020-02-25,966,997,-31,-3.11,1198
2020-02-26,966,1002,-36,-3.59,1198
2020-02-27,966,1007,-41,-4.07,1198
2020-02-28,883,913,-30,-3.29,1198
2020-02-29,362,360,2,0.56,1198
2020-03-01,86,103,-17,-16.5,1198
2020-03-02,866,1026,-160,-15.59,1198
2020-03-03,883,1035,-152,-14.69,1198
2020-03-04,883,1041,-158,-15.18,1198
2020-03-05,883,1045,-162,-15.5,1198
2020-03-06,768,950,-182,-19.16,1198
2020-03-07,295,396,-101,-25.51,1198
2020-03-08,86,137,-51,-37.23,1198
2020-03-09,866,1058,-192,-18.15,1198
2020-03-10,883,1065,-182,-17.09,1198
2020-03-11,883,1068,-185,-17.32,1198
2020-03-12,883,1070,-187,-17.48,1198
2020-03-13,768,972,-204,-20.99,1198
2020-03-14,295,416,-121,-29.09,1198
2020-03-15,86,154,-68,-44.16,1198
2020-03-16,866,1074,-208,-19.37,1198
2020-03-17,883,1078,-195,-18.09,1198
2020-03-18,883,1080,-197,-18.24,1198
2020-03-19,883,1080,-197,-18.24,1198
2020-03-20,768,981,-213,-21.71,1198
2020-03-21,295,424,-129,-30.42,1198
2020-03-22,86,162,-76,-46.91,1198
2020-03-23,866,1082,-216,-19.96,1198
2020-03-24,883,1087,-204,-18.77,1198
2020-03-25,883,1089,-206,-18.92,1198
2020-03-26,883,1090,-207,-18.99,1198
2020-03-27,768,992,-224,-22.58,1198
2020-03-28,295,437,-142,-32.49,1198
2020-03-29,86,176,-90,-51.14,1198
2020-03-30,866,1098,-232,-21.13,1198
2020-03-31,883,1105,-222,-20.09,1198
2020-04-01,881,1109,-228,-20.56,1198
2020-04-02,881,1112,-231,-20.77,1198
2020-04-03,729,1016,-287,-28.25,1198
2020-04-04,232,462,-230,-49.78,1198
2020-04-05,67,203,-136,-67.0,1198
2020-04-06,872,1125,-253,-22.49,1198
2020-04-07,881,1132,-251,-22.17,1198
2020-04-08,881,1136,-255,-22.45,1198
2020-04-09,881,1140,-259,-22.72,1198
2020-04-10,729,1043,-314,-30.11,1198
2020-04-11,232,488,-256,-52.46,1198
2020-04-12,67,228,-161,-70.61,1198
2020-04-13,872,1149,-277,-24.11,1198
2020-04-14,881,1155,-274,-23.72,1198
2020-04-15,881,1157,-276,-23.85,1198
2020-04-16,881,1158,-277,-23.92,1198
2020-04-17,729,1059,-330,-31.16,1198
2020-04-18,232,502,-270,-53.78,1198
2020-04-19,67,239,-172,-71.97,1198
2020-04-20,872,1158,-286,-24.7,1198
2020-04-21,881,1161,-280,-24.12,1198
2020-04-22,881,1161,-280,-24.12,1198
2020-04-23,881,1160,-279,-24.05,1198
2020-04-24,729,1059,-330,-31.16,1198
2020-04-25,232,501,-269,-53.69,1198
2020-04-26,67,237,-170,-71.73,1198
2020-04-27,872,1154,-282,-24.44,1198
2020-04-28,881,1157,-276,-23.85,1198
2020-04-29,881,1157,-276,-23.85,1198
2020-04-30,881,1156,-275,-23.79,1198
2020-05-01,948,1056,-108,-10.23,1198
2020-05-02,370,498,-128,-25.7,1198
2020-05-03,114,234,-120,-51.28,1198
2020-05-04,1116,1153,-37,-3.21,1198
2020-05-05,1114,1157,-43,-3.72,1198
2020-05-06,1114,1158,-44,-3.8,1198
2020-05-07,1114,1158,-44,-3.8,1198
2020-05-08,948,1059,-111,-10.48,1198
2020-05-09,370,502,-132,-26.29,1198
2020-05-10,114,240,-126,-52.5,1198
2020-05-11,1116,1160,-44,-3.79,1198
2020-05-12,1114,1165,-51,-4.38,1198
2020-05-13,1114,1166,-52,-4.46,1198
2020-05-14,1114,1167,-53,-4.54,1198
2020-05-15,948,1068,-120,-11.24,1198
2020-05-16,370,512,-142,-27.73,1198
2020-05-17,114,249,-135,-54.22,1198
2020-05-18,1116,1169,-53,-4.53,1198
2020-05-19,1114,1173,-59,-5.03,1198
2020-05-20,1114,1174,-60,-5.11,1198
2020-05-21,1114,1174,-60,-5.11,1198
2020-05-22,948,1074,-126,-11.73,1198
2020-05-23,370,517,-147,-28.43,1198
2020-05-24,114,254,-140,-55.12,1198
2020-05-25,1116,1172,-56,-4.78,1198
2020-05-26,1114,1175,-61,-5.19,1198
2020-05-27,1114,1175,-61,-5.19,1198
2020-05-28,1114,1175,-61,-5.19,1198
2020-05-29,948,1074,-126,-11.73,1198
2020-05-30,370,516,-146,-28.29,1198
2020-05-31,114,253,-139,-54.94,1198
2020-06-01,1177,1171,6,0.51,1198
2020-06-02,1232,1175,57,4.85,1198
2020-06-03,1232,1175,57,4.85,1198
2020-06-04,1232,1174,58,4.94,1198
2020-06-05,997,1075,-78,-7.26,1198
2020-06-06,379,517,-138,-26.69,1198
2020-06-07,142,254,-112,-44.09,1198
2020-06-08,1177,1173,4,0.34,1198
2020-06-09,1232,1178,54,4.58,1198
2020-06-10,1232,1179,53,4.5,1198
2020-06-11,1232,1179,53,4.5,1198
2020-06-12,997,1080,-83,-7.69,1198
2020-06-13,379,523,-144,-27.53,1198
2020-06-14,142,260,-118,-45.38,1198
2020-06-15,1177,1179,-2,-0.17,1198
2020-06-16,1232,1183,49,4.14,1198
2020-06-17,1232,1184,48,4.05,1198
2020-06-18,1232,1184,48,4.05,1198
2020-06-19,997,1084,-87,-8.03,1198
2020-06-20,379,526,-147,-27.95,1198
2020-06-21,142,262,-120,-45.8,1198
2020-06-22,1177,1180,-3,-0.25,1198
2020-06-23,1232,1182,50,4.23,1198
2020-06-24,1232,1181,51,4.32,1198
2020-06-25,1232,1179,53,4.5,1198
2020-06-26,997,1078,-81,-7.51,1198
2020-06-27,379,518,-139,-26.83,1198
2020-06-28,142,252,-110,-43.65,1198
2020-06-29,1177,1169,8,0.68,1198
2020-06-30,1232,1170,62,5.3,1198
2020-07-01,1147,1168,-21,-1.8,1198
2020-07-02,1147,1165,-18,-1.55,1198
2020-07-03,1007,1063,-56,-5.27,1198
2020-07-04,352,503,-151,-30.02,1198
2020-07-05,119,237,-118,-49.79,1198
2020-07-06,1168,1154,14,1.21,1198
2020-07-07,1147,1155,-8,-0.69,1198
2020-07-08,1147,1154,-7,-0.61,1198
2020-07-09,1147,1152,-5,-0.43,1198
2020-07-10,1007,1051,-44,-4.19,1198
2020-07-11,352,493,-141,-28.6,1198
2020-07-12,119,229,-110,-48.03,1198
2020-07-13,1168,1147,21,1.83,1198
2020-07-14,1147,1150,-3,-0.26,1198
2020-07-15,1147,1151,-4,-0.35,1198
2020-07-16,1147,1151,-4,-0.35,1198
2020-07-17,1007,1051,-44,-4.19,1198
2020-07-18,352,494,-142,-28.74,1198
2020-07-19,119,231,-112,-48.48,1198
2020-07-20,1168,1150,18,1.57,1198
2020-07-21,1147,1154,-7,-0.61,1198
2020-07-22,1147,1155,-8,-0.69,1198
2020-07-23,1147,1154,-7,-0.61,1198
2020-07-24,1007,1054,-47,-4.46,1198
2020-07-25,352,496,-144,-29.03,1198
2020-07-26,119,232,-113,-48.71,1198
2020-07-27,1168,1149,19,1.65,1198
2020-07-28,1147,1151,-4,-0.35,1198
2020-07-29,1147,1150,-3,-0.26,1198
2020-07-30,1147,1147,0,0.0,1198
2020-07-31,1007,1045,-38,-3.64,1198
2020-08-01,338,484,-146,-30.17,1198
2020-08-02,110,218,-108,-49.54,1198
2020-08-03,1032,1133,-101,-8.91,1198
2020-08-04,1015,1133,-118,-10.41,1198
2020-08-05,1015,1130,-115,-10.18,1198
2020-08-06,1015,1126,-111,-9.86,1198
2020-08-07,922,1022,-100,-9.78,1198
2020-08-08,338,461,-123,-26.68,1198
2020-08-09,110,194,-84,-43.3,1198
2020-08-10,1032,1109,-77,-6.94,1198
2020-08-11,1015,1110,-95,-8.56,1198
2020-08-12,1015,1108,-93,-8.39,1198
2020-08-13,1015,1105,-90,-8.14,1198
2020-08-14,922,1004,-82,-8.17,1198
2020-08-15,338,445,-107,-24.04,1198
2020-08-16,110,181,-71,-39.23,1198
2020-08-17,1032,1100,-68,-6.18,1198
2020-08-18,1015,1104,-89,-8.06,1198
2020-08-19,1015,1105,-90,-8.14,1198
2020-08-20,1015,1106,-91,-8.23,1198
2020-08-21,922,1008,-86,-8.53,1198
2020-08-22,338,453,-115,-25.39,1198
2020-08-23,110,193,-83,-43.01,1198
2020-08-24,1032,1115,-83,-7.44,1198
2020-08-25,1015,1122,-107,-9.54,1198
2020-08-26,1015,1126,-111,-9.86,1198
2020-08-27,1015,1129,-114,-10.1,1198
2020-08-28,922,1033,-111,-10.75,1198
2020-08-29,338,480,-142,-29.58,1198
2020-08-30,110,220,-110,-50.0,1198
2020-08-31,1032,1142,-110,-9.63,1198
2020-09-01,1123,1149,-26,-2.26,1198
2020-09-02,1123,1153,-30,-2.6,1198
2020-09-03,1123,1155,-32,-2.77,1198
2020-09-04,991,1058,-67,-6.33,1198
2020-09-05,368,502,-134,-26.69,1198
2020-09-06,120,240,-120,-50.0,1198
2020-09-07,1106,1160,-54,-4.66,1198
2020-09-08,1123,1164,-41,-3.52,1198
2020-09-09,1123,1165,-42,-3.61,1198
2020-09-10,1123,1164,-41,-3.52,1198
2020-09-11,991,1064,-73,-6.86,1198
2020-09-12,368,506,-138,-27.27,1198
2020-09-13,120,242,-122,-50.41,1198
2020-09-14,1106,1159,-53,-4.57,1198
2020-09-15,1123,1162,-39,-3.36,1198
2020-09-16,1123,1161,-38,-3.27,1198
2020-09-17,1123,1159,-36,-3.11,1198
2020-09-18,991,1058,-67,-6.33,1198
2020-09-19,368,500,-132,-26.4,1198
2020-09-20,120,236,-116,-49.15,1198
2020-09-21,1106,1154,-48,-4.16,1198
2020-09-22,1123,1157,-34,-2.94,1198
2020-09-23,1123,1158,-35,-3.02,1198
2020-09-24,1123,1157,-34,-2.94,1198
2020-09-25,991,1058,-67,-6.33,1198
2020-09-26,368,501,-133,-26.55,1198
2020-09-27,120,239,-119,-49.79,1198
2020-09-28,1106,1159,-53,-4.57,1198
2020-09-29,1123,1164,-41,-3.52,1198
2020-09-30,1123,1166,-43,-3.69,1198
2020-10-01,1090,1167,-77,-6.6,1198
2020-10-02,973,1069,-96,-8.98,1198
2020-10-03,370,513,-143,-27.88,1198
2020-10-04,120,252,-132,-52.38,1198
2020-10-05,1141,1172,-31,-2.65,1198
2020-10-06,1090,1177,-87,-7.39,1198
2020-10-07,1090,1178,-88,-7.47,1198
2020-10-08,1090,1179,-89,-7.55,1198
2020-10-09,973,1079,-106,-9.82,1198
2020-10-10,370,522,-152,-29.12,1198
2020-10-11,120,258,-138,-53.49,1198
2020-10-12,1141,1176,-35,-2.98,1198
2020-10-13,1090,1179,-89,-7.55,1198
2020-10-14,1090,1178,-88,-7.47,1198
2020-10-15,1090,1177,-87,-7.39,1198
2020-10-16,973,1075,-102,-9.49,1198
2020-10-17,370,515,-145,-28.16,1198
2020-10-18,120,250,-130,-52.0,1198
2020-10-19,1141,1167,-26,-2.23,1198
2020-10-20,1090,1168,-78,-6.68,1198
2020-10-21,1090,1166,-76,-6.52,1198
2020-10-22,1090,1164,-74,-6.36,1198
2020-10-23,973,1062,-89,-8.38,1198
2020-10-24,370,503,-133,-26.44,1198
2020-10-25,120,238,-118,-49.58,1198
2020-10-26,1141,1155,-14,-1.21,1198
2020-10-27,1090,1158,-68,-5.87,1198
2020-10-28,1090,1158,-68,-5.87,1198
2020-10-29,1090,1158,-68,-5.87,1198
2020-10-30,973,1058,-85,-8.03,1198
2020-10-31,370,501,-131,-26.15,1198
2020-11-01,116,238,-122,-51.26,1198
2020-11-02,1050,1158,-108,-9.33,1198
2020-11-03,1045,1163,-118,-10.15,1198
2020-11-04,1045,1165,-120,-10.3,1198
2020-11-05,1045,1167,-122,-10.45,1198
2020-11-06,951,1069,-118,-11.04,1198
2020-11-07,355,513,-158,-30.8,1198
2020-11-08,116,251,-135,-53.78,1198
2020-11-09,1050,1171,-121,-10.33,1198
2020-11-10,1045,1176,-131,-11.14,1198
2020-11-11,1045,1177,-132,-11.21,1198
2020-11-12,1045,1177,-132,-11.21,1198
2020-11-13,951,1076,-125,-11.62,1198
2020-11-14,355,518,-163,-31.47,1198
2020-11-15,116,253,-137,-54.15,1198
2020-11-16,1050,1170,-120,-10.26,1198
2020-11-17,1045,1171,-126,-10.76,1198
2020-11-18,1045,1168,-123,-10.53,1198
2020-11-19,1045,1163,-118,-10.15,1198
2020-11-20,951,1059,-108,-10.2,1198
2020-11-21,355,496,-141,-28.43,1198
2020-11-22,116,227,-111,-48.9,1198
2020-11-23,1050,1139,-89,-7.81,1198
2020-11-24,1045,1136,-91,-8.01,1198
2020-11-25,1045,1130,-85,-7.52,1198
2020-11-26,1045,1122,-77,-6.86,1198
2020-11-27,951,1015,-64,-6.31,1198
2020-11-28,355,450,-95,-21.11,1198
2020-11-29,116,180,-64,-35.56,1198
2020-11-30,1050,1091,-41,-3.76,1198
2020-12-01,879,1088,-209,-19.21,1198
2020-12-02,879,1082,-203,-18.76,1198
2020-12-03,879,1075,-196,-18.23,1198
2020-12-04,999,970,29,2.99,1198
2020-12-05,388,407,-19,-4.67,1198
2020-12-06,131,139,-8,-5.76,1198
2020-12-07,965,1053,-88,-8.36,1198
2020-12-08,879,1053,-174,-16.52,1198
2020-12-09,879,1050,-171,-16.29,1198
2020-12-10,879,1047,-168,-16.05,1198
2020-12-11,999,945,54,5.71,1198
2020-12-12,388,385,3,0.78,1198
2020-12-13,131,120,11,9.17,1198
2020-12-14,965,1037,-72,-6.94,1198
2020-12-15,879,1040,-161,-15.48,1198
2020-12-16,879,1039,-160,-15.4,1198
2020-12-17,879,1037,-158,-15.24,1198
2020-12-18,999,936,63,6.73,1198
2020-12-19,388,377,11,2.92,1198
2020-12-20,131,112,19,16.96,1198
2020-12-21,965,1029,-64,-6.22,1198
2020-12-22,879,1030,-151,-14.66,1198
2020-12-23,879,1028,-149,-14.49,1198
2020-12-24,879,1025,-146,-14.24,1198
2020-12-25,999,922,77,8.35,1198
2020-12-26,388,360,28,7.78,1198
2020-12-27,131,92,39,42.39,1198
2020-12-28,965,1006,-41,-4.08,1198
2020-12-29,879,1005,-126,-12.54,1198
2020-12-30,879,1000,-121,-12.1,1198
2020-12-31,879,994,-115,-11.57,1198
2021-01-01,728,888,-160,-18.02,1198
2021-01-02,244,325,-81,-24.92,1198
2021-01-03,89,56,33,58.93,1198
2021-01-04,802,969,-167,-17.23,1198
2021-01-05,846,967,-121,-12.51,1198
2021-01-06,846,962,-116,-12.06,1198
2021-01-07,846,956,-110,-11.51,1198
2021-01-08,728,852,-124,-14.55,1198
2021-01-09,244,290,-46,-15.86,1198
2021-01-10,89,23,66,286.96,1198
2021-01-11,802,939,-137,-14.59,1198
2021-01-12,846,940,-94,-10.0,1198
2021-01-13,846,938,-92,-9.81,1198
2021-01-14,846,937,-91,-9.71,1198
2021-01-15,728,837,-109,-13.02,1198
2021-01-16,244,279,-35,-12.54,1198
2021-01-17,89,17,72,423.53,1198
2021-01-18,802,937,-135,-14.41,1198
2021-01-19,846,942,-96,-10.19,1198
2021-01-20,846,945,-99,-10.48,1198
2021-01-21,846,947,-101,-10.67,1198
2021-01-22,728,851,-123,-14.45,1198
2021-01-23,244,296,-52,-17.57,1198
2021-01-24,89,36,53,147.22,1198
2021-01-25,802,958,-156,-16.28,1198
2021-01-26,846,966,-120,-12.42,1198
2021-01-27,846,969,-123,-12.69,1198
2021-01-28,846,972,-126,-12.96,1198
2021-01-29,728,876,-148,-16.89,1198
2021-01-30,244,321,-77,-23.99,1198
2021-01-31,89,61,28,45.9,1198
2021-02-01,1018,982,36,3.67,1198
2021-02-02,985,987,-2,-0.2,1198
2021-02-03,985,990,-5,-0.51,1198
2021-02-04,985,991,-6,-0.61,1198
2021-02-05,886,893,-7,-0.78,1198
2021-02-06,339,336,3,0.89,1198
2021-02-07,100,74,26,35.14,1198
2021-02-08,1018,993,25,2.52,1198
2021-02-09,985,998,-13,-1.3,1198
2021-02-10,985,999,-14,-1.4,1198
2021-02-11,985,1000,-15,-1.5,1198
2021-02-12,886,901,-15,-1.66,1198
2021-02-13,339,345,-6,-1.74,1198
2021-02-14,100,83,17,20.48,1198
2021-02-15,1018,1003,15,1.5,1198
2021-02-16,985,1009,-24,-2.38,1198
2021-02-17,985,1012,-27,-2.67,1198
2021-02-18,985,1014,-29,-2.86,1198
2021-02-19,886,918,-32,-3.49,1198
2021-02-20,339,364,-25,-6.87,1198
2021-02-21,100,104,-4,-3.85,1198
2021-02-22,1018,1027,-9,-0.88,1198
2021-02-23,985,1035,-50,-4.83,1198
2021-02-24,985,1040,-55,-5.29,1198
2021-02-25,985,1045,-60,-5.74,1198
2021-02-26,886,951,-65,-6.83,1198
2021-02-27,339,398,-59,-14.82,1198
2021-02-28,100,141,-41,-29.08,1198
2021-03-01,1161,1065,96,9.01,1198
2021-03-02,1130,1074,56,5.21,1198
2021-03-03,1130,1079,51,4.73,1198
2021-03-04,1130,1084,46,4.24,1198
2021-03-05,997,989,8,0.81,1198
2021-03-06,414,436,-22,-5.05,1198
2021-03-07,110,177,-67,-37.85,1198
2021-03-08,1161,1099,62,5.64,1198
2021-03-09,1130,1106,24,2.17,1198
2021-03-10,1130,1110,20,1.8,1198
2021-03-11,1130,1112,18,1.62,1198
2021-03-12,997,1014,-17,-1.68,1198
2021-03-13,414,459,-45,-9.8,1198
2021-03-14,110,197,-87,-44.16,1198
2021-03-15,1161,1117,44,3.94,1198
2021-03-16,1130,1122,8,0.71,1198
2021-03-17,1130,1123,7,0.62,1198
2021-03-18,1130,1124,6,0.53,1198
2021-03-19,997,1025,-28,-2.73,1198
2021-03-20,414,468,-54,-11.54,1198
2021-03-21,110,206,-96,-46.6,1198
2021-03-22,1161,1125,36,3.2,1198
2021-03-23,1130,1130,0,0.0,1198
2021-03-24,1130,1131,-1,-0.09,1198
2021-03-25,1130,1133,-3,-0.26,1198
2021-03-26,997,1035,-38,-3.67,1198
2021-03-27,414,479,-65,-13.57,1198
2021-03-28,110,218,-108,-49.54,1198
2021-03-29,1161,1139,22,1.93,1198
2021-03-30,1130,1146,-16,-1.4,1198
2021-03-31,1130,1149,-19,-1.65,1198
2021-04-01,1088,1152,-64,-5.56,1198
2021-04-02,957,1056,-99,-9.38,1198
2021-04-03,342,502,-160,-31.87,1198
2021-04-04,134,242,-108,-44.63,1198
2021-04-05,1136,1165,-29,-2.49,1198
2021-04-06,1088,1172,-84,-7.17,1198
2021-04-07,1088,1177,-89,-7.56,1198
2021-04-08,1088,1180,-92,-7.8,1198
2021-04-09,957,1084,-127,-11.72,1198
2021-04-10,342,529,-187,-35.35,1198
2021-04-11,134,269,-135,-50.19,1198
2021-04-12,1136,1191,-55,-4.62,1198
2021-04-13,1088,1197,-109,-9.11,1198
2021-04-14,1088,1199,-111,-9.26,1198
2021-04-15,1088,1201,-113,-9.41,1198
2021-04-16,957,1102,-145,-13.16,1198
2021-04-17,342,546,-204,-37.36,1198
2021-04-18,134,283,-149,-52.65,1198
2021-04-19,1136,1202,-66,-5.49,1198
2021-04-20,1088,1206,-118,-9.78,1198
2021-04-21,1088,1206,-118,-9.78,1198
2021-04-22,1088,1205,-117,-9.71,1198
2021-04-23,957,1105,-148,-13.39,1198
2021-04-24,342,547,-205,-37.48,1198
2021-04-25,134,283,-149,-52.65,1198
2021-04-26,1136,1200,-64,-5.33,1198
2021-04-27,1088,1203,-115,-9.56,1198
2021-04-28,1088,1203,-115,-9.56,1198
2021-04-29,1088,1201,-113,-9.41,1198
2021-04-30,957,1101,-144,-13.08,1198
2021-05-01,456,543,-87,-16.02,1198
2021-05-02,143,279,-136,-48.75,1198
2021-05-03,1176,1198,-22,-1.84,1198
2021-05-04,1186,1201,-15,-1.25,1198
2021-05-05,1186,1202,-16,-1.33,1198
2021-05-06,1186,1202,-16,-1.33,1198
2021-05-07,1050,1103,-53,-4.81,1198
2021-05-08,456,546,-90,-16.48,1198
2021-05-09,143,284,-141,-49.65,1198
2021-05-10,1176,1203,-27,-2.24,1198
2021-05-11,1186,1208,-22,-1.82,1198
2021-05-12,1186,1209,-23,-1.9,1198
2021-05-13,1186,1210,-24,-1.98,1198
2021-05-14,1050,1112,-62,-5.58,1198
2021-05-15,456,555,-99,-17.84,1198
2021-05-16,143,293,-150,-51.19,1198
2021-05-17,1176,1213,-37,-3.05,1198
2021-05-18,1186,1217,-31,-2.55,1198
2021-05-19,1186,1218,-32,-2.63,1198
2021-05-20,1186,1218,-32,-2.63,1198
2021-05-21,1050,1119,-69,-6.17,1198
2021-05-22,456,562,-106,-18.86,1198
2021-05-23,143,298,-155,-52.01,1198
2021-05-24,1176,1217,-41,-3.37,1198
2021-05-25,1186,1221,-35,-2.87,1198
2021-05-26,1186,1221,-35,-2.87,1198
2021-05-27,1186,1220,-34,-2.79,1198
2021-05-28,1050,1120,-70,-6.25,1198
2021-05-29,456,562,-106,-18.86,1198
2021-05-30,143,298,-155,-52.01,1198
2021-05-31,1176,1216,-40,-3.29,1198
2021-06-01,1229,1220,9,0.74,1198
2021-06-02,1229,1220,9,0.74,1198
2021-06-03,1229,1219,10,0.82,1198
2021-06-04,1075,1119,-44,-3.93,1198
2021-06-05,441,562,-121,-21.53,1198
2021-06-06,164,299,-135,-45.15,1198
2021-06-07,1233,1218,15,1.23,1198
2021-06-08,1229,1222,7,0.57,1198
2021-06-09,1229,1223,6,0.49,1198
2021-06-10,1229,1223,6,0.49,1198
2021-06-11,1075,1124,-49,-4.36,1198
2021-06-12,441,567,-126,-22.22,1198
2021-06-13,164,304,-140,-46.05,1198
2021-06-14,1233,1223,10,0.82,1198
2021-06-15,1229,1228,1,0.08,1198
2021-06-16,1229,1228,1,0.08,1198
2021-06-17,1229,1228,1,0.08,1198
2021-06-18,1075,1129,-54,-4.78,1198
2021-06-19,441,571,-130,-22.77,1198
2021-06-20,164,307,-143,-46.58,1198
2021-06-21,1233,1225,8,0.65,1198
2021-06-22,1229,1228,1,0.08,1198
2021-06-23,1229,1228,1,0.08,1198
2021-06-24,1229,1226,3,0.24,1198
2021-06-25,1075,1125,-50,-4.44,1198
2021-06-26,441,565,-124,-21.95,1198
2021-06-27,164,300,-136,-45.33,1198
2021-06-28,1233,1216,17,1.4,1198
2021-06-29,1229,1218,11,0.9,1198
2021-06-30,1229,1216,13,1.07,1198
2021-07-01,1081,1213,-132,-10.88,1198
2021-07-02,1006,1111,-105,-9.45,1198
2021-07-03,366,550,-184,-33.45,1198
2021-07-04,138,285,-147,-51.58,1198
2021-07-05,1120,1201,-81,-6.74,1198
2021-07-06,1081,1203,-122,-10.14,1198
2021-07-07,1081,1201,-120,-9.99,1198
2021-07-08,1081,1199,-118,-9.84,1198
2021-07-09,1006,1098,-92,-8.38,1198
2021-07-10,366,539,-173,-32.1,1198
2021-07-11,138,274,-136,-49.64,1198
2021-07-12,1120,1192,-72,-6.04,1198
2021-07-13,1081,1196,-115,-9.62,1198
2021-07-14,1081,1196,-115,-9.62,1198
2021-07-15,1081,1195,-114,-9.54,1198
2021-07-16,1006,1096,-90,-8.21,1198
2021-07-17,366,538,-172,-31.97,1198
2021-07-18,138,275,-137,-49.82,1198
2021-07-19,1120,1194,-74,-6.2,1198
2021-07-20,1081,1198,-117,-9.77,1198
2021-07-21,1081,1199,-118,-9.84,1198
2021-07-22,1081,1199,-118,-9.84,1198
2021-07-23,1006,1099,-93,-8.46,1198
2021-07-24,366,541,-175,-32.35,1198
2021-07-25,138,278,-140,-50.36,1198
2021-07-26,1120,1195,-75,-6.28,1198
2021-07-27,1081,1198,-117,-9.77,1198
2021-07-28,1081,1197,-116,-9.69,1198
2021-07-29,1081,1195,-114,-9.54,1198
2021-07-30,1006,1093,-87,-7.96,1198
2021-07-31,366,533,-167,-31.33,1198
2021-08-01,140,267,-127,-47.57,1198
2021-08-02,1023,1182,-159,-13.45,1198
2021-08-03,1008,1183,-175,-14.79,1198
2021-08-04,1008,1179,-171,-14.5,1198
2021-08-05,1008,1175,-167,-14.21,1198
2021-08-06,938,1072,-134,-12.5,1198
2021-08-07,347,510,-163,-31.96,1198
2021-08-08,140,243,-103,-42.39,1198
2021-08-09,1023,1158,-135,-11.66,1198
2021-08-10,1008,1159,-151,-13.03,1198
2021-08-11,1008,1156,-148,-12.8,1198
2021-08-12,1008,1153,-145,-12.58,1198
2021-08-13,938,1051,-113,-10.75,1198
2021-08-14,347,491,-144,-29.33,1198
2021-08-15,140,227,-87,-38.33,1198
2021-08-16,1023,1145,-122,-10.66,1198
2021-08-17,1008,1148,-140,-12.2,1198
2021-08-18,1008,1149,-141,-12.27,1198
2021-08-19,1008,1149,-141,-12.27,1198
2021-08-20,938,1051,-113,-10.75,1198
2021-08-21,347,495,-148,-29.9,1198
2021-08-22,140,234,-94,-40.17,1198
2021-08-23,1023,1155,-132,-11.43,1198
2021-08-24,1008,1162,-154,-13.25,1198
2021-08-25,1008,1166,-158,-13.55,1198
2021-08-26,1008,1169,-161,-13.77,1198
2021-08-27,938,1073,-135,-12.58,1198
2021-08-28,347,520,-173,-33.27,1198
2021-08-29,140,260,-120,-46.15,1198
2021-08-30,1023,1183,-160,-13.52,1198
2021-08-31,1008,1190,-182,-15.29,1198
2021-09-01,1181,1194,-13,-1.09,1198
2021-09-02,1181,1196,-15,-1.25,1198
2021-09-03,1038,1099,-61,-5.55,1198
2021-09-04,420,544,-124,-22.79,1198
2021-09-05,160,283,-123,-43.46,1198
2021-09-06,1209,1203,6,0.5,1198
2021-09-07,1181,1208,-27,-2.24,1198
2021-09-08,1181,1209,-28,-2.32,1198
2021-09-09,1181,1209,-28,-2.32,1198
2021-09-10,1038,1109,-71,-6.4,1198
2021-09-11,420,551,-131,-23.77,1198
2021-09-12,160,287,-127,-44.25,1198
2021-09-13,1209,1205,4,0.33,1198
2021-09-14,1181,1208,-27,-2.24,1198
2021-09-15,1181,1207,-26,-2.15,1198
2021-09-16,1181,1206,-25,-2.07,1198
2021-09-17,1038,1105,-67,-6.06,1198
2021-09-18,420,546,-126,-23.08,1198
2021-09-19,160,282,-122,-43.26,1198
2021-09-20,1209,1199,10,0.83,1198
2021-09-21,1181,1202,-21,-1.75,1198
2021-09-22,1181,1202,-21,-1.75,1198
2021-09-23,1181,1202,-21,-1.75,1198
2021-09-24,1038,1102,-64,-5.81,1198
2021-09-25,420,545,-125,-22.94,1198
2021-09-26,160,283,-123,-43.46,1198
2021-09-27,1209,1202,7,0.58,1198
2021-09-28,1181,1207,-26,-2.15,1198
2021-09-29,1181,1209,-28,-2.32,1198
2021-09-30,1181,1210,-29,-2.4,1198
2021-10-01,1061,1112,-51,-4.59,1198
2021-10-02,401,556,-155,-27.88,1198
2021-10-03,130,294,-164,-55.78,1198
2021-10-04,1136,1215,-79,-6.5,1198
2021-10-05,1169,1220,-51,-4.18,1198
2021-10-06,1169,1222,-53,-4.34,1198
2021-10-07,1169,1222,-53,-4.34,1198
2021-10-08,1061,1123,-62,-5.52,1198
2021-10-09,401,566,-165,-29.15,1198
2021-10-10,130,303,-173,-57.1,1198
2021-10-11,1136,1222,-86,-7.04,1198
2021-10-12,1169,1225,-56,-4.57,1198
2021-10-13,1169,1225,-56,-4.57,1198
2021-10-14,1169,1223,-54,-4.42,1198
2021-10-15,1061,1122,-61,-5.44,1198
2021-10-16,401,563,-162,-28.77,1198
2021-10-17,130,298,-168,-56.38,1198
2021-10-18,1136,1214,-78,-6.43,1198
2021-10-19,1169,1216,-47,-3.87,1198
2021-10-20,1169,1214,-45,-3.71,1198
2021-10-21,1169,1211,-42,-3.47,1198
2021-10-22,1061,1109,-48,-4.33,1198
2021-10-23,401,550,-149,-27.09,1198
2021-10-24,130,285,-155,-54.39,1198
2021-10-25,1136,1202,-66,-5.49,1198
2021-10-26,1169,1204,-35,-2.91,1198
2021-10-27,1169,1203,-34,-2.83,1198
2021-10-28,1169,1203,-34,-2.83,1198
2021-10-29,1061,1102,-41,-3.72,1198
2021-10-30,401,545,-144,-26.42,1198
2021-10-31,130,282,-152,-53.9,1198
2021-11-01,1070,1202,-132,-10.98,1198
2021-11-02,1096,1206,-110,-9.12,1198
2021-11-03,1096,1208,-112,-9.27,1198
2021-11-04,1096,1209,-113,-9.35,1198
2021-11-05,1012,1111,-99,-8.91,1198
2021-11-06,354,555,-201,-36.22,1198
2021-11-07,105,294,-189,-64.29,1198
2021-11-08,1070,1214,-144,-11.86,1198
2021-11-09,1096,1219,-123,-10.09,1198
2021-11-10,1096,1220,-124,-10.16,1198
2021-11-11,1096,1221,-125,-10.24,1198
2021-11-12,1012,1121,-109,-9.72,1198
2021-11-13,354,564,-210,-37.23,1198
2021-11-14,105,300,-195,-65.0,1198
2021-11-15,1070,1217,-147,-12.08,1198
2021-11-16,1096,1219,-123,-10.09,1198
2021-11-17,1096,1217,-121,-9.94,1198
2021-11-18,1096,1213,-117,-9.65,1198
2021-11-19,1012,1109,-97,-8.75,1198
2021-11-20,354,547,-193,-35.28,1198
2021-11-21,105,279,-174,-62.37,1198
2021-11-22,1070,1192,-122,-10.23,1198
2021-11-23,1096,1189,-93,-7.82,1198
2021-11-24,1096,1183,-87,-7.35,1198
2021-11-25,1096,1176,-80,-6.8,1198
2021-11-26,1012,1069,-57,-5.33,1198
2021-11-27,354,504,-150,-29.76,1198
2021-11-28,105,234,-129,-55.13,1198
2021-11-29,1070,1145,-75,-6.55,1198
2021-11-30,1096,1142,-46,-4.03,1198
2021-12-01,893,1135,-242,-21.32,1198
2021-12-02,893,1128,-235,-20.83,1198
2021-12-03,714,1022,-308,-30.14,1198
2021-12-04,381,458,-77,-16.81,1198
2021-12-05,94,190,-96,-50.53,1198
2021-12-06,973,1103,-130,-11.79,1198
2021-12-07,893,1103,-210,-19.04,1198
2021-12-08,893,1099,-206,-18.74,1198
2021-12-09,893,1095,-202,-18.45,1198
2021-12-10,714,993,-279,-28.1,1198
2021-12-11,381,432,-51,-11.81,1198
2021-12-12,94,167,-73,-43.71,1198
2021-12-13,973,1084,-111,-10.24,1198
2021-12-14,893,1086,-193,-17.77,1198
2021-12-15,893,1085,-192,-17.7,1198
2021-12-16,893,1084,-191,-17.62,1198
2021-12-17,714,983,-269,-27.37,1198
2021-12-18,381,424,-43,-10.14,1198
2021-12-19,94,159,-65,-40.88,1198
2021-12-20,973,1076,-103,-9.57,1198
2021-12-21,893,1078,-185,-17.16,1198
2021-12-22,893,1076,-183,-17.01,1198
2021-12-23,893,1073,-180,-16.78,1198
2021-12-24,714,971,-257,-26.47,1198
2021-12-25,381,410,-29,-7.07,1198
2021-12-26,94,143,-49,-34.27,1198
2021-12-27,973,1057,-84,-7.95,1198
2021-12-28,893,1056,-163,-15.44,1198
2021-12-29,893,1051,-158,-15.03,1198
2021-12-30,893,1046,-153,-14.63,1198
2021-12-31,714,940,-226,-24.04,1198
2022-01-01,330,377,-47,-12.47,1198
2022-01-02,103,108,-5,-4.63,1198
2022-01-03,923,1021,-98,-9.6,1198
2022-01-04,925,1018,-93,-9.14,1198
2022-01-05,925,1013,-88,-8.69,1198
2022-01-06,925,1007,-82,-8.14,1198
2022-01-07,819,902,-83,-9.2,1198
2022-01-08,330,340,-10,-2.94,1198
2022-01-09,103,72,31,43.06,1198
2022-01-10,923,987,-64,-6.48,1198
2022-01-11,925,988,-63,-6.38,1198
2022-01-12,925,986,-61,-6.19,1198
2022-01-13,925,983,-58,-5.9,1198
2022-01-14,819,882,-63,-7.14,1198
2022-01-15,330,324,6,1.85,1198
2022-01-16,103,61,42,68.85,1198
2022-01-17,923,980,-57,-5.82,1198
2022-01-18,925,985,-60,-6.09,1198
2022-01-19,925,987,-62,-6.28,1198
2022-01-20,925,989,-64,-6.47,1198
2022-01-21,819,892,-73,-8.18,1198
2022-01-22,330,337,-7,-2.08,1198
2022-01-23,103,77,26,33.77,1198
2022-01-24,923,999,-76,-7.61,1198
2022-01-25,925,1006,-81,-8.05,1198
2022-01-26,925,1010,-85,-8.42,1198
2022-01-27,925,1013,-88,-8.69,1198
2022-01-28,819,917,-98,-10.69,1198
2022-01-29,330,362,-32,-8.84,1198
2022-01-30,103,102,1,0.98,1198
2020-02-01,280,201,79,39.3,1617
2020-02-02,143,86,57,66.28,1617
2020-02-03,521,569,-48,-8.44,1617
2020-02-04,606,565,41,7.26,1617
2020-02-05,606,563,43,7.64,1617
2020-02-06,606,560,46,8.21,1617
2020-02-07,564,525,39,7.43,1617
2020-02-08,280,186,94,50.54,1617
2020-02-09,143,69,74,107.25,1617
2020-02-10,521,553,-32,-5.79,1617
2020-02-11,606,549,57,10.38,1617
2020-02-12,606,547,59,10.79,1617
2020-02-13,606,545,61,11.19,1617
2020-02-14,564,511,53,10.37,1617
2020-02-15,280,173,107,61.85,1617
2020-02-16,143,59,84,142.37,1617
2020-02-17,521,545,-24,-4.4,1617
2020-02-18,606,544,62,11.4,1617
2020-02-19,606,544,62,11.4,1617
2020-02-20,606,546,60,10.99,1617
2020-02-21,564,516,48,9.3,1617
2020-02-22,280,181,99,54.7,1617
2020-02-23,143,71,72,101.41,1617
2020-02-24,521,560,-39,-6.96,1617
2020-02-25,606,562,44,7.83,1617
2020-02-26,606,566,40,7.07,1617
2020-02-27,606,570,36,6.32,1617
2020-02-28,564,542,22,4.06,1617
2020-02-29,280,210,70,33.33,1617
2020-03-01,132,101,31,30.69,1617
2020-03-02,499,591,-92,-15.57,1617
2020-03-03,467,594,-127,-21.38,1617
2020-03-04,467,598,-131,-21.91,1617
2020-03-05,467,602,-135,-22.43,1617
2020-03-06,393,573,-180,-31.41,1617
2020-03-07,195,240,-45,-18.75,1617
2020-03-08,132,129,3,2.33,1617
2020-03-09,499,617,-118,-19.12,1617
2020-03-10,467,617,-150,-24.31,1617
2020-03-11,467,618,-151,-24.43,1617
2020-03-12,467,619,-152,-24.56,1617
2020-03-13,393,587,-194,-33.05,1617
2020-03-14,195,250,-55,-22.0,1617
2020-03-15,132,136,-4,-2.94,1617
2020-03-16,499,620,-121,-19.52,1617
2020-03-17,467,617,-150,-24.31,1617
2020-03-18,467,615,-148,-24.07,1617
2020-03-19,467,613,-146,-23.82,1617
2020-03-20,393,579,-186,-32.12,1617
2020-03-21,195,239,-44,-18.41,1617
2020-03-22,132,123,9,7.32,1617
2020-03-23,499,606,-107,-17.66,1617
2020-03-24,467,602,-135,-22.43,1617
2020-03-25,467,599,-132,-22.04,1617
2020-03-26,467,597,-130,-21.78,1617
2020-03-27,393,563,-170,-30.2,1617
2020-03-28,195,224,-29,-12.95,1617
2020-03-29,132,109,23,21.1,1617
2020-03-30,499,593,-94,-15.85,1617
2020-03-31,467,590,-123,-20.85,1617
2020-04-01,422,589,-167,-28.35,1617
2020-04-02,422,588,-166,-28.23,1617
2020-04-03,359,556,-197,-35.43,1617
2020-04-04,178,219,-41,-18.72,1617
2020-04-05,90,105,-15,-14.29,1617
2020-04-06,423,591,-168,-28.43,1617
2020-04-07,422,589,-167,-28.35,1617
2020-04-08,422,590,-168,-28.47,1617
2020-04-09,422,590,-168,-28.47,1617
2020-04-10,359,558,-199,-35.66,1617
2020-04-11,178,221,-43,-19.46,1617
2020-04-12,90,108,-18,-16.67,1617
2020-04-13,423,594,-171,-28.79,1617
2020-04-14,422,592,-170,-28.72,1617
2020-04-15,422,591,-169,-28.6,1617
2020-04-16,422,590,-168,-28.47,1617
2020-04-17,359,557,-198,-35.55,1617
2020-04-18,178,219,-41,-18.72,1617
2020-04-19,90,104,-14,-13.46,1617
2020-04-20,423,587,-164,-27.94,1617
2020-04-21,422,583,-161,-27.62,1617
2020-04-22,422,581,-159,-27.37,1617
2020-04-23,422,578,-156,-26.99,1617
2020-04-24,359,543,-184,-33.89,1617
2020-04-25,178,203,-25,-12.32,1617
2020-04-26,90,86,4,4.65,1617
2020-04-27,423,568,-145,-25.53,1617
2020-04-28,422,563,-141,-25.04,1617
2020-04-29,422,559,-137,-24.51,1617
2020-04-30,422,556,-134,-24.1,1617
2020-05-01,456,520,-64,-12.31,1617
2020-05-02,262,180,82,45.56,1617
2020-05-03,124,64,60,93.75,1617
2020-05-04,465,546,-81,-14.84,1617
2020-05-05,549,542,7,1.29,1617
2020-05-06,549,539,10,1.86,1617
2020-05-07,549,537,12,2.23,1617
2020-05-08,456,503,-47,-9.34,1617
2020-05-09,262,164,98,59.76,1617
2020-05-10,124,49,75,153.06,1617
2020-05-11,465,533,-68,-12.76,1617
2020-05-12,549,531,18,3.39,1617
2020-05-13,549,530,19,3.58,1617
2020-05-14,549,529,20,3.78,1617
2020-05-15,456,496,-40,-8.06,1617
2020-05-16,262,159,103,64.78,1617
2020-05-17,124,45,79,175.56,1617
2020-05-18,465,530,-65,-12.26,1617
2020-05-19,549,529,20,3.78,1617
2020-05-20,549,528,21,3.98,1617
2020-05-21,549,528,21,3.98,1617
2020-05-22,456,496,-40,-8.06,1617
2020-05-23,262,159,103,64.78,1617
2020-05-24,124,45,79,175.56,1617
2020-05-25,465,530,-65,-12.26,1617
2020-05-26,549,528,21,3.98,1617
2020-05-27,549,528,21,3.98,1617
2020-05-28,549,527,22,4.17,1617
2020-05-29,456,495,-39,-7.88,1617
2020-05-30,262,157,105,66.88,1617
2020-05-31,124,43,81,188.37,1617
2020-06-01,477,528,-51,-9.66,1617
2020-06-02,556,526,30,5.7,1617
2020-06-03,556,525,31,5.9,1617
2020-06-04,556,524,32,6.11,1617
2020-06-05,393,492,-99,-20.12,1617
2020-06-06,186,154,32,20.78,1617
2020-06-07,100,41,59,143.9,1617
2020-06-08,477,526,-49,-9.32,1617
2020-06-09,556,524,32,6.11,1617
2020-06-10,556,523,33,6.31,1617
2020-06-11,556,523,33,6.31,1617
2020-06-12,393,491,-98,-19.96,1617
2020-06-13,186,153,33,21.57,1617
2020-06-14,100,40,60,150.0,1617
2020-06-15,477,525,-48,-9.14,1617
2020-06-16,556,523,33,6.31,1617
2020-06-17,556,523,33,6.31,1617
2020-06-18,556,522,34,6.51,1617
2020-06-19,393,490,-97,-19.8,1617
2020-06-20,186,152,34,22.37,1617
2020-06-21,100,38,62,163.16,1617
2020-06-22,477,523,-46,-8.8,1617
2020-06-23,556,521,35,6.72,1617
2020-06-24,556,520,36,6.92,1617
2020-06-25,556,519,37,7.13,1617
2020-06-26,393,485,-92,-18.97,1617
2020-06-27,186,147,39,26.53,1617
2020-06-28,100,32,68,212.5,1617
2020-06-29,477,516,-39,-7.56,1617
2020-06-30,556,513,43,8.38,1617
2020-07-01,478,511,-33,-6.46,1617
2020-07-02,478,509,-31,-6.09,1617
2020-07-03,417,476,-59,-12.39,1617
2020-07-04,164,137,27,19.71,1617
2020-07-05,119,22,97,440.91,1617
2020-07-06,496,506,-10,-1.98,1617
2020-07-07,478,503,-25,-4.97,1617
2020-07-08,478,501,-23,-4.59,1617
2020-07-09,478,500,-22,-4.4,1617
2020-07-10,417,467,-50,-10.71,1617
2020-07-11,164,129,35,27.13,1617
2020-07-12,119,15,104,693.33,1617
2020-07-13,496,500,-4,-0.8,1617
2020-07-14,478,498,-20,-4.02,1617
2020-07-15,478,498,-20,-4.02,1617
2020-07-16,478,498,-20,-4.02,1617
2020-07-17,417,466,-49,-10.52,1617
2020-07-18,164,129,35,27.13,1617
2020-07-19,119,16,103,643.75,1617
2020-07-20,496,502,-6,-1.2,1617
2020-07-21,478,500,-22,-4.4,1617
2020-07-22,478,501,-23,-4.59,1617
2020-07-23,478,501,-23,-4.59,1617
2020-07-24,417,469,-52,-11.09,1617
2020-07-25,164,132,32,24.24,1617
2020-07-26,119,18,101,561.11,1617
2020-07-27,496,504,-8,-1.59,1617
2020-07-28,478,502,-24,-4.78,1617
2020-07-29,478,501,-23,-4.59,1617
2020-07-30,478,500,-22,-4.4,1617
2020-07-31,417,467,-50,-10.71,1617
2020-08-01,185,128,57,44.53,1617
2020-08-02,117,13,104,800.0,1617
2020-08-03,446,497,-51,-10.26,1617
2020-08-04,495,494,1,0.2,1617
2020-08-05,495,491,4,0.81,1617
2020-08-06,495,489,6,1.23,1617
2020-08-07,447,455,-8,-1.76,1617
2020-08-08,185,116,69,59.48,1617
2020-08-09,117,0,117,inf,1617
2020-08-10,446,484,-38,-7.85,1617
2020-08-11,495,481,14,2.91,1617
2020-08-12,495,479,16,3.34,1617
2020-08-13,495,478,17,3.56,1617
2020-08-14,447,445,2,0.45,1617
2020-08-15,185,108,77,71.3,1617
2020-08-16,117,44,73,165.91,1617
2020-08-17,446,480,-34,-7.08,1617
2020-08-18,495,479,16,3.34,1617
2020-08-19,495,481,14,2.91,1617
2020-08-20,495,483,12,2.48,1617
2020-08-21,447,453,-6,-1.32,1617
2020-08-22,185,119,66,55.46,1617
2020-08-23,117,9,108,1200.0,1617
2020-08-24,446,499,-53,-10.62,1617
2020-08-25,495,501,-6,-1.2,1617
2020-08-26,495,506,-11,-2.17,1617
2020-08-27,495,511,-16,-3.13,1617
2020-08-28,447,484,-37,-7.64,1617
2020-08-29,185,153,32,20.92,1617
2020-08-30,117,45,72,160.0,1617
2020-08-31,446,536,-90,-16.79,1617
2020-09-01,513,540,-27,-5.0,1617
2020-09-02,513,545,-32,-5.87,1617
2020-09-03,513,551,-38,-6.9,1617
2020-09-04,394,524,-130,-24.81,1617
2020-09-05,188,192,-4,-2.08,1617
2020-09-06,99,83,16,19.28,1617
2020-09-07,485,573,-88,-15.36,1617
2020-09-08,513,575,-62,-10.78,1617
2020-09-09,513,578,-65,-11.25,1617
2020-09-10,513,581,-68,-11.7,1617
2020-09-11,394,551,-157,-28.49,1617
2020-09-12,188,216,-28,-12.96,1617
2020-09-13,99,104,-5,-4.81,1617
2020-09-14,485,591,-106,-17.94,1617
2020-09-15,513,590,-77,-13.05,1617
2020-09-16,513,590,-77,-13.05,1617
2020-09-17,513,590,-77,-13.05,1617
2020-09-18,394,558,-164,-29.39,1617
2020-09-19,188,220,-32,-14.55,1617
2020-09-20,99,106,-7,-6.6,1617
2020-09-21,485,591,-106,-17.94,1617
2020-09-22,513,588,-75,-12.76,1617
2020-09-23,513,587,-74,-12.61,1617
2020-09-24,513,585,-72,-12.31,1617
2020-09-25,394,552,-158,-28.62,1617
2020-09-26,188,214,-26,-12.15,1617
2020-09-27,99,99,0,0.0,1617
2020-09-28,485,584,-99,-16.95,1617
2020-09-29,513,582,-69,-11.86,1617
2020-09-30,513,581,-68,-11.7,1617
2020-10-01,499,580,-81,-13.97,1617
2020-10-02,408,547,-139,-25.41,1617
2020-10-03,202,210,-8,-3.81,1617
2020-10-04,110,96,14,14.58,1617
2020-10-05,594,582,12,2.06,1617
2020-10-06,499,580,-81,-13.97,1617
2020-10-07,499,580,-81,-13.97,1617
2020-10-08,499,580,-81,-13.97,1617
2020-10-09,408,548,-140,-25.55,1617
2020-10-10,202,211,-9,-4.27,1617
2020-10-11,110,98,12,12.24,1617
2020-10-12,594,584,10,1.71,1617
2020-10-13,499,583,-84,-14.41,1617
2020-10-14,499,583,-84,-14.41,1617
2020-10-15,499,583,-84,-14.41,1617
2020-10-16,408,551,-143,-25.95,1617
2020-10-17,202,215,-13,-6.05,1617
2020-10-18,110,102,8,7.84,1617
2020-10-19,594,588,6,1.02,1617
2020-10-20,499,587,-88,-14.99,1617
2020-10-21,499,587,-88,-14.99,1617
2020-10-22,499,588,-89,-15.14,1617
2020-10-23,408,556,-148,-26.62,1617
2020-10-24,202,220,-18,-8.18,1617
2020-10-25,110,108,2,1.85,1617
2020-10-26,594,595,-1,-0.17,1617
2020-10-27,499,594,-95,-15.99,1617
2020-10-28,499,596,-97,-16.28,1617
2020-10-29,499,597,-98,-16.42,1617
2020-10-30,408,567,-159,-28.04,1617
2020-10-31,202,232,-30,-12.93,1617
2020-11-01,126,121,5,4.13,1617
2020-11-02,566,609,-43,-7.06,1617
2020-11-03,595,609,-14,-2.3,1617
2020-11-04,595,612,-17,-2.78,1617
2020-11-05,595,614,-19,-3.09,1617
2020-11-06,598,584,14,2.4,1617
2020-11-07,237,250,-13,-5.2,1617
2020-11-08,126,138,-12,-8.7,1617
2020-11-09,566,626,-60,-9.58,1617
2020-11-10,595,626,-31,-4.95,1617
2020-11-11,595,628,-33,-5.25,1617
2020-11-12,595,629,-34,-5.41,1617
2020-11-13,598,598,0,0.0,1617
2020-11-14,237,262,-25,-9.54,1617
2020-11-15,126,149,-23,-15.44,1617
2020-11-16,566,635,-69,-10.87,1617
2020-11-17,595,633,-38,-6.0,1617
2020-11-18,595,632,-37,-5.85,1617
2020-11-19,595,630,-35,-5.56,1617
2020-11-20,598,597,1,0.17,1617
2020-11-21,237,258,-21,-8.14,1617
2020-11-22,126,142,-16,-11.27,1617
2020-11-23,566,625,-59,-9.44,1617
2020-11-24,595,620,-25,-4.03,1617
2020-11-25,595,617,-22,-3.57,1617
2020-11-26,595,613,-18,-2.94,1617
2020-11-27,598,578,20,3.46,1617
2020-11-28,237,237,0,0.0,1617
2020-11-29,126,120,6,5.0,1617
2020-11-30,566,602,-36,-5.98,1617
2020-12-01,480,596,-116,-19.46,1617
2020-12-02,480,593,-113,-19.06,1617
2020-12-03,480,589,-109,-18.51,1617
2020-12-04,527,554,-27,-4.87,1617
2020-12-05,214,214,0,0.0,1617
2020-12-06,132,98,34,34.69,1617
2020-12-07,502,581,-79,-13.6,1617
2020-12-08,480,577,-97,-16.81,1617
2020-12-09,480,575,-95,-16.52,1617
2020-12-10,480,574,-94,-16.38,1617
2020-12-11,527,540,-13,-2.41,1617
2020-12-12,214,203,11,5.42,1617
2020-12-13,132,88,44,50.0,1617
2020-12-14,502,574,-72,-12.54,1617
2020-12-15,480,572,-92,-16.08,1617
2020-12-16,480,572,-92,-16.08,1617
2020-12-17,480,571,-91,-15.94,1617
2020-12-18,527,539,-12,-2.23,1617
2020-12-19,214,203,11,5.42,1617
2020-12-20,132,89,43,48.31,1617
2020-12-21,502,575,-73,-12.7,1617
2020-12-22,480,573,-93,-16.23,1617
2020-12-23,480,573,-93,-16.23,1617
2020-12-24,480,572,-92,-16.08,1617
2020-12-25,527,540,-13,-2.41,1617
2020-12-26,214,202,12,5.94,1617
2020-12-27,132,88,44,50.0,1617
2020-12-28,502,573,-71,-12.39,1617
2020-12-29,480,570,-90,-15.79,1617
2020-12-30,480,568,-88,-15.49,1617
2020-12-31,480,567,-87,-15.34,1617
2021-01-01,465,533,-68,-12.76,1617
2021-01-02,203,194,9,4.64,1617
2021-01-03,142,79,63,79.75,1617
2021-01-04,516,563,-47,-8.35,1617
2021-01-05,498,560,-62,-11.07,1617
2021-01-06,498,558,-60,-10.75,1617
2021-01-07,498,556,-58,-10.43,1617
2021-01-08,465,522,-57,-10.92,1617
2021-01-09,203,184,19,10.33,1617
2021-01-10,142,70,72,102.86,1617
2021-01-11,516,554,-38,-6.86,1617
2021-01-12,498,552,-54,-9.78,1617
2021-01-13,498,551,-53,-9.62,1617
2021-01-14,498,550,-52,-9.45,1617
2021-01-15,465,518,-53,-10.23,1617
2021-01-16,203,181,22,12.15,1617
2021-01-17,142,67,75,111.94,1617
2021-01-18,516,553,-37,-6.69,1617
2021-01-19,498,552,-54,-9.78,1617
2021-01-20,498,552,-54,-9.78,1617
2021-01-21,498,552,-54,-9.78,1617
2021-01-22,465,520,-55,-10.58,1617
2021-01-23,203,183,20,10.93,1617
2021-01-24,142,69,73,105.8,1617
2021-01-25,516,555,-39,-7.03,1617
2021-01-26,498,553,-55,-9.95,1617
2021-01-27,498,552,-54,-9.78,1617
2021-01-28,498,551,-53,-9.62,1617
2021-01-29,465,518,-53,-10.23,1617
2021-01-30,203,180,23,12.78,1617
2021-01-31,142,65,77,118.46,1617
2021-02-01,622,548,74,13.5,1617
2021-02-02,527,545,-18,-3.3,1617
2021-02-03,527,542,-15,-2.77,1617
2021-02-04,527,540,-13,-2.41,1617
2021-02-05,559,505,54,10.69,1617
2021-02-06,246,166,80,48.19,1617
2021-02-07,136,49,87,177.55,1617
2021-02-08,622,532,90,16.92,1617
2021-02-09,527,528,-1,-0.19,1617
2021-02-10,527,526,1,0.19,1617
2021-02-11,527,524,3,0.57,1617
2021-02-12,559,490,69,14.08,1617
2021-02-13,246,151,95,62.91,1617
2021-02-14,136,37,99,267.57,1617
2021-02-15,622,522,100,19.16,1617
2021-02-16,527,520,7,1.35,1617
2021-02-17,527,520,7,1.35,1617
2021-02-18,527,521,6,1.15,1617
2021-02-19,559,490,69,14.08,1617
2021-02-20,246,155,91,58.71,1617
2021-02-21,136,44,92,209.09,1617
2021-02-22,622,532,90,16.92,1617
2021-02-23,527,534,-7,-1.31,1617
2021-02-24,527,537,-10,-1.86,1617
2021-02-25,527,541,-14,-2.59,1617
2021-02-26,559,513,46,8.97,1617
2021-02-27,246,181,65,35.91,1617
2021-02-28,136,72,64,88.89,1617
2021-03-01,612,562,50,8.9,1617
2021-03-02,598,565,33,5.84,1617
2021-03-03,598,569,29,5.1,1617
2021-03-04,598,574,24,4.18,1617
2021-03-05,466,546,-80,-14.65,1617
2021-03-06,260,212,48,22.64,1617
2021-03-07,163,102,61,59.8,1617
2021-03-08,612,591,21,3.55,1617
2021-03-09,598,591,7,1.18,1617
2021-03-10,598,593,5,0.84,1617
2021-03-11,598,595,3,0.5,1617
2021-03-12,466,563,-97,-17.23,1617
2021-03-13,260,227,33,14.54,1617
2021-03-14,163,113,50,44.25,1617
2021-03-15,612,598,14,2.34,1617
2021-03-16,598,596,2,0.34,1617
2021-03-17,598,594,4,0.67,1617
2021-03-18,598,592,6,1.01,1617
2021-03-19,466,558,-92,-16.49,1617
2021-03-20,260,219,41,18.72,1617
2021-03-21,163,103,60,58.25,1617
2021-03-22,612,586,26,4.44,1617
2021-03-23,598,582,16,2.75,1617
2021-03-24,598,579,19,3.28,1617
2021-03-25,598,577,21,3.64,1617
2021-03-26,466,542,-76,-14.02,1617
2021-03-27,260,203,57,28.08,1617
2021-03-28,163,87,76,87.36,1617
2021-03-29,612,571,41,7.18,1617
2021-03-30,598,568,30,5.28,1617
2021-03-31,598,567,31,5.47,1617
2021-04-01,551,566,-15,-2.65,1617
2021-04-02,500,533,-33,-6.19,1617
2021-04-03,229,196,33,16.84,1617
2021-04-04,127,82,45,54.88,1617
2021-04-05,549,567,-18,-3.17,1617
2021-04-06,551,566,-15,-2.65,1617
2021-04-07,551,566,-15,-2.65,1617
2021-04-08,551,566,-15,-2.65,1617
2021-04-09,500,534,-34,-6.37,1617
2021-04-10,229,198,31,15.66,1617
2021-04-11,127,85,42,49.41,1617
2021-04-12,549,570,-21,-3.68,1617
2021-04-13,551,569,-18,-3.16,1617
2021-04-14,551,568,-17,-2.99,1617
2021-04-15,551,568,-17,-2.99,1617
2021-04-16,500,535,-35,-6.54,1617
2021-04-17,229,197,32,16.24,1617
2021-04-18,127,82,45,54.88,1617
2021-04-19,549,566,-17,-3.0,1617
2021-04-20,551,563,-12,-2.13,1617
2021-04-21,551,561,-10,-1.78,1617
2021-04-22,551,558,-7,-1.25,1617
2021-04-23,500,523,-23,-4.4,1617
2021-04-24,229,183,46,25.14,1617
2021-04-25,127,67,60,89.55,1617
2021-04-26,549,549,0,0.0,1617
2021-04-27,551,544,7,1.29,1617
2021-04-28,551,540,11,2.04,1617
2021-04-29,551,537,14,2.61,1617
2021-04-30,500,501,-1,-0.2,1617
2021-05-01,213,161,52,32.3,1617
2021-05-02,97,44,53,120.45,1617
2021-05-03,507,527,-20,-3.8,1617
2021-05-04,514,522,-8,-1.53,1617
2021-05-05,514,519,-5,-0.96,1617
2021-05-06,514,517,-3,-0.58,1617
2021-05-07,452,482,-30,-6.22,1617
2021-05-08,213,143,70,48.95,1617
2021-05-09,97,28,69,246.43,1617
2021-05-10,507,512,-5,-0.98,1617
2021-05-11,514,509,5,0.98,1617
2021-05-12,514,508,6,1.18,1617
2021-05-13,514,506,8,1.58,1617
2021-05-14,452,474,-22,-4.64,1617
2021-05-15,213,136,77,56.62,1617
2021-05-16,97,22,75,340.91,1617
2021-05-17,507,507,0,0.0,1617
2021-05-18,514,506,8,1.58,1617
2021-05-19,514,505,9,1.78,1617
2021-05-20,514,505,9,1.78,1617
2021-05-21,452,473,-21,-4.44,1617
2021-05-22,213,136,77,56.62,1617
2021-05-23,97,22,75,340.91,1617
2021-05-24,507,507,0,0.0,1617
2021-05-25,514,505,9,1.78,1617
2021-05-26,514,505,9,1.78,1617
2021-05-27,514,504,10,1.98,1617
2021-05-28,452,472,-20,-4.24,1617
2021-05-29,213,134,79,58.96,1617
2021-05-30,97,20,77,385.0,1617
2021-05-31,507,506,1,0.2,1617
2021-06-01,494,503,-9,-1.79,1617
2021-06-02,494,503,-9,-1.79,1617
2021-06-03,494,502,-8,-1.59,1617
2021-06-04,411,469,-58,-12.37,1617
2021-06-05,171,132,39,29.55,1617
2021-06-06,101,18,83,461.11,1617
2021-06-07,492,503,-11,-2.19,1617
2021-06-08,494,501,-7,-1.4,1617
2021-06-09,494,500,-6,-1.2,1617
2021-06-10,494,500,-6,-1.2,1617
2021-06-11,411,468,-57,-12.18,1617
2021-06-12,171,130,41,31.54,1617
2021-06-13,101,17,84,494.12,1617
2021-06-14,492,502,-10,-1.99,1617
2021-06-15,494,500,-6,-1.2,1617
2021-06-16,494,500,-6,-1.2,1617
2021-06-17,494,499,-5,-1.0,1617
2021-06-18,411,467,-56,-11.99,1617
2021-06-19,171,130,41,31.54,1617
2021-06-20,101,16,85,531.25,1617
2021-06-21,492,501,-9,-1.8,1617
2021-06-22,494,499,-5,-1.0,1617
2021-06-23,494,498,-4,-0.8,1617
2021-06-24,494,497,-3,-0.6,1617
2021-06-25,411,463,-52,-11.23,1617
2021-06-26,171,125,46,36.8,1617
2021-06-27,101,11,90,818.18,1617
2021-06-28,492,495,-3,-0.61,1617
2021-06-29,494,492,2,0.41,1617
2021-06-30,494,490,4,0.82,1617
2021-07-01,481,488,-7,-1.43,1617
2021-07-02,427,454,-27,-5.95,1617
2021-07-03,161,116,45,38.79,1617
2021-07-04,88,1,87,8700.0,1617
2021-07-05,453,485,-32,-6.6,1617
2021-07-06,481,481,0,0.0,1617
2021-07-07,481,480,1,0.21,1617
2021-07-08,481,478,3,0.63,1617
2021-07-09,427,445,-18,-4.04,1617
2021-07-10,161,107,54,50.47,1617
2021-07-11,88,163,-75,-46.01,1617
2021-07-12,453,477,-24,-5.03,1617
2021-07-13,481,475,6,1.26,1617
2021-07-14,481,475,6,1.26,1617
2021-07-15,481,474,7,1.48,1617
2021-07-16,427,442,-15,-3.39,1617
2021-07-17,161,105,56,53.33,1617
2021-07-18,88,160,-72,-45.0,1617
2021-07-19,453,478,-25,-5.23,1617
2021-07-20,481,477,4,0.84,1617
2021-07-21,481,477,4,0.84,1617
2021-07-22,481,477,4,0.84,1617
2021-07-23,427,445,-18,-4.04,1617
2021-07-24,161,109,52,47.71,1617
2021-07-25,88,168,-80,-47.62,1617
2021-07-26,453,481,-28,-5.82,1617
2021-07-27,481,479,2,0.42,1617
2021-07-28,481,478,3,0.63,1617
2021-07-29,481,478,3,0.63,1617
2021-07-30,427,445,-18,-4.04,1617
2021-07-31,161,107,54,50.47,1617
2021-08-01,104,172,-68,-39.53,1617
2021-08-02,513,476,37,7.77,1617
2021-08-03,531,473,58,12.26,1617
2021-08-04,531,471,60,12.74,1617
2021-08-05,531,469,62,13.22,1617
2021-08-06,476,434,42,9.68,1617
2021-08-07,190,95,95,100.0,1617
2021-08-08,104,164,-60,-36.59,1617
2021-08-09,513,463,50,10.8,1617
2021-08-10,531,460,71,15.43,1617
2021-08-11,531,458,73,15.94,1617
2021-08-12,531,456,75,16.45,1617
2021-08-13,476,423,53,12.53,1617
2021-08-14,190,85,105,123.53,1617
2021-08-15,104,165,-61,-36.97,1617
2021-08-16,513,456,57,12.5,1617
2021-08-17,531,455,76,16.7,1617
2021-08-18,531,456,75,16.45,1617
2021-08-19,531,457,74,16.19,1617
2021-08-20,476,427,49,11.48,1617
2021-08-21,190,92,98,106.52,1617
2021-08-22,104,165,-61,-36.97,1617
2021-08-23,513,471,42,8.92,1617
2021-08-24,531,473,58,12.26,1617
2021-08-25,531,477,54,11.32,1617
2021-08-26,531,481,50,10.4,1617
2021-08-27,476,454,22,4.85,1617
2021-08-28,190,123,67,54.47,1617
2021-08-29,104,15,89,593.33,1617
2021-08-30,513,506,7,1.38,1617
2021-08-31,531,510,21,4.12,1617
2021-09-01,692,515,177,34.37,1617
2021-09-02,692,521,171,32.82,1617
2021-09-03,567,494,73,14.78,1617
2021-09-04,221,162,59,36.42,1617
2021-09-05,139,54,85,157.41,1617
2021-09-06,664,544,120,22.06,1617
2021-09-07,692,547,145,26.51,1617
2021-09-08,692,550,142,25.82,1617
2021-09-09,692,554,138,24.91,1617
2021-09-10,567,525,42,8.0,1617
2021-09-11,221,190,31,16.32,1617
2021-09-12,139,79,60,75.95,1617
2021-09-13,664,566,98,17.31,1617
2021-09-14,692,566,126,22.26,1617
2021-09-15,692,566,126,22.26,1617
2021-09-16,692,567,125,22.05,1617
2021-09-17,567,535,32,5.98,1617
2021-09-18,221,198,23,11.62,1617
2021-09-19,139,84,55,65.48,1617
2021-09-20,664,568,96,16.9,1617
2021-09-21,692,566,126,22.26,1617
2021-09-22,692,565,127,22.48,1617
2021-09-23,692,563,129,22.91,1617
2021-09-24,567,530,37,6.98,1617
2021-09-25,221,192,29,15.1,1617
2021-09-26,139,78,61,78.21,1617
2021-09-27,664,562,102,18.15,1617
2021-09-28,692,559,133,23.79,1617
2021-09-29,692,558,134,24.01,1617
2021-09-30,692,557,135,24.24,1617
2021-10-01,691,525,166,31.62,1617
2021-10-02,321,187,134,71.66,1617
2021-10-03,183,73,110,150.68,1617
2021-10-04,747,559,188,33.63,1617
2021-10-05,766,557,209,37.52,1617
2021-10-06,766,557,209,37.52,1617
2021-10-07,766,556,210,37.77,1617
2021-10-08,691,524,167,31.87,1617
2021-10-09,321,188,133,70.74,1617
2021-10-10,183,74,109,147.3,1617
2021-10-11,747,560,187,33.39,1617
2021-10-12,766,559,207,37.03,1617
2021-10-13,766,559,207,37.03,1617
2021-10-14,766,559,207,37.03,1617
2021-10-15,691,528,163,30.87,1617
2021-10-16,321,191,130,68.06,1617
2021-10-17,183,78,105,134.62,1617
2021-10-18,747,564,183,32.45,1617
2021-10-19,766,563,203,36.06,1617
2021-10-20,766,563,203,36.06,1617
2021-10-21,766,564,202,35.82,1617
2021-10-22,691,532,159,29.89,1617
2021-10-23,321,196,125,63.78,1617
2021-10-24,183,83,100,120.48,1617
2021-10-25,747,570,177,31.05,1617
2021-10-26,766,569,197,34.62,1617
2021-10-27,766,571,195,34.15,1617
2021-10-28,766,572,194,33.92,1617
2021-10-29,691,542,149,27.49,1617
2021-10-30,321,206,115,55.83,1617
2021-10-31,183,95,88,92.63,1617
2021-11-01,699,583,116,19.9,1617
2021-11-02,705,583,122,20.93,1617
2021-11-03,705,585,120,20.51,1617
2021-11-04,705,588,117,19.9,1617
2021-11-05,559,558,1,0.18,1617
2021-11-06,274,223,51,22.87,1617
2021-11-07,160,112,48,42.86,1617
2021-11-08,699,600,99,16.5,1617
2021-11-09,705,601,104,17.3,1617
2021-11-10,705,603,102,16.92,1617
2021-11-11,705,604,101,16.72,1617
2021-11-12,559,574,-15,-2.61,1617
2021-11-13,274,238,36,15.13,1617
2021-11-14,160,125,35,28.0,1617
2021-11-15,699,611,88,14.4,1617
2021-11-16,705,610,95,15.57,1617
2021-11-17,705,610,95,15.57,1617
2021-11-18,705,609,96,15.76,1617
2021-11-19,559,575,-16,-2.78,1617
2021-11-20,274,237,37,15.61,1617
2021-11-21,160,122,38,31.15,1617
2021-11-22,699,605,94,15.54,1617
2021-11-23,705,601,104,17.3,1617
2021-11-24,705,598,107,17.89,1617
2021-11-25,705,594,111,18.69,1617
2021-11-26,559,559,0,0.0,1617
2021-11-27,274,218,56,25.69,1617
2021-11-28,160,101,59,58.42,1617
2021-11-29,699,583,116,19.9,1617
2021-11-30,705,578,127,21.97,1617
2021-12-01,580,574,6,1.05,1617
2021-12-02,580,570,10,1.75,1617
2021-12-03,495,535,-40,-7.48,1617
2021-12-04,317,194,123,63.4,1617
2021-12-05,158,78,80,102.56,1617
2021-12-06,626,561,65,11.59,1617
2021-12-07,580,557,23,4.13,1617
2021-12-08,580,554,26,4.69,1617
2021-12-09,580,552,28,5.07,1617
2021-12-10,495,519,-24,-4.62,1617
2021-12-11,317,180,137,76.11,1617
2021-12-12,158,66,92,139.39,1617
2021-12-13,626,551,75,13.61,1617
2021-12-14,580,549,31,5.65,1617
2021-12-15,580,548,32,5.84,1617
2021-12-16,580,548,32,5.84,1617
2021-12-17,495,516,-21,-4.07,1617
2021-12-18,317,179,138,77.09,1617
2021-12-19,158,66,92,139.39,1617
2021-12-20,626,551,75,13.61,1617
2021-12-21,580,550,30,5.45,1617
2021-12-22,580,550,30,5.45,1617
2021-12-23,580,549,31,5.65,1617
2021-12-24,495,517,-22,-4.26,1617
2021-12-25,317,180,137,76.11,1617
2021-12-26,158,66,92,139.39,1617
2021-12-27,626,551,75,13.61,1617
2021-12-28,580,548,32,5.84,1617
2021-12-29,580,547,33,6.03,1617
2021-12-30,580,545,35,6.42,1617
2021-12-31,495,512,-17,-3.32,1617
2022-01-01,264,173,91,52.6,1617
2022-01-02,130,58,72,124.14,1617
2022-01-03,590,542,48,8.86,1617
2022-01-04,665,538,127,23.61,1617
2022-01-05,665,537,128,23.84,1617
2022-01-06,665,535,130,24.3,1617
2022-01-07,580,501,79,15.77,1617
2022-01-08,264,163,101,61.96,1617
2022-01-09,130,48,82,170.83,1617
2022-01-10,590,532,58,10.9,1617
2022-01-11,665,529,136,25.71,1617
2022-01-12,665,528,137,25.95,1617
2022-01-13,665,528,137,25.95,1617
2022-01-14,580,495,85,17.17,1617
2022-01-15,264,158,106,67.09,1617
2022-01-16,130,44,86,195.45,1617
2022-01-17,590,530,60,11.32,1617
2022-01-18,665,528,137,25.95,1617
2022-01-19,665,528,137,25.95,1617
2022-01-20,665,528,137,25.95,1617
2022-01-21,580,496,84,16.94,1617
2022-01-22,264,160,104,65.0,1617
2022-01-23,130,46,84,182.61,1617
2022-01-24,590,532,58,10.9,1617
2022-01-25,665,530,135,25.47,1617
2022-01-26,665,530,135,25.47,1617
2022-01-27,665,529,136,25.71,1617
2022-01-28,580,496,84,16.94,1617
2022-01-29,264,158,106,67.09,1617
2022-01-30,130,43,87,202.33,1617
2020-02-01,1077,1783,-706,-39.6,1618
2020-02-02,714,1628,-914,-56.14,1618
2020-02-03,2640,2688,-48,-1.79,1618
2020-02-04,2804,2698,106,3.93,1618
2020-02-05,2804,2707,97,3.58,1618
2020-02-06,2804,2714,90,3.32,1618
2020-02-07,2520,2576,-56,-2.17,1618
2020-02-08,1077,1833,-756,-41.24,1618
2020-02-09,714,1677,-963,-57.42,1618
2020-02-10,2640,2735,-95,-3.47,1618
2020-02-11,2804,2743,61,2.22,1618
2020-02-12,2804,2751,53,1.93,1618
2020-02-13,2804,2756,48,1.74,1618
2020-02-14,2520,2617,-97,-3.71,1618
2020-02-15,1077,1872,-795,-42.47,1618
2020-02-16,714,1715,-1001,-58.37,1618
2020-02-17,2640,2772,-132,-4.76,1618
2020-02-18,2804,2780,24,0.86,1618
2020-02-19,2804,2788,16,0.57,1618
2020-02-20,2804,2793,11,0.39,1618
2020-02-21,2520,2654,-134,-5.05,1618
2020-02-22,1077,1910,-833,-43.61,1618
2020-02-23,714,1754,-1040,-59.29,1618
2020-02-24,2640,2812,-172,-6.12,1618
2020-02-25,2804,2822,-18,-0.64,1618
2020-02-26,2804,2830,-26,-0.92,1618
2020-02-27,2804,2837,-33,-1.16,1618
2020-02-28,2520,2700,-180,-6.67,1618
2020-02-29,1077,1958,-881,-44.99,1618
2020-03-01,601,1803,-1202,-66.67,1618
2020-03-02,2194,2862,-668,-23.34,1618
2020-03-03,2207,2873,-666,-23.18,1618
2020-03-04,2207,2883,-676,-23.45,1618
2020-03-05,2207,2890,-683,-23.63,1618
2020-03-06,2032,2754,-722,-26.22,1618
2020-03-07,894,2012,-1118,-55.57,1618
2020-03-08,601,1856,-1255,-67.62,1618
2020-03-09,2194,2916,-722,-24.76,1618
2020-03-10,2207,2926,-719,-24.57,1618
2020-03-11,2207,2934,-727,-24.78,1618
2020-03-12,2207,2940,-733,-24.93,1618
2020-03-13,2032,2802,-770,-27.48,1618
2020-03-14,894,2058,-1164,-56.56,1618
2020-03-15,601,1901,-1300,-68.39,1618
2020-03-16,2194,2958,-764,-25.83,1618
2020-03-17,2207,2966,-759,-25.59,1618
2020-03-18,2207,2972,-765,-25.74,1618
2020-03-19,2207,2976,-769,-25.84,1618
2020-03-20,2032,2836,-804,-28.35,1618
2020-03-21,894,2090,-1196,-57.22,1618
2020-03-22,601,1931,-1330,-68.88,1618
2020-03-23,2194,2986,-792,-26.52,1618
2020-03-24,2207,2993,-786,-26.26,1618
2020-03-25,2207,2998,-791,-26.38,1618
2020-03-26,2207,3001,-794,-26.46,1618
2020-03-27,2032,2860,-828,-28.95,1618
2020-03-28,894,2113,-1219,-57.69,1618
2020-03-29,601,1954,-1353,-69.24,1618
2020-03-30,2194,3010,-816,-27.11,1618
2020-03-31,2207,3016,-809,-26.82,1618
2020-04-01,2243,3022,-779,-25.78,1618
2020-04-02,2243,3026,-783,-25.88,1618
2020-04-03,1854,2885,-1031,-35.74,1618
2020-04-04,856,2140,-1284,-60.0,1618
2020-04-05,523,1981,-1458,-73.6,1618
2020-04-06,2295,3038,-743,-24.46,1618
2020-04-07,2243,3046,-803,-26.36,1618
2020-04-08,2243,3052,-809,-26.51,1618
2020-04-09,2243,3057,-814,-26.63,1618
2020-04-10,1854,2917,-1063,-36.44,1618
2020-04-11,856,2173,-1317,-60.61,1618
2020-04-12,523,2015,-1492,-74.04,1618
2020-04-13,2295,3072,-777,-25.29,1618
2020-04-14,2243,3080,-837,-27.18,1618
2020-04-15,2243,3088,-845,-27.36,1618
2020-04-16,2243,3092,-849,-27.46,1618
2020-04-17,1854,2953,-1099,-37.22,1618
2020-04-18,856,2209,-1353,-61.25,1618
2020-04-19,523,2051,-1528,-74.5,1618
2020-04-20,2295,3109,-814,-26.18,1618
2020-04-21,2243,3117,-874,-28.04,1618
2020-04-22,2243,3125,-882,-28.22,1618
2020-04-23,2243,3130,-887,-28.34,1618
2020-04-24,1854,2991,-1137,-38.01,1618
2020-04-25,856,2247,-1391,-61.9,1618
2020-04-26,523,2090,-1567,-74.98,1618
2020-04-27,2295,3149,-854,-27.12,1618
2020-04-28,2243,3158,-915,-28.97,1618
2020-04-29,2243,3166,-923,-29.15,1618
2020-04-30,2243,3173,-930,-29.31,1618
2020-05-01,2519,3035,-516,-17.0,1618
2020-05-02,1242,2292,-1050,-45.81,1618
2020-05-03,682,2137,-1455,-68.09,1618
2020-05-04,2906,3196,-290,-9.07,1618
2020-05-05,2930,3207,-277,-8.64,1618
2020-05-06,2930,3216,-286,-8.89,1618
2020-05-07,2930,3223,-293,-9.09,1618
2020-05-08,2519,3087,-568,-18.4,1618
2020-05-09,1242,2344,-1102,-47.01,1618
2020-05-10,682,2189,-1507,-68.84,1618
2020-05-11,2906,3248,-342,-10.53,1618
2020-05-12,2930,3259,-329,-10.1,1618
2020-05-13,2930,3268,-338,-10.34,1618
2020-05-14,2930,3274,-344,-10.51,1618
2020-05-15,2519,3136,-617,-19.67,1618
2020-05-16,1242,2392,-1150,-48.08,1618
2020-05-17,682,2235,-1553,-69.49,1618
2020-05-18,2906,3293,-387,-11.75,1618
2020-05-19,2930,3301,-371,-11.24,1618
2020-05-20,2930,3308,-378,-11.43,1618
2020-05-21,2930,3312,-382,-11.53,1618
2020-05-22,2519,3171,-652,-20.56,1618
2020-05-23,1242,2425,-1183,-48.78,1618
2020-05-24,682,2266,-1584,-69.9,1618
2020-05-25,2906,3321,-415,-12.5,1618
2020-05-26,2930,3327,-397,-11.93,1618
2020-05-27,2930,3332,-402,-12.06,1618
2020-05-28,2930,3334,-404,-12.12,1618
2020-05-29,2519,3193,-674,-21.11,1618
2020-05-30,1242,2445,-1203,-49.2,1618
2020-05-31,682,2286,-1604,-70.17,1618
2020-06-01,3052,3340,-288,-8.62,1618
2020-06-02,3177,3346,-169,-5.05,1618
2020-06-03,3177,3352,-175,-5.22,1618
2020-06-04,3177,3355,-178,-5.31,1618
2020-06-05,2597,3214,-617,-19.2,1618
2020-06-06,1150,2468,-1318,-53.4,1618
2020-06-07,684,2310,-1626,-70.39,1618
2020-06-08,3052,3366,-314,-9.33,1618
2020-06-09,3177,3374,-197,-5.84,1618
2020-06-10,3177,3381,-204,-6.03,1618
2020-06-11,3177,3386,-209,-6.17,1618
2020-06-12,2597,3247,-650,-20.02,1618
2020-06-13,1150,2503,-1353,-54.06,1618
2020-06-14,684,2345,-1661,-70.83,1618
2020-06-15,3052,3403,-351,-10.31,1618
2020-06-16,3177,3412,-235,-6.89,1618
2020-06-17,3177,3419,-242,-7.08,1618
2020-06-18,3177,3424,-247,-7.21,1618
2020-06-19,2597,3284,-687,-20.92,1618
2020-06-20,1150,2539,-1389,-54.71,1618
2020-06-21,684,2381,-1697,-71.27,1618
2020-06-22,3052,3437,-385,-11.2,1618
2020-06-23,3177,3443,-266,-7.73,1618
2020-06-24,3177,3448,-271,-7.86,1618
2020-06-25,3177,3450,-273,-7.91,1618
2020-06-26,2597,3308,-711,-21.49,1618
2020-06-27,1150,2560,-1410,-55.08,1618
2020-06-28,684,2398,-1714,-71.48,1618
2020-06-29,3052,3451,-399,-11.56,1618
2020-06-30,3177,3455,-278,-8.05,1618
2020-07-01,2882,3457,-575,-16.63,1618
2020-07-02,2882,3457,-575,-16.63,1618
2020-07-03,2576,3313,-737,-22.25,1618
2020-07-04,1080,2563,-1483,-57.86,1618
2020-07-05,756,2401,-1645,-68.51,1618
2020-07-06,2971,3453,-482,-13.96,1618
2020-07-07,2882,3457,-575,-16.63,1618
2020-07-08,2882,3460,-578,-16.71,1618
2020-07-09,2882,3460,-578,-16.71,1618
2020-07-10,2576,3318,-742,-22.36,1618
2020-07-11,1080,2570,-1490,-57.98,1618
2020-07-12,756,2410,-1654,-68.63,1618
2020-07-13,2971,3466,-495,-14.28,1618
2020-07-14,2882,3472,-590,-16.99,1618
2020-07-15,2882,3479,-597,-17.16,1618
2020-07-16,2882,3483,-601,-17.26,1618
2020-07-17,2576,3344,-768,-22.97,1618
2020-07-18,1080,2600,-1520,-58.46,1618
2020-07-19,756,2443,-1687,-69.05,1618
2020-07-20,2971,3501,-530,-15.14,1618
2020-07-21,2882,3511,-629,-17.92,1618
2020-07-22,2882,3519,-637,-18.1,1618
2020-07-23,2882,3525,-643,-18.24,1618
2020-07-24,2576,3387,-811,-23.94,1618
2020-07-25,1080,2643,-1563,-59.14,1618
2020-07-26,756,2486,-1730,-69.59,1618
2020-07-27,2971,3544,-573,-16.17,1618
2020-07-28,2882,3552,-670,-18.86,1618
2020-07-29,2882,3558,-676,-19.0,1618
2020-07-30,2882,3562,-680,-19.09,1618
2020-07-31,2576,3421,-845,-24.7,1618
2020-08-01,1277,2674,-1397,-52.24,1618
2020-08-02,764,2513,-1749,-69.6,1618
2020-08-03,3021,3567,-546,-15.31,1618
2020-08-04,2886,3571,-685,-19.18,1618
2020-08-05,2886,3573,-687,-19.23,1618
2020-08-06,2886,3573,-687,-19.23,1618
2020-08-07,2517,3429,-912,-26.6,1618
2020-08-08,1277,2679,-1402,-52.33,1618
2020-08-09,764,2516,-1752,-69.63,1618
2020-08-10,3021,3569,-548,-15.35,1618
2020-08-11,2886,3572,-686,-19.2,1618
2020-08-12,2886,3575,-689,-19.27,1618
2020-08-13,2886,3577,-691,-19.32,1618
2020-08-14,2517,3435,-918,-26.72,1618
2020-08-15,1277,2688,-1411,-52.49,1618
2020-08-16,764,2530,-1766,-69.8,1618
2020-08-17,3021,3588,-567,-15.8,1618
2020-08-18,2886,3597,-711,-19.77,1618
2020-08-19,2886,3607,-721,-19.99,1618
2020-08-20,2886,3616,-730,-20.19,1618
2020-08-21,2517,3483,-966,-27.73,1618
2020-08-22,1277,2745,-1468,-53.48,1618
2020-08-23,764,2595,-1831,-70.56,1618
2020-08-24,3021,3662,-641,-17.5,1618
2020-08-25,2886,3681,-795,-21.6,1618
2020-08-26,2886,3699,-813,-21.98,1618
2020-08-27,2886,3716,-830,-22.34,1618
2020-08-28,2517,3590,-1073,-29.89,1618
2020-08-29,1277,2859,-1582,-55.33,1618
2020-08-30,764,2716,-1952,-71.87,1618
2020-08-31,3021,3787,-766,-20.23,1618
2020-09-01,2975,3809,-834,-21.9,1618
2020-09-02,2975,3830,-855,-22.32,1618
2020-09-03,2975,3848,-873,-22.69,1618
2020-09-04,2547,3722,-1175,-31.57,1618
2020-09-05,1064,2989,-1925,-64.4,1618
2020-09-06,665,2843,-2178,-76.61,1618
2020-09-07,2894,3910,-1016,-25.98,1618
2020-09-08,2975,3926,-951,-24.22,1618
2020-09-09,2975,3940,-965,-24.49,1618
2020-09-10,2975,3951,-976,-24.7,1618
2020-09-11,2547,3815,-1268,-33.24,1618
2020-09-12,1064,3073,-2009,-65.38,1618
2020-09-13,665,2917,-2252,-77.2,1618
2020-09-14,2894,3973,-1079,-27.16,1618
2020-09-15,2975,3979,-1004,-25.23,1618
2020-09-16,2975,3983,-1008,-25.31,1618
2020-09-17,2975,3983,-1008,-25.31,1618
2020-09-18,2547,3838,-1291,-33.64,1618
2020-09-19,1064,3086,-2022,-65.52,1618
2020-09-20,665,2920,-2255,-77.23,1618
2020-09-21,2894,3969,-1075,-27.08,1618
2020-09-22,2975,3968,-993,-25.03,1618
2020-09-23,2975,3965,-990,-24.97,1618
2020-09-24,2975,3960,-985,-24.87,1618
2020-09-25,2547,3810,-1263,-33.15,1618
2020-09-26,1064,3056,-1992,-65.18,1618
2020-09-27,665,2888,-2223,-76.97,1618
2020-09-28,2894,3936,-1042,-26.47,1618
2020-09-29,2975,3935,-960,-24.4,1618
2020-09-30,2975,3933,-958,-24.36,1618
2020-10-01,2687,3930,-1243,-31.63,1618
2020-10-02,2314,3783,-1469,-38.83,1618
2020-10-03,1023,3031,-2008,-66.25,1618
2020-10-04,647,2868,-2221,-77.44,1618
2020-10-05,2957,3919,-962,-24.55,1618
2020-10-06,2687,3923,-1236,-31.51,1618
2020-10-07,2687,3925,-1238,-31.54,1618
2020-10-08,2687,3926,-1239,-31.56,1618
2020-10-09,2314,3784,-1470,-38.85,1618
2020-10-10,1023,3036,-2013,-66.3,1618
2020-10-11,647,2876,-2229,-77.5,1618
2020-10-12,2957,3931,-974,-24.78,1618
2020-10-13,2687,3938,-1251,-31.77,1618
2020-10-14,2687,3943,-1256,-31.85,1618
2020-10-15,2687,3946,-1259,-31.91,1618
2020-10-16,2314,3805,-1491,-39.19,1618
2020-10-17,1023,3058,-2035,-66.55,1618
2020-10-18,647,2898,-2251,-77.67,1618
2020-10-19,2957,3953,-996,-25.2,1618
2020-10-20,2687,3959,-1272,-32.13,1618
2020-10-21,2687,3964,-1277,-32.21,1618
2020-10-22,2687,3966,-1279,-32.25,1618
2020-10-23,2314,3824,-1510,-39.49,1618
2020-10-24,1023,3076,-2053,-66.74,1618
2020-10-25,647,2915,-2268,-77.8,1618
2020-10-26,2957,3969,-1012,-25.5,1618
2020-10-27,2687,3974,-1287,-32.39,1618
2020-10-28,2687,3978,-1291,-32.45,1618
2020-10-29,2687,3979,-1292,-32.47,1618
2020-10-30,2314,3837,-1523,-39.69,1618
2020-10-31,1023,3089,-2066,-66.88,1618
2020-11-01,536,2928,-2392,-81.69,1618
2020-11-02,2461,3983,-1522,-38.21,1618
2020-11-03,2455,3988,-1533,-38.44,1618
2020-11-04,2455,3993,-1538,-38.52,1618
2020-11-05,2455,3996,-1541,-38.56,1618
2020-11-06,2166,3854,-1688,-43.8,1618
2020-11-07,920,3108,-2188,-70.4,1618
2020-11-08,536,2949,-2413,-81.82,1618
2020-11-09,2461,4004,-1543,-38.54,1618
2020-11-10,2455,4011,-1556,-38.79,1618
2020-11-11,2455,4016,-1561,-38.87,1618
2020-11-12,2455,4019,-1564,-38.92,1618
2020-11-13,2166,3878,-1712,-44.15,1618
2020-11-14,920,3131,-2211,-70.62,1618
2020-11-15,536,2971,-2435,-81.96,1618
2020-11-16,2461,4025,-1564,-38.86,1618
2020-11-17,2455,4030,-1575,-39.08,1618
2020-11-18,2455,4034,-1579,-39.14,1618
2020-11-19,2455,4034,-1579,-39.14,1618
2020-11-20,2166,3890,-1724,-44.32,1618
2020-11-21,920,3140,-2220,-70.7,1618
2020-11-22,536,2976,-2440,-81.99,1618
2020-11-23,2461,4027,-1566,-38.89,1618
2020-11-24,2455,4028,-1573,-39.05,1618
2020-11-25,2455,4027,-1572,-39.04,1618
2020-11-26,2455,4023,-1568,-38.98,1618
2020-11-27,2166,3875,-1709,-44.1,1618
2020-11-28,920,3121,-2201,-70.52,1618
2020-11-29,536,2954,-2418,-81.86,1618
2020-11-30,2461,4002,-1541,-38.51,1618
2020-12-01,1911,4000,-2089,-52.22,1618
2020-12-02,1911,3997,-2086,-52.19,1618
2020-12-03,1911,3992,-2081,-52.13,1618
2020-12-04,2110,3843,-1733,-45.09,1618
2020-12-05,899,3089,-2190,-70.9,1618
2020-12-06,537,2923,-2386,-81.63,1618
2020-12-07,1910,3972,-2062,-51.91,1618
2020-12-08,1911,3972,-2061,-51.89,1618
2020-12-09,1911,3972,-2061,-51.89,1618
2020-12-10,1911,3970,-2059,-51.86,1618
2020-12-11,2110,3825,-1715,-44.84,1618
2020-12-12,899,3075,-2176,-70.76,1618
2020-12-13,537,2914,-2377,-81.57,1618
2020-12-14,1910,3967,-2057,-51.85,1618
2020-12-15,1911,3973,-2062,-51.9,1618
2020-12-16,1911,3978,-2067,-51.96,1618
2020-12-17,1911,3981,-2070,-52.0,1618
2020-12-18,2110,3841,-1731,-45.07,1618
2020-12-19,899,3096,-2197,-70.96,1618
2020-12-20,537,2939,-2402,-81.73,1618
2020-12-21,1910,3997,-2087,-52.21,1618
2020-12-22,1911,4006,-2095,-52.3,1618
2020-12-23,1911,4014,-2103,-52.39,1618
2020-12-24,1911,4020,-2109,-52.46,1618
2020-12-25,2110,3883,-1773,-45.66,1618
2020-12-26,899,3139,-2240,-71.36,1618
2020-12-27,537,2983,-2446,-82.0,1618
2020-12-28,1910,4041,-2131,-52.73,1618
2020-12-29,1911,4050,-2139,-52.81,1618
2020-12-30,1911,4057,-2146,-52.9,1618
2020-12-31,1911,4062,-2151,-52.95,1618
2021-01-01,1761,3922,-2161,-55.1,1618
2021-01-02,728,3177,-2449,-77.09,1618
2021-01-03,498,3018,-2520,-83.5,1618
2021-01-04,1870,4074,-2204,-54.1,1618
2021-01-05,2013,4080,-2067,-50.66,1618
2021-01-06,2013,4085,-2072,-50.72,1618
2021-01-07,2013,4088,-2075,-50.76,1618
2021-01-08,1761,3946,-2185,-55.37,1618
2021-01-09,728,3199,-2471,-77.24,1618
2021-01-10,498,3039,-2541,-83.61,1618
2021-01-11,1870,4094,-2224,-54.32,1618
2021-01-12,2013,4100,-2087,-50.9,1618
2021-01-13,2013,4105,-2092,-50.96,1618
2021-01-14,2013,4108,-2095,-51.0,1618
2021-01-15,1761,3967,-2206,-55.61,1618
2021-01-16,728,3221,-2493,-77.4,1618
2021-01-17,498,3062,-2564,-83.74,1618
2021-01-18,1870,4119,-2249,-54.6,1618
2021-01-19,2013,4127,-2114,-51.22,1618
2021-01-20,2013,4135,-2122,-51.32,1618
2021-01-21,2013,4140,-2127,-51.38,1618
2021-01-22,1761,4002,-2241,-56.0,1618
2021-01-23,728,3259,-2531,-77.66,1618
2021-01-24,498,3103,-2605,-83.95,1618
2021-01-25,1870,4163,-2293,-55.08,1618
2021-01-26,2013,4173,-2160,-51.76,1618
2021-01-27,2013,4183,-2170,-51.88,1618
2021-01-28,2013,4190,-2177,-51.96,1618
2021-01-29,1761,4054,-2293,-56.56,1618
2021-01-30,728,3312,-2584,-78.02,1618
2021-01-31,498,3157,-2659,-84.23,1618
2021-02-01,2232,4217,-1985,-47.07,1618
2021-02-02,2258,4228,-1970,-46.59,1618
2021-02-03,2258,4237,-1979,-46.71,1618
2021-02-04,2258,4244,-1986,-46.8,1618
2021-02-05,2022,4107,-2085,-50.77,1618
2021-02-06,839,3364,-2525,-75.06,1618
2021-02-07,530,3208,-2678,-83.48,1618
2021-02-08,2232,4266,-2034,-47.68,1618
2021-02-09,2258,4275,-2017,-47.18,1618
2021-02-10,2258,4283,-2025,-47.28,1618
2021-02-11,2258,4288,-2030,-47.34,1618
2021-02-12,2022,4149,-2127,-51.27,1618
2021-02-13,839,3405,-2566,-75.36,1618
2021-02-14,530,3247,-2717,-83.68,1618
2021-02-15,2232,4305,-2073,-48.15,1618
2021-02-16,2258,4313,-2055,-47.65,1618
2021-02-17,2258,4320,-2062,-47.73,1618
2021-02-18,2258,4325,-2067,-47.79,1618
2021-02-19,2022,4186,-2164,-51.7,1618
2021-02-20,839,3442,-2603,-75.62,1618
2021-02-21,530,3285,-2755,-83.87,1618
2021-02-22,2232,4343,-2111,-48.61,1618
2021-02-23,2258,4353,-2095,-48.13,1618
2021-02-24,2258,4361,-2103,-48.22,1618
2021-02-25,2258,4367,-2109,-48.29,1618
2021-02-26,2022,4230,-2208,-52.2,1618
2021-02-27,839,3487,-2648,-75.94,1618
2021-02-28,530,3332,-2802,-84.09,1618
2021-03-01,2503,4392,-1889,-43.01,1618
2021-03-02,2498,4403,-1905,-43.27,1618
2021-03-03,2498,4412,-1914,-43.38,1618
2021-03-04,2498,4420,-1922,-43.48,1618
2021-03-05,2192,4283,-2091,-48.82,1618
2021-03-06,1016,3541,-2525,-71.31,1618
2021-03-07,586,3386,-2800,-82.69,1618
2021-03-08,2503,4446,-1943,-43.7,1618
2021-03-09,2498,4456,-1958,-43.94,1618
2021-03-10,2498,4465,-1967,-44.05,1618
2021-03-11,2498,4471,-1973,-44.13,1618
2021-03-12,2192,4334,-2142,-49.42,1618
2021-03-13,1016,3590,-2574,-71.7,1618
2021-03-14,586,3433,-2847,-82.93,1618
2021-03-15,2503,4491,-1988,-44.27,1618
2021-03-16,2498,4499,-2001,-44.48,1618
2021-03-17,2498,4506,-2008,-44.56,1618
2021-03-18,2498,4510,-2012,-44.61,1618
2021-03-19,2192,4370,-2178,-49.84,1618
2021-03-20,1016,3624,-2608,-71.96,1618
2021-03-21,586,3465,-2879,-83.09,1618
2021-03-22,2503,4521,-2018,-44.64,1618
2021-03-23,2498,4528,-2030,-44.83,1618
2021-03-24,2498,4533,-2035,-44.89,1618
2021-03-25,2498,4536,-2038,-44.93,1618
2021-03-26,2192,4395,-2203,-50.13,1618
2021-03-27,1016,3648,-2632,-72.15,1618
2021-03-28,586,3489,-2903,-83.2,1618
2021-03-29,2503,4544,-2041,-44.92,1618
2021-03-30,2498,4551,-2053,-45.11,1618
2021-03-31,2498,4556,-2058,-45.17,1618
2021-04-01,2549,4560,-2011,-44.1,1618
2021-04-02,2270,4419,-2149,-48.63,1618
2021-04-03,992,3674,-2682,-73.0,1618
2021-04-04,598,3515,-2917,-82.99,1618
2021-04-05,2547,4572,-2025,-44.29,1618
2021-04-06,2549,4579,-2030,-44.33,1618
2021-04-07,2549,4586,-2037,-44.42,1618
2021-04-08,2549,4590,-2041,-44.47,1618
2021-04-09,2270,4450,-2180,-48.99,1618
2021-04-10,992,3705,-2713,-73.23,1618
2021-04-11,598,3548,-2950,-83.15,1618
2021-04-12,2547,4605,-2058,-44.69,1618
2021-04-13,2549,4613,-2064,-44.74,1618
2021-04-14,2549,4620,-2071,-44.83,1618
2021-04-15,2549,4625,-2076,-44.89,1618
2021-04-16,2270,4486,-2216,-49.4,1618
2021-04-17,992,3741,-2749,-73.48,1618
2021-04-18,598,3584,-2986,-83.31,1618
2021-04-19,2547,4641,-2094,-45.12,1618
2021-04-20,2549,4649,-2100,-45.17,1618
2021-04-21,2549,4657,-2108,-45.27,1618
2021-04-22,2549,4662,-2113,-45.32,1618
2021-04-23,2270,4523,-2253,-49.81,1618
2021-04-24,992,3779,-2787,-73.75,1618
2021-04-25,598,3622,-3024,-83.49,1618
2021-04-26,2547,4680,-2133,-45.58,1618
2021-04-27,2549,4689,-2140,-45.64,1618
2021-04-28,2549,4697,-2148,-45.73,1618
2021-04-29,2549,4703,-2154,-45.8,1618
2021-04-30,2270,4566,-2296,-50.28,1618
2021-05-01,1104,3823,-2719,-71.12,1618
2021-05-02,585,3667,-3082,-84.05,1618
2021-05-03,2726,4726,-2000,-42.32,1618
2021-05-04,2712,4737,-2025,-42.75,1618
2021-05-05,2712,4746,-2034,-42.86,1618
2021-05-06,2712,4753,-2041,-42.94,1618
2021-05-07,2348,4616,-2268,-49.13,1618
2021-05-08,1104,3874,-2770,-71.5,1618
2021-05-09,585,3719,-3134,-84.27,1618
2021-05-10,2726,4778,-2052,-42.95,1618
2021-05-11,2712,4789,-2077,-43.37,1618
2021-05-12,2712,4798,-2086,-43.48,1618
2021-05-13,2712,4805,-2093,-43.56,1618
2021-05-14,2348,4667,-2319,-49.69,1618
2021-05-15,1104,3924,-2820,-71.87,1618
2021-05-16,585,3767,-3182,-84.47,1618
2021-05-17,2726,4825,-2099,-43.5,1618
2021-05-18,2712,4834,-2122,-43.9,1618
2021-05-19,2712,4841,-2129,-43.98,1618
2021-05-20,2712,4845,-2133,-44.02,1618
2021-05-21,2348,4705,-2357,-50.1,1618
2021-05-22,1104,3960,-2856,-72.12,1618
2021-05-23,585,3801,-3216,-84.61,1618
2021-05-24,2726,4856,-2130,-43.86,1618
2021-05-25,2712,4863,-2151,-44.23,1618
2021-05-26,2712,4868,-2156,-44.29,1618
2021-05-27,2712,4870,-2158,-44.31,1618
2021-05-28,2348,4728,-2380,-50.34,1618
2021-05-29,1104,3981,-2877,-72.27,1618
2021-05-30,585,3821,-3236,-84.69,1618
2021-05-31,2726,4876,-2150,-44.09,1618
2021-06-01,2763,4882,-2119,-43.4,1618
2021-06-02,2763,4887,-2124,-43.46,1618
2021-06-03,2763,4889,-2126,-43.49,1618
2021-06-04,2352,4748,-2396,-50.46,1618
2021-06-05,1020,4002,-2982,-74.51,1618
2021-06-06,671,3843,-3172,-82.54,1618
2021-06-07,2776,4900,-2124,-43.35,1618
2021-06-08,2763,4907,-2144,-43.69,1618
2021-06-09,2763,4914,-2151,-43.77,1618
2021-06-10,2763,4918,-2155,-43.82,1618
2021-06-11,2352,4779,-2427,-50.78,1618
2021-06-12,1020,4035,-3015,-74.72,1618
2021-06-13,671,3878,-3207,-82.7,1618
2021-06-14,2776,4935,-2159,-43.75,1618
2021-06-15,2763,4944,-2181,-44.11,1618
2021-06-16,2763,4951,-2188,-44.19,1618
2021-06-17,2763,4956,-2193,-44.25,1618
2021-06-18,2352,4817,-2465,-51.17,1618
2021-06-19,1020,4072,-3052,-74.95,1618
2021-06-20,671,3914,-3243,-82.86,1618
2021-06-21,2776,4971,-2195,-44.16,1618
2021-06-22,2763,4978,-2215,-44.5,1618
2021-06-23,2763,4983,-2220,-44.55,1618
2021-06-24,2763,4986,-2223,-44.58,1618
2021-06-25,2352,4844,-2492,-51.45,1618
2021-06-26,1020,4097,-3077,-75.1,1618
2021-06-27,671,3936,-3265,-82.95,1618
2021-06-28,2776,4989,-2213,-44.36,1618
2021-06-29,2763,4993,-2230,-44.66,1618
2021-06-30,2763,4996,-2233,-44.7,1618
2021-07-01,2573,4996,-2423,-48.5,1618
2021-07-02,2270,4852,-2582,-53.22,1618
2021-07-03,940,4102,-3162,-77.08,1618
2021-07-04,625,3940,-3315,-84.14,1618
2021-07-05,2565,4992,-2427,-48.62,1618
2021-07-06,2573,4995,-2422,-48.49,1618
2021-07-07,2573,4998,-2425,-48.52,1618
2021-07-08,2573,4998,-2425,-48.52,1618
2021-07-09,2270,4855,-2585,-53.24,1618
2021-07-10,940,4107,-3167,-77.11,1618
2021-07-11,625,3946,-3321,-84.16,1618
2021-07-12,2565,5001,-2436,-48.71,1618
2021-07-13,2573,5007,-2434,-48.61,1618
2021-07-14,2573,5012,-2439,-48.66,1618
2021-07-15,2573,5016,-2443,-48.7,1618
2021-07-16,2270,4876,-2606,-53.45,1618
2021-07-17,940,4132,-3192,-77.25,1618
2021-07-18,625,3975,-3350,-84.28,1618
2021-07-19,2565,5033,-2468,-49.04,1618
2021-07-20,2573,5042,-2469,-48.97,1618
2021-07-21,2573,5050,-2477,-49.05,1618
2021-07-22,2573,5056,-2483,-49.11,1618
2021-07-23,2270,4918,-2648,-53.84,1618
2021-07-24,940,4175,-3235,-77.49,1618
2021-07-25,625,4018,-3393,-84.44,1618
2021-07-26,2565,5076,-2511,-49.47,1618
2021-07-27,2573,5085,-2512,-49.4,1618
2021-07-28,2573,5092,-2519,-49.47,1618
2021-07-29,2573,5096,-2523,-49.51,1618
2021-07-30,2270,4956,-2686,-54.2,1618
2021-07-31,940,4209,-3269,-77.67,1618
2021-08-01,584,4049,-3465,-85.58,1618
2021-08-02,2354,5104,-2750,-53.88,1618
2021-08-03,2319,5108,-2789,-54.6,1618
2021-08-04,2319,5112,-2793,-54.64,1618
2021-08-05,2319,5112,-2793,-54.64,1618
2021-08-06,1965,4968,-3003,-60.45,1618
2021-08-07,905,4218,-3313,-78.54,1618
2021-08-08,584,4056,-3472,-85.6,1618
2021-08-09,2354,5108,-2754,-53.92,1618
2021-08-10,2319,5111,-2792,-54.63,1618
2021-08-11,2319,5113,-2794,-54.65,1618
2021-08-12,2319,5114,-2795,-54.65,1618
2021-08-13,1965,4971,-3006,-60.47,1618
2021-08-14,905,4223,-3318,-78.57,1618
2021-08-15,584,4064,-3480,-85.63,1618
2021-08-16,2354,5120,-2766,-54.02,1618
2021-08-17,2319,5128,-2809,-54.78,1618
2021-08-18,2319,5137,-2818,-54.86,1618
2021-08-19,2319,5144,-2825,-54.92,1618
2021-08-20,1965,5009,-3044,-60.77,1618
2021-08-21,905,4269,-3364,-78.8,1618
2021-08-22,584,4118,-3534,-85.82,1618
2021-08-23,2354,5183,-2829,-54.58,1618
2021-08-24,2319,5200,-2881,-55.4,1618
2021-08-25,2319,5218,-2899,-55.56,1618
2021-08-26,2319,5234,-2915,-55.69,1618
2021-08-27,1965,5107,-3142,-61.52,1618
2021-08-28,905,4375,-3470,-79.31,1618
2021-08-29,584,4231,-3647,-86.2,1618
2021-08-30,2354,5302,-2948,-55.6,1618
2021-08-31,2319,5324,-3005,-56.44,1618
2021-09-01,2629,5346,-2717,-50.82,1618
2021-09-02,2629,5364,-2735,-50.99,1618
2021-09-03,2321,5239,-2918,-55.7,1618
2021-09-04,952,4507,-3555,-78.88,1618
2021-09-05,611,4362,-3751,-85.99,1618
2021-09-06,2697,5430,-2733,-50.33,1618
2021-09-07,2629,5448,-2819,-51.74,1618
2021-09-08,2629,5464,-2835,-51.89,1618
2021-09-09,2629,5476,-2847,-51.99,1618
2021-09-10,2321,5343,-3022,-56.56,1618
2021-09-11,952,4603,-3651,-79.32,1618
2021-09-12,611,4448,-3837,-86.26,1618
2021-09-13,2697,5506,-2809,-51.02,1618
2021-09-14,2629,5514,-2885,-52.32,1618
2021-09-15,2629,5520,-2891,-52.37,1618
2021-09-16,2629,5521,-2892,-52.38,1618
2021-09-17,2321,5378,-3057,-56.84,1618
2021-09-18,952,4627,-3675,-79.43,1618
2021-09-19,611,4463,-3852,-86.31,1618
2021-09-20,2697,5512,-2815,-51.07,1618
2021-09-21,2629,5512,-2883,-52.3,1618
2021-09-22,2629,5510,-2881,-52.29,1618
2021-09-23,2629,5505,-2876,-52.24,1618
2021-09-24,2321,5356,-3035,-56.67,1618
2021-09-25,952,4601,-3649,-79.31,1618
2021-09-26,611,4433,-3822,-86.22,1618
2021-09-27,2697,5480,-2783,-50.78,1618
2021-09-28,2629,5479,-2850,-52.02,1618
2021-09-29,2629,5477,-2848,-52.0,1618
2021-09-30,2629,5473,-2844,-51.96,1618
2021-10-01,2286,5325,-3039,-57.07,1618
2021-10-02,974,4573,-3599,-78.7,1618
2021-10-03,599,4408,-3809,-86.41,1618
2021-10-04,2480,5459,-2979,-54.57,1618
2021-10-05,2521,5462,-2941,-53.84,1618
2021-10-06,2521,5464,-2943,-53.86,1618
2021-10-07,2521,5464,-2943,-53.86,1618
2021-10-08,2286,5321,-3035,-57.04,1618
2021-10-09,974,4573,-3599,-78.7,1618
2021-10-10,599,4412,-3813,-86.42,1618
2021-10-11,2480,5467,-2987,-54.64,1618
2021-10-12,2521,5473,-2952,-53.94,1618
2021-10-13,2521,5478,-2957,-53.98,1618
2021-10-14,2521,5481,-2960,-54.0,1618
2021-10-15,2286,5340,-3054,-57.19,1618
2021-10-16,974,4593,-3619,-78.79,1618
2021-10-17,599,4434,-3835,-86.49,1618
2021-10-18,2480,5489,-3009,-54.82,1618
2021-10-19,2521,5495,-2974,-54.12,1618
2021-10-20,2521,5500,-2979,-54.16,1618
2021-10-21,2521,5502,-2981,-54.18,1618
2021-10-22,2286,5360,-3074,-57.35,1618
2021-10-23,974,4612,-3638,-78.88,1618
2021-10-24,599,4452,-3853,-86.55,1618
2021-10-25,2480,5506,-3026,-54.96,1618
2021-10-26,2521,5511,-2990,-54.26,1618
2021-10-27,2521,5515,-2994,-54.29,1618
2021-10-28,2521,5516,-2995,-54.3,1618
2021-10-29,2286,5373,-3087,-57.45,1618
2021-10-30,974,4626,-3652,-78.95,1618
2021-10-31,599,4465,-3866,-86.58,1618
2021-11-01,2299,5519,-3220,-58.34,1618
2021-11-02,2329,5524,-3195,-57.84,1618
2021-11-03,2329,5529,-3200,-57.88,1618
2021-11-04,2329,5531,-3202,-57.89,1618
2021-11-05,1996,5390,-3394,-62.97,1618
2021-11-06,916,4643,-3727,-80.27,1618
2021-11-07,551,4483,-3932,-87.71,1618
2021-11-08,2299,5539,-3240,-58.49,1618
2021-11-09,2329,5545,-3216,-58.0,1618
2021-11-10,2329,5551,-3222,-58.04,1618
2021-11-11,2329,5554,-3225,-58.07,1618
2021-11-12,1996,5413,-3417,-63.13,1618
2021-11-13,916,4666,-3750,-80.37,1618
2021-11-14,551,4507,-3956,-87.77,1618
2021-11-15,2299,5562,-3263,-58.67,1618
2021-11-16,2329,5567,-3238,-58.16,1618
2021-11-17,2329,5571,-3242,-58.19,1618
2021-11-18,2329,5572,-3243,-58.2,1618
2021-11-19,1996,5429,-3433,-63.23,1618
2021-11-20,916,4679,-3763,-80.42,1618
2021-11-21,551,4516,-3965,-87.8,1618
2021-11-22,2299,5568,-3269,-58.71,1618
2021-11-23,2329,5569,-3240,-58.18,1618
2021-11-24,2329,5569,-3240,-58.18,1618
2021-11-25,2329,5566,-3237,-58.16,1618
2021-11-26,1996,5419,-3423,-63.17,1618
2021-11-27,916,4665,-3749,-80.36,1618
2021-11-28,551,4499,-3948,-87.75,1618
2021-11-29,2299,5547,-3248,-58.55,1618
2021-11-30,2329,5545,-3216,-58.0,1618
2021-12-01,1784,5542,-3758,-67.81,1618
2021-12-02,1784,5537,-3753,-67.78,1618
2021-12-03,1540,5388,-3848,-71.42,1618
2021-12-04,831,4634,-3803,-82.07,1618
2021-12-05,490,4467,-3977,-89.03,1618
2021-12-06,1974,5515,-3541,-64.21,1618
2021-12-07,1784,5515,-3731,-67.65,1618
2021-12-08,1784,5514,-3730,-67.65,1618
2021-12-09,1784,5511,-3727,-67.63,1618
2021-12-10,1540,5365,-3825,-71.3,1618
2021-12-11,831,4614,-3783,-81.99,1618
2021-12-12,490,4452,-3962,-88.99,1618
2021-12-13,1974,5504,-3530,-64.14,1618
2021-12-14,1784,5509,-3725,-67.62,1618
2021-12-15,1784,5513,-3729,-67.64,1618
2021-12-16,1784,5516,-3732,-67.66,1618
2021-12-17,1540,5375,-3835,-71.35,1618
2021-12-18,831,4629,-3798,-82.05,1618
2021-12-19,490,4472,-3982,-89.04,1618
2021-12-20,1974,5529,-3555,-64.3,1618
2021-12-21,1784,5538,-3754,-67.79,1618
2021-12-22,1784,5546,-3762,-67.83,1618
2021-12-23,1784,5552,-3768,-67.87,1618
2021-12-24,1540,5414,-3874,-71.56,1618
2021-12-25,831,4670,-3839,-82.21,1618
2021-12-26,490,4514,-4024,-89.14,1618
2021-12-27,1974,5572,-3598,-64.57,1618
2021-12-28,1784,5581,-3797,-68.03,1618
2021-12-29,1784,5589,-3805,-68.08,1618
2021-12-30,1784,5594,-3810,-68.11,1618
2021-12-31,1540,5455,-3915,-71.77,1618
2022-01-01,752,4710,-3958,-84.03,1618
2022-01-02,482,4552,-4070,-89.41,1618
2022-01-03,1868,5608,-3740,-66.69,1618
2022-01-04,1839,5615,-3776,-67.25,1618
2022-01-05,1839,5620,-3781,-67.28,1618
2022-01-06,1839,5623,-3784,-67.3,1618
2022-01-07,1663,5482,-3819,-69.66,1618
2022-01-08,752,4735,-3983,-84.12,1618
2022-01-09,482,4575,-4093,-89.46,1618
2022-01-10,1868,5630,-3762,-66.82,1618
2022-01-11,1839,5635,-3796,-67.36,1618
2022-01-12,1839,5640,-3801,-67.39,1618
2022-01-13,1839,5643,-3804,-67.41,1618
2022-01-14,1663,5502,-3839,-69.77,1618
2022-01-15,752,4755,-4003,-84.19,1618
2022-01-16,482,4596,-4114,-89.51,1618
2022-01-17,1868,5652,-3784,-66.95,1618
2022-01-18,1839,5660,-3821,-67.51,1618
2022-01-19,1839,5667,-3828,-67.55,1618
2022-01-20,1839,5672,-3833,-67.58,1618
2022-01-21,1663,5533,-3870,-69.94,1618
2022-01-22,752,4790,-4038,-84.3,1618
2022-01-23,482,4634,-4152,-89.6,1618
2022-01-24,1868,5693,-3825,-67.19,1618
2022-01-25,1839,5703,-3864,-67.75,1618
2022-01-26,1839,5712,-3873,-67.8,1618
2022-01-27,1839,5720,-3881,-67.85,1618
2022-01-28,1663,5583,-3920,-70.21,1618
2022-01-29,752,4841,-4089,-84.47,1618
2022-01-30,482,4687,-4205,-89.72,1618
2020-02-01,69,390,-321,-82.31,1624
2020-02-02,23,390,-367,-94.1,1624
2020-02-03,554,563,-9,-1.6,1624
2020-02-04,588,575,13,2.26,1624
2020-02-05,588,576,12,2.08,1624
2020-02-06,588,577,11,1.91,1624
2020-02-07,485,399,86,21.55,1624
2020-02-08,69,399,-330,-82.71,1624
2020-02-09,23,399,-376,-94.24,1624
2020-02-10,554,567,-13,-2.29,1624
2020-02-11,588,577,11,1.91,1624
2020-02-12,588,577,11,1.91,1624
2020-02-13,588,578,10,1.73,1624
2020-02-14,485,400,85,21.25,1624
2020-02-15,69,400,-331,-82.75,1624
2020-02-16,23,400,-377,-94.25,1624
2020-02-17,554,571,-17,-2.98,1624
2020-02-18,588,584,4,0.68,1624
2020-02-19,588,586,2,0.34,1624
2020-02-20,588,590,-2,-0.34,1624
2020-02-21,485,415,70,16.87,1624
2020-02-22,69,1,68,6800.0,1624
2020-02-23,23,1,22,2200.0,1624
2020-02-24,554,597,-43,-7.2,1624
2020-02-25,588,613,-25,-4.08,1624
2020-02-26,588,619,-31,-5.01,1624
2020-02-27,588,627,-39,-6.22,1624
2020-02-28,485,454,31,6.83,1624
2020-02-29,69,24,45,187.5,1624
2020-03-01,20,24,-4,-16.67,1624
2020-03-02,542,643,-101,-15.71,1624
2020-03-03,607,660,-53,-8.03,1624
2020-03-04,607,666,-59,-8.86,1624
2020-03-05,607,674,-67,-9.94,1624
2020-03-06,400,501,-101,-20.16,1624
2020-03-07,50,7,43,614.29,1624
2020-03-08,20,18,2,11.11,1624
2020-03-09,542,684,-142,-20.76,1624
2020-03-10,607,698,-91,-13.04,1624
2020-03-11,607,701,-94,-13.41,1624
2020-03-12,607,705,-98,-13.9,1624
2020-03-13,400,528,-128,-24.24,1624
2020-03-14,50,30,20,66.67,1624
2020-03-15,20,29,-9,-31.03,1624
2020-03-16,542,698,-156,-22.35,1624
2020-03-17,607,708,-101,-14.27,1624
2020-03-18,607,707,-100,-14.14,1624
2020-03-19,607,708,-101,-14.27,1624
2020-03-20,400,528,-128,-24.24,1624
2020-03-21,50,27,23,85.19,1624
2020-03-22,20,27,-7,-25.93,1624
2020-03-23,542,691,-149,-21.56,1624
2020-03-24,607,700,-93,-13.29,1624
2020-03-25,607,698,-91,-13.04,1624
2020-03-26,607,698,-91,-13.04,1624
2020-03-27,400,519,-119,-22.93,1624
2020-03-28,50,19,31,163.16,1624
2020-03-29,20,24,-4,-16.67,1624
2020-03-30,542,685,-143,-20.88,1624
2020-03-31,607,696,-89,-12.79,1624
2020-04-01,715,696,19,2.73,1624
2020-04-02,715,698,17,2.44,1624
2020-04-03,445,521,-76,-14.59,1624
2020-04-04,66,23,43,186.96,1624
2020-04-05,17,25,-8,-32.0,1624
2020-04-06,724,694,30,4.32,1624
2020-04-07,715,706,9,1.27,1624
2020-04-08,715,708,7,0.99,1624
2020-04-09,715,711,4,0.56,1624
2020-04-10,445,535,-90,-16.82,1624
2020-04-11,66,37,29,78.38,1624
2020-04-12,17,33,-16,-48.48,1624
2020-04-13,724,708,16,2.26,1624
2020-04-14,715,720,-5,-0.69,1624
2020-04-15,715,720,-5,-0.69,1624
2020-04-16,715,722,-7,-0.97,1624
2020-04-17,445,544,-99,-18.2,1624
2020-04-18,66,45,21,46.67,1624
2020-04-19,17,36,-19,-52.78,1624
2020-04-20,724,711,13,1.83,1624
2020-04-21,715,721,-6,-0.83,1624
2020-04-22,715,719,-4,-0.56,1624
2020-04-23,715,719,-4,-0.56,1624
2020-04-24,445,538,-93,-17.29,1624
2020-04-25,66,37,29,78.38,1624
2020-04-26,17,32,-15,-46.88,1624
2020-04-27,724,700,24,3.43,1624
2020-04-28,715,709,6,0.85,1624
2020-04-29,715,706,9,1.27,1624
2020-04-30,715,706,9,1.27,1624
2020-05-01,553,525,28,5.33,1624
2020-05-02,92,24,68,283.33,1624
2020-05-03,26,27,-1,-3.7,1624
2020-05-04,830,688,142,20.64,1624
2020-05-05,809,697,112,16.07,1624
2020-05-06,809,696,113,16.24,1624
2020-05-07,809,696,113,16.24,1624
2020-05-08,553,516,37,7.17,1624
2020-05-09,92,17,75,441.18,1624
2020-05-10,26,26,0,0.0,1624
2020-05-11,830,684,146,21.35,1624
2020-05-12,809,694,115,16.57,1624
2020-05-13,809,694,115,16.57,1624
2020-05-14,809,696,113,16.24,1624
2020-05-15,553,517,36,6.96,1624
2020-05-16,92,18,74,411.11,1624
2020-05-17,26,22,4,18.18,1624
2020-05-18,830,687,143,20.82,1624
2020-05-19,809,698,111,15.9,1624
2020-05-20,809,698,111,15.9,1624
2020-05-21,809,699,110,15.74,1624
2020-05-22,553,521,32,6.14,1624
2020-05-23,92,22,70,318.18,1624
2020-05-24,26,28,-2,-7.14,1624
2020-05-25,830,690,140,20.29,1624
2020-05-26,809,700,109,15.57,1624
2020-05-27,809,700,109,15.57,1624
2020-05-28,809,701,108,15.41,1624
2020-05-29,553,523,30,5.74,1624
2020-05-30,92,23,69,300.0,1624
2020-05-31,26,26,0,0.0,1624
2020-06-01,784,691,93,13.46,1624
2020-06-02,758,702,56,7.98,1624
2020-06-03,758,702,56,7.98,1624
2020-06-04,758,703,55,7.82,1624
2020-06-05,459,525,-66,-12.57,1624
2020-06-06,68,26,42,161.54,1624
2020-06-07,28,27,1,3.7,1624
2020-06-08,784,694,90,12.97,1624
2020-06-09,758,705,53,7.52,1624
2020-06-10,758,706,52,7.37,1624
2020-06-11,758,707,51,7.21,1624
2020-06-12,459,529,-70,-13.23,1624
2020-06-13,68,30,38,126.67,1624
2020-06-14,28,28,0,0.0,1624
2020-06-15,784,698,86,12.32,1624
2020-06-16,758,709,49,6.91,1624
2020-06-17,758,708,50,7.06,1624
2020-06-18,758,709,49,6.91,1624
2020-06-19,459,530,-71,-13.4,1624
2020-06-20,68,30,38,126.67,1624
2020-06-21,28,29,-1,-3.45,1624
2020-06-22,784,694,90,12.97,1624
2020-06-23,758,703,55,7.82,1624
2020-06-24,758,701,57,8.13,1624
2020-06-25,758,699,59,8.44,1624
2020-06-26,459,518,-59,-11.39,1624
2020-06-27,68,16,52,325.0,1624
2020-06-28,28,20,8,40.0,1624
2020-06-29,784,678,106,15.63,1624
2020-06-30,758,685,73,10.66,1624
2020-07-01,864,682,182,26.69,1624
2020-07-02,864,680,184,27.06,1624
2020-07-03,635,498,137,27.51,1624
2020-07-04,103,41,62,151.22,1624
2020-07-05,36,13,23,176.92,1624
2020-07-06,860,657,203,30.9,1624
2020-07-07,864,665,199,29.92,1624
2020-07-08,864,662,202,30.51,1624
2020-07-09,864,662,202,30.51,1624
2020-07-10,635,481,154,32.02,1624
2020-07-11,103,36,67,186.11,1624
2020-07-12,36,7,29,414.29,1624
2020-07-13,860,645,215,33.33,1624
2020-07-14,864,654,210,32.11,1624
2020-07-15,864,653,211,32.31,1624
2020-07-16,864,654,210,32.11,1624
2020-07-17,635,474,161,33.97,1624
2020-07-18,103,32,71,221.88,1624
2020-07-19,36,2,34,1700.0,1624
2020-07-20,860,640,220,34.38,1624
2020-07-21,864,650,214,32.92,1624
2020-07-22,864,648,216,33.33,1624
2020-07-23,864,648,216,33.33,1624
2020-07-24,635,467,168,35.97,1624
2020-07-25,103,27,76,281.48,1624
2020-07-26,36,27,9,33.33,1624
2020-07-27,860,627,233,37.16,1624
2020-07-28,864,634,230,36.28,1624
2020-07-29,864,630,234,37.14,1624
2020-07-30,864,627,237,37.8,1624
2020-07-31,635,443,192,43.34,1624
2020-08-01,104,17,87,511.76,1624
2020-08-02,38,17,21,123.53,1624
2020-08-03,740,595,145,24.37,1624
2020-08-04,716,600,116,19.33,1624
2020-08-05,716,594,122,20.54,1624
2020-08-06,716,589,127,21.56,1624
2020-08-07,537,405,132,32.59,1624
2020-08-08,104,405,-301,-74.32,1624
2020-08-09,38,405,-367,-90.62,1624
2020-08-10,740,557,183,32.85,1624
2020-08-11,716,563,153,27.18,1624
2020-08-12,716,559,157,28.09,1624
2020-08-13,716,557,159,28.55,1624
2020-08-14,537,376,161,42.82,1624
2020-08-15,104,376,-272,-72.34,1624
2020-08-16,38,376,-338,-89.89,1624
2020-08-17,740,541,199,36.78,1624
2020-08-18,716,552,164,29.71,1624
2020-08-19,716,553,163,29.48,1624
2020-08-20,716,557,159,28.55,1624
2020-08-21,537,381,156,40.94,1624
2020-08-22,104,381,-277,-72.7,1624
2020-08-23,38,381,-343,-90.03,1624
2020-08-24,740,561,179,31.91,1624
2020-08-25,716,576,140,24.31,1624
2020-08-26,716,581,135,23.24,1624
2020-08-27,716,587,129,21.98,1624
2020-08-28,537,414,123,29.71,1624
2020-08-29,104,8,96,1200.0,1624
2020-08-30,38,8,30,375.0,1624
2020-08-31,740,598,142,23.75,1624
2020-09-01,838,613,225,36.7,1624
2020-09-02,838,617,221,35.82,1624
2020-09-03,838,622,216,34.73,1624
2020-09-04,644,447,197,44.07,1624
2020-09-05,89,21,68,323.81,1624
2020-09-06,46,21,25,119.05,1624
2020-09-07,825,622,203,32.64,1624
2020-09-08,838,634,204,32.18,1624
2020-09-09,838,634,204,32.18,1624
2020-09-10,838,636,202,31.76,1624
2020-09-11,644,457,187,40.92,1624
2020-09-12,89,26,63,242.31,1624
2020-09-13,46,26,20,76.92,1624
2020-09-14,825,623,202,32.42,1624
2020-09-15,838,632,206,32.59,1624
2020-09-16,838,631,207,32.81,1624
2020-09-17,838,631,207,32.81,1624
2020-09-18,644,452,192,42.48,1624
2020-09-19,89,24,65,270.83,1624
2020-09-20,46,24,22,91.67,1624
2020-09-21,825,620,205,33.06,1624
2020-09-22,838,631,207,32.81,1624
2020-09-23,838,632,206,32.59,1624
2020-09-24,838,634,204,32.18,1624
2020-09-25,644,458,186,40.61,1624
2020-09-26,89,26,63,242.31,1624
2020-09-27,46,26,20,76.92,1624
2020-09-28,825,634,191,30.13,1624
2020-09-29,838,649,189,29.12,1624
2020-09-30,838,652,186,28.53,1624
2020-10-01,807,658,149,22.64,1624
2020-10-02,649,483,166,34.37,1624
2020-10-03,98,40,58,145.0,1624
2020-10-04,31,12,19,158.33,1624
2020-10-05,876,664,212,31.93,1624
2020-10-06,807,678,129,19.03,1624
2020-10-07,807,681,126,18.5,1624
2020-10-08,807,685,122,17.81,1624
2020-10-09,649,509,140,27.5,1624
2020-10-10,98,12,86,716.67,1624
2020-10-11,31,18,13,72.22,1624
2020-10-12,876,682,194,28.45,1624
2020-10-13,807,693,114,16.45,1624
2020-10-14,807,693,114,16.45,1624
2020-10-15,807,693,114,16.45,1624
2020-10-16,649,513,136,26.51,1624
2020-10-17,98,12,86,716.67,1624
2020-10-18,31,22,9,40.91,1624
2020-10-19,876,675,201,29.78,1624
2020-10-20,807,683,124,18.16,1624
2020-10-21,807,680,127,18.68,1624
2020-10-22,807,678,129,19.03,1624
2020-10-23,649,497,152,30.58,1624
2020-10-24,98,43,55,127.91,1624
2020-10-25,31,14,17,121.43,1624
2020-10-26,876,657,219,33.33,1624
2020-10-27,807,666,141,21.17,1624
2020-10-28,807,664,143,21.54,1624
2020-10-29,807,664,143,21.54,1624
2020-10-30,649,485,164,33.81,1624
2020-10-31,98,41,57,139.02,1624
2020-11-01,27,11,16,145.45,1624
2020-11-02,881,654,227,34.71,1624
2020-11-03,879,666,213,31.98,1624
2020-11-04,879,667,212,31.78,1624
2020-11-05,879,670,209,31.19,1624
2020-11-06,706,493,213,43.2,1624
2020-11-07,118,45,73,162.22,1624
2020-11-08,27,13,14,107.69,1624
2020-11-09,881,667,214,32.08,1624
2020-11-10,879,680,199,29.26,1624
2020-11-11,879,681,198,29.07,1624
2020-11-12,879,683,196,28.7,1624
2020-11-13,706,505,201,39.8,1624
2020-11-14,118,5,113,2260.0,1624
2020-11-15,27,20,7,35.0,1624
2020-11-16,881,670,211,31.49,1624
2020-11-17,879,678,201,29.65,1624
2020-11-18,879,675,204,30.22,1624
2020-11-19,879,672,207,30.8,1624
2020-11-20,706,488,218,44.67,1624
2020-11-21,118,41,77,187.8,1624
2020-11-22,27,5,22,440.0,1624
2020-11-23,881,637,244,38.3,1624
2020-11-24,879,639,240,37.56,1624
2020-11-25,879,630,249,39.52,1624
2020-11-26,879,623,256,41.09,1624
2020-11-27,706,435,271,62.3,1624
2020-11-28,118,8,110,1375.0,1624
2020-11-29,27,8,19,237.5,1624
2020-11-30,881,574,307,53.48,1624
2020-12-01,535,575,-40,-6.96,1624
2020-12-02,535,566,-31,-5.48,1624
2020-12-03,535,559,-24,-4.29,1624
2020-12-04,659,372,287,77.15,1624
2020-12-05,106,372,-266,-71.51,1624
2020-12-06,34,372,-338,-90.86,1624
2020-12-07,542,518,24,4.63,1624
2020-12-08,535,523,12,2.29,1624
2020-12-09,535,518,17,3.28,1624
2020-12-10,535,514,21,4.09,1624
2020-12-11,659,332,327,98.49,1624
2020-12-12,106,332,-226,-68.07,1624
2020-12-13,34,332,-298,-89.76,1624
2020-12-14,542,493,49,9.94,1624
2020-12-15,535,502,33,6.57,1624
2020-12-16,535,500,35,7.0,1624
2020-12-17,535,500,35,7.0,1624
2020-12-18,659,321,338,105.3,1624
2020-12-19,106,321,-215,-66.98,1624
2020-12-20,34,321,-287,-89.41,1624
2020-12-21,542,487,55,11.29,1624
2020-12-22,535,496,39,7.86,1624
2020-12-23,535,494,41,8.3,1624
2020-12-24,535,494,41,8.3,1624
2020-12-25,659,313,346,110.54,1624
2020-12-26,106,313,-207,-66.13,1624
2020-12-27,34,313,-279,-89.14,1624
2020-12-28,542,472,70,14.83,1624
2020-12-29,535,479,56,11.69,1624
2020-12-30,535,474,61,12.87,1624
2020-12-31,535,471,64,13.59,1624
2021-01-01,444,287,157,54.7,1624
2021-01-02,74,287,-213,-74.22,1624
2021-01-03,39,287,-248,-86.41,1624
2021-01-04,555,439,116,26.42,1624
2021-01-05,632,444,188,42.34,1624
2021-01-06,632,439,193,43.96,1624
2021-01-07,632,435,197,45.29,1624
2021-01-08,444,251,193,76.89,1624
2021-01-09,74,251,-177,-70.52,1624
2021-01-10,39,251,-212,-84.46,1624
2021-01-11,555,408,147,36.03,1624
2021-01-12,632,415,217,52.29,1624
2021-01-13,632,413,219,53.03,1624
2021-01-14,632,412,220,53.4,1624
2021-01-15,444,233,211,90.56,1624
2021-01-16,74,233,-159,-68.24,1624
2021-01-17,39,233,-194,-83.26,1624
2021-01-18,555,402,153,38.06,1624
2021-01-19,632,414,218,52.66,1624
2021-01-20,632,416,216,51.92,1624
2021-01-21,632,419,213,50.84,1624
2021-01-22,444,243,201,82.72,1624
2021-01-23,74,243,-169,-69.55,1624
2021-01-24,39,243,-204,-83.95,1624
2021-01-25,555,421,134,31.83,1624
2021-01-26,632,434,198,45.62,1624
2021-01-27,632,437,195,44.62,1624
2021-01-28,632,442,190,42.99,1624
2021-01-29,444,266,178,66.92,1624
2021-01-30,74,266,-192,-72.18,1624
2021-01-31,39,266,-227,-85.34,1624
2021-02-01,697,441,256,58.05,1624
2021-02-02,634,453,181,39.96,1624
2021-02-03,634,454,180,39.65,1624
2021-02-04,634,456,178,39.04,1624
2021-02-05,556,278,278,100.0,1624
2021-02-06,85,278,-193,-69.42,1624
2021-02-07,32,278,-246,-88.49,1624
2021-02-08,697,446,251,56.28,1624
2021-02-09,634,457,177,38.73,1624
2021-02-10,634,456,178,39.04,1624
2021-02-11,634,457,177,38.73,1624
2021-02-12,556,279,277,99.28,1624
2021-02-13,85,279,-194,-69.53,1624
2021-02-14,32,279,-247,-88.53,1624
2021-02-15,697,449,248,55.23,1624
2021-02-16,634,461,173,37.53,1624
2021-02-17,634,462,172,37.23,1624
2021-02-18,634,466,168,36.05,1624
2021-02-19,556,290,266,91.72,1624
2021-02-20,85,290,-205,-70.69,1624
2021-02-21,32,290,-258,-88.97,1624
2021-02-22,697,470,227,48.3,1624
2021-02-23,634,486,148,30.45,1624
2021-02-24,634,491,143,29.12,1624
2021-02-25,634,498,136,27.31,1624
2021-02-26,556,326,230,70.55,1624
2021-02-27,85,326,-241,-73.93,1624
2021-02-28,32,326,-294,-90.18,1624
2021-03-01,801,514,287,55.84,1624
2021-03-02,809,531,278,52.35,1624
2021-03-03,809,538,271,50.37,1624
2021-03-04,809,545,264,48.44,1624
2021-03-05,669,373,296,79.36,1624
2021-03-06,100,373,-273,-73.19,1624
2021-03-07,47,373,-326,-87.4,1624
2021-03-08,801,558,243,43.55,1624
2021-03-09,809,573,236,41.19,1624
2021-03-10,809,576,233,40.45,1624
2021-03-11,809,581,228,39.24,1624
2021-03-12,669,405,264,65.19,1624
2021-03-13,100,7,93,1328.57,1624
2021-03-14,47,7,40,571.43,1624
2021-03-15,801,577,224,38.82,1624
2021-03-16,809,588,221,37.59,1624
2021-03-17,809,587,222,37.82,1624
2021-03-18,809,588,221,37.59,1624
2021-03-19,669,408,261,63.97,1624
2021-03-20,100,4,96,2400.0,1624
2021-03-21,47,4,43,1075.0,1624
2021-03-22,801,572,229,40.03,1624
2021-03-23,809,581,228,39.24,1624
2021-03-24,809,580,229,39.48,1624
2021-03-25,809,579,230,39.72,1624
2021-03-26,669,399,270,67.67,1624
2021-03-27,100,2,98,4900.0,1624
2021-03-28,47,2,45,2250.0,1624
2021-03-29,801,565,236,41.77,1624
2021-03-30,809,575,234,40.7,1624
2021-03-31,809,575,234,40.7,1624
2021-04-01,872,577,295,51.13,1624
2021-04-02,592,399,193,48.37,1624
2021-04-03,106,3,103,3433.33,1624
2021-04-04,28,3,25,833.33,1624
2021-04-05,876,571,305,53.42,1624
2021-04-06,872,583,289,49.57,1624
2021-04-07,872,585,287,49.06,1624
2021-04-08,872,588,284,48.3,1624
2021-04-09,592,411,181,44.04,1624
2021-04-10,106,7,99,1414.29,1624
2021-04-11,28,7,21,300.0,1624
2021-04-12,876,585,291,49.74,1624
2021-04-13,872,597,275,46.06,1624
2021-04-14,872,598,274,45.82,1624
2021-04-15,872,601,271,45.09,1624
2021-04-16,592,423,169,39.95,1624
2021-04-17,106,15,91,606.67,1624
2021-04-18,28,15,13,86.67,1624
2021-04-19,876,591,285,48.22,1624
2021-04-20,872,601,271,45.09,1624
2021-04-21,872,600,272,45.33,1624
2021-04-22,872,600,272,45.33,1624
2021-04-23,592,420,172,40.95,1624
2021-04-24,106,11,95,863.64,1624
2021-04-25,28,11,17,154.55,1624
2021-04-26,876,582,294,50.52,1624
2021-04-27,872,591,281,47.55,1624
2021-04-28,872,588,284,48.3,1624
2021-04-29,872,588,284,48.3,1624
2021-04-30,592,407,185,45.45,1624
2021-05-01,133,6,127,2116.67,1624
2021-05-02,46,6,40,666.67,1624
2021-05-03,844,569,275,48.33,1624
2021-05-04,896,578,318,55.02,1624
2021-05-05,896,576,320,55.56,1624
2021-05-06,896,576,320,55.56,1624
2021-05-07,647,397,250,62.97,1624
2021-05-08,133,397,-264,-66.5,1624
2021-05-09,46,397,-351,-88.41,1624
2021-05-10,844,563,281,49.91,1624
2021-05-11,896,574,322,56.1,1624
2021-05-12,896,573,323,56.37,1624
2021-05-13,896,575,321,55.83,1624
2021-05-14,647,396,251,63.38,1624
2021-05-15,133,0,133,inf,1624
2021-05-16,46,0,46,inf,1624
2021-05-17,844,565,279,49.38,1624
2021-05-18,896,576,320,55.56,1624
2021-05-19,896,577,319,55.29,1624
2021-05-20,896,578,318,55.02,1624
2021-05-21,647,400,247,61.75,1624
2021-05-22,133,2,131,6550.0,1624
2021-05-23,46,2,44,2200.0,1624
2021-05-24,844,569,275,48.33,1624
2021-05-25,896,579,317,54.75,1624
2021-05-26,896,579,317,54.75,1624
2021-05-27,896,580,316,54.48,1624
2021-05-28,647,402,245,60.95,1624
2021-05-29,133,7,126,1800.0,1624
2021-05-30,46,7,39,557.14,1624
2021-05-31,844,570,274,48.07,1624
2021-06-01,889,581,308,53.01,1624
2021-06-02,889,581,308,53.01,1624
2021-06-03,889,582,307,52.75,1624
2021-06-04,580,404,176,43.56,1624
2021-06-05,120,10,110,1100.0,1624
2021-06-06,40,10,30,300.0,1624
2021-06-07,860,573,287,50.09,1624
2021-06-08,889,584,305,52.23,1624
2021-06-09,889,584,305,52.23,1624
2021-06-10,889,586,303,51.71,1624
2021-06-11,580,408,172,42.16,1624
2021-06-12,120,11,109,990.91,1624
2021-06-13,40,11,29,263.64,1624
2021-06-14,860,577,283,49.05,1624
2021-06-15,889,588,301,51.19,1624
2021-06-16,889,588,301,51.19,1624
2021-06-17,889,589,300,50.93,1624
2021-06-18,580,410,170,41.46,1624
2021-06-19,120,11,109,990.91,1624
2021-06-20,40,11,29,263.64,1624
2021-06-21,860,575,285,49.57,1624
2021-06-22,889,584,305,52.23,1624
2021-06-23,889,582,307,52.75,1624
2021-06-24,889,582,307,52.75,1624
2021-06-25,580,401,179,44.64,1624
2021-06-26,120,4,116,2900.0,1624
2021-06-27,40,4,36,900.0,1624
2021-06-28,860,561,299,53.3,1624
2021-06-29,889,568,321,56.51,1624
2021-06-30,889,565,324,57.35,1624
2021-07-01,859,563,296,52.58,1624
2021-07-02,657,381,276,72.44,1624
2021-07-03,90,381,-291,-76.38,1624
2021-07-04,36,381,-345,-90.55,1624
2021-07-05,856,540,316,58.52,1624
2021-07-06,859,548,311,56.75,1624
2021-07-07,859,545,314,57.61,1624
2021-07-08,859,544,315,57.9,1624
2021-07-09,657,363,294,80.99,1624
2021-07-10,90,363,-273,-75.21,1624
2021-07-11,36,363,-327,-90.08,1624
2021-07-12,856,526,330,62.74,1624
2021-07-13,859,535,324,60.56,1624
2021-07-14,859,534,325,60.86,1624
2021-07-15,859,534,325,60.86,1624
2021-07-16,657,355,302,85.07,1624
2021-07-17,90,355,-265,-74.65,1624
2021-07-18,36,355,-319,-89.86,1624
2021-07-19,856,521,335,64.3,1624
2021-07-20,859,530,329,62.08,1624
2021-07-21,859,529,330,62.38,1624
2021-07-22,859,529,330,62.38,1624
2021-07-23,657,349,308,88.25,1624
2021-07-24,90,349,-259,-74.21,1624
2021-07-25,36,349,-313,-89.68,1624
2021-07-26,856,510,346,67.84,1624
2021-07-27,859,518,341,65.83,1624
2021-07-28,859,514,345,67.12,1624
2021-07-29,859,511,348,68.1,1624
2021-07-30,657,328,329,100.3,1624
2021-07-31,90,328,-238,-72.56,1624
2021-08-01,37,328,-291,-88.72,1624
2021-08-02,807,482,325,67.43,1624
2021-08-03,820,486,334,68.72,1624
2021-08-04,820,480,340,70.83,1624
2021-08-05,820,476,344,72.27,1624
2021-08-06,596,291,305,104.81,1624
2021-08-07,90,291,-201,-69.07,1624
2021-08-08,37,291,-254,-87.29,1624
2021-08-09,807,443,364,82.17,1624
2021-08-10,820,448,372,83.04,1624
2021-08-11,820,443,377,85.1,1624
2021-08-12,820,441,379,85.94,1624
2021-08-13,596,259,337,130.12,1624
2021-08-14,90,259,-169,-65.25,1624
2021-08-15,37,259,-222,-85.71,1624
2021-08-16,807,421,386,91.69,1624
2021-08-17,820,431,389,90.26,1624
2021-08-18,820,431,389,90.26,1624
2021-08-19,820,434,386,88.94,1624
2021-08-20,596,257,339,131.91,1624
2021-08-21,90,257,-167,-64.98,1624
2021-08-22,37,257,-220,-85.6,1624
2021-08-23,807,435,372,85.52,1624
2021-08-24,820,450,370,82.22,1624
2021-08-25,820,454,366,80.62,1624
2021-08-26,820,460,360,78.26,1624
2021-08-27,596,287,309,107.67,1624
2021-08-28,90,287,-197,-68.64,1624
2021-08-29,37,287,-250,-87.11,1624
2021-08-30,807,471,336,71.34,1624
2021-08-31,820,487,333,68.38,1624
2021-09-01,898,491,407,82.89,1624
2021-09-02,898,497,401,80.68,1624
2021-09-03,693,322,371,115.22,1624
2021-09-04,112,322,-210,-65.22,1624
2021-09-05,36,322,-286,-88.82,1624
2021-09-06,932,499,433,86.77,1624
2021-09-07,898,511,387,75.73,1624
2021-09-08,898,513,385,75.05,1624
2021-09-09,898,515,383,74.37,1624
2021-09-10,693,336,357,106.25,1624
2021-09-11,112,336,-224,-66.67,1624
2021-09-12,36,336,-300,-89.29,1624
2021-09-13,932,503,429,85.29,1624
2021-09-14,898,513,385,75.05,1624
2021-09-15,898,512,386,75.39,1624
2021-09-16,898,512,386,75.39,1624
2021-09-17,693,332,361,108.73,1624
2021-09-18,112,332,-220,-66.27,1624
2021-09-19,36,332,-296,-89.16,1624
2021-09-20,932,499,433,86.77,1624
2021-09-21,898,509,389,76.42,1624
2021-09-22,898,510,388,76.08,1624
2021-09-23,898,512,386,75.39,1624
2021-09-24,693,335,358,106.87,1624
2021-09-25,112,335,-223,-66.57,1624
2021-09-26,36,335,-299,-89.25,1624
2021-09-27,932,510,422,82.75,1624
2021-09-28,898,523,375,71.7,1624
2021-09-29,898,527,371,70.4,1624
2021-09-30,898,532,366,68.8,1624
2021-10-01,712,357,355,99.44,1624
2021-10-02,111,357,-246,-68.91,1624
2021-10-03,38,357,-319,-89.36,1624
2021-10-04,825,538,287,53.35,1624
2021-10-05,864,553,311,56.24,1624
2021-10-06,864,556,308,55.4,1624
2021-10-07,864,561,303,54.01,1624
2021-10-08,712,385,327,84.94,1624
2021-10-09,111,11,100,909.09,1624
2021-10-10,38,11,27,245.45,1624
2021-10-11,825,560,265,47.32,1624
2021-10-12,864,572,292,51.05,1624
2021-10-13,864,572,292,51.05,1624
2021-10-14,864,573,291,50.79,1624
2021-10-15,712,394,318,80.71,1624
2021-10-16,111,13,98,753.85,1624
2021-10-17,38,13,25,192.31,1624
2021-10-18,825,558,267,47.85,1624
2021-10-19,864,566,298,52.65,1624
2021-10-20,864,563,301,53.46,1624
2021-10-21,864,561,303,54.01,1624
2021-10-22,712,380,332,87.37,1624
2021-10-23,111,1,110,11000.0,1624
2021-10-24,38,1,37,3700.0,1624
2021-10-25,825,540,285,52.78,1624
2021-10-26,864,548,316,57.66,1624
2021-10-27,864,546,318,58.24,1624
2021-10-28,864,545,319,58.53,1624
2021-10-29,712,365,347,95.07,1624
2021-10-30,111,0,111,inf,1624
2021-10-31,38,0,38,inf,1624
2021-11-01,884,533,351,65.85,1624
2021-11-02,908,544,364,66.91,1624
2021-11-03,908,544,364,66.91,1624
2021-11-04,908,547,361,66.0,1624
2021-11-05,712,370,342,92.43,1624
2021-11-06,108,4,104,2600.0,1624
2021-11-07,37,4,33,825.0,1624
2021-11-08,884,544,340,62.5,1624
2021-11-09,908,557,351,63.02,1624
2021-11-10,908,558,350,62.72,1624
2021-11-11,908,561,347,61.85,1624
2021-11-12,712,383,329,85.9,1624
2021-11-13,108,8,100,1250.0,1624
2021-11-14,37,8,29,362.5,1624
2021-11-15,884,551,333,60.44,1624
2021-11-16,908,560,348,62.14,1624
2021-11-17,908,558,350,62.72,1624
2021-11-18,908,556,352,63.31,1624
2021-11-19,712,373,339,90.88,1624
2021-11-20,108,0,108,inf,1624
2021-11-21,37,0,37,inf,1624
2021-11-22,884,525,359,68.38,1624
2021-11-23,908,528,380,71.97,1624
2021-11-24,908,520,388,74.62,1624
2021-11-25,908,513,395,77.0,1624
2021-11-26,712,326,386,118.4,1624
2021-11-27,108,326,-218,-66.87,1624
2021-11-28,37,326,-289,-88.65,1624
2021-11-29,884,466,418,89.7,1624
2021-11-30,908,467,441,94.43,1624
2021-12-01,508,457,51,11.16,1624
2021-12-02,508,449,59,13.14,1624
2021-12-03,370,261,109,41.76,1624
2021-12-04,95,261,-166,-63.6,1624
2021-12-05,27,261,-234,-89.66,1624
2021-12-06,568,406,162,39.9,1624
2021-12-07,508,410,98,23.9,1624
2021-12-08,508,403,105,26.05,1624
2021-12-09,508,399,109,27.32,1624
2021-12-10,370,216,154,71.3,1624
2021-12-11,95,216,-121,-56.02,1624
2021-12-12,27,216,-189,-87.5,1624
2021-12-13,568,375,193,51.47,1624
2021-12-14,508,383,125,32.64,1624
2021-12-15,508,381,127,33.33,1624
2021-12-16,508,381,127,33.33,1624
2021-12-17,370,201,169,84.08,1624
2021-12-18,95,201,-106,-52.74,1624
2021-12-19,27,201,-174,-86.57,1624
2021-12-20,568,367,201,54.77,1624
2021-12-21,508,377,131,34.75,1624
2021-12-22,508,375,133,35.47,1624
2021-12-23,508,375,133,35.47,1624
2021-12-24,370,195,175,89.74,1624
2021-12-25,95,195,-100,-51.28,1624
2021-12-26,27,195,-168,-86.15,1624
2021-12-27,568,356,212,59.55,1624
2021-12-28,508,363,145,39.94,1624
2021-12-29,508,359,149,41.5,1624
2021-12-30,508,356,152,42.7,1624
2021-12-31,370,173,197,113.87,1624
2022-01-01,100,173,-73,-42.2,1624
2022-01-02,31,173,-142,-82.08,1624
2022-01-03,539,325,214,65.85,1624
2022-01-04,577,331,246,74.32,1624
2022-01-05,577,325,252,77.54,1624
2022-01-06,577,321,256,79.75,1624
2022-01-07,460,137,323,235.77,1624
2022-01-08,100,137,-37,-27.01,1624
2022-01-09,31,137,-106,-77.37,1624
2022-01-10,539,292,247,84.59,1624
2022-01-11,577,298,279,93.62,1624
2022-01-12,577,295,282,95.59,1624
2022-01-13,577,294,283,96.26,1624
2022-01-14,460,113,347,307.08,1624
2022-01-15,100,113,-13,-11.5,1624
2022-01-16,31,113,-82,-72.57,1624
2022-01-17,539,280,259,92.5,1624
2022-01-18,577,291,286,98.28,1624
2022-01-19,577,293,284,96.93,1624
2022-01-20,577,296,281,94.93,1624
2022-01-21,460,119,341,286.55,1624
2022-01-22,100,119,-19,-15.97,1624
2022-01-23,31,119,-88,-73.95,1624
2022-01-24,539,296,243,82.09,1624
2022-01-25,577,310,267,86.13,1624
2022-01-26,577,313,264,84.35,1624
2022-01-27,577,317,260,82.02,1624
2022-01-28,460,142,318,223.94,1624
2022-01-29,100,142,-42,-29.58,1624
2022-01-30,31,142,-111,-78.17,1624
2020-02-01,585,416,169,40.62,1075
2020-02-02,344,141,203,143.97,1075
2020-02-03,1442,1414,28,1.98,1075
2020-02-04,1456,1441,15,1.04,1075
2020-02-05,1456,1443,13,0.9,1075
2020-02-06,1456,1443,13,0.9,1075
2020-02-07,1320,1296,24,1.85,1075
2020-02-08,585,423,162,38.3,1075
2020-02-09,344,146,198,135.62,1075
2020-02-10,1442,1418,24,1.69,1075
2020-02-11,1456,1444,12,0.83,1075
2020-02-12,1456,1446,10,0.69,1075
2020-02-13,1456,1447,9,0.62,1075
2020-02-14,1320,1301,19,1.46,1075
2020-02-15,585,431,154,35.73,1075
2020-02-16,344,157,187,119.11,1075
2020-02-17,1442,1433,9,0.63,1075
2020-02-18,1456,1463,-7,-0.48,1075
2020-02-19,1456,1470,-14,-0.95,1075
2020-02-20,1456,1476,-20,-1.36,1075
2020-02-21,1320,1336,-16,-1.2,1075
2020-02-22,585,471,114,24.2,1075
2020-02-23,344,203,141,69.46,1075
2020-02-24,1442,1484,-42,-2.83,1075
2020-02-25,1456,1519,-63,-4.15,1075
2020-02-26,1456,1531,-75,-4.9,1075
2020-02-27,1456,1541,-85,-5.52,1075
2020-02-28,1320,1404,-84,-5.98,1075
2020-02-29,585,542,43,7.93,1075
2020-03-01,231,275,-44,-16.0,1075
2020-03-02,1103,1557,-454,-29.16,1075
2020-03-03,1137,1592,-455,-28.58,1075
2020-03-04,1137,1603,-466,-29.07,1075
2020-03-05,1137,1612,-475,-29.47,1075
2020-03-06,928,1473,-545,-37.0,1075
2020-03-07,350,607,-257,-42.34,1075
2020-03-08,231,337,-106,-31.45,1075
2020-03-09,1103,1615,-512,-31.7,1075
2020-03-10,1137,1646,-509,-30.92,1075
2020-03-11,1137,1652,-515,-31.17,1075
2020-03-12,1137,1656,-519,-31.34,1075
2020-03-13,928,1512,-584,-38.62,1075
2020-03-14,350,642,-292,-45.48,1075
2020-03-15,231,367,-136,-37.06,1075
2020-03-16,1103,1641,-538,-32.78,1075
2020-03-17,1137,1668,-531,-31.83,1075
2020-03-18,1137,1671,-534,-31.96,1075
2020-03-19,1137,1672,-535,-32.0,1075
2020-03-20,928,1526,-598,-39.19,1075
2020-03-21,350,655,-305,-46.56,1075
2020-03-22,231,379,-148,-39.05,1075
2020-03-23,1103,1653,-550,-33.27,1075
2020-03-24,1137,1681,-544,-32.36,1075
2020-03-25,1137,1685,-548,-32.52,1075
2020-03-26,1137,1688,-551,-32.64,1075
2020-03-27,928,1544,-616,-39.9,1075
2020-03-28,350,675,-325,-48.15,1075
2020-03-29,231,403,-172,-42.68,1075
2020-03-30,1103,1680,-577,-34.35,1075
2020-03-31,1137,1710,-573,-33.51,1075
2020-04-01,818,1717,-899,-52.36,1075
2020-04-02,818,1723,-905,-52.52,1075
2020-04-03,642,1581,-939,-59.39,1075
2020-04-04,275,715,-440,-61.54,1075
2020-04-05,123,444,-321,-72.3,1075
2020-04-06,819,1722,-903,-52.44,1075
2020-04-07,818,1753,-935,-53.34,1075
2020-04-08,818,1760,-942,-53.52,1075
2020-04-09,818,1766,-948,-53.68,1075
2020-04-10,642,1624,-982,-60.47,1075
2020-04-11,275,756,-481,-63.62,1075
2020-04-12,123,483,-360,-74.53,1075
2020-04-13,819,1759,-940,-53.44,1075
2020-04-14,818,1788,-970,-54.25,1075
2020-04-15,818,1793,-975,-54.38,1075
2020-04-16,818,1796,-978,-54.45,1075
2020-04-17,642,1651,-1009,-61.11,1075
2020-04-18,275,781,-506,-64.79,1075
2020-04-19,123,506,-383,-75.69,1075
2020-04-20,819,1780,-961,-53.99,1075
2020-04-21,818,1807,-989,-54.73,1075
2020-04-22,818,1810,-992,-54.81,1075
2020-04-23,818,1811,-993,-54.83,1075
2020-04-24,642,1666,-1024,-61.46,1075
2020-04-25,275,795,-520,-65.41,1075
2020-04-26,123,520,-397,-76.35,1075
2020-04-27,819,1794,-975,-54.35,1075
2020-04-28,818,1822,-1004,-55.1,1075
2020-04-29,818,1826,-1008,-55.2,1075
2020-04-30,818,1829,-1011,-55.28,1075
2020-05-01,1019,1686,-667,-39.56,1075
2020-05-02,387,816,-429,-52.57,1075
2020-05-03,186,543,-357,-65.75,1075
2020-05-04,1187,1820,-633,-34.78,1075
2020-05-05,1279,1849,-570,-30.83,1075
2020-05-06,1279,1855,-576,-31.05,1075
2020-05-07,1279,1860,-581,-31.24,1075
2020-05-08,1019,1717,-698,-40.65,1075
2020-05-09,387,848,-461,-54.36,1075
2020-05-10,186,576,-390,-67.71,1075
2020-05-11,1187,1852,-665,-35.91,1075
2020-05-12,1279,1881,-602,-32.0,1075
2020-05-13,1279,1886,-607,-32.18,1075
2020-05-14,1279,1889,-610,-32.29,1075
2020-05-15,1019,1744,-725,-41.57,1075
2020-05-16,387,873,-486,-55.67,1075
2020-05-17,186,597,-411,-68.84,1075
2020-05-18,1187,1870,-683,-36.52,1075
2020-05-19,1279,1896,-617,-32.54,1075
2020-05-20,1279,1897,-618,-32.58,1075
2020-05-21,1279,1896,-617,-32.54,1075
2020-05-22,1019,1748,-729,-41.7,1075
2020-05-23,387,873,-486,-55.67,1075
2020-05-24,186,595,-409,-68.74,1075
2020-05-25,1187,1865,-678,-36.35,1075
2020-05-26,1279,1888,-609,-32.26,1075
2020-05-27,1279,1887,-608,-32.22,1075
2020-05-28,1279,1885,-606,-32.15,1075
2020-05-29,1019,1735,-716,-41.27,1075
2020-05-30,387,860,-473,-55.0,1075
2020-05-31,186,581,-395,-67.99,1075
2020-06-01,1466,1852,-386,-20.84,1075
2020-06-02,1587,1876,-289,-15.41,1075
2020-06-03,1587,1876,-289,-15.41,1075
2020-06-04,1587,1876,-289,-15.41,1075
2020-06-05,1185,1729,-544,-31.46,1075
2020-06-06,482,856,-374,-43.69,1075
2020-06-07,247,579,-332,-57.34,1075
2020-06-08,1466,1852,-386,-20.84,1075
2020-06-09,1587,1879,-292,-15.54,1075
2020-06-10,1587,1881,-294,-15.63,1075
2020-06-11,1587,1883,-296,-15.72,1075
2020-06-12,1185,1737,-552,-31.78,1075
2020-06-13,482,865,-383,-44.28,1075
2020-06-14,247,589,-342,-58.06,1075
2020-06-15,1466,1862,-396,-21.27,1075
2020-06-16,1587,1887,-300,-15.9,1075
2020-06-17,1587,1888,-301,-15.94,1075
2020-06-18,1587,1887,-300,-15.9,1075
2020-06-19,1185,1738,-553,-31.82,1075
2020-06-20,482,863,-381,-44.15,1075
2020-06-21,247,583,-336,-57.63,1075
2020-06-22,1466,1852,-386,-20.84,1075
2020-06-23,1587,1873,-286,-15.27,1075
2020-06-24,1587,1869,-282,-15.09,1075
2020-06-25,1587,1863,-276,-14.81,1075
2020-06-26,1185,1710,-525,-30.7,1075
2020-06-27,482,830,-348,-41.93,1075
2020-06-28,247,545,-298,-54.68,1075
2020-06-29,1466,1809,-343,-18.96,1075
2020-06-30,1587,1827,-240,-13.14,1075
2020-07-01,1599,1820,-221,-12.14,1075
2020-07-02,1599,1811,-212,-11.71,1075
2020-07-03,1310,1656,-346,-20.89,1075
2020-07-04,512,775,-263,-33.94,1075
2020-07-05,294,491,-197,-40.12,1075
2020-07-06,1510,1756,-246,-14.01,1075
2020-07-07,1599,1774,-175,-9.86,1075
2020-07-08,1599,1770,-171,-9.66,1075
2020-07-09,1599,1765,-166,-9.41,1075
2020-07-10,1310,1613,-303,-18.78,1075
2020-07-11,512,737,-225,-30.53,1075
2020-07-12,294,457,-163,-35.67,1075
2020-07-13,1510,1727,-217,-12.57,1075
2020-07-14,1599,1751,-152,-8.68,1075
2020-07-15,1599,1751,-152,-8.68,1075
2020-07-16,1599,1752,-153,-8.73,1075
2020-07-17,1310,1605,-295,-18.38,1075
2020-07-18,512,733,-221,-30.15,1075
2020-07-19,294,458,-164,-35.81,1075
2020-07-20,1510,1731,-221,-12.77,1075
2020-07-21,1599,1758,-159,-9.04,1075
2020-07-22,1599,1761,-162,-9.2,1075
2020-07-23,1599,1763,-164,-9.3,1075
2020-07-24,1310,1617,-307,-18.99,1075
2020-07-25,512,744,-232,-31.18,1075
2020-07-26,294,468,-174,-37.18,1075
2020-07-27,1510,1739,-229,-13.17,1075
2020-07-28,1599,1764,-165,-9.35,1075
2020-07-29,1599,1763,-164,-9.3,1075
2020-07-30,1599,1761,-162,-9.2,1075
2020-07-31,1310,1611,-301,-18.68,1075
2020-08-01,528,734,-206,-28.07,1075
2020-08-02,318,453,-135,-29.8,1075
2020-08-03,1420,1721,-301,-17.49,1075
2020-08-04,1469,1740,-271,-15.57,1075
2020-08-05,1469,1736,-267,-15.38,1075
2020-08-06,1469,1730,-261,-15.09,1075
2020-08-07,1276,1577,-301,-19.09,1075
2020-08-08,528,698,-170,-24.36,1075
2020-08-09,318,415,-97,-23.37,1075
2020-08-10,1420,1682,-262,-15.58,1075
2020-08-11,1469,1702,-233,-13.69,1075
2020-08-12,1469,1699,-230,-13.54,1075
2020-08-13,1469,1695,-226,-13.33,1075
2020-08-14,1276,1545,-269,-17.41,1075
2020-08-15,528,670,-142,-21.19,1075
2020-08-16,318,391,-73,-18.67,1075
2020-08-17,1420,1663,-243,-14.61,1075
2020-08-18,1469,1689,-220,-13.03,1075
2020-08-19,1469,1692,-223,-13.18,1075
2020-08-20,1469,1695,-226,-13.33,1075
2020-08-21,1276,1551,-275,-17.73,1075
2020-08-22,528,683,-155,-22.69,1075
2020-08-23,318,411,-93,-22.63,1075
2020-08-24,1420,1689,-269,-15.93,1075
2020-08-25,1469,1721,-252,-14.64,1075
2020-08-26,1469,1730,-261,-15.09,1075
2020-08-27,1469,1737,-268,-15.43,1075
2020-08-28,1276,1598,-322,-20.15,1075
2020-08-29,528,732,-204,-27.87,1075
2020-08-30,318,463,-145,-31.32,1075
2020-08-31,1420,1742,-322,-18.48,1075
2020-09-01,1686,1774,-88,-4.96,1075
2020-09-02,1686,1782,-96,-5.39,1075
2020-09-03,1686,1787,-101,-5.65,1075
2020-09-04,1374,1645,-271,-16.47,1075
2020-09-05,547,777,-230,-29.6,1075
2020-09-06,304,503,-199,-39.56,1075
2020-09-07,1611,1778,-167,-9.39,1075
2020-09-08,1686,1805,-119,-6.59,1075
2020-09-09,1686,1807,-121,-6.7,1075
2020-09-10,1686,1808,-122,-6.75,1075
2020-09-11,1374,1660,-286,-17.23,1075
2020-09-12,547,786,-239,-30.41,1075
2020-09-13,304,508,-204,-40.16,1075
2020-09-14,1611,1778,-167,-9.39,1075
2020-09-15,1686,1801,-115,-6.39,1075
2020-09-16,1686,1799,-113,-6.28,1075
2020-09-17,1686,1796,-110,-6.12,1075
2020-09-18,1374,1646,-272,-16.52,1075
2020-09-19,547,770,-223,-28.96,1075
2020-09-20,304,491,-187,-38.09,1075
2020-09-21,1611,1760,-149,-8.47,1075
2020-09-22,1686,1783,-97,-5.44,1075
2020-09-23,1686,1783,-97,-5.44,1075
2020-09-24,1686,1781,-95,-5.33,1075
2020-09-25,1374,1633,-259,-15.86,1075
2020-09-26,547,759,-212,-27.93,1075
2020-09-27,304,482,-178,-36.93,1075
2020-09-28,1611,1754,-143,-8.15,1075
2020-09-29,1686,1780,-94,-5.28,1075
2020-09-30,1686,1781,-95,-5.33,1075
2020-10-01,1642,1782,-140,-7.86,1075
2020-10-02,1339,1636,-297,-18.15,1075
2020-10-03,482,764,-282,-36.91,1075
2020-10-04,246,488,-242,-49.59,1075
2020-10-05,1688,1761,-73,-4.15,1075
2020-10-06,1642,1787,-145,-8.11,1075
2020-10-07,1642,1788,-146,-8.17,1075
2020-10-08,1642,1789,-147,-8.22,1075
2020-10-09,1339,1641,-302,-18.4,1075
2020-10-10,482,767,-285,-37.16,1075
2020-10-11,246,489,-243,-49.69,1075
2020-10-12,1688,1760,-72,-4.09,1075
2020-10-13,1642,1783,-141,-7.91,1075
2020-10-14,1642,1781,-139,-7.8,1075
2020-10-15,1642,1779,-137,-7.7,1075
2020-10-16,1339,1628,-289,-17.75,1075
2020-10-17,482,751,-269,-35.82,1075
2020-10-18,246,470,-224,-47.66,1075
2020-10-19,1688,1738,-50,-2.88,1075
2020-10-20,1642,1759,-117,-6.65,1075
2020-10-21,1642,1756,-114,-6.49,1075
2020-10-22,1642,1752,-110,-6.28,1075
2020-10-23,1339,1600,-261,-16.31,1075
2020-10-24,482,723,-241,-33.33,1075
2020-10-25,246,442,-196,-44.34,1075
2020-10-26,1688,1711,-23,-1.34,1075
2020-10-27,1642,1733,-91,-5.25,1075
2020-10-28,1642,1731,-89,-5.14,1075
2020-10-29,1642,1729,-87,-5.03,1075
2020-10-30,1339,1580,-241,-15.25,1075
2020-10-31,482,705,-223,-31.63,1075
2020-11-01,219,427,-208,-48.71,1075
2020-11-02,1343,1698,-355,-20.91,1075
2020-11-03,1286,1722,-436,-25.32,1075
2020-11-04,1286,1723,-437,-25.36,1075
2020-11-05,1286,1723,-437,-25.36,1075
2020-11-06,1074,1575,-501,-31.81,1075
2020-11-07,373,702,-329,-46.87,1075
2020-11-08,219,424,-205,-48.35,1075
2020-11-09,1343,1696,-353,-20.81,1075
2020-11-10,1286,1720,-434,-25.23,1075
2020-11-11,1286,1720,-434,-25.23,1075
2020-11-12,1286,1719,-433,-25.19,1075
2020-11-13,1074,1570,-496,-31.59,1075
2020-11-14,373,694,-321,-46.25,1075
2020-11-15,219,414,-195,-47.1,1075
2020-11-16,1343,1683,-340,-20.2,1075
2020-11-17,1286,1705,-419,-24.57,1075
2020-11-18,1286,1701,-415,-24.4,1075
2020-11-19,1286,1697,-411,-24.22,1075
2020-11-20,1074,1545,-471,-30.49,1075
2020-11-21,373,666,-293,-43.99,1075
2020-11-22,219,384,-165,-42.97,1075
2020-11-23,1343,1650,-307,-18.61,1075
2020-11-24,1286,1669,-383,-22.95,1075
2020-11-25,1286,1665,-379,-22.76,1075
2020-11-26,1286,1659,-373,-22.48,1075
2020-11-27,1074,1507,-433,-28.73,1075
2020-11-28,373,629,-256,-40.7,1075
2020-11-29,219,347,-128,-36.89,1075
2020-11-30,1343,1615,-272,-16.84,1075
2020-12-01,1167,1637,-470,-28.71,1075
2020-12-02,1167,1635,-468,-28.62,1075
2020-12-03,1167,1632,-465,-28.49,1075
2020-12-04,1253,1483,-230,-15.51,1075
2020-12-05,422,608,-186,-30.59,1075
2020-12-06,205,330,-125,-37.88,1075
2020-12-07,1083,1602,-519,-32.4,1075
2020-12-08,1167,1626,-459,-28.23,1075
2020-12-09,1167,1627,-460,-28.27,1075
2020-12-10,1167,1627,-460,-28.27,1075
2020-12-11,1253,1480,-227,-15.34,1075
2020-12-12,422,607,-185,-30.48,1075
2020-12-13,205,329,-124,-37.69,1075
2020-12-14,1083,1600,-517,-32.31,1075
2020-12-15,1167,1624,-457,-28.14,1075
2020-12-16,1167,1623,-456,-28.1,1075
2020-12-17,1167,1620,-453,-27.96,1075
2020-12-18,1253,1468,-215,-14.65,1075
2020-12-19,422,590,-168,-28.47,1075
2020-12-20,205,307,-102,-33.22,1075
2020-12-21,1083,1572,-489,-31.11,1075
2020-12-22,1167,1589,-422,-26.56,1075
2020-12-23,1167,1581,-414,-26.19,1075
2020-12-24,1167,1571,-404,-25.72,1075
2020-12-25,1253,1412,-159,-11.26,1075
2020-12-26,422,527,-105,-19.92,1075
2020-12-27,205,236,-31,-13.14,1075
2020-12-28,1083,1494,-411,-27.51,1075
2020-12-29,1167,1505,-338,-22.46,1075
2020-12-30,1167,1492,-325,-21.78,1075
2020-12-31,1167,1477,-310,-20.99,1075
2021-01-01,915,1314,-399,-30.37,1075
2021-01-02,330,426,-96,-22.54,1075
2021-01-03,181,135,46,34.07,1075
2021-01-04,956,1393,-437,-31.37,1075
2021-01-05,1030,1405,-375,-26.69,1075
2021-01-06,1030,1394,-364,-26.11,1075
2021-01-07,1030,1382,-352,-25.47,1075
2021-01-08,915,1225,-310,-25.31,1075
2021-01-09,330,343,-13,-3.79,1075
2021-01-10,181,58,123,212.07,1075
2021-01-11,956,1324,-368,-27.79,1075
2021-01-12,1030,1344,-314,-23.36,1075
2021-01-13,1030,1342,-312,-23.25,1075
2021-01-14,1030,1339,-309,-23.08,1075
2021-01-15,915,1191,-276,-23.17,1075
2021-01-16,330,319,11,3.45,1075
2021-01-17,181,43,138,320.93,1075
2021-01-18,956,1317,-361,-27.41,1075
2021-01-19,1030,1346,-316,-23.48,1075
2021-01-20,1030,1351,-321,-23.76,1075
2021-01-21,1030,1355,-325,-23.99,1075
2021-01-22,915,1213,-298,-24.57,1075
2021-01-23,330,345,-15,-4.35,1075
2021-01-24,181,73,108,147.95,1075
2021-01-25,956,1350,-394,-29.19,1075
2021-01-26,1030,1380,-350,-25.36,1075
2021-01-27,1030,1386,-356,-25.69,1075
2021-01-28,1030,1390,-360,-25.9,1075
2021-01-29,915,1247,-332,-26.62,1075
2021-01-30,330,377,-47,-12.47,1075
2021-01-31,181,103,78,75.73,1075
2021-02-01,1274,1377,-103,-7.48,1075
2021-02-02,1279,1404,-125,-8.9,1075
2021-02-03,1279,1406,-127,-9.03,1075
2021-02-04,1279,1407,-128,-9.1,1075
2021-02-05,1070,1260,-190,-15.08,1075
2021-02-06,368,387,-19,-4.91,1075
2021-02-07,208,110,98,89.09,1075
2021-02-08,1274,1382,-108,-7.81,1075
2021-02-09,1279,1408,-129,-9.16,1075
2021-02-10,1279,1409,-130,-9.23,1075
2021-02-11,1279,1410,-131,-9.29,1075
2021-02-12,1070,1264,-194,-15.35,1075
2021-02-13,368,392,-24,-6.12,1075
2021-02-14,208,118,90,76.27,1075
2021-02-15,1274,1393,-119,-8.54,1075
2021-02-16,1279,1422,-143,-10.06,1075
2021-02-17,1279,1427,-148,-10.37,1075
2021-02-18,1279,1433,-154,-10.75,1075
2021-02-19,1070,1292,-222,-17.18,1075
2021-02-20,368,426,-58,-13.62,1075
2021-02-21,208,157,51,32.48,1075
2021-02-22,1274,1437,-163,-11.34,1075
2021-02-23,1279,1472,-193,-13.11,1075
2021-02-24,1279,1482,-203,-13.7,1075
2021-02-25,1279,1493,-214,-14.33,1075
2021-02-26,1070,1356,-286,-21.09,1075
2021-02-27,368,493,-125,-25.35,1075
2021-02-28,208,227,-19,-8.37,1075
2021-03-01,1458,1509,-51,-3.38,1075
2021-03-02,1439,1545,-106,-6.86,1075
2021-03-03,1439,1556,-117,-7.52,1075
2021-03-04,1439,1565,-126,-8.05,1075
2021-03-05,1221,1427,-206,-14.44,1075
2021-03-06,406,562,-156,-27.76,1075
2021-03-07,217,293,-76,-25.94,1075
2021-03-08,1458,1572,-114,-7.25,1075
2021-03-09,1439,1604,-165,-10.29,1075
2021-03-10,1439,1610,-171,-10.62,1075
2021-03-11,1439,1615,-176,-10.9,1075
2021-03-12,1221,1472,-251,-17.05,1075
2021-03-13,406,603,-197,-32.67,1075
2021-03-14,217,329,-112,-34.04,1075
2021-03-15,1458,1603,-145,-9.05,1075
2021-03-16,1439,1630,-191,-11.72,1075
2021-03-17,1439,1633,-194,-11.88,1075
2021-03-18,1439,1635,-196,-11.99,1075
2021-03-19,1221,1489,-268,-18.0,1075
2021-03-20,406,617,-211,-34.2,1075
2021-03-21,217,342,-125,-36.55,1075
2021-03-22,1458,1616,-158,-9.78,1075
2021-03-23,1439,1643,-204,-12.42,1075
2021-03-24,1439,1646,-207,-12.58,1075
2021-03-25,1439,1649,-210,-12.73,1075
2021-03-26,1221,1505,-284,-18.87,1075
2021-03-27,406,635,-229,-36.06,1075
2021-03-28,217,362,-145,-40.06,1075
2021-03-29,1458,1638,-180,-10.99,1075
2021-03-30,1439,1668,-229,-13.73,1075
2021-03-31,1439,1675,-236,-14.09,1075
2021-04-01,1398,1680,-282,-16.79,1075
2021-04-02,1104,1539,-435,-28.27,1075
2021-04-03,389,671,-282,-42.03,1075
2021-04-04,198,401,-203,-50.62,1075
2021-04-05,1483,1679,-196,-11.67,1075
2021-04-06,1398,1710,-312,-18.25,1075
2021-04-07,1398,1717,-319,-18.58,1075
2021-04-08,1398,1723,-325,-18.86,1075
2021-04-09,1104,1582,-478,-30.21,1075
2021-04-10,389,714,-325,-45.52,1075
2021-04-11,198,442,-244,-55.2,1075
2021-04-12,1483,1719,-236,-13.73,1075
2021-04-13,1398,1748,-350,-20.02,1075
2021-04-14,1398,1753,-355,-20.25,1075
2021-04-15,1398,1757,-359,-20.43,1075
2021-04-16,1104,1613,-509,-31.56,1075
2021-04-17,389,742,-353,-47.57,1075
2021-04-18,198,468,-270,-57.69,1075
2021-04-19,1483,1742,-259,-14.87,1075
2021-04-20,1398,1769,-371,-20.97,1075
2021-04-21,1398,1772,-374,-21.11,1075
2021-04-22,1398,1774,-376,-21.2,1075
2021-04-23,1104,1628,-524,-32.19,1075
2021-04-24,389,757,-368,-48.61,1075
2021-04-25,198,482,-284,-58.92,1075
2021-04-26,1483,1756,-273,-15.55,1075
2021-04-27,1398,1783,-385,-21.59,1075
2021-04-28,1398,1787,-389,-21.77,1075
2021-04-29,1398,1790,-392,-21.9,1075
2021-04-30,1104,1646,-542,-32.93,1075
2021-05-01,455,776,-321,-41.37,1075
2021-05-02,240,503,-263,-52.29,1075
2021-05-03,1813,1779,34,1.91,1075
2021-05-04,1771,1808,-37,-2.05,1075
2021-05-05,1771,1814,-43,-2.37,1075
2021-05-06,1771,1818,-47,-2.59,1075
2021-05-07,1363,1676,-313,-18.68,1075
2021-05-08,455,807,-352,-43.62,1075
2021-05-09,240,535,-295,-55.14,1075
2021-05-10,1813,1811,2,0.11,1075
2021-05-11,1771,1841,-70,-3.8,1075
2021-05-12,1771,1846,-75,-4.06,1075
2021-05-13,1771,1849,-78,-4.22,1075
2021-05-14,1363,1705,-342,-20.06,1075
2021-05-15,455,835,-380,-45.51,1075
2021-05-16,240,560,-320,-57.14,1075
2021-05-17,1813,1834,-21,-1.15,1075
2021-05-18,1771,1860,-89,-4.78,1075
2021-05-19,1771,1861,-90,-4.84,1075
2021-05-20,1771,1861,-90,-4.84,1075
2021-05-21,1363,1714,-351,-20.48,1075
2021-05-22,455,840,-385,-45.83,1075
2021-05-23,240,561,-321,-57.22,1075
2021-05-24,1813,1832,-19,-1.04,1075
2021-05-25,1771,1855,-84,-4.53,1075
2021-05-26,1771,1854,-83,-4.48,1075
2021-05-27,1771,1852,-81,-4.37,1075
2021-05-28,1363,1702,-339,-19.92,1075
2021-05-29,455,827,-372,-44.98,1075
2021-05-30,240,548,-308,-56.2,1075
2021-05-31,1813,1818,-5,-0.28,1075
2021-06-01,1807,1842,-35,-1.9,1075
2021-06-02,1807,1842,-35,-1.9,1075
2021-06-03,1807,1841,-34,-1.85,1075
2021-06-04,1460,1693,-233,-13.76,1075
2021-06-05,577,820,-243,-29.63,1075
2021-06-06,319,543,-224,-41.25,1075
2021-06-07,1856,1816,40,2.2,1075
2021-06-08,1807,1842,-35,-1.9,1075
2021-06-09,1807,1844,-37,-2.01,1075
2021-06-10,1807,1845,-38,-2.06,1075
2021-06-11,1460,1700,-240,-14.12,1075
2021-06-12,577,828,-251,-30.31,1075
2021-06-13,319,552,-233,-42.21,1075
2021-06-14,1856,1825,31,1.7,1075
2021-06-15,1807,1851,-44,-2.38,1075
2021-06-16,1807,1853,-46,-2.48,1075
2021-06-17,1807,1853,-46,-2.48,1075
2021-06-18,1460,1705,-245,-14.37,1075
2021-06-19,577,830,-253,-30.48,1075
2021-06-20,319,551,-232,-42.11,1075
2021-06-21,1856,1821,35,1.92,1075
2021-06-22,1807,1843,-36,-1.95,1075
2021-06-23,1807,1840,-33,-1.79,1075
2021-06-24,1807,1835,-28,-1.53,1075
2021-06-25,1460,1682,-222,-13.2,1075
2021-06-26,577,803,-226,-28.14,1075
2021-06-27,319,519,-200,-38.54,1075
2021-06-28,1856,1784,72,4.04,1075
2021-06-29,1807,1801,6,0.33,1075
2021-06-30,1807,1794,13,0.72,1075
2021-07-01,1685,1786,-101,-5.66,1075
2021-07-02,1402,1631,-229,-14.04,1075
2021-07-03,518,750,-232,-30.93,1075
2021-07-04,314,465,-151,-32.47,1075
2021-07-05,1613,1729,-116,-6.71,1075
2021-07-06,1685,1747,-62,-3.55,1075
2021-07-07,1685,1742,-57,-3.27,1075
2021-07-08,1685,1736,-51,-2.94,1075
2021-07-09,1402,1583,-181,-11.43,1075
2021-07-10,518,706,-188,-26.63,1075
2021-07-11,314,425,-111,-26.12,1075
2021-07-12,1613,1694,-81,-4.78,1075
2021-07-13,1685,1717,-32,-1.86,1075
2021-07-14,1685,1717,-32,-1.86,1075
2021-07-15,1685,1716,-31,-1.81,1075
2021-07-16,1402,1569,-167,-10.64,1075
2021-07-17,518,696,-178,-25.57,1075
2021-07-18,314,420,-106,-25.24,1075
2021-07-19,1613,1694,-81,-4.78,1075
2021-07-20,1685,1721,-36,-2.09,1075
2021-07-21,1685,1724,-39,-2.26,1075
2021-07-22,1685,1725,-40,-2.32,1075
2021-07-23,1402,1580,-178,-11.27,1075
2021-07-24,518,708,-190,-26.84,1075
2021-07-25,314,432,-118,-27.31,1075
2021-07-26,1613,1704,-91,-5.34,1075
2021-07-27,1685,1729,-44,-2.54,1075
2021-07-28,1685,1730,-45,-2.6,1075
2021-07-29,1685,1729,-44,-2.54,1075
2021-07-30,1402,1579,-177,-11.21,1075
2021-07-31,518,703,-185,-26.32,1075
2021-08-01,329,423,-94,-22.22,1075
2021-08-02,1510,1691,-181,-10.7,1075
2021-08-03,1525,1712,-187,-10.92,1075
2021-08-04,1525,1708,-183,-10.71,1075
2021-08-05,1525,1702,-177,-10.4,1075
2021-08-06,1292,1549,-257,-16.59,1075
2021-08-07,548,670,-122,-18.21,1075
2021-08-08,329,387,-58,-14.99,1075
2021-08-09,1510,1653,-143,-8.65,1075
2021-08-10,1525,1673,-148,-8.85,1075
2021-08-11,1525,1669,-144,-8.63,1075
2021-08-12,1525,1664,-139,-8.35,1075
2021-08-13,1292,1513,-221,-14.61,1075
2021-08-14,548,637,-89,-13.97,1075
2021-08-15,329,358,-29,-8.1,1075
2021-08-16,1510,1628,-118,-7.25,1075
2021-08-17,1525,1653,-128,-7.74,1075
2021-08-18,1525,1655,-130,-7.85,1075
2021-08-19,1525,1656,-131,-7.91,1075
2021-08-20,1292,1511,-219,-14.49,1075
2021-08-21,548,642,-94,-14.64,1075
2021-08-22,329,369,-40,-10.84,1075
2021-08-23,1510,1647,-137,-8.32,1075
2021-08-24,1525,1678,-153,-9.12,1075
2021-08-25,1525,1685,-160,-9.5,1075
2021-08-26,1525,1692,-167,-9.87,1075
2021-08-27,1292,1553,-261,-16.81,1075
2021-08-28,548,687,-139,-20.23,1075
2021-08-29,329,418,-89,-21.29,1075
2021-08-30,1510,1697,-187,-11.02,1075
2021-08-31,1525,1730,-205,-11.85,1075
2021-09-01,1693,1738,-45,-2.59,1075
2021-09-02,1693,1745,-52,-2.98,1075
2021-09-03,1452,1603,-151,-9.42,1075
2021-09-04,572,736,-164,-22.28,1075
2021-09-05,356,463,-107,-23.11,1075
2021-09-06,1808,1739,69,3.97,1075
2021-09-07,1693,1767,-74,-4.19,1075
2021-09-08,1693,1770,-77,-4.35,1075
2021-09-09,1693,1772,-79,-4.46,1075
2021-09-10,1452,1625,-173,-10.65,1075
2021-09-11,572,752,-180,-23.94,1075
2021-09-12,356,474,-118,-24.89,1075
2021-09-13,1808,1745,63,3.61,1075
2021-09-14,1693,1768,-75,-4.24,1075
2021-09-15,1693,1767,-74,-4.19,1075
2021-09-16,1693,1764,-71,-4.02,1075
2021-09-17,1452,1614,-162,-10.04,1075
2021-09-18,572,739,-167,-22.6,1075
2021-09-19,356,459,-103,-22.44,1075
2021-09-20,1808,1728,80,4.63,1075
2021-09-21,1693,1751,-58,-3.31,1075
2021-09-22,1693,1750,-57,-3.26,1075
2021-09-23,1693,1748,-55,-3.15,1075
2021-09-24,1452,1599,-147,-9.19,1075
2021-09-25,572,725,-153,-21.1,1075
2021-09-26,356,447,-91,-20.36,1075
2021-09-27,1808,1719,89,5.18,1075
2021-09-28,1693,1744,-51,-2.92,1075
2021-09-29,1693,1745,-52,-2.98,1075
2021-09-30,1693,1746,-53,-3.04,1075
2021-10-01,1476,1599,-123,-7.69,1075
2021-10-02,573,727,-154,-21.18,1075
2021-10-03,302,451,-149,-33.04,1075
2021-10-04,1563,1724,-161,-9.34,1075
2021-10-05,1728,1750,-22,-1.26,1075
2021-10-06,1728,1752,-24,-1.37,1075
2021-10-07,1728,1753,-25,-1.43,1075
2021-10-08,1476,1606,-130,-8.09,1075
2021-10-09,573,733,-160,-21.83,1075
2021-10-10,302,455,-153,-33.63,1075
2021-10-11,1563,1726,-163,-9.44,1075
2021-10-12,1728,1750,-22,-1.26,1075
2021-10-13,1728,1749,-21,-1.2,1075
2021-10-14,1728,1747,-19,-1.09,1075
2021-10-15,1476,1597,-121,-7.58,1075
2021-10-16,573,720,-147,-20.42,1075
2021-10-17,302,440,-138,-31.36,1075
2021-10-18,1563,1708,-145,-8.49,1075
2021-10-19,1728,1729,-1,-0.06,1075
2021-10-20,1728,1726,2,0.12,1075
2021-10-21,1728,1722,6,0.35,1075
2021-10-22,1476,1570,-94,-5.99,1075
2021-10-23,573,693,-120,-17.32,1075
2021-10-24,302,412,-110,-26.7,1075
2021-10-25,1563,1680,-117,-6.96,1075
2021-10-26,1728,1701,27,1.59,1075
2021-10-27,1728,1699,29,1.71,1075
2021-10-28,1728,1697,31,1.83,1075
2021-10-29,1476,1547,-71,-4.59,1075
2021-10-30,573,672,-99,-14.73,1075
2021-10-31,302,393,-91,-23.16,1075
2021-11-01,1475,1664,-189,-11.36,1075
2021-11-02,1592,1688,-96,-5.69,1075
2021-11-03,1592,1688,-96,-5.69,1075
2021-11-04,1592,1688,-96,-5.69,1075
2021-11-05,1294,1540,-246,-15.97,1075
2021-11-06,445,667,-222,-33.28,1075
2021-11-07,272,389,-117,-30.08,1075
2021-11-08,1475,1661,-186,-11.2,1075
2021-11-09,1592,1686,-94,-5.58,1075
2021-11-10,1592,1686,-94,-5.58,1075
2021-11-11,1592,1685,-93,-5.52,1075
2021-11-12,1294,1537,-243,-15.81,1075
2021-11-13,445,662,-217,-32.78,1075
2021-11-14,272,383,-111,-28.98,1075
2021-11-15,1475,1652,-177,-10.71,1075
2021-11-16,1592,1674,-82,-4.9,1075
2021-11-17,1592,1671,-79,-4.73,1075
2021-11-18,1592,1667,-75,-4.5,1075
2021-11-19,1294,1515,-221,-14.59,1075
2021-11-20,445,637,-192,-30.14,1075
2021-11-21,272,355,-83,-23.38,1075
2021-11-22,1475,1622,-147,-9.06,1075
2021-11-23,1592,1641,-49,-2.99,1075
2021-11-24,1592,1637,-45,-2.75,1075
2021-11-25,1592,1631,-39,-2.39,1075
2021-11-26,1294,1478,-184,-12.45,1075
2021-11-27,445,600,-155,-25.83,1075
2021-11-28,272,318,-46,-14.47,1075
2021-11-29,1475,1585,-110,-6.94,1075
2021-11-30,1592,1606,-14,-0.87,1075
2021-12-01,1107,1603,-496,-30.94,1075
2021-12-02,1107,1600,-493,-30.81,1075
2021-12-03,861,1450,-589,-40.62,1075
2021-12-04,400,575,-175,-30.43,1075
2021-12-05,216,296,-80,-27.03,1075
2021-12-06,1256,1567,-311,-19.85,1075
2021-12-07,1107,1592,-485,-30.46,1075
2021-12-08,1107,1592,-485,-30.46,1075
2021-12-09,1107,1592,-485,-30.46,1075
2021-12-10,861,1445,-584,-40.42,1075
2021-12-11,400,572,-172,-30.07,1075
2021-12-12,216,294,-78,-26.53,1075
2021-12-13,1256,1566,-310,-19.8,1075
2021-12-14,1107,1590,-483,-30.38,1075
2021-12-15,1107,1590,-483,-30.38,1075
2021-12-16,1107,1588,-481,-30.29,1075
2021-12-17,861,1438,-577,-40.13,1075
2021-12-18,400,561,-161,-28.7,1075
2021-12-19,216,279,-63,-22.58,1075
2021-12-20,1256,1546,-290,-18.76,1075
2021-12-21,1107,1564,-457,-29.22,1075
2021-12-22,1107,1557,-450,-28.9,1075
2021-12-23,1107,1548,-441,-28.49,1075
2021-12-24,861,1391,-530,-38.1,1075
2021-12-25,400,506,-106,-20.95,1075
2021-12-26,216,217,-1,-0.46,1075
2021-12-27,1256,1476,-220,-14.91,1075
2021-12-28,1107,1488,-381,-25.6,1075
2021-12-29,1107,1475,-368,-24.95,1075
2021-12-30,1107,1460,-353,-24.18,1075
2021-12-31,861,1298,-437,-33.67,1075
2022-01-01,367,410,-43,-10.49,1075
2022-01-02,191,118,73,61.86,1075
2022-01-03,1118,1375,-257,-18.69,1075
2022-01-04,1074,1386,-312,-22.51,1075
2022-01-05,1074,1374,-300,-21.83,1075
2022-01-06,1074,1361,-287,-21.09,1075
2022-01-07,960,1202,-242,-20.13,1075
2022-01-08,367,319,48,15.05,1075
2022-01-09,191,33,158,478.79,1075
2022-01-10,1118,1297,-179,-13.8,1075
2022-01-11,1074,1315,-241,-18.33,1075
2022-01-12,1074,1311,-237,-18.08,1075
2022-01-13,1074,1307,-233,-17.83,1075
2022-01-14,960,1157,-197,-17.03,1075
2022-01-15,367,283,84,29.68,1075
2022-01-16,191,6,185,3083.33,1075
2022-01-17,1118,1279,-161,-12.59,1075
2022-01-18,1074,1306,-232,-17.76,1075
2022-01-19,1074,1311,-237,-18.08,1075
2022-01-20,1074,1314,-240,-18.26,1075
2022-01-21,960,1171,-211,-18.02,1075
2022-01-22,367,303,64,21.12,1075
2022-01-23,191,31,160,516.13,1075
2022-01-24,1118,1308,-190,-14.53,1075
2022-01-25,1074,1339,-265,-19.79,1075
2022-01-26,1074,1345,-271,-20.15,1075
2022-01-27,1074,1350,-276,-20.44,1075
2022-01-28,960,1207,-247,-20.46,1075
2022-01-29,367,338,29,8.58,1075
2022-01-30,191,64,127,198.44,1075
2020-02-01,117,101,16,15.84,1195
2020-02-02,25,22,3,13.64,1195
2020-02-03,303,265,38,14.34,1195
2020-02-04,308,276,32,11.59,1195
2020-02-05,308,277,31,11.19,1195
2020-02-06,308,277,31,11.19,1195
2020-02-07,288,253,35,13.83,1195
2020-02-08,117,106,11,10.38,1195
2020-02-09,25,26,-1,-3.85,1195
2020-02-10,303,269,34,12.64,1195
2020-02-11,308,279,29,10.39,1195
2020-02-12,308,280,28,10.0,1195
2020-02-13,308,280,28,10.0,1195
2020-02-14,288,257,31,12.06,1195
2020-02-15,117,109,8,7.34,1195
2020-02-16,25,29,-4,-13.79,1195
2020-02-17,303,273,30,10.99,1195
2020-02-18,308,283,25,8.83,1195
2020-02-19,308,285,23,8.07,1195
2020-02-20,308,285,23,8.07,1195
2020-02-21,288,262,26,9.92,1195
2020-02-22,117,115,2,1.74,1195
2020-02-23,25,36,-11,-30.56,1195
2020-02-24,303,280,23,8.21,1195
2020-02-25,308,291,17,5.84,1195
2020-02-26,308,292,16,5.48,1195
2020-02-27,308,293,15,5.12,1195
2020-02-28,288,271,17,6.27,1195
2020-02-29,117,124,-7,-5.65,1195
2020-03-01,32,45,-13,-28.89,1195
2020-03-02,267,289,-22,-7.61,1195
2020-03-03,271,300,-29,-9.67,1195
2020-03-04,271,301,-30,-9.97,1195
2020-03-05,271,302,-31,-10.26,1195
2020-03-06,260,279,-19,-6.81,1195
2020-03-07,103,132,-29,-21.97,1195
2020-03-08,32,53,-21,-39.62,1195
2020-03-09,267,297,-30,-10.1,1195
2020-03-10,271,307,-36,-11.73,1195
2020-03-11,271,308,-37,-12.01,1195
2020-03-12,271,308,-37,-12.01,1195
2020-03-13,260,284,-24,-8.45,1195
2020-03-14,103,137,-34,-24.82,1195
2020-03-15,32,57,-25,-43.86,1195
2020-03-16,267,300,-33,-11.0,1195
2020-03-17,271,310,-39,-12.58,1195
2020-03-18,271,311,-40,-12.86,1195
2020-03-19,271,311,-40,-12.86,1195
2020-03-20,260,287,-27,-9.41,1195
2020-03-21,103,140,-37,-26.43,1195
2020-03-22,32,60,-28,-46.67,1195
2020-03-23,267,304,-37,-12.17,1195
2020-03-24,271,314,-43,-13.69,1195
2020-03-25,271,315,-44,-13.97,1195
2020-03-26,271,315,-44,-13.97,1195
2020-03-27,260,292,-32,-10.96,1195
2020-03-28,103,145,-42,-28.97,1195
2020-03-29,32,66,-34,-51.52,1195
2020-03-30,267,310,-43,-13.87,1195
2020-03-31,271,321,-50,-15.58,1195
2020-04-01,306,322,-16,-4.97,1195
2020-04-02,306,323,-17,-5.26,1195
2020-04-03,296,300,-4,-1.33,1195
2020-04-04,85,153,-68,-44.44,1195
2020-04-05,24,74,-50,-67.57,1195
2020-04-06,318,319,-1,-0.31,1195
2020-04-07,306,330,-24,-7.27,1195
2020-04-08,306,331,-25,-7.55,1195
2020-04-09,306,332,-26,-7.83,1195
2020-04-10,296,309,-13,-4.21,1195
2020-04-11,85,162,-77,-47.53,1195
2020-04-12,24,82,-58,-70.73,1195
2020-04-13,318,326,-8,-2.45,1195
2020-04-14,306,336,-30,-8.93,1195
2020-04-15,306,337,-31,-9.2,1195
2020-04-16,306,338,-32,-9.47,1195
2020-04-17,296,314,-18,-5.73,1195
2020-04-18,85,166,-81,-48.8,1195
2020-04-19,24,86,-62,-72.09,1195
2020-04-20,318,329,-11,-3.34,1195
2020-04-21,306,338,-32,-9.47,1195
2020-04-22,306,339,-33,-9.73,1195
2020-04-23,306,338,-32,-9.47,1195
2020-04-24,296,314,-18,-5.73,1195
2020-04-25,85,165,-80,-48.48,1195
2020-04-26,24,85,-61,-71.76,1195
2020-04-27,318,328,-10,-3.05,1195
2020-04-28,306,337,-31,-9.2,1195
2020-04-29,306,337,-31,-9.2,1195
2020-04-30,306,336,-30,-8.93,1195
2020-05-01,364,312,52,16.67,1195
2020-05-02,139,164,-25,-15.24,1195
2020-05-03,41,83,-42,-50.6,1195
2020-05-04,384,326,58,17.79,1195
2020-05-05,379,336,43,12.8,1195
2020-05-06,379,336,43,12.8,1195
2020-05-07,379,336,43,12.8,1195
2020-05-08,364,312,52,16.67,1195
2020-05-09,139,164,-25,-15.24,1195
2020-05-10,41,84,-43,-51.19,1195
2020-05-11,384,327,57,17.43,1195
2020-05-12,379,337,42,12.46,1195
2020-05-13,379,337,42,12.46,1195
2020-05-14,379,337,42,12.46,1195
2020-05-15,364,313,51,16.29,1195
2020-05-16,139,166,-27,-16.27,1195
2020-05-17,41,86,-45,-52.33,1195
2020-05-18,384,329,55,16.72,1195
2020-05-19,379,339,40,11.8,1195
2020-05-20,379,340,39,11.47,1195
2020-05-21,379,340,39,11.47,1195
2020-05-22,364,316,48,15.19,1195
2020-05-23,139,168,-29,-17.26,1195
2020-05-24,41,88,-47,-53.41,1195
2020-05-25,384,332,52,15.66,1195
2020-05-26,379,342,37,10.82,1195
2020-05-27,379,343,36,10.5,1195
2020-05-28,379,343,36,10.5,1195
2020-05-29,364,319,45,14.11,1195
2020-05-30,139,172,-33,-19.19,1195
2020-05-31,41,92,-51,-55.43,1195
2020-06-01,371,336,35,10.42,1195
2020-06-02,406,346,60,17.34,1195
2020-06-03,406,347,59,17.0,1195
2020-06-04,406,347,59,17.0,1195
2020-06-05,356,324,32,9.88,1195
2020-06-06,160,176,-16,-9.09,1195
2020-06-07,42,97,-55,-56.7,1195
2020-06-08,371,340,31,9.12,1195
2020-06-09,406,351,55,15.67,1195
2020-06-10,406,351,55,15.67,1195
2020-06-11,406,352,54,15.34,1195
2020-06-12,356,328,28,8.54,1195
2020-06-13,160,180,-20,-11.11,1195
2020-06-14,42,100,-58,-58.0,1195
2020-06-15,371,344,27,7.85,1195
2020-06-16,406,353,53,15.01,1195
2020-06-17,406,354,52,14.69,1195
2020-06-18,406,353,53,15.01,1195
2020-06-19,356,329,27,8.21,1195
2020-06-20,160,181,-21,-11.6,1195
2020-06-21,42,100,-58,-58.0,1195
2020-06-22,371,343,28,8.16,1195
2020-06-23,406,351,55,15.67,1195
2020-06-24,406,351,55,15.67,1195
2020-06-25,406,350,56,16.0,1195
2020-06-26,356,325,31,9.54,1195
2020-06-27,160,176,-16,-9.09,1195
2020-06-28,42,95,-53,-55.79,1195
2020-06-29,371,337,34,10.09,1195
2020-06-30,406,345,61,17.68,1195
2020-07-01,384,345,39,11.3,1195
2020-07-02,384,344,40,11.63,1195
2020-07-03,353,318,35,11.01,1195
2020-07-04,140,170,-30,-17.65,1195
2020-07-05,82,88,-6,-6.82,1195
2020-07-06,371,331,40,12.08,1195
2020-07-07,384,340,44,12.94,1195
2020-07-08,384,340,44,12.94,1195
2020-07-09,384,339,45,13.27,1195
2020-07-10,353,315,38,12.06,1195
2020-07-11,140,166,-26,-15.66,1195
2020-07-12,82,86,-4,-4.65,1195
2020-07-13,371,329,42,12.77,1195
2020-07-14,384,338,46,13.61,1195
2020-07-15,384,339,45,13.27,1195
2020-07-16,384,339,45,13.27,1195
2020-07-17,353,315,38,12.06,1195
2020-07-18,140,167,-27,-16.17,1195
2020-07-19,82,86,-4,-4.65,1195
2020-07-20,371,329,42,12.77,1195
2020-07-21,384,339,45,13.27,1195
2020-07-22,384,339,45,13.27,1195
2020-07-23,384,339,45,13.27,1195
2020-07-24,353,314,39,12.42,1195
2020-07-25,140,166,-26,-15.66,1195
2020-07-26,82,85,-3,-3.53,1195
2020-07-27,371,327,44,13.46,1195
2020-07-28,384,336,48,14.29,1195
2020-07-29,384,335,49,14.63,1195
2020-07-30,384,334,50,14.97,1195
2020-07-31,353,308,45,14.61,1195
2020-08-01,149,159,-10,-6.29,1195
2020-08-02,87,77,10,12.99,1195
2020-08-03,329,319,10,3.13,1195
2020-08-04,338,327,11,3.36,1195
2020-08-05,338,326,12,3.68,1195
2020-08-06,338,324,14,4.32,1195
2020-08-07,316,299,17,5.69,1195
2020-08-08,149,149,0,0.0,1195
2020-08-09,87,68,19,27.94,1195
2020-08-10,329,309,20,6.47,1195
2020-08-11,338,318,20,6.29,1195
2020-08-12,338,317,21,6.62,1195
2020-08-13,338,316,22,6.96,1195
2020-08-14,316,292,24,8.22,1195
2020-08-15,149,143,6,4.2,1195
2020-08-16,87,63,24,38.1,1195
2020-08-17,329,306,23,7.52,1195
2020-08-18,338,316,22,6.96,1195
2020-08-19,338,317,21,6.62,1195
2020-08-20,338,317,21,6.62,1195
2020-08-21,316,294,22,7.48,1195
2020-08-22,149,147,2,1.36,1195
2020-08-23,87,68,19,27.94,1195
2020-08-24,329,312,17,5.45,1195
2020-08-25,338,323,15,4.64,1195
2020-08-26,338,325,13,4.0,1195
2020-08-27,338,326,12,3.68,1195
2020-08-28,316,303,13,4.29,1195
2020-08-29,149,156,-7,-4.49,1195
2020-08-30,87,77,10,12.99,1195
2020-08-31,329,322,7,2.17,1195
2020-09-01,380,332,48,14.46,1195
2020-09-02,380,334,46,13.77,1195
2020-09-03,380,334,46,13.77,1195
2020-09-04,344,311,33,10.61,1195
2020-09-05,152,164,-12,-7.32,1195
2020-09-06,83,84,-1,-1.19,1195
2020-09-07,364,327,37,11.31,1195
2020-09-08,380,337,43,12.76,1195
2020-09-09,380,338,42,12.43,1195
2020-09-10,380,337,43,12.76,1195
2020-09-11,344,313,31,9.9,1195
2020-09-12,152,165,-13,-7.88,1195
2020-09-13,83,84,-1,-1.19,1195
2020-09-14,364,327,37,11.31,1195
2020-09-15,380,336,44,13.1,1195
2020-09-16,380,337,43,12.76,1195
2020-09-17,380,336,44,13.1,1195
2020-09-18,344,312,32,10.26,1195
2020-09-19,152,163,-11,-6.75,1195
2020-09-20,83,83,0,0.0,1195
2020-09-21,364,326,38,11.66,1195
2020-09-22,380,336,44,13.1,1195
2020-09-23,380,336,44,13.1,1195
2020-09-24,380,336,44,13.1,1195
2020-09-25,344,313,31,9.9,1195
2020-09-26,152,165,-13,-7.88,1195
2020-09-27,83,85,-2,-2.35,1195
2020-09-28,364,329,35,10.64,1195
2020-09-29,380,339,41,12.09,1195
2020-09-30,380,340,40,11.76,1195
2020-10-01,361,341,20,5.87,1195
2020-10-02,341,317,24,7.57,1195
2020-10-03,148,170,-22,-12.94,1195
2020-10-04,81,91,-10,-10.99,1195
2020-10-05,365,335,30,8.96,1195
2020-10-06,361,345,16,4.64,1195
2020-10-07,361,346,15,4.34,1195
2020-10-08,361,346,15,4.34,1195
2020-10-09,341,322,19,5.9,1195
2020-10-10,148,174,-26,-14.94,1195
2020-10-11,81,94,-13,-13.83,1195
2020-10-12,365,337,28,8.31,1195
2020-10-13,361,347,14,4.03,1195
2020-10-14,361,347,14,4.03,1195
2020-10-15,361,346,15,4.34,1195
2020-10-16,341,322,19,5.9,1195
2020-10-17,148,173,-25,-14.45,1195
2020-10-18,81,92,-11,-11.96,1195
2020-10-19,365,335,30,8.96,1195
2020-10-20,361,344,17,4.94,1195
2020-10-21,361,344,17,4.94,1195
2020-10-22,361,343,18,5.25,1195
2020-10-23,341,318,23,7.23,1195
2020-10-24,148,170,-22,-12.94,1195
2020-10-25,81,89,-8,-8.99,1195
2020-10-26,365,332,33,9.94,1195
2020-10-27,361,341,20,5.87,1195
2020-10-28,361,341,20,5.87,1195
2020-10-29,361,341,20,5.87,1195
2020-10-30,341,317,24,7.57,1195
2020-10-31,148,169,-21,-12.43,1195
2020-11-01,73,89,-16,-17.98,1195
2020-11-02,368,332,36,10.84,1195
2020-11-03,341,342,-1,-0.29,1195
2020-11-04,341,343,-2,-0.58,1195
2020-11-05,341,343,-2,-0.58,1195
2020-11-06,325,319,6,1.88,1195
2020-11-07,142,172,-30,-17.44,1195
2020-11-08,73,92,-19,-20.65,1195
2020-11-09,368,336,32,9.52,1195
2020-11-10,341,345,-4,-1.16,1195
2020-11-11,341,346,-5,-1.45,1195
2020-11-12,341,346,-5,-1.45,1195
2020-11-13,325,322,3,0.93,1195
2020-11-14,142,173,-31,-17.92,1195
2020-11-15,73,93,-20,-21.51,1195
2020-11-16,368,336,32,9.52,1195
2020-11-17,341,344,-3,-0.87,1195
2020-11-18,341,344,-3,-0.87,1195
2020-11-19,341,343,-2,-0.58,1195
2020-11-20,325,317,8,2.52,1195
2020-11-21,142,168,-26,-15.48,1195
2020-11-22,73,86,-13,-15.12,1195
2020-11-23,368,328,40,12.2,1195
2020-11-24,341,336,5,1.49,1195
2020-11-25,341,335,6,1.79,1195
2020-11-26,341,333,8,2.4,1195
2020-11-27,325,307,18,5.86,1195
2020-11-28,142,157,-15,-9.55,1195
2020-11-29,73,75,-2,-2.67,1195
2020-11-30,368,316,52,16.46,1195
2020-12-01,286,324,-38,-11.73,1195
2020-12-02,286,323,-37,-11.46,1195
2020-12-03,286,321,-35,-10.9,1195
2020-12-04,328,296,32,10.81,1195
2020-12-05,150,147,3,2.04,1195
2020-12-06,75,65,10,15.38,1195
2020-12-07,304,307,-3,-0.98,1195
2020-12-08,286,316,-30,-9.49,1195
2020-12-09,286,316,-30,-9.49,1195
2020-12-10,286,315,-29,-9.21,1195
2020-12-11,328,290,38,13.1,1195
2020-12-12,150,142,8,5.63,1195
2020-12-13,75,61,14,22.95,1195
2020-12-14,304,304,0,0.0,1195
2020-12-15,286,313,-27,-8.63,1195
2020-12-16,286,313,-27,-8.63,1195
2020-12-17,286,313,-27,-8.63,1195
2020-12-18,328,288,40,13.89,1195
2020-12-19,150,140,10,7.14,1195
2020-12-20,75,59,16,27.12,1195
2020-12-21,304,301,3,1.0,1195
2020-12-22,286,310,-24,-7.74,1195
2020-12-23,286,310,-24,-7.74,1195
2020-12-24,286,308,-22,-7.14,1195
2020-12-25,328,283,45,15.9,1195
2020-12-26,150,134,16,11.94,1195
2020-12-27,75,52,23,44.23,1195
2020-12-28,304,294,10,3.4,1195
2020-12-29,286,302,-16,-5.3,1195
2020-12-30,286,300,-14,-4.67,1195
2020-12-31,286,298,-12,-4.03,1195
2021-01-01,254,272,-18,-6.62,1195
2021-01-02,106,123,-17,-13.82,1195
2021-01-03,74,40,34,85.0,1195
2021-01-04,257,282,-25,-8.87,1195
2021-01-05,260,290,-30,-10.34,1195
2021-01-06,260,288,-28,-9.72,1195
2021-01-07,260,287,-27,-9.41,1195
2021-01-08,254,261,-7,-2.68,1195
2021-01-09,106,112,-6,-5.36,1195
2021-01-10,74,31,43,138.71,1195
2021-01-11,257,273,-16,-5.86,1195
2021-01-12,260,282,-22,-7.8,1195
2021-01-13,260,282,-22,-7.8,1195
2021-01-14,260,281,-21,-7.47,1195
2021-01-15,254,257,-3,-1.17,1195
2021-01-16,106,109,-3,-2.75,1195
2021-01-17,74,29,45,155.17,1195
2021-01-18,257,273,-16,-5.86,1195
2021-01-19,260,283,-23,-8.13,1195
2021-01-20,260,284,-24,-8.45,1195
2021-01-21,260,284,-24,-8.45,1195
2021-01-22,254,261,-7,-2.68,1195
2021-01-23,106,114,-8,-7.02,1195
2021-01-24,74,35,39,111.43,1195
2021-01-25,257,279,-22,-7.89,1195
2021-01-26,260,290,-30,-10.34,1195
2021-01-27,260,291,-31,-10.65,1195
2021-01-28,260,292,-32,-10.96,1195
2021-01-29,254,269,-15,-5.58,1195
2021-01-30,106,122,-16,-13.11,1195
2021-01-31,74,43,31,72.09,1195
2021-02-01,298,287,11,3.83,1195
2021-02-02,289,297,-8,-2.69,1195
2021-02-03,289,298,-9,-3.02,1195
2021-02-04,289,299,-10,-3.34,1195
2021-02-05,279,275,4,1.45,1195
2021-02-06,134,127,7,5.51,1195
2021-02-07,68,48,20,41.67,1195
2021-02-08,298,291,7,2.41,1195
2021-02-09,289,301,-12,-3.99,1195
2021-02-10,289,302,-13,-4.3,1195
2021-02-11,289,302,-13,-4.3,1195
2021-02-12,279,278,1,0.36,1195
2021-02-13,134,131,3,2.29,1195
2021-02-14,68,51,17,33.33,1195
2021-02-15,298,295,3,1.02,1195
2021-02-16,289,305,-16,-5.25,1195
2021-02-17,289,306,-17,-5.56,1195
2021-02-18,289,306,-17,-5.56,1195
2021-02-19,279,283,-4,-1.41,1195
2021-02-20,134,136,-2,-1.47,1195
2021-02-21,68,57,11,19.3,1195
2021-02-22,298,301,-3,-1.0,1195
2021-02-23,289,312,-23,-7.37,1195
2021-02-24,289,313,-24,-7.67,1195
2021-02-25,289,314,-25,-7.96,1195
2021-02-26,279,291,-12,-4.12,1195
2021-02-27,134,145,-11,-7.59,1195
2021-02-28,68,66,2,3.03,1195
2021-03-01,340,310,30,9.68,1195
2021-03-02,346,321,25,7.79,1195
2021-03-03,346,322,24,7.45,1195
2021-03-04,346,323,23,7.12,1195
2021-03-05,310,300,10,3.33,1195
2021-03-06,156,153,3,1.96,1195
2021-03-07,81,74,7,9.46,1195
2021-03-08,340,318,22,6.92,1195
2021-03-09,346,328,18,5.49,1195
2021-03-10,346,329,17,5.17,1195
2021-03-11,346,330,16,4.85,1195
2021-03-12,310,306,4,1.31,1195
2021-03-13,156,159,-3,-1.89,1195
2021-03-14,81,79,2,2.53,1195
2021-03-15,340,322,18,5.59,1195
2021-03-16,346,332,14,4.22,1195
2021-03-17,346,333,13,3.9,1195
2021-03-18,346,333,13,3.9,1195
2021-03-19,310,309,1,0.32,1195
2021-03-20,156,162,-6,-3.7,1195
2021-03-21,81,82,-1,-1.22,1195
2021-03-22,340,325,15,4.62,1195
2021-03-23,346,335,11,3.28,1195
2021-03-24,346,336,10,2.98,1195
2021-03-25,346,337,9,2.67,1195
2021-03-26,310,313,-3,-0.96,1195
2021-03-27,156,166,-10,-6.02,1195
2021-03-28,81,87,-6,-6.9,1195
2021-03-29,340,331,9,2.72,1195
2021-03-30,346,341,5,1.47,1195
2021-03-31,346,343,3,0.87,1195
2021-04-01,351,344,7,2.03,1195
2021-04-02,330,321,9,2.8,1195
2021-04-03,155,174,-19,-10.92,1195
2021-04-04,84,95,-11,-11.58,1195
2021-04-05,338,340,-2,-0.59,1195
2021-04-06,351,350,1,0.29,1195
2021-04-07,351,352,-1,-0.28,1195
2021-04-08,351,353,-2,-0.57,1195
2021-04-09,330,330,0,0.0,1195
2021-04-10,155,183,-28,-15.3,1195
2021-04-11,84,104,-20,-19.23,1195
2021-04-12,338,348,-10,-2.87,1195
2021-04-13,351,358,-7,-1.96,1195
2021-04-14,351,359,-8,-2.23,1195
2021-04-15,351,359,-8,-2.23,1195
2021-04-16,330,336,-6,-1.79,1195
2021-04-17,155,188,-33,-17.55,1195
2021-04-18,84,108,-24,-22.22,1195
2021-04-19,338,351,-13,-3.7,1195
2021-04-20,351,361,-10,-2.77,1195
2021-04-21,351,361,-10,-2.77,1195
2021-04-22,351,361,-10,-2.77,1195
2021-04-23,330,336,-6,-1.79,1195
2021-04-24,155,188,-33,-17.55,1195
2021-04-25,84,108,-24,-22.22,1195
2021-04-26,338,350,-12,-3.43,1195
2021-04-27,351,360,-9,-2.5,1195
2021-04-28,351,360,-9,-2.5,1195
2021-04-29,351,359,-8,-2.23,1195
2021-04-30,330,335,-5,-1.49,1195
2021-05-01,178,186,-8,-4.3,1195
2021-05-02,88,106,-18,-16.98,1195
2021-05-03,396,349,47,13.47,1195
2021-05-04,399,358,41,11.45,1195
2021-05-05,399,358,41,11.45,1195
2021-05-06,399,358,41,11.45,1195
2021-05-07,360,334,26,7.78,1195
2021-05-08,178,186,-8,-4.3,1195
2021-05-09,88,106,-18,-16.98,1195
2021-05-10,396,349,47,13.47,1195
2021-05-11,399,359,40,11.14,1195
2021-05-12,399,359,40,11.14,1195
2021-05-13,399,359,40,11.14,1195
2021-05-14,360,335,25,7.46,1195
2021-05-15,178,188,-10,-5.32,1195
2021-05-16,88,108,-20,-18.52,1195
2021-05-17,396,351,45,12.82,1195
2021-05-18,399,361,38,10.53,1195
2021-05-19,399,361,38,10.53,1195
2021-05-20,399,362,37,10.22,1195
2021-05-21,360,338,22,6.51,1195
2021-05-22,178,190,-12,-6.32,1195
2021-05-23,88,110,-22,-20.0,1195
2021-05-24,396,354,42,11.86,1195
2021-05-25,399,364,35,9.62,1195
2021-05-26,399,364,35,9.62,1195
2021-05-27,399,365,34,9.32,1195
2021-05-28,360,341,19,5.57,1195
2021-05-29,178,193,-15,-7.77,1195
2021-05-30,88,114,-26,-22.81,1195
2021-05-31,396,357,39,10.92,1195
2021-06-01,399,367,32,8.72,1195
2021-06-02,399,368,31,8.42,1195
2021-06-03,399,369,30,8.13,1195
2021-06-04,384,345,39,11.3,1195
2021-06-05,169,198,-29,-14.65,1195
2021-06-06,107,118,-11,-9.32,1195
2021-06-07,387,362,25,6.91,1195
2021-06-08,399,372,27,7.26,1195
2021-06-09,399,373,26,6.97,1195
2021-06-10,399,373,26,6.97,1195
2021-06-11,384,350,34,9.71,1195
2021-06-12,169,202,-33,-16.34,1195
2021-06-13,107,122,-15,-12.3,1195
2021-06-14,387,366,21,5.74,1195
2021-06-15,399,376,23,6.12,1195
2021-06-16,399,376,23,6.12,1195
2021-06-17,399,376,23,6.12,1195
2021-06-18,384,352,32,9.09,1195
2021-06-19,169,203,-34,-16.75,1195
2021-06-20,107,123,-16,-13.01,1195
2021-06-21,387,366,21,5.74,1195
2021-06-22,399,374,25,6.68,1195
2021-06-23,399,374,25,6.68,1195
2021-06-24,399,373,26,6.97,1195
2021-06-25,384,348,36,10.34,1195
2021-06-26,169,199,-30,-15.08,1195
2021-06-27,107,118,-11,-9.32,1195
2021-06-28,387,360,27,7.5,1195
2021-06-29,399,369,30,8.13,1195
2021-06-30,399,368,31,8.42,1195
2021-07-01,384,367,17,4.63,1195
2021-07-02,351,342,9,2.63,1195
2021-07-03,140,193,-53,-27.46,1195
2021-07-04,91,112,-21,-18.75,1195
2021-07-05,361,354,7,1.98,1195
2021-07-06,384,363,21,5.79,1195
2021-07-07,384,363,21,5.79,1195
2021-07-08,384,362,22,6.08,1195
2021-07-09,351,337,14,4.15,1195
2021-07-10,140,189,-49,-25.93,1195
2021-07-11,91,108,-17,-15.74,1195
2021-07-12,361,351,10,2.85,1195
2021-07-13,384,361,23,6.37,1195
2021-07-14,384,361,23,6.37,1195
2021-07-15,384,361,23,6.37,1195
2021-07-16,351,337,14,4.15,1195
2021-07-17,140,189,-49,-25.93,1195
2021-07-18,91,109,-18,-16.51,1195
2021-07-19,361,352,9,2.56,1195
2021-07-20,384,361,23,6.37,1195
2021-07-21,384,362,22,6.08,1195
2021-07-22,384,361,23,6.37,1195
2021-07-23,351,337,14,4.15,1195
2021-07-24,140,189,-49,-25.93,1195
2021-07-25,91,108,-17,-15.74,1195
2021-07-26,361,350,11,3.14,1195
2021-07-27,384,359,25,6.96,1195
2021-07-28,384,359,25,6.96,1195
2021-07-29,384,358,26,7.26,1195
2021-07-30,351,332,19,5.72,1195
2021-07-31,140,183,-43,-23.5,1195
2021-08-01,89,101,-12,-11.88,1195
2021-08-02,371,343,28,8.16,1195
2021-08-03,354,351,3,0.85,1195
2021-08-04,354,350,4,1.14,1195
2021-08-05,354,348,6,1.72,1195
2021-08-06,334,323,11,3.41,1195
2021-08-07,148,173,-25,-14.45,1195
2021-08-08,89,91,-2,-2.2,1195
2021-08-09,371,333,38,11.41,1195
2021-08-10,354,342,12,3.51,1195
2021-08-11,354,341,13,3.81,1195
2021-08-12,354,340,14,4.12,1195
2021-08-13,334,315,19,6.03,1195
2021-08-14,148,166,-18,-10.84,1195
2021-08-15,89,85,4,4.71,1195
2021-08-16,371,328,43,13.11,1195
2021-08-17,354,338,16,4.73,1195
2021-08-18,354,339,15,4.42,1195
2021-08-19,354,339,15,4.42,1195
2021-08-20,334,315,19,6.03,1195
2021-08-21,148,168,-20,-11.9,1195
2021-08-22,89,89,0,0.0,1195
2021-08-23,371,333,38,11.41,1195
2021-08-24,354,343,11,3.21,1195
2021-08-25,354,345,9,2.61,1195
2021-08-26,354,346,8,2.31,1195
2021-08-27,334,323,11,3.41,1195
2021-08-28,148,177,-29,-16.38,1195
2021-08-29,89,98,-9,-9.18,1195
2021-08-30,371,342,29,8.48,1195
2021-08-31,354,353,1,0.28,1195
2021-09-01,391,355,36,10.14,1195
2021-09-02,391,356,35,9.83,1195
2021-09-03,372,332,40,12.05,1195
2021-09-04,163,185,-22,-11.89,1195
2021-09-05,101,105,-4,-3.81,1195
2021-09-06,372,349,23,6.59,1195
2021-09-07,391,359,32,8.91,1195
2021-09-08,391,360,31,8.61,1195
2021-09-09,391,360,31,8.61,1195
2021-09-10,372,335,37,11.04,1195
2021-09-11,163,187,-24,-12.83,1195
2021-09-12,101,107,-6,-5.61,1195
2021-09-13,372,350,22,6.29,1195
2021-09-14,391,359,32,8.91,1195
2021-09-15,391,359,32,8.91,1195
2021-09-16,391,359,32,8.91,1195
2021-09-17,372,334,38,11.38,1195
2021-09-18,163,186,-23,-12.37,1195
2021-09-19,101,105,-4,-3.81,1195
2021-09-20,372,349,23,6.59,1195
2021-09-21,391,358,33,9.22,1195
2021-09-22,391,358,33,9.22,1195
2021-09-23,391,358,33,9.22,1195
2021-09-24,372,334,38,11.38,1195
2021-09-25,163,187,-24,-12.83,1195
2021-09-26,101,107,-6,-5.61,1195
2021-09-27,372,351,21,5.98,1195
2021-09-28,391,361,30,8.31,1195
2021-09-29,391,362,29,8.01,1195
2021-09-30,391,362,29,8.01,1195
2021-10-01,346,339,7,2.06,1195
2021-10-02,144,192,-48,-25.0,1195
2021-10-03,88,112,-24,-21.43,1195
2021-10-04,343,356,-13,-3.65,1195
2021-10-05,395,366,29,7.92,1195
2021-10-06,395,367,28,7.63,1195
2021-10-07,395,368,27,7.34,1195
2021-10-08,346,344,2,0.58,1195
2021-10-09,144,196,-52,-26.53,1195
2021-10-10,88,116,-28,-24.14,1195
2021-10-11,343,359,-16,-4.46,1195
2021-10-12,395,369,26,7.05,1195
2021-10-13,395,369,26,7.05,1195
2021-10-14,395,369,26,7.05,1195
2021-10-15,346,344,2,0.58,1195
2021-10-16,144,196,-52,-26.53,1195
2021-10-17,88,115,-27,-23.48,1195
2021-10-18,343,358,-15,-4.19,1195
2021-10-19,395,367,28,7.63,1195
2021-10-20,395,367,28,7.63,1195
2021-10-21,395,366,29,7.92,1195
2021-10-22,346,341,5,1.47,1195
2021-10-23,144,192,-48,-25.0,1195
2021-10-24,88,112,-24,-21.43,1195
2021-10-25,343,354,-11,-3.11,1195
2021-10-26,395,363,32,8.82,1195
2021-10-27,395,364,31,8.52,1195
2021-10-28,395,363,32,8.82,1195
2021-10-29,346,339,7,2.06,1195
2021-10-30,144,191,-47,-24.61,1195
2021-10-31,88,111,-23,-20.72,1195
2021-11-01,331,354,-23,-6.5,1195
2021-11-02,370,364,6,1.65,1195
2021-11-03,370,365,5,1.37,1195
2021-11-04,370,365,5,1.37,1195
2021-11-05,320,341,-21,-6.16,1195
2021-11-06,131,194,-63,-32.47,1195
2021-11-07,78,114,-36,-31.58,1195
2021-11-08,331,357,-26,-7.28,1195
2021-11-09,370,367,3,0.82,1195
2021-11-10,370,368,2,0.54,1195
2021-11-11,370,368,2,0.54,1195
2021-11-12,320,344,-24,-6.98,1195
2021-11-13,131,196,-65,-33.16,1195
2021-11-14,78,116,-38,-32.76,1195
2021-11-15,331,358,-27,-7.54,1195
2021-11-16,370,367,3,0.82,1195
2021-11-17,370,367,3,0.82,1195
2021-11-18,370,366,4,1.09,1195
2021-11-19,320,341,-21,-6.16,1195
2021-11-20,131,192,-61,-31.77,1195
2021-11-21,78,110,-32,-29.09,1195
2021-11-22,331,352,-21,-5.97,1195
2021-11-23,370,360,10,2.78,1195
2021-11-24,370,359,11,3.06,1195
2021-11-25,370,357,13,3.64,1195
2021-11-26,320,331,-11,-3.32,1195
2021-11-27,131,181,-50,-27.62,1195
2021-11-28,78,99,-21,-21.21,1195
2021-11-29,331,341,-10,-2.93,1195
2021-11-30,370,348,22,6.32,1195
2021-12-01,293,347,-54,-15.56,1195
2021-12-02,293,345,-52,-15.07,1195
2021-12-03,237,320,-83,-25.94,1195
2021-12-04,138,170,-32,-18.82,1195
2021-12-05,70,89,-19,-21.35,1195
2021-12-06,277,331,-54,-16.31,1195
2021-12-07,293,339,-46,-13.57,1195
2021-12-08,293,339,-46,-13.57,1195
2021-12-09,293,338,-45,-13.31,1195
2021-12-10,237,313,-76,-24.28,1195
2021-12-11,138,165,-27,-16.36,1195
2021-12-12,70,84,-14,-16.67,1195
2021-12-13,277,327,-50,-15.29,1195
2021-12-14,293,336,-43,-12.8,1195
2021-12-15,293,336,-43,-12.8,1195
2021-12-16,293,335,-42,-12.54,1195
2021-12-17,237,311,-74,-23.79,1195
2021-12-18,138,163,-25,-15.34,1195
2021-12-19,70,82,-12,-14.63,1195
2021-12-20,277,325,-48,-14.77,1195
2021-12-21,293,333,-40,-12.01,1195
2021-12-22,293,333,-40,-12.01,1195
2021-12-23,293,332,-39,-11.75,1195
2021-12-24,237,307,-70,-22.8,1195
2021-12-25,138,158,-20,-12.66,1195
2021-12-26,70,76,-6,-7.89,1195
2021-12-27,277,318,-41,-12.89,1195
2021-12-28,293,326,-33,-10.12,1195
2021-12-29,293,325,-32,-9.85,1195
2021-12-30,293,323,-30,-9.29,1195
2021-12-31,237,297,-60,-20.2,1195
2022-01-01,134,147,-13,-8.84,1195
2022-01-02,63,65,-2,-3.08,1195
2022-01-03,234,306,-72,-23.53,1195
2022-01-04,286,314,-28,-8.92,1195
2022-01-05,286,313,-27,-8.63,1195
2022-01-06,286,311,-25,-8.04,1195
2022-01-07,268,285,-17,-5.96,1195
2022-01-08,134,136,-2,-1.47,1195
2022-01-09,63,54,9,16.67,1195
2022-01-10,234,296,-62,-20.95,1195
2022-01-11,286,305,-19,-6.23,1195
2022-01-12,286,305,-19,-6.23,1195
2022-01-13,286,304,-18,-5.92,1195
2022-01-14,268,279,-11,-3.94,1195
2022-01-15,134,131,3,2.29,1195
2022-01-16,63,51,12,23.53,1195
2022-01-17,234,294,-60,-20.41,1195
2022-01-18,286,304,-18,-5.92,1195
2022-01-19,286,305,-19,-6.23,1195
2022-01-20,286,306,-20,-6.54,1195
2022-01-21,268,282,-14,-4.96,1195
2022-01-22,134,135,-1,-0.74,1195
2022-01-23,63,56,7,12.5,1195
2022-01-24,234,300,-66,-22.0,1195
2022-01-25,286,311,-25,-8.04,1195
2022-01-26,286,312,-26,-8.33,1195
2022-01-27,286,313,-27,-8.63,1195
2022-01-28,268,290,-22,-7.59,1195
2022-01-29,134,143,-9,-6.29,1195
2022-01-30,63,64,-1,-1.56,1195
2020-02-01,392,329,63,19.15,1196
2020-02-02,317,236,81,34.32,1196
2020-02-03,877,923,-46,-4.98,1196
2020-02-04,909,938,-29,-3.09,1196
2020-02-05,909,939,-30,-3.19,1196
2020-02-06,909,937,-28,-2.99,1196
2020-02-07,850,849,1,0.12,1196
2020-02-08,392,334,58,17.37,1196
2020-02-09,317,241,76,31.54,1196
2020-02-10,877,928,-51,-5.5,1196
2020-02-11,909,943,-34,-3.61,1196
2020-02-12,909,944,-35,-3.71,1196
2020-02-13,909,942,-33,-3.5,1196
2020-02-14,850,854,-4,-0.47,1196
2020-02-15,392,340,52,15.29,1196
2020-02-16,317,247,70,28.34,1196
2020-02-17,877,935,-58,-6.2,1196
2020-02-18,909,951,-42,-4.42,1196
2020-02-19,909,953,-44,-4.62,1196
2020-02-20,909,952,-43,-4.52,1196
2020-02-21,850,865,-15,-1.73,1196
2020-02-22,392,352,40,11.36,1196
2020-02-23,317,260,57,21.92,1196
2020-02-24,877,948,-71,-7.49,1196
2020-02-25,909,965,-56,-5.8,1196
2020-02-26,909,968,-59,-6.1,1196
2020-02-27,909,968,-59,-6.1,1196
2020-02-28,850,882,-32,-3.63,1196
2020-02-29,392,369,23,6.23,1196
2020-03-01,335,277,58,20.94,1196
2020-03-02,776,966,-190,-19.67,1196
2020-03-03,801,983,-182,-18.51,1196
2020-03-04,801,985,-184,-18.68,1196
2020-03-05,801,985,-184,-18.68,1196
2020-03-06,744,898,-154,-17.15,1196
2020-03-07,379,385,-6,-1.56,1196
2020-03-08,335,293,42,14.33,1196
2020-03-09,776,981,-205,-20.9,1196
2020-03-10,801,997,-196,-19.66,1196
2020-03-11,801,998,-197,-19.74,1196
2020-03-12,801,997,-196,-19.66,1196
2020-03-13,744,909,-165,-18.15,1196
2020-03-14,379,395,-16,-4.05,1196
2020-03-15,335,302,33,10.93,1196
2020-03-16,776,989,-213,-21.54,1196
2020-03-17,801,1004,-203,-20.22,1196
2020-03-18,801,1005,-204,-20.3,1196
2020-03-19,801,1003,-202,-20.14,1196
2020-03-20,744,915,-171,-18.69,1196
2020-03-21,379,401,-22,-5.49,1196
2020-03-22,335,308,27,8.77,1196
2020-03-23,776,995,-219,-22.01,1196
2020-03-24,801,1010,-209,-20.69,1196
2020-03-25,801,1011,-210,-20.77,1196
2020-03-26,801,1010,-209,-20.69,1196
2020-03-27,744,922,-178,-19.31,1196
2020-03-28,379,408,-29,-7.11,1196
2020-03-29,335,316,19,6.01,1196
2020-03-30,776,1003,-227,-22.63,1196
2020-03-31,801,1019,-218,-21.39,1196
2020-04-01,759,1021,-262,-25.66,1196
2020-04-02,759,1020,-261,-25.59,1196
2020-04-03,691,933,-242,-25.94,1196
2020-04-04,387,419,-32,-7.64,1196
2020-04-05,342,327,15,4.59,1196
2020-04-06,794,1015,-221,-21.77,1196
2020-04-07,759,1031,-272,-26.38,1196
2020-04-08,759,1033,-274,-26.52,1196
2020-04-09,759,1032,-273,-26.45,1196
2020-04-10,691,945,-254,-26.88,1196
2020-04-11,387,431,-44,-10.21,1196
2020-04-12,342,338,4,1.18,1196
2020-04-13,794,1026,-232,-22.61,1196
2020-04-14,759,1041,-282,-27.09,1196
2020-04-15,759,1043,-284,-27.23,1196
2020-04-16,759,1042,-283,-27.16,1196
2020-04-17,691,954,-263,-27.57,1196
2020-04-18,387,440,-53,-12.05,1196
2020-04-19,342,347,-5,-1.44,1196
2020-04-20,794,1034,-240,-23.21,1196
2020-04-21,759,1049,-290,-27.65,1196
2020-04-22,759,1050,-291,-27.71,1196
2020-04-23,759,1048,-289,-27.58,1196
2020-04-24,691,961,-270,-28.1,1196
2020-04-25,387,446,-59,-13.23,1196
2020-04-26,342,353,-11,-3.12,1196
2020-04-27,794,1040,-246,-23.65,1196
2020-04-28,759,1055,-296,-28.06,1196
2020-04-29,759,1057,-298,-28.19,1196
2020-04-30,759,1055,-296,-28.06,1196
2020-05-01,904,967,-63,-6.51,1196
2020-05-02,415,453,-38,-8.39,1196
2020-05-03,331,360,-29,-8.06,1196
2020-05-04,989,1047,-58,-5.54,1196
2020-05-05,1022,1063,-41,-3.86,1196
2020-05-06,1022,1064,-42,-3.95,1196
2020-05-07,1022,1063,-41,-3.86,1196
2020-05-08,904,975,-71,-7.28,1196
2020-05-09,415,460,-45,-9.78,1196
2020-05-10,331,368,-37,-10.05,1196
2020-05-11,989,1055,-66,-6.26,1196
2020-05-12,1022,1070,-48,-4.49,1196
2020-05-13,1022,1071,-49,-4.58,1196
2020-05-14,1022,1069,-47,-4.4,1196
2020-05-15,904,981,-77,-7.85,1196
2020-05-16,415,466,-51,-10.94,1196
2020-05-17,331,372,-41,-11.02,1196
2020-05-18,989,1058,-69,-6.52,1196
2020-05-19,1022,1073,-51,-4.75,1196
2020-05-20,1022,1073,-51,-4.75,1196
2020-05-21,1022,1070,-48,-4.49,1196
2020-05-22,904,981,-77,-7.85,1196
2020-05-23,415,465,-50,-10.75,1196
2020-05-24,331,371,-40,-10.78,1196
2020-05-25,989,1056,-67,-6.34,1196
2020-05-26,1022,1069,-47,-4.4,1196
2020-05-27,1022,1069,-47,-4.4,1196
2020-05-28,1022,1065,-43,-4.04,1196
2020-05-29,904,975,-71,-7.28,1196
2020-05-30,415,459,-44,-9.59,1196
2020-05-31,331,364,-33,-9.07,1196
2020-06-01,1064,1049,15,1.43,1196
2020-06-02,1147,1062,85,8.0,1196
2020-06-03,1147,1061,86,8.11,1196
2020-06-04,1147,1058,89,8.41,1196
2020-06-05,937,968,-31,-3.2,1196
2020-06-06,448,452,-4,-0.88,1196
2020-06-07,338,357,-19,-5.32,1196
2020-06-08,1064,1042,22,2.11,1196
2020-06-09,1147,1056,91,8.62,1196
2020-06-10,1147,1055,92,8.72,1196
2020-06-11,1147,1052,95,9.03,1196
2020-06-12,937,963,-26,-2.7,1196
2020-06-13,448,447,1,0.22,1196
2020-06-14,338,353,-15,-4.25,1196
2020-06-15,1064,1038,26,2.5,1196
2020-06-16,1147,1052,95,9.03,1196
2020-06-17,1147,1053,94,8.93,1196
2020-06-18,1147,1050,97,9.24,1196
2020-06-19,937,961,-24,-2.5,1196
2020-06-20,448,445,3,0.67,1196
2020-06-21,338,351,-13,-3.7,1196
2020-06-22,1064,1037,27,2.6,1196
2020-06-23,1147,1052,95,9.03,1196
2020-06-24,1147,1052,95,9.03,1196
2020-06-25,1147,1049,98,9.34,1196
2020-06-26,937,961,-24,-2.5,1196
2020-06-27,448,445,3,0.67,1196
2020-06-28,338,352,-14,-3.98,1196
2020-06-29,1064,1038,26,2.5,1196
2020-06-30,1147,1052,95,9.03,1196
2020-07-01,1046,1053,-7,-0.66,1196
2020-07-02,1046,1051,-5,-0.48,1196
2020-07-03,910,962,-52,-5.41,1196
2020-07-04,410,447,-37,-8.28,1196
2020-07-05,332,354,-22,-6.21,1196
2020-07-06,1029,1040,-11,-1.06,1196
2020-07-07,1046,1055,-9,-0.85,1196
2020-07-08,1046,1056,-10,-0.95,1196
2020-07-09,1046,1054,-8,-0.76,1196
2020-07-10,910,965,-55,-5.7,1196
2020-07-11,410,450,-40,-8.89,1196
2020-07-12,332,357,-25,-7.0,1196
2020-07-13,1029,1044,-15,-1.44,1196
2020-07-14,1046,1059,-13,-1.23,1196
2020-07-15,1046,1060,-14,-1.32,1196
2020-07-16,1046,1057,-11,-1.04,1196
2020-07-17,910,969,-59,-6.09,1196
2020-07-18,410,454,-44,-9.69,1196
2020-07-19,332,361,-29,-8.03,1196
2020-07-20,1029,1047,-18,-1.72,1196
2020-07-21,1046,1061,-15,-1.41,1196
2020-07-22,1046,1062,-16,-1.51,1196
2020-07-23,1046,1059,-13,-1.23,1196
2020-07-24,910,971,-61,-6.28,1196
2020-07-25,410,455,-45,-9.89,1196
2020-07-26,332,361,-29,-8.03,1196
2020-07-27,1029,1047,-18,-1.72,1196
2020-07-28,1046,1061,-15,-1.41,1196
2020-07-29,1046,1061,-15,-1.41,1196
2020-07-30,1046,1058,-12,-1.13,1196
2020-07-31,910,969,-59,-6.09,1196
2020-08-01,421,453,-32,-7.06,1196
2020-08-02,343,359,-16,-4.46,1196
2020-08-03,954,1044,-90,-8.62,1196
2020-08-04,939,1058,-119,-11.25,1196
2020-08-05,939,1058,-119,-11.25,1196
2020-08-06,939,1055,-116,-11.0,1196
2020-08-07,836,966,-130,-13.46,1196
2020-08-08,421,450,-29,-6.44,1196
2020-08-09,343,356,-13,-3.65,1196
2020-08-10,954,1042,-88,-8.45,1196
2020-08-11,939,1056,-117,-11.08,1196
2020-08-12,939,1056,-117,-11.08,1196
2020-08-13,939,1053,-114,-10.83,1196
2020-08-14,836,964,-128,-13.28,1196
2020-08-15,421,449,-28,-6.24,1196
2020-08-16,343,355,-12,-3.38,1196
2020-08-17,954,1041,-87,-8.36,1196
2020-08-18,939,1055,-116,-11.0,1196
2020-08-19,939,1055,-116,-11.0,1196
2020-08-20,939,1052,-113,-10.74,1196
2020-08-21,836,963,-127,-13.19,1196
2020-08-22,421,447,-26,-5.82,1196
2020-08-23,343,352,-9,-2.56,1196
2020-08-24,954,1037,-83,-8.0,1196
2020-08-25,939,1051,-112,-10.66,1196
2020-08-26,939,1050,-111,-10.57,1196
2020-08-27,939,1046,-107,-10.23,1196
2020-08-28,836,956,-120,-12.55,1196
2020-08-29,421,439,-18,-4.1,1196
2020-08-30,343,343,0,0.0,1196
2020-08-31,954,1027,-73,-7.11,1196
2020-09-01,1117,1039,78,7.51,1196
2020-09-02,1117,1037,80,7.71,1196
2020-09-03,1117,1032,85,8.24,1196
2020-09-04,985,941,44,4.68,1196
2020-09-05,430,423,7,1.65,1196
2020-09-06,344,327,17,5.2,1196
2020-09-07,1078,1010,68,6.73,1196
2020-09-08,1117,1022,95,9.3,1196
2020-09-09,1117,1020,97,9.51,1196
2020-09-10,1117,1015,102,10.05,1196
2020-09-11,985,924,61,6.6,1196
2020-09-12,430,407,23,5.65,1196
2020-09-13,344,312,32,10.26,1196
2020-09-14,1078,996,82,8.23,1196
2020-09-15,1117,1009,108,10.7,1196
2020-09-16,1117,1009,108,10.7,1196
2020-09-17,1117,1006,111,11.03,1196
2020-09-18,985,917,68,7.42,1196
2020-09-19,430,401,29,7.23,1196
2020-09-20,344,308,36,11.69,1196
2020-09-21,1078,994,84,8.45,1196
2020-09-22,1117,1010,107,10.59,1196
2020-09-23,1117,1011,106,10.48,1196
2020-09-24,1117,1010,107,10.59,1196
2020-09-25,985,922,63,6.83,1196
2020-09-26,430,408,22,5.39,1196
2020-09-27,344,316,28,8.86,1196
2020-09-28,1078,1004,74,7.37,1196
2020-09-29,1117,1020,97,9.51,1196
2020-09-30,1117,1022,95,9.3,1196
2020-10-01,1090,1021,69,6.76,1196
2020-10-02,962,934,28,3.0,1196
2020-10-03,435,420,15,3.57,1196
2020-10-04,326,327,-1,-0.31,1196
2020-10-05,1105,1014,91,8.97,1196
2020-10-06,1090,1029,61,5.93,1196
2020-10-07,1090,1030,60,5.83,1196
2020-10-08,1090,1028,62,6.03,1196
2020-10-09,962,939,23,2.45,1196
2020-10-10,435,424,11,2.59,1196
2020-10-11,326,329,-3,-0.91,1196
2020-10-12,1105,1015,90,8.87,1196
2020-10-13,1090,1029,61,5.93,1196
2020-10-14,1090,1028,62,6.03,1196
2020-10-15,1090,1025,65,6.34,1196
2020-10-16,962,935,27,2.89,1196
2020-10-17,435,419,16,3.82,1196
2020-10-18,326,324,2,0.62,1196
2020-10-19,1105,1009,96,9.51,1196
2020-10-20,1090,1022,68,6.65,1196
2020-10-21,1090,1022,68,6.65,1196
2020-10-22,1090,1019,71,6.97,1196
2020-10-23,962,929,33,3.55,1196
2020-10-24,435,414,21,5.07,1196
2020-10-25,326,320,6,1.88,1196
2020-10-26,1105,1006,99,9.84,1196
2020-10-27,1090,1021,69,6.76,1196
2020-10-28,1090,1022,68,6.65,1196
2020-10-29,1090,1020,70,6.86,1196
2020-10-30,962,932,30,3.22,1196
2020-10-31,435,418,17,4.07,1196
2020-11-01,337,326,11,3.37,1196
2020-11-02,1012,1013,-1,-0.1,1196
2020-11-03,980,1029,-49,-4.76,1196
2020-11-04,980,1031,-51,-4.95,1196
2020-11-05,980,1030,-50,-4.85,1196
2020-11-06,926,943,-17,-1.8,1196
2020-11-07,420,429,-9,-2.1,1196
2020-11-08,337,336,1,0.3,1196
2020-11-09,1012,1024,-12,-1.17,1196
2020-11-10,980,1039,-59,-5.68,1196
2020-11-11,980,1040,-60,-5.77,1196
2020-11-12,980,1037,-57,-5.5,1196
2020-11-13,926,949,-23,-2.42,1196
2020-11-14,420,433,-13,-3.0,1196
2020-11-15,337,339,-2,-0.59,1196
2020-11-16,1012,1024,-12,-1.17,1196
2020-11-17,980,1037,-57,-5.5,1196
2020-11-18,980,1036,-56,-5.41,1196
2020-11-19,980,1031,-51,-4.95,1196
2020-11-20,926,940,-14,-1.49,1196
2020-11-21,420,422,-2,-0.47,1196
2020-11-22,337,325,12,3.69,1196
2020-11-23,1012,1009,3,0.3,1196
2020-11-24,980,1020,-40,-3.92,1196
2020-11-25,980,1017,-37,-3.64,1196
2020-11-26,980,1011,-31,-3.07,1196
2020-11-27,926,919,7,0.76,1196
2020-11-28,420,401,19,4.74,1196
2020-11-29,337,304,33,10.86,1196
2020-11-30,1012,987,25,2.53,1196
2020-12-01,892,998,-106,-10.62,1196
2020-12-02,892,996,-104,-10.44,1196
2020-12-03,892,991,-99,-9.99,1196
2020-12-04,945,900,45,5.0,1196
2020-12-05,435,383,52,13.58,1196
2020-12-06,328,287,41,14.29,1196
2020-12-07,872,972,-100,-10.29,1196
2020-12-08,892,985,-93,-9.44,1196
2020-12-09,892,984,-92,-9.35,1196
2020-12-10,892,980,-88,-8.98,1196
2020-12-11,945,891,54,6.06,1196
2020-12-12,435,375,60,16.0,1196
2020-12-13,328,280,48,17.14,1196
2020-12-14,872,966,-94,-9.73,1196
2020-12-15,892,980,-88,-8.98,1196
2020-12-16,892,980,-88,-8.98,1196
2020-12-17,892,977,-85,-8.7,1196
2020-12-18,945,888,57,6.42,1196
2020-12-19,435,372,63,16.94,1196
2020-12-20,328,277,51,18.41,1196
2020-12-21,872,962,-90,-9.36,1196
2020-12-22,892,976,-84,-8.61,1196
2020-12-23,892,975,-83,-8.51,1196
2020-12-24,892,971,-79,-8.14,1196
2020-12-25,945,880,65,7.39,1196
2020-12-26,435,363,72,19.83,1196
2020-12-27,328,267,61,22.85,1196
2020-12-28,872,951,-79,-8.31,1196
2020-12-29,892,964,-72,-7.47,1196
2020-12-30,892,962,-70,-7.28,1196
2020-12-31,892,957,-65,-6.79,1196
2021-01-01,826,865,-39,-4.51,1196
2021-01-02,381,347,34,9.8,1196
2021-01-03,336,251,85,33.86,1196
2021-01-04,831,935,-104,-11.12,1196
2021-01-05,888,947,-59,-6.23,1196
2021-01-06,888,945,-57,-6.03,1196
2021-01-07,888,941,-53,-5.63,1196
2021-01-08,826,850,-24,-2.82,1196
2021-01-09,381,333,48,14.41,1196
2021-01-10,336,238,98,41.18,1196
2021-01-11,831,923,-92,-9.97,1196
2021-01-12,888,936,-48,-5.13,1196
2021-01-13,888,936,-48,-5.13,1196
2021-01-14,888,933,-45,-4.82,1196
2021-01-15,826,845,-19,-2.25,1196
2021-01-16,381,329,52,15.81,1196
2021-01-17,336,236,100,42.37,1196
2021-01-18,831,923,-92,-9.97,1196
2021-01-19,888,938,-50,-5.33,1196
2021-01-20,888,939,-51,-5.43,1196
2021-01-21,888,938,-50,-5.33,1196
2021-01-22,826,850,-24,-2.82,1196
2021-01-23,381,336,45,13.39,1196
2021-01-24,336,243,93,38.27,1196
2021-01-25,831,931,-100,-10.74,1196
2021-01-26,888,946,-58,-6.13,1196
2021-01-27,888,948,-60,-6.33,1196
2021-01-28,888,947,-59,-6.23,1196
2021-01-29,826,859,-33,-3.84,1196
2021-01-30,381,345,36,10.43,1196
2021-01-31,336,252,84,33.33,1196
2021-02-01,932,939,-7,-0.75,1196
2021-02-02,944,954,-10,-1.05,1196
2021-02-03,944,956,-12,-1.26,1196
2021-02-04,944,954,-10,-1.05,1196
2021-02-05,884,866,18,2.08,1196
2021-02-06,378,351,27,7.69,1196
2021-02-07,314,258,56,21.71,1196
2021-02-08,932,944,-12,-1.27,1196
2021-02-09,944,959,-15,-1.56,1196
2021-02-10,944,960,-16,-1.67,1196
2021-02-11,944,958,-14,-1.46,1196
2021-02-12,884,870,14,1.61,1196
2021-02-13,378,356,22,6.18,1196
2021-02-14,314,263,51,19.39,1196
2021-02-15,932,950,-18,-1.89,1196
2021-02-16,944,966,-22,-2.28,1196
2021-02-17,944,968,-24,-2.48,1196
2021-02-18,944,967,-23,-2.38,1196
2021-02-19,884,880,4,0.45,1196
2021-02-20,378,366,12,3.28,1196
2021-02-21,314,274,40,14.6,1196
2021-02-22,932,963,-31,-3.22,1196
2021-02-23,944,979,-35,-3.58,1196
2021-02-24,944,982,-38,-3.87,1196
2021-02-25,944,982,-38,-3.87,1196
2021-02-26,884,896,-12,-1.34,1196
2021-02-27,378,383,-5,-1.31,1196
2021-02-28,314,291,23,7.9,1196
2021-03-01,1019,980,39,3.98,1196
2021-03-02,1024,997,27,2.71,1196
2021-03-03,1024,1000,24,2.4,1196
2021-03-04,1024,999,25,2.5,1196
2021-03-05,927,913,14,1.53,1196
2021-03-06,428,400,28,7.0,1196
2021-03-07,318,308,10,3.25,1196
2021-03-08,1019,996,23,2.31,1196
2021-03-09,1024,1012,12,1.19,1196
2021-03-10,1024,1014,10,0.99,1196
2021-03-11,1024,1012,12,1.19,1196
2021-03-12,927,925,2,0.22,1196
2021-03-13,428,411,17,4.14,1196
2021-03-14,318,318,0,0.0,1196
2021-03-15,1019,1005,14,1.39,1196
2021-03-16,1024,1020,4,0.39,1196
2021-03-17,1024,1022,2,0.2,1196
2021-03-18,1024,1020,4,0.39,1196
2021-03-19,927,932,-5,-0.54,1196
2021-03-20,428,417,11,2.64,1196
2021-03-21,318,324,-6,-1.85,1196
2021-03-22,1019,1011,8,0.79,1196
2021-03-23,1024,1026,-2,-0.19,1196
2021-03-24,1024,1027,-3,-0.29,1196
2021-03-25,1024,1026,-2,-0.19,1196
2021-03-26,927,938,-11,-1.17,1196
2021-03-27,428,424,4,0.94,1196
2021-03-28,318,331,-13,-3.93,1196
2021-03-29,1019,1018,1,0.1,1196
2021-03-30,1024,1034,-10,-0.97,1196
2021-03-31,1024,1036,-12,-1.16,1196
2021-04-01,991,1035,-44,-4.25,1196
2021-04-02,883,948,-65,-6.86,1196
2021-04-03,391,434,-43,-9.91,1196
2021-04-04,314,342,-28,-8.19,1196
2021-04-05,1022,1030,-8,-0.78,1196
2021-04-06,991,1046,-55,-5.26,1196
2021-04-07,991,1048,-57,-5.44,1196
2021-04-08,991,1047,-56,-5.35,1196
2021-04-09,883,960,-77,-8.02,1196
2021-04-10,391,446,-55,-12.33,1196
2021-04-11,314,354,-40,-11.3,1196
2021-04-12,1022,1041,-19,-1.83,1196
2021-04-13,991,1057,-66,-6.24,1196
2021-04-14,991,1059,-68,-6.42,1196
2021-04-15,991,1057,-66,-6.24,1196
2021-04-16,883,970,-87,-8.97,1196
2021-04-17,391,455,-64,-14.07,1196
2021-04-18,314,363,-49,-13.5,1196
2021-04-19,1022,1050,-28,-2.67,1196
2021-04-20,991,1065,-74,-6.95,1196
2021-04-21,991,1066,-75,-7.04,1196
2021-04-22,991,1065,-74,-6.95,1196
2021-04-23,883,977,-94,-9.62,1196
2021-04-24,391,462,-71,-15.37,1196
2021-04-25,314,369,-55,-14.91,1196
2021-04-26,1022,1056,-34,-3.22,1196
2021-04-27,991,1071,-80,-7.47,1196
2021-04-28,991,1073,-82,-7.64,1196
2021-04-29,991,1071,-80,-7.47,1196
2021-04-30,883,983,-100,-10.17,1196
2021-05-01,428,469,-41,-8.74,1196
2021-05-02,326,376,-50,-13.3,1196
2021-05-03,1184,1063,121,11.38,1196
2021-05-04,1143,1078,65,6.03,1196
2021-05-05,1143,1080,63,5.83,1196
2021-05-06,1143,1078,65,6.03,1196
2021-05-07,1008,991,17,1.72,1196
2021-05-08,428,476,-48,-10.08,1196
2021-05-09,326,384,-58,-15.1,1196
2021-05-10,1184,1071,113,10.55,1196
2021-05-11,1143,1086,57,5.25,1196
2021-05-12,1143,1087,56,5.15,1196
2021-05-13,1143,1085,58,5.35,1196
2021-05-14,1008,997,11,1.1,1196
2021-05-15,428,482,-54,-11.2,1196
2021-05-16,326,389,-63,-16.2,1196
2021-05-17,1184,1075,109,10.14,1196
2021-05-18,1143,1090,53,4.86,1196
2021-05-19,1143,1090,53,4.86,1196
2021-05-20,1143,1088,55,5.06,1196
2021-05-21,1008,999,9,0.9,1196
2021-05-22,428,483,-55,-11.39,1196
2021-05-23,326,389,-63,-16.2,1196
2021-05-24,1184,1074,110,10.24,1196
2021-05-25,1143,1088,55,5.06,1196
2021-05-26,1143,1087,56,5.15,1196
2021-05-27,1143,1084,59,5.44,1196
2021-05-28,1008,994,14,1.41,1196
2021-05-29,428,477,-49,-10.27,1196
2021-05-30,326,383,-57,-14.88,1196
2021-05-31,1184,1068,116,10.86,1196
2021-06-01,1135,1081,54,5.0,1196
2021-06-02,1135,1080,55,5.09,1196
2021-06-03,1135,1076,59,5.48,1196
2021-06-04,1004,987,17,1.72,1196
2021-06-05,428,470,-42,-8.94,1196
2021-06-06,334,375,-41,-10.93,1196
2021-06-07,1054,1060,-6,-0.57,1196
2021-06-08,1135,1074,61,5.68,1196
2021-06-09,1135,1074,61,5.68,1196
2021-06-10,1135,1070,65,6.07,1196
2021-06-11,1004,981,23,2.34,1196
2021-06-12,428,465,-37,-7.96,1196
2021-06-13,334,370,-36,-9.73,1196
2021-06-14,1054,1056,-2,-0.19,1196
2021-06-15,1135,1070,65,6.07,1196
2021-06-16,1135,1070,65,6.07,1196
2021-06-17,1135,1067,68,6.37,1196
2021-06-18,1004,978,26,2.66,1196
2021-06-19,428,463,-35,-7.56,1196
2021-06-20,334,369,-35,-9.49,1196
2021-06-21,1054,1055,-1,-0.09,1196
2021-06-22,1135,1069,66,6.17,1196
2021-06-23,1135,1069,66,6.17,1196
2021-06-24,1135,1067,68,6.37,1196
2021-06-25,1004,978,26,2.66,1196
2021-06-26,428,463,-35,-7.56,1196
2021-06-27,334,369,-35,-9.49,1196
2021-06-28,1054,1055,-1,-0.09,1196
2021-06-29,1135,1069,66,6.17,1196
2021-06-30,1135,1070,65,6.07,1196
2021-07-01,1031,1068,-37,-3.46,1196
2021-07-02,921,979,-58,-5.92,1196
2021-07-03,422,464,-42,-9.05,1196
2021-07-04,344,370,-26,-7.03,1196
2021-07-05,1016,1057,-41,-3.88,1196
2021-07-06,1031,1072,-41,-3.82,1196
2021-07-07,1031,1072,-41,-3.82,1196
2021-07-08,1031,1070,-39,-3.64,1196
2021-07-09,921,982,-61,-6.21,1196
2021-07-10,422,467,-45,-9.64,1196
2021-07-11,344,374,-30,-8.02,1196
2021-07-12,1016,1060,-44,-4.15,1196
2021-07-13,1031,1075,-44,-4.09,1196
2021-07-14,1031,1076,-45,-4.18,1196
2021-07-15,1031,1074,-43,-4.0,1196
2021-07-16,921,986,-65,-6.59,1196
2021-07-17,422,471,-49,-10.4,1196
2021-07-18,344,377,-33,-8.75,1196
2021-07-19,1016,1064,-48,-4.51,1196
2021-07-20,1031,1078,-47,-4.36,1196
2021-07-21,1031,1079,-48,-4.45,1196
2021-07-22,1031,1076,-45,-4.18,1196
2021-07-23,921,988,-67,-6.78,1196
2021-07-24,422,472,-50,-10.59,1196
2021-07-25,344,379,-35,-9.23,1196
2021-07-26,1016,1064,-48,-4.51,1196
2021-07-27,1031,1079,-48,-4.45,1196
2021-07-28,1031,1079,-48,-4.45,1196
2021-07-29,1031,1076,-45,-4.18,1196
2021-07-30,921,987,-66,-6.69,1196
2021-07-31,422,471,-49,-10.4,1196
2021-08-01,337,376,-39,-10.37,1196
2021-08-02,947,1062,-115,-10.83,1196
2021-08-03,947,1076,-129,-11.99,1196
2021-08-04,947,1076,-129,-11.99,1196
2021-08-05,947,1073,-126,-11.74,1196
2021-08-06,842,984,-142,-14.43,1196
2021-08-07,390,468,-78,-16.67,1196
2021-08-08,337,374,-37,-9.89,1196
2021-08-09,947,1059,-112,-10.58,1196
2021-08-10,947,1073,-126,-11.74,1196
2021-08-11,947,1073,-126,-11.74,1196
2021-08-12,947,1071,-124,-11.58,1196
2021-08-13,842,982,-140,-14.26,1196
2021-08-14,390,466,-76,-16.31,1196
2021-08-15,337,372,-35,-9.41,1196
2021-08-16,947,1058,-111,-10.49,1196
2021-08-17,947,1072,-125,-11.66,1196
2021-08-18,947,1072,-125,-11.66,1196
2021-08-19,947,1070,-123,-11.5,1196
2021-08-20,842,981,-139,-14.17,1196
2021-08-21,390,465,-75,-16.13,1196
2021-08-22,337,370,-33,-8.92,1196
2021-08-23,947,1056,-109,-10.32,1196
2021-08-24,947,1069,-122,-11.41,1196
2021-08-25,947,1069,-122,-11.41,1196
2021-08-26,947,1065,-118,-11.08,1196
2021-08-27,842,975,-133,-13.64,1196
2021-08-28,390,458,-68,-14.85,1196
2021-08-29,337,362,-25,-6.91,1196
2021-08-30,947,1047,-100,-9.55,1196
2021-08-31,947,1059,-112,-10.58,1196
2021-09-01,1059,1057,2,0.19,1196
2021-09-02,1059,1052,7,0.67,1196
2021-09-03,943,961,-18,-1.87,1196
2021-09-04,405,443,-38,-8.58,1196
2021-09-05,333,347,-14,-4.03,1196
2021-09-06,1123,1031,92,8.92,1196
2021-09-07,1059,1042,17,1.63,1196
2021-09-08,1059,1040,19,1.83,1196
2021-09-09,1059,1035,24,2.32,1196
2021-09-10,943,944,-1,-0.11,1196
2021-09-11,405,427,-22,-5.15,1196
2021-09-12,333,331,2,0.6,1196
2021-09-13,1123,1015,108,10.64,1196
2021-09-14,1059,1028,31,3.02,1196
2021-09-15,1059,1027,32,3.12,1196
2021-09-16,1059,1024,35,3.42,1196
2021-09-17,943,934,9,0.96,1196
2021-09-18,405,419,-14,-3.34,1196
2021-09-19,333,325,8,2.46,1196
2021-09-20,1123,1011,112,11.08,1196
2021-09-21,1059,1026,33,3.22,1196
2021-09-22,1059,1027,32,3.12,1196
2021-09-23,1059,1025,34,3.32,1196
2021-09-24,943,938,5,0.53,1196
2021-09-25,405,424,-19,-4.48,1196
2021-09-26,333,331,2,0.6,1196
2021-09-27,1123,1019,104,10.21,1196
2021-09-28,1059,1035,24,2.32,1196
2021-09-29,1059,1037,22,2.12,1196
2021-09-30,1059,1036,23,2.22,1196
2021-10-01,945,949,-4,-0.42,1196
2021-10-02,428,435,-7,-1.61,1196
2021-10-03,325,343,-18,-5.25,1196
2021-10-04,1028,1030,-2,-0.19,1196
2021-10-05,1076,1045,31,2.97,1196
2021-10-06,1076,1047,29,2.77,1196
2021-10-07,1076,1045,31,2.97,1196
2021-10-08,945,956,-11,-1.15,1196
2021-10-09,428,441,-13,-2.95,1196
2021-10-10,325,347,-22,-6.34,1196
2021-10-11,1028,1033,-5,-0.48,1196
2021-10-12,1076,1047,29,2.77,1196
2021-10-13,1076,1046,30,2.87,1196
2021-10-14,1076,1043,33,3.16,1196
2021-10-15,945,953,-8,-0.84,1196
2021-10-16,428,437,-9,-2.06,1196
2021-10-17,325,342,-17,-4.97,1196
2021-10-18,1028,1027,1,0.1,1196
2021-10-19,1076,1041,35,3.36,1196
2021-10-20,1076,1040,36,3.46,1196
2021-10-21,1076,1037,39,3.76,1196
2021-10-22,945,947,-2,-0.21,1196
2021-10-23,428,431,-3,-0.7,1196
2021-10-24,325,337,-12,-3.56,1196
2021-10-25,1028,1023,5,0.49,1196
2021-10-26,1076,1038,38,3.66,1196
2021-10-27,1076,1038,38,3.66,1196
2021-10-28,1076,1036,40,3.86,1196
2021-10-29,945,948,-3,-0.32,1196
2021-10-30,428,434,-6,-1.38,1196
2021-10-31,325,341,-16,-4.69,1196
2021-11-01,976,1029,-53,-5.15,1196
2021-11-02,1063,1044,19,1.82,1196
2021-11-03,1063,1046,17,1.63,1196
2021-11-04,1063,1045,18,1.72,1196
2021-11-05,955,958,-3,-0.31,1196
2021-11-06,417,444,-27,-6.08,1196
2021-11-07,332,352,-20,-5.68,1196
2021-11-08,976,1039,-63,-6.06,1196
2021-11-09,1063,1055,8,0.76,1196
2021-11-10,1063,1056,7,0.66,1196
2021-11-11,1063,1054,9,0.85,1196
2021-11-12,955,966,-11,-1.14,1196
2021-11-13,417,451,-34,-7.54,1196
2021-11-14,332,357,-25,-7.0,1196
2021-11-15,976,1042,-66,-6.33,1196
2021-11-16,1063,1056,7,0.66,1196
2021-11-17,1063,1055,8,0.76,1196
2021-11-18,1063,1051,12,1.14,1196
2021-11-19,955,960,-5,-0.52,1196
2021-11-20,417,442,-25,-5.66,1196
2021-11-21,332,346,-14,-4.05,1196
2021-11-22,976,1029,-53,-5.15,1196
2021-11-23,1063,1041,22,2.11,1196
2021-11-24,1063,1038,25,2.41,1196
2021-11-25,1063,1033,30,2.9,1196
2021-11-26,955,941,14,1.49,1196
2021-11-27,417,422,-5,-1.18,1196
2021-11-28,332,325,7,2.15,1196
2021-11-29,976,1008,-32,-3.17,1196
2021-11-30,1063,1019,44,4.32,1196
2021-12-01,925,1017,-92,-9.05,1196
2021-12-02,925,1011,-86,-8.51,1196
2021-12-03,712,920,-208,-22.61,1196
2021-12-04,439,402,37,9.2,1196
2021-12-05,326,306,20,6.54,1196
2021-12-06,912,991,-79,-7.97,1196
2021-12-07,925,1003,-78,-7.78,1196
2021-12-08,925,1002,-77,-7.68,1196
2021-12-09,925,999,-74,-7.41,1196
2021-12-10,712,909,-197,-21.67,1196
2021-12-11,439,393,46,11.7,1196
2021-12-12,326,298,28,9.4,1196
2021-12-13,912,984,-72,-7.32,1196
2021-12-14,925,998,-73,-7.31,1196
2021-12-15,925,998,-73,-7.31,1196
2021-12-16,925,995,-70,-7.04,1196
2021-12-17,712,905,-193,-21.33,1196
2021-12-18,439,390,49,12.56,1196
2021-12-19,326,295,31,10.51,1196
2021-12-20,912,981,-69,-7.03,1196
2021-12-21,925,994,-69,-6.94,1196
2021-12-22,925,993,-68,-6.85,1196
2021-12-23,925,990,-65,-6.57,1196
2021-12-24,712,900,-188,-20.89,1196
2021-12-25,439,383,56,14.62,1196
2021-12-26,326,287,39,13.59,1196
2021-12-27,912,971,-59,-6.08,1196
2021-12-28,925,984,-59,-6.0,1196
2021-12-29,925,982,-57,-5.8,1196
2021-12-30,925,977,-52,-5.32,1196
2021-12-31,712,886,-174,-19.64,1196
2022-01-01,398,368,30,8.15,1196
2022-01-02,314,271,43,15.87,1196
2022-01-03,850,955,-105,-10.99,1196
2022-01-04,847,967,-120,-12.41,1196
2022-01-05,847,965,-118,-12.23,1196
2022-01-06,847,960,-113,-11.77,1196
2022-01-07,818,870,-52,-5.98,1196
2022-01-08,398,352,46,13.07,1196
2022-01-09,314,257,57,22.18,1196
2022-01-10,850,942,-92,-9.77,1196
2022-01-11,847,955,-108,-11.31,1196
2022-01-12,847,954,-107,-11.22,1196
2022-01-13,847,951,-104,-10.94,1196
2022-01-14,818,862,-44,-5.1,1196
2022-01-15,398,346,52,15.03,1196
2022-01-16,314,253,61,24.11,1196
2022-01-17,850,939,-89,-9.48,1196
2022-01-18,847,954,-107,-11.22,1196
2022-01-19,847,955,-108,-11.31,1196
2022-01-20,847,953,-106,-11.12,1196
2022-01-21,818,866,-48,-5.54,1196
2022-01-22,398,351,47,13.39,1196
2022-01-23,314,259,55,21.24,1196
2022-01-24,850,946,-96,-10.15,1196
2022-01-25,847,962,-115,-11.95,1196
2022-01-26,847,964,-117,-12.14,1196
2022-01-27,847,962,-115,-11.95,1196
2022-01-28,818,875,-57,-6.51,1196
2022-01-29,398,361,37,10.25,1196
2022-01-30,314,268,46,17.16,1196
2020-02-01,223,212,11,5.19,1197
2020-02-02,134,91,43,47.25,1197
2020-02-03,666,717,-51,-7.11,1197
2020-02-04,659,711,-52,-7.31,1197
2020-02-05,659,714,-55,-7.7,1197
2020-02-06,659,716,-57,-7.96,1197
2020-02-07,586,636,-50,-7.86,1197
2020-02-08,223,233,-10,-4.29,1197
2020-02-09,134,110,24,21.82,1197
2020-02-10,666,735,-69,-9.39,1197
2020-02-11,659,727,-68,-9.35,1197
2020-02-12,659,729,-70,-9.6,1197
2020-02-13,659,730,-71,-9.73,1197
2020-02-14,586,648,-62,-9.57,1197
2020-02-15,223,244,-21,-8.61,1197
2020-02-16,134,120,14,11.67,1197
2020-02-17,666,743,-77,-10.36,1197
2020-02-18,659,735,-76,-10.34,1197
2020-02-19,659,736,-77,-10.46,1197
2020-02-20,659,736,-77,-10.46,1197
2020-02-21,586,654,-68,-10.4,1197
2020-02-22,223,250,-27,-10.8,1197
2020-02-23,134,126,8,6.35,1197
2020-02-24,666,750,-84,-11.2,1197
2020-02-25,659,741,-82,-11.07,1197
2020-02-26,659,743,-84,-11.31,1197
2020-02-27,659,743,-84,-11.31,1197
2020-02-28,586,661,-75,-11.35,1197
2020-02-29,223,258,-35,-13.57,1197
2020-03-01,132,134,-2,-1.49,1197
2020-03-02,490,758,-268,-35.36,1197
2020-03-03,546,750,-204,-27.2,1197
2020-03-04,546,752,-206,-27.39,1197
2020-03-05,546,752,-206,-27.39,1197
2020-03-06,447,671,-224,-33.38,1197
2020-03-07,154,267,-113,-42.32,1197
2020-03-08,132,143,-11,-7.69,1197
2020-03-09,490,767,-277,-36.11,1197
2020-03-10,546,758,-212,-27.97,1197
2020-03-11,546,760,-214,-28.16,1197
2020-03-12,546,760,-214,-28.16,1197
2020-03-13,447,678,-231,-34.07,1197
2020-03-14,154,274,-120,-43.8,1197
2020-03-15,132,149,-17,-11.41,1197
2020-03-16,490,773,-283,-36.61,1197
2020-03-17,546,764,-218,-28.53,1197
2020-03-18,546,765,-219,-28.63,1197
2020-03-19,546,765,-219,-28.63,1197
2020-03-20,447,683,-236,-34.55,1197
2020-03-21,154,278,-124,-44.6,1197
2020-03-22,132,154,-22,-14.29,1197
2020-03-23,490,778,-288,-37.02,1197
2020-03-24,546,769,-223,-29.0,1197
2020-03-25,546,770,-224,-29.09,1197
2020-03-26,546,771,-225,-29.18,1197
2020-03-27,447,689,-242,-35.12,1197
2020-03-28,154,286,-132,-46.15,1197
2020-03-29,132,162,-30,-18.52,1197
2020-03-30,490,787,-297,-37.74,1197
2020-03-31,546,779,-233,-29.91,1197
2020-04-01,529,781,-252,-32.27,1197
2020-04-02,529,782,-253,-32.35,1197
2020-04-03,411,701,-290,-41.37,1197
2020-04-04,146,298,-152,-51.01,1197
2020-04-05,119,175,-56,-32.0,1197
2020-04-06,463,799,-336,-42.05,1197
2020-04-07,529,792,-263,-33.21,1197
2020-04-08,529,794,-265,-33.38,1197
2020-04-09,529,795,-266,-33.46,1197
2020-04-10,411,714,-303,-42.44,1197
2020-04-11,146,310,-164,-52.9,1197
2020-04-12,119,187,-68,-36.36,1197
2020-04-13,463,811,-348,-42.91,1197
2020-04-14,529,802,-273,-34.04,1197
2020-04-15,529,803,-274,-34.12,1197
2020-04-16,529,804,-275,-34.2,1197
2020-04-17,411,721,-310,-43.0,1197
2020-04-18,146,317,-171,-53.94,1197
2020-04-19,119,192,-73,-38.02,1197
2020-04-20,463,815,-352,-43.19,1197
2020-04-21,529,805,-276,-34.29,1197
2020-04-22,529,805,-276,-34.29,1197
2020-04-23,529,805,-276,-34.29,1197
2020-04-24,411,721,-310,-43.0,1197
2020-04-25,146,316,-170,-53.8,1197
2020-04-26,119,191,-72,-37.7,1197
2020-04-27,463,813,-350,-43.05,1197
2020-04-28,529,803,-274,-34.12,1197
2020-04-29,529,803,-274,-34.12,1197
2020-04-30,529,802,-273,-34.04,1197
2020-05-01,623,719,-96,-13.35,1197
2020-05-02,260,313,-53,-16.93,1197
2020-05-03,131,188,-57,-30.32,1197
2020-05-04,730,811,-81,-9.99,1197
2020-05-05,773,801,-28,-3.5,1197
2020-05-06,773,802,-29,-3.62,1197
2020-05-07,773,801,-28,-3.5,1197
2020-05-08,623,719,-96,-13.35,1197
2020-05-09,260,314,-54,-17.2,1197
2020-05-10,131,190,-59,-31.05,1197
2020-05-11,730,813,-83,-10.21,1197
2020-05-12,773,804,-31,-3.86,1197
2020-05-13,773,805,-32,-3.98,1197
2020-05-14,773,804,-31,-3.86,1197
2020-05-15,623,722,-99,-13.71,1197
2020-05-16,260,317,-57,-17.98,1197
2020-05-17,131,193,-62,-32.12,1197
2020-05-18,730,816,-86,-10.54,1197
2020-05-19,773,807,-34,-4.21,1197
2020-05-20,773,808,-35,-4.33,1197
2020-05-21,773,808,-35,-4.33,1197
2020-05-22,623,725,-102,-14.07,1197
2020-05-23,260,321,-61,-19.0,1197
2020-05-24,131,196,-65,-33.16,1197
2020-05-25,730,819,-89,-10.87,1197
2020-05-26,773,810,-37,-4.57,1197
2020-05-27,773,810,-37,-4.57,1197
2020-05-28,773,810,-37,-4.57,1197
2020-05-29,623,727,-104,-14.31,1197
2020-05-30,260,322,-62,-19.25,1197
2020-05-31,131,198,-67,-33.84,1197
2020-06-01,712,821,-109,-13.28,1197
2020-06-02,808,811,-3,-0.37,1197
2020-06-03,808,812,-4,-0.49,1197
2020-06-04,808,812,-4,-0.49,1197
2020-06-05,605,729,-124,-17.01,1197
2020-06-06,281,325,-44,-13.54,1197
2020-06-07,153,200,-47,-23.5,1197
2020-06-08,712,823,-111,-13.49,1197
2020-06-09,808,814,-6,-0.74,1197
2020-06-10,808,815,-7,-0.86,1197
2020-06-11,808,815,-7,-0.86,1197
2020-06-12,605,733,-128,-17.46,1197
2020-06-13,281,328,-47,-14.33,1197
2020-06-14,153,203,-50,-24.63,1197
2020-06-15,712,826,-114,-13.8,1197
2020-06-16,808,817,-9,-1.1,1197
2020-06-17,808,817,-9,-1.1,1197
2020-06-18,808,817,-9,-1.1,1197
2020-06-19,605,734,-129,-17.57,1197
2020-06-20,281,328,-47,-14.33,1197
2020-06-21,153,203,-50,-24.63,1197
2020-06-22,712,825,-113,-13.7,1197
2020-06-23,808,815,-7,-0.86,1197
2020-06-24,808,815,-7,-0.86,1197
2020-06-25,808,813,-5,-0.62,1197
2020-06-26,605,730,-125,-17.12,1197
2020-06-27,281,324,-43,-13.27,1197
2020-06-28,153,198,-45,-22.73,1197
2020-06-29,712,819,-107,-13.06,1197
2020-06-30,808,809,-1,-0.12,1197
2020-07-01,760,808,-48,-5.94,1197
2020-07-02,760,806,-46,-5.71,1197
2020-07-03,580,723,-143,-19.78,1197
2020-07-04,248,317,-69,-21.77,1197
2020-07-05,138,191,-53,-27.75,1197
2020-07-06,704,813,-109,-13.41,1197
2020-07-07,760,803,-43,-5.35,1197
2020-07-08,760,803,-43,-5.35,1197
2020-07-09,760,802,-42,-5.24,1197
2020-07-10,580,719,-139,-19.33,1197
2020-07-11,248,313,-65,-20.77,1197
2020-07-12,138,188,-50,-26.6,1197
2020-07-13,704,811,-107,-13.19,1197
2020-07-14,760,802,-42,-5.24,1197
2020-07-15,760,802,-42,-5.24,1197
2020-07-16,760,802,-42,-5.24,1197
2020-07-17,580,719,-139,-19.33,1197
2020-07-18,248,314,-66,-21.02,1197
2020-07-19,138,189,-51,-26.98,1197
2020-07-20,704,811,-107,-13.19,1197
2020-07-21,760,801,-41,-5.12,1197
2020-07-22,760,801,-41,-5.12,1197
2020-07-23,760,799,-39,-4.88,1197
2020-07-24,580,715,-135,-18.88,1197
2020-07-25,248,309,-61,-19.74,1197
2020-07-26,138,182,-44,-24.18,1197
2020-07-27,704,803,-99,-12.33,1197
2020-07-28,760,792,-32,-4.04,1197
2020-07-29,760,789,-29,-3.68,1197
2020-07-30,760,786,-26,-3.31,1197
2020-07-31,580,700,-120,-17.14,1197
2020-08-01,269,292,-23,-7.88,1197
2020-08-02,129,164,-35,-21.34,1197
2020-08-03,595,784,-189,-24.11,1197
2020-08-04,658,771,-113,-14.66,1197
2020-08-05,658,767,-109,-14.21,1197
2020-08-06,658,763,-105,-13.76,1197
2020-08-07,533,677,-144,-21.27,1197
2020-08-08,269,269,0,0.0,1197
2020-08-09,129,141,-12,-8.51,1197
2020-08-10,595,761,-166,-21.81,1197
2020-08-11,658,749,-91,-12.15,1197
2020-08-12,658,748,-90,-12.03,1197
2020-08-13,658,745,-87,-11.68,1197
2020-08-14,533,661,-128,-19.36,1197
2020-08-15,269,255,14,5.49,1197
2020-08-16,129,130,-1,-0.77,1197
2020-08-17,595,753,-158,-20.98,1197
2020-08-18,658,744,-86,-11.56,1197
2020-08-19,658,745,-87,-11.68,1197
2020-08-20,658,746,-88,-11.8,1197
2020-08-21,533,665,-132,-19.85,1197
2020-08-22,269,262,7,2.67,1197
2020-08-23,129,140,-11,-7.86,1197
2020-08-24,595,766,-171,-22.32,1197
2020-08-25,658,759,-101,-13.31,1197
2020-08-26,658,763,-105,-13.76,1197
2020-08-27,658,765,-107,-13.99,1197
2020-08-28,533,686,-153,-22.3,1197
2020-08-29,269,284,-15,-5.28,1197
2020-08-30,129,162,-33,-20.37,1197
2020-08-31,595,788,-193,-24.49,1197
2020-09-01,874,781,93,11.91,1197
2020-09-02,874,784,90,11.48,1197
2020-09-03,874,786,88,11.2,1197
2020-09-04,778,705,73,10.35,1197
2020-09-05,271,302,-31,-10.26,1197
2020-09-06,143,178,-35,-19.66,1197
2020-09-07,867,802,65,8.1,1197
2020-09-08,874,794,80,10.08,1197
2020-09-09,874,795,79,9.94,1197
2020-09-10,874,794,80,10.08,1197
2020-09-11,778,711,67,9.42,1197
2020-09-12,271,306,-35,-11.44,1197
2020-09-13,143,181,-38,-20.99,1197
2020-09-14,867,803,64,7.97,1197
2020-09-15,874,793,81,10.21,1197
2020-09-16,874,793,81,10.21,1197
2020-09-17,874,792,82,10.35,1197
2020-09-18,778,709,69,9.73,1197
2020-09-19,271,304,-33,-10.86,1197
2020-09-20,143,179,-36,-20.11,1197
2020-09-21,867,802,65,8.1,1197
2020-09-22,874,793,81,10.21,1197
2020-09-23,874,794,80,10.08,1197
2020-09-24,874,794,80,10.08,1197
2020-09-25,778,712,66,9.27,1197
2020-09-26,271,309,-38,-12.3,1197
2020-09-27,143,186,-43,-23.12,1197
2020-09-28,867,810,57,7.04,1197
2020-09-29,874,803,71,8.84,1197
2020-09-30,874,805,69,8.57,1197
2020-10-01,837,807,30,3.72,1197
2020-10-02,696,727,-31,-4.26,1197
2020-10-03,241,324,-83,-25.62,1197
2020-10-04,138,202,-64,-31.68,1197
2020-10-05,838,827,11,1.33,1197
2020-10-06,837,819,18,2.2,1197
2020-10-07,837,822,15,1.82,1197
2020-10-08,837,823,14,1.7,1197
2020-10-09,696,742,-46,-6.2,1197
2020-10-10,241,338,-97,-28.7,1197
2020-10-11,138,214,-76,-35.51,1197
2020-10-12,838,837,1,0.12,1197
2020-10-13,837,828,9,1.09,1197
2020-10-14,837,828,9,1.09,1197
2020-10-15,837,827,10,1.21,1197
2020-10-16,696,743,-47,-6.33,1197
2020-10-17,241,337,-96,-28.49,1197
2020-10-18,138,210,-72,-34.29,1197
2020-10-19,838,831,7,0.84,1197
2020-10-20,837,820,17,2.07,1197
2020-10-21,837,818,19,2.32,1197
2020-10-22,837,815,22,2.7,1197
2020-10-23,696,730,-34,-4.66,1197
2020-10-24,241,323,-82,-25.39,1197
2020-10-25,138,196,-58,-29.59,1197
2020-10-26,838,817,21,2.57,1197
2020-10-27,837,805,32,3.98,1197
2020-10-28,837,804,33,4.1,1197
2020-10-29,837,802,35,4.36,1197
2020-10-30,696,717,-21,-2.93,1197
2020-10-31,241,311,-70,-22.51,1197
2020-11-01,142,185,-43,-23.24,1197
2020-11-02,798,808,-10,-1.24,1197
2020-11-03,878,798,80,10.03,1197
2020-11-04,878,798,80,10.03,1197
2020-11-05,878,797,81,10.16,1197
2020-11-06,743,715,28,3.92,1197
2020-11-07,234,310,-76,-24.52,1197
2020-11-08,142,185,-43,-23.24,1197
2020-11-09,798,808,-10,-1.24,1197
2020-11-10,878,799,79,9.89,1197
2020-11-11,878,800,78,9.75,1197
2020-11-12,878,799,79,9.89,1197
2020-11-13,743,716,27,3.77,1197
2020-11-14,234,311,-77,-24.76,1197
2020-11-15,142,185,-43,-23.24,1197
2020-11-16,798,807,-9,-1.12,1197
2020-11-17,878,796,82,10.3,1197
2020-11-18,878,795,83,10.44,1197
2020-11-19,878,792,86,10.86,1197
2020-11-20,743,707,36,5.09,1197
2020-11-21,234,299,-65,-21.74,1197
2020-11-22,142,171,-29,-16.96,1197
2020-11-23,798,790,8,1.01,1197
2020-11-24,878,777,101,13.0,1197
2020-11-25,878,773,105,13.58,1197
2020-11-26,878,768,110,14.32,1197
2020-11-27,743,681,62,9.1,1197
2020-11-28,234,271,-37,-13.65,1197
2020-11-29,142,142,0,0.0,1197
2020-11-30,798,760,38,5.0,1197
2020-12-01,635,746,-111,-14.88,1197
2020-12-02,635,741,-106,-14.3,1197
2020-12-03,635,737,-102,-13.84,1197
2020-12-04,642,650,-8,-1.23,1197
2020-12-05,252,241,11,4.56,1197
2020-12-06,156,112,44,39.29,1197
2020-12-07,624,732,-108,-14.75,1197
2020-12-08,635,719,-84,-11.68,1197
2020-12-09,635,717,-82,-11.44,1197
2020-12-10,635,714,-79,-11.06,1197
2020-12-11,642,629,13,2.07,1197
2020-12-12,252,223,29,13.0,1197
2020-12-13,156,96,60,62.5,1197
2020-12-14,624,718,-94,-13.09,1197
2020-12-15,635,708,-73,-10.31,1197
2020-12-16,635,708,-73,-10.31,1197
2020-12-17,635,706,-71,-10.06,1197
2020-12-18,642,623,19,3.05,1197
2020-12-19,252,218,34,15.6,1197
2020-12-20,156,92,64,69.57,1197
2020-12-21,624,714,-90,-12.61,1197
2020-12-22,635,704,-69,-9.8,1197
2020-12-23,635,704,-69,-9.8,1197
2020-12-24,635,702,-67,-9.54,1197
2020-12-25,642,618,24,3.88,1197
2020-12-26,252,211,41,19.43,1197
2020-12-27,156,85,71,83.53,1197
2020-12-28,624,706,-82,-11.61,1197
2020-12-29,635,694,-59,-8.5,1197
2020-12-30,635,692,-57,-8.24,1197
2020-12-31,635,688,-53,-7.7,1197
2021-01-01,550,602,-52,-8.64,1197
2021-01-02,235,194,41,21.13,1197
2021-01-03,142,66,76,115.15,1197
2021-01-04,608,686,-78,-11.37,1197
2021-01-05,642,673,-31,-4.61,1197
2021-01-06,642,670,-28,-4.18,1197
2021-01-07,642,666,-24,-3.6,1197
2021-01-08,550,581,-31,-5.34,1197
2021-01-09,235,173,62,35.84,1197
2021-01-10,142,46,96,208.7,1197
2021-01-11,608,666,-58,-8.71,1197
2021-01-12,642,655,-13,-1.98,1197
2021-01-13,642,654,-12,-1.83,1197
2021-01-14,642,653,-11,-1.68,1197
2021-01-15,550,569,-19,-3.34,1197
2021-01-16,235,164,71,43.29,1197
2021-01-17,142,40,102,255.0,1197
2021-01-18,608,664,-56,-8.43,1197
2021-01-19,642,656,-14,-2.13,1197
2021-01-20,642,658,-16,-2.43,1197
2021-01-21,642,659,-17,-2.58,1197
2021-01-22,550,579,-29,-5.01,1197
2021-01-23,235,177,58,32.77,1197
2021-01-24,142,55,87,158.18,1197
2021-01-25,608,681,-73,-10.72,1197
2021-01-26,642,676,-34,-5.03,1197
2021-01-27,642,680,-38,-5.59,1197
2021-01-28,642,683,-41,-6.0,1197
2021-01-29,550,604,-54,-8.94,1197
2021-01-30,235,202,33,16.34,1197
2021-01-31,142,81,61,75.31,1197
2021-02-01,694,708,-14,-1.98,1197
2021-02-02,676,702,-26,-3.7,1197
2021-02-03,676,705,-29,-4.11,1197
2021-02-04,676,708,-32,-4.52,1197
2021-02-05,623,628,-5,-0.8,1197
2021-02-06,244,225,19,8.44,1197
2021-02-07,146,103,43,41.75,1197
2021-02-08,694,727,-33,-4.54,1197
2021-02-09,676,720,-44,-6.11,1197
2021-02-10,676,722,-46,-6.37,1197
2021-02-11,676,723,-47,-6.5,1197
2021-02-12,623,641,-18,-2.81,1197
2021-02-13,244,237,7,2.95,1197
2021-02-14,146,113,33,29.2,1197
2021-02-15,694,737,-43,-5.83,1197
2021-02-16,676,729,-53,-7.27,1197
2021-02-17,676,730,-54,-7.4,1197
2021-02-18,676,730,-54,-7.4,1197
2021-02-19,623,648,-25,-3.86,1197
2021-02-20,244,243,1,0.41,1197
2021-02-21,146,119,27,22.69,1197
2021-02-22,694,743,-49,-6.59,1197
2021-02-23,676,735,-59,-8.03,1197
2021-02-24,676,736,-60,-8.15,1197
2021-02-25,676,736,-60,-8.15,1197
2021-02-26,623,655,-32,-4.89,1197
2021-02-27,244,251,-7,-2.79,1197
2021-02-28,146,127,19,14.96,1197
2021-03-01,820,751,69,9.19,1197
2021-03-02,781,743,38,5.11,1197
2021-03-03,781,745,36,4.83,1197
2021-03-04,781,745,36,4.83,1197
2021-03-05,678,664,14,2.11,1197
2021-03-06,268,260,8,3.08,1197
2021-03-07,150,136,14,10.29,1197
2021-03-08,820,760,60,7.89,1197
2021-03-09,781,752,29,3.86,1197
2021-03-10,781,753,28,3.72,1197
2021-03-11,781,754,27,3.58,1197
2021-03-12,678,672,6,0.89,1197
2021-03-13,268,267,1,0.37,1197
2021-03-14,150,143,7,4.9,1197
2021-03-15,820,767,53,6.91,1197
2021-03-16,781,758,23,3.03,1197
2021-03-17,781,759,22,2.9,1197
2021-03-18,781,759,22,2.9,1197
2021-03-19,678,677,1,0.15,1197
2021-03-20,268,272,-4,-1.47,1197
2021-03-21,150,148,2,1.35,1197
2021-03-22,820,772,48,6.22,1197
2021-03-23,781,763,18,2.36,1197
2021-03-24,781,764,17,2.23,1197
2021-03-25,781,764,17,2.23,1197
2021-03-26,678,683,-5,-0.73,1197
2021-03-27,268,279,-11,-3.94,1197
2021-03-28,150,155,-5,-3.23,1197
2021-03-29,820,779,41,5.26,1197
2021-03-30,781,771,10,1.3,1197
2021-03-31,781,773,8,1.03,1197
2021-04-01,817,775,42,5.42,1197
2021-04-02,703,693,10,1.44,1197
2021-04-03,254,290,-36,-12.41,1197
2021-04-04,139,167,-28,-16.77,1197
2021-04-05,811,792,19,2.4,1197
2021-04-06,817,784,33,4.21,1197
2021-04-07,817,786,31,3.94,1197
2021-04-08,817,788,29,3.68,1197
2021-04-09,703,707,-4,-0.57,1197
2021-04-10,254,303,-49,-16.17,1197
2021-04-11,139,180,-41,-22.78,1197
2021-04-12,811,804,7,0.87,1197
2021-04-13,817,796,21,2.64,1197
2021-04-14,817,797,20,2.51,1197
2021-04-15,817,797,20,2.51,1197
2021-04-16,703,715,-12,-1.68,1197
2021-04-17,254,311,-57,-18.33,1197
2021-04-18,139,186,-47,-25.27,1197
2021-04-19,811,809,2,0.25,1197
2021-04-20,817,800,17,2.12,1197
2021-04-21,817,800,17,2.12,1197
2021-04-22,817,800,17,2.12,1197
2021-04-23,703,717,-14,-1.95,1197
2021-04-24,254,311,-57,-18.33,1197
2021-04-25,139,186,-47,-25.27,1197
2021-04-26,811,808,3,0.37,1197
2021-04-27,817,798,19,2.38,1197
2021-04-28,817,798,19,2.38,1197
2021-04-29,817,797,20,2.51,1197
2021-04-30,703,714,-11,-1.54,1197
2021-05-01,302,308,-6,-1.95,1197
2021-05-02,153,183,-30,-16.39,1197
2021-05-03,954,806,148,18.36,1197
2021-05-04,915,796,119,14.95,1197
2021-05-05,915,797,118,14.81,1197
2021-05-06,915,796,119,14.95,1197
2021-05-07,744,713,31,4.35,1197
2021-05-08,302,308,-6,-1.95,1197
2021-05-09,153,184,-31,-16.85,1197
2021-05-10,954,807,147,18.22,1197
2021-05-11,915,798,117,14.66,1197
2021-05-12,915,799,116,14.52,1197
2021-05-13,915,799,116,14.52,1197
2021-05-14,744,716,28,3.91,1197
2021-05-15,302,312,-10,-3.21,1197
2021-05-16,153,187,-34,-18.18,1197
2021-05-17,954,811,143,17.63,1197
2021-05-18,915,802,113,14.09,1197
2021-05-19,915,802,113,14.09,1197
2021-05-20,915,802,113,14.09,1197
2021-05-21,744,720,24,3.33,1197
2021-05-22,302,315,-13,-4.13,1197
2021-05-23,153,190,-37,-19.47,1197
2021-05-24,954,814,140,17.2,1197
2021-05-25,915,804,111,13.81,1197
2021-05-26,915,805,110,13.66,1197
2021-05-27,915,804,111,13.81,1197
2021-05-28,744,722,22,3.05,1197
2021-05-29,302,317,-15,-4.73,1197
2021-05-30,153,192,-39,-20.31,1197
2021-05-31,954,815,139,17.06,1197
2021-06-01,977,806,171,21.22,1197
2021-06-02,977,807,170,21.07,1197
2021-06-03,977,806,171,21.22,1197
2021-06-04,818,724,94,12.98,1197
2021-06-05,346,319,27,8.46,1197
2021-06-06,150,194,-44,-22.68,1197
2021-06-07,928,818,110,13.45,1197
2021-06-08,977,809,168,20.77,1197
2021-06-09,977,809,168,20.77,1197
2021-06-10,977,809,168,20.77,1197
2021-06-11,818,727,91,12.52,1197
2021-06-12,346,322,24,7.45,1197
2021-06-13,150,198,-48,-24.24,1197
2021-06-14,928,821,107,13.03,1197
2021-06-15,977,812,165,20.32,1197
2021-06-16,977,812,165,20.32,1197
2021-06-17,977,812,165,20.32,1197
2021-06-18,818,729,89,12.21,1197
2021-06-19,346,323,23,7.12,1197
2021-06-20,150,198,-48,-24.24,1197
2021-06-21,928,821,107,13.03,1197
2021-06-22,977,811,166,20.47,1197
2021-06-23,977,811,166,20.47,1197
2021-06-24,977,809,168,20.77,1197
2021-06-25,818,726,92,12.67,1197
2021-06-26,346,320,26,8.12,1197
2021-06-27,150,194,-44,-22.68,1197
2021-06-28,928,816,112,13.73,1197
2021-06-29,977,805,172,21.37,1197
2021-06-30,977,804,173,21.52,1197
2021-07-01,798,803,-5,-0.62,1197
2021-07-02,726,719,7,0.97,1197
2021-07-03,293,313,-20,-6.39,1197
2021-07-04,149,187,-38,-20.32,1197
2021-07-05,839,809,30,3.71,1197
2021-07-06,798,798,0,0.0,1197
2021-07-07,798,798,0,0.0,1197
2021-07-08,798,797,1,0.13,1197
2021-07-09,726,714,12,1.68,1197
2021-07-10,293,308,-15,-4.87,1197
2021-07-11,149,183,-34,-18.58,1197
2021-07-12,839,806,33,4.09,1197
2021-07-13,798,796,2,0.25,1197
2021-07-14,798,797,1,0.13,1197
2021-07-15,798,796,2,0.25,1197
2021-07-16,726,714,12,1.68,1197
2021-07-17,293,308,-15,-4.87,1197
2021-07-18,149,184,-35,-19.02,1197
2021-07-19,839,806,33,4.09,1197
2021-07-20,798,796,2,0.25,1197
2021-07-21,798,796,2,0.25,1197
2021-07-22,798,795,3,0.38,1197
2021-07-23,726,712,14,1.97,1197
2021-07-24,293,305,-12,-3.93,1197
2021-07-25,149,179,-30,-16.76,1197
2021-07-26,839,800,39,4.88,1197
2021-07-27,798,789,9,1.14,1197
2021-07-28,798,787,11,1.4,1197
2021-07-29,798,784,14,1.79,1197
2021-07-30,726,699,27,3.86,1197
2021-07-31,293,291,2,0.69,1197
2021-08-01,148,163,-15,-9.2,1197
2021-08-02,714,783,-69,-8.81,1197
2021-08-03,683,770,-87,-11.3,1197
2021-08-04,683,767,-84,-10.95,1197
2021-08-05,683,763,-80,-10.48,1197
2021-08-06,572,676,-104,-15.38,1197
2021-08-07,240,268,-28,-10.45,1197
2021-08-08,148,140,8,5.71,1197
2021-08-09,714,759,-45,-5.93,1197
2021-08-10,683,747,-64,-8.57,1197
2021-08-11,683,745,-62,-8.32,1197
2021-08-12,683,742,-59,-7.95,1197
2021-08-13,572,658,-86,-13.07,1197
2021-08-14,240,251,-11,-4.38,1197
2021-08-15,148,125,23,18.4,1197
2021-08-16,714,748,-34,-4.55,1197
2021-08-17,683,738,-55,-7.45,1197
2021-08-18,683,739,-56,-7.58,1197
2021-08-19,683,739,-56,-7.58,1197
2021-08-20,572,658,-86,-13.07,1197
2021-08-21,240,255,-15,-5.88,1197
2021-08-22,148,132,16,12.12,1197
2021-08-23,714,757,-43,-5.68,1197
2021-08-24,683,750,-67,-8.93,1197
2021-08-25,683,754,-71,-9.42,1197
2021-08-26,683,756,-73,-9.66,1197
2021-08-27,572,676,-104,-15.38,1197
2021-08-28,240,275,-35,-12.73,1197
2021-08-29,148,153,-5,-3.27,1197
2021-08-30,714,779,-65,-8.34,1197
2021-08-31,683,772,-89,-11.53,1197
2021-09-01,777,776,1,0.13,1197
2021-09-02,777,778,-1,-0.13,1197
2021-09-03,674,697,-23,-3.3,1197
2021-09-04,250,294,-44,-14.97,1197
2021-09-05,159,171,-12,-7.02,1197
2021-09-06,818,796,22,2.76,1197
2021-09-07,777,787,-10,-1.27,1197
2021-09-08,777,789,-12,-1.52,1197
2021-09-09,777,789,-12,-1.52,1197
2021-09-10,674,706,-32,-4.53,1197
2021-09-11,250,301,-51,-16.94,1197
2021-09-12,159,176,-17,-9.66,1197
2021-09-13,818,799,19,2.38,1197
2021-09-14,777,789,-12,-1.52,1197
2021-09-15,777,789,-12,-1.52,1197
2021-09-16,777,788,-11,-1.4,1197
2021-09-17,674,704,-30,-4.26,1197
2021-09-18,250,299,-49,-16.39,1197
2021-09-19,159,174,-15,-8.62,1197
2021-09-20,818,796,22,2.76,1197
2021-09-21,777,787,-10,-1.27,1197
2021-09-22,777,788,-11,-1.4,1197
2021-09-23,777,788,-11,-1.4,1197
2021-09-24,674,706,-32,-4.53,1197
2021-09-25,250,302,-52,-17.22,1197
2021-09-26,159,178,-19,-10.67,1197
2021-09-27,818,803,15,1.87,1197
2021-09-28,777,795,-18,-2.26,1197
2021-09-29,777,797,-20,-2.51,1197
2021-09-30,777,799,-22,-2.75,1197
2021-10-01,708,719,-11,-1.53,1197
2021-10-02,256,316,-60,-18.99,1197
2021-10-03,154,193,-39,-20.21,1197
2021-10-04,791,819,-28,-3.42,1197
2021-10-05,830,811,19,2.34,1197
2021-10-06,830,814,16,1.97,1197
2021-10-07,830,816,14,1.72,1197
2021-10-08,708,735,-27,-3.67,1197
2021-10-09,256,331,-75,-22.66,1197
2021-10-10,154,207,-53,-25.6,1197
2021-10-11,791,831,-40,-4.81,1197
2021-10-12,830,822,8,0.97,1197
2021-10-13,830,823,7,0.85,1197
2021-10-14,830,822,8,0.97,1197
2021-10-15,708,739,-31,-4.19,1197
2021-10-16,256,333,-77,-23.12,1197
2021-10-17,154,207,-53,-25.6,1197
2021-10-18,791,828,-37,-4.47,1197
2021-10-19,830,817,13,1.59,1197
2021-10-20,830,815,15,1.84,1197
2021-10-21,830,813,17,2.09,1197
2021-10-22,708,728,-20,-2.75,1197
2021-10-23,256,320,-64,-20.0,1197
2021-10-24,154,193,-39,-20.21,1197
2021-10-25,791,814,-23,-2.83,1197
2021-10-26,830,802,28,3.49,1197
2021-10-27,830,801,29,3.62,1197
2021-10-28,830,798,32,4.01,1197
2021-10-29,708,714,-6,-0.84,1197
2021-10-30,256,307,-51,-16.61,1197
2021-10-31,154,181,-27,-14.92,1197
2021-11-01,825,803,22,2.74,1197
2021-11-02,856,793,63,7.94,1197
2021-11-03,856,793,63,7.94,1197
2021-11-04,856,792,64,8.08,1197
2021-11-05,741,709,32,4.51,1197
2021-11-06,278,304,-26,-8.55,1197
2021-11-07,154,180,-26,-14.44,1197
2021-11-08,825,803,22,2.74,1197
2021-11-09,856,794,62,7.81,1197
2021-11-10,856,794,62,7.81,1197
2021-11-11,856,794,62,7.81,1197
2021-11-12,741,711,30,4.22,1197
2021-11-13,278,306,-28,-9.15,1197
2021-11-14,154,181,-27,-14.92,1197
2021-11-15,825,803,22,2.74,1197
2021-11-16,856,793,63,7.94,1197
2021-11-17,856,792,64,8.08,1197
2021-11-18,856,790,66,8.35,1197
2021-11-19,741,705,36,5.11,1197
2021-11-20,278,297,-19,-6.4,1197
2021-11-21,154,170,-16,-9.41,1197
2021-11-22,825,789,36,4.56,1197
2021-11-23,856,776,80,10.31,1197
2021-11-24,856,773,83,10.74,1197
2021-11-25,856,768,88,11.46,1197
2021-11-26,741,681,60,8.81,1197
2021-11-27,278,272,6,2.21,1197
2021-11-28,154,142,12,8.45,1197
2021-11-29,825,760,65,8.55,1197
2021-11-30,856,746,110,14.75,1197
2021-12-01,690,742,-52,-7.01,1197
2021-12-02,690,737,-47,-6.38,1197
2021-12-03,555,650,-95,-14.62,1197
2021-12-04,262,240,22,9.17,1197
2021-12-05,155,111,44,39.64,1197
2021-12-06,759,731,28,3.83,1197
2021-12-07,690,718,-28,-3.9,1197
2021-12-08,690,715,-25,-3.5,1197
2021-12-09,690,712,-22,-3.09,1197
2021-12-10,555,627,-72,-11.48,1197
2021-12-11,262,219,43,19.63,1197
2021-12-12,155,93,62,66.67,1197
2021-12-13,759,714,45,6.3,1197
2021-12-14,690,704,-14,-1.99,1197
2021-12-15,690,703,-13,-1.85,1197
2021-12-16,690,702,-12,-1.71,1197
2021-12-17,555,619,-64,-10.34,1197
2021-12-18,262,213,49,23.0,1197
2021-12-19,155,88,67,76.14,1197
2021-12-20,759,710,49,6.9,1197
2021-12-21,690,700,-10,-1.43,1197
2021-12-22,690,700,-10,-1.43,1197
2021-12-23,690,698,-8,-1.15,1197
2021-12-24,555,614,-59,-9.61,1197
2021-12-25,262,208,54,25.96,1197
2021-12-26,155,82,73,89.02,1197
2021-12-27,759,703,56,7.97,1197
2021-12-28,690,691,-1,-0.14,1197
2021-12-29,690,689,1,0.15,1197
2021-12-30,690,686,4,0.58,1197
2021-12-31,555,601,-46,-7.65,1197
2022-01-01,237,193,44,22.8,1197
2022-01-02,136,65,71,109.23,1197
2022-01-03,636,685,-49,-7.15,1197
2022-01-04,639,672,-33,-4.91,1197
2022-01-05,639,669,-30,-4.48,1197
2022-01-06,639,665,-26,-3.91,1197
2022-01-07,572,579,-7,-1.21,1197
2022-01-08,237,171,66,38.6,1197
2022-01-09,136,43,93,216.28,1197
2022-01-10,636,664,-28,-4.22,1197
2022-01-11,639,652,-13,-1.99,1197
2022-01-12,639,651,-12,-1.84,1197
2022-01-13,639,649,-10,-1.54,1197
2022-01-14,572,565,7,1.24,1197
2022-01-15,237,159,78,49.06,1197
2022-01-16,136,34,102,300.0,1197
2022-01-17,636,657,-21,-3.2,1197
2022-01-18,639,649,-10,-1.54,1197
2022-01-19,639,650,-11,-1.69,1197
2022-01-20,639,651,-12,-1.84,1197
2022-01-21,572,571,1,0.18,1197
2022-01-22,237,168,69,41.07,1197
2022-01-23,136,46,90,195.65,1197
2022-01-24,636,672,-36,-5.36,1197
2022-01-25,639,666,-27,-4.05,1197
2022-01-26,639,670,-31,-4.63,1197
2022-01-27,639,673,-34,-5.05,1197
2022-01-28,572,594,-22,-3.7,1197
2022-01-29,237,192,45,23.44,1197
2022-01-30,136,71,65,91.55,1197
2020-02-01,487,319,168,52.66,1199
2020-02-02,331,183,148,80.87,1199
2020-02-03,1244,1250,-6,-0.48,1199
2020-02-04,1276,1264,12,0.95,1199
2020-02-05,1276,1268,8,0.63,1199
2020-02-06,1276,1268,8,0.63,1199
2020-02-07,1212,1163,49,4.21,1199
2020-02-08,487,333,154,46.25,1199
2020-02-09,331,195,136,69.74,1199
2020-02-10,1244,1261,-17,-1.35,1199
2020-02-11,1276,1275,1,0.08,1199
2020-02-12,1276,1277,-1,-0.08,1199
2020-02-13,1276,1278,-2,-0.16,1199
2020-02-14,1212,1173,39,3.32,1199
2020-02-15,487,343,144,41.98,1199
2020-02-16,331,206,125,60.68,1199
2020-02-17,1244,1273,-29,-2.28,1199
2020-02-18,1276,1289,-13,-1.01,1199
2020-02-19,1276,1293,-17,-1.31,1199
2020-02-20,1276,1296,-20,-1.54,1199
2020-02-21,1212,1193,19,1.59,1199
2020-02-22,487,366,121,33.06,1199
2020-02-23,331,231,100,43.29,1199
2020-02-24,1244,1301,-57,-4.38,1199
2020-02-25,1276,1319,-43,-3.26,1199
2020-02-26,1276,1326,-50,-3.77,1199
2020-02-27,1276,1331,-55,-4.13,1199
2020-02-28,1212,1229,-17,-1.38,1199
2020-02-29,487,404,83,20.54,1199
2020-03-01,310,270,40,14.81,1199
2020-03-02,1127,1341,-214,-15.96,1199
2020-03-03,1163,1359,-196,-14.42,1199
2020-03-04,1163,1366,-203,-14.86,1199
2020-03-05,1163,1370,-207,-15.11,1199
2020-03-06,1075,1268,-193,-15.22,1199
2020-03-07,433,441,-8,-1.81,1199
2020-03-08,310,306,4,1.31,1199
2020-03-09,1127,1375,-248,-18.04,1199
2020-03-10,1163,1390,-227,-16.33,1199
2020-03-11,1163,1395,-232,-16.63,1199
2020-03-12,1163,1396,-233,-16.69,1199
2020-03-13,1075,1292,-217,-16.8,1199
2020-03-14,433,462,-29,-6.28,1199
2020-03-15,310,324,-14,-4.32,1199
2020-03-16,1127,1391,-264,-18.98,1199
2020-03-17,1163,1404,-241,-17.17,1199
2020-03-18,1163,1407,-244,-17.34,1199
2020-03-19,1163,1407,-244,-17.34,1199
2020-03-20,1075,1301,-226,-17.37,1199
2020-03-21,433,471,-38,-8.07,1199
2020-03-22,310,332,-22,-6.63,1199
2020-03-23,1127,1399,-272,-19.44,1199
2020-03-24,1163,1413,-250,-17.69,1199
2020-03-25,1163,1416,-253,-17.87,1199
2020-03-26,1163,1417,-254,-17.93,1199
2020-03-27,1075,1312,-237,-18.06,1199
2020-03-28,433,484,-51,-10.54,1199
2020-03-29,310,347,-37,-10.66,1199
2020-03-30,1127,1415,-288,-20.35,1199
2020-03-31,1163,1431,-268,-18.73,1199
2020-04-01,1185,1436,-251,-17.48,1199
2020-04-02,1185,1439,-254,-17.65,1199
2020-04-03,1049,1336,-287,-21.48,1199
2020-04-04,433,509,-76,-14.93,1199
2020-04-05,291,374,-83,-22.19,1199
2020-04-06,1213,1443,-230,-15.94,1199
2020-04-07,1185,1460,-275,-18.84,1199
2020-04-08,1185,1465,-280,-19.11,1199
2020-04-09,1185,1468,-283,-19.28,1199
2020-04-10,1049,1365,-316,-23.15,1199
2020-04-11,433,537,-104,-19.37,1199
2020-04-12,291,401,-110,-27.43,1199
2020-04-13,1213,1469,-256,-17.43,1199
2020-04-14,1185,1483,-298,-20.09,1199
2020-04-15,1185,1487,-302,-20.31,1199
2020-04-16,1185,1488,-303,-20.36,1199
2020-04-17,1049,1382,-333,-24.1,1199
2020-04-18,433,552,-119,-21.56,1199
2020-04-19,291,413,-122,-29.54,1199
2020-04-20,1213,1478,-265,-17.93,1199
2020-04-21,1185,1491,-306,-20.52,1199
2020-04-22,1185,1493,-308,-20.63,1199
2020-04-23,1185,1491,-306,-20.52,1199
2020-04-24,1049,1384,-335,-24.21,1199
2020-04-25,433,553,-120,-21.7,1199
2020-04-26,291,413,-122,-29.54,1199
2020-04-27,1213,1478,-265,-17.93,1199
2020-04-28,1185,1490,-305,-20.47,1199
2020-04-29,1185,1492,-307,-20.58,1199
2020-04-30,1185,1491,-306,-20.52,1199
2020-05-01,1356,1384,-28,-2.02,1199
2020-05-02,522,553,-31,-5.61,1199
2020-05-03,341,415,-74,-17.83,1199
2020-05-04,1414,1481,-67,-4.52,1199
2020-05-05,1428,1495,-67,-4.48,1199
2020-05-06,1428,1498,-70,-4.67,1199
2020-05-07,1428,1499,-71,-4.74,1199
2020-05-08,1356,1393,-37,-2.66,1199
2020-05-09,522,564,-42,-7.45,1199
2020-05-10,341,426,-85,-19.95,1199
2020-05-11,1414,1493,-79,-5.29,1199
2020-05-12,1428,1508,-80,-5.31,1199
2020-05-13,1428,1511,-83,-5.49,1199
2020-05-14,1428,1512,-84,-5.56,1199
2020-05-15,1356,1407,-51,-3.62,1199
2020-05-16,522,576,-54,-9.38,1199
2020-05-17,341,438,-97,-22.15,1199
2020-05-18,1414,1504,-90,-5.98,1199
2020-05-19,1428,1517,-89,-5.87,1199
2020-05-20,1428,1519,-91,-5.99,1199
2020-05-21,1428,1518,-90,-5.93,1199
2020-05-22,1356,1410,-54,-3.83,1199
2020-05-23,522,578,-56,-9.69,1199
2020-05-24,341,438,-97,-22.15,1199
2020-05-25,1414,1502,-88,-5.86,1199
2020-05-26,1428,1513,-85,-5.62,1199
2020-05-27,1428,1513,-85,-5.62,1199
2020-05-28,1428,1510,-82,-5.43,1199
2020-05-29,1356,1401,-45,-3.21,1199
2020-05-30,522,568,-46,-8.1,1199
2020-05-31,341,427,-86,-20.14,1199
2020-06-01,1451,1490,-39,-2.62,1199
2020-06-02,1452,1501,-49,-3.26,1199
2020-06-03,1452,1501,-49,-3.26,1199
2020-06-04,1452,1499,-47,-3.14,1199
2020-06-05,1350,1391,-41,-2.95,1199
2020-06-06,518,558,-40,-7.17,1199
2020-06-07,365,418,-53,-12.68,1199
2020-06-08,1451,1483,-32,-2.16,1199
2020-06-09,1452,1495,-43,-2.88,1199
2020-06-10,1452,1497,-45,-3.01,1199
2020-06-11,1452,1496,-44,-2.94,1199
2020-06-12,1350,1389,-39,-2.81,1199
2020-06-13,518,558,-40,-7.17,1199
2020-06-14,365,419,-54,-12.89,1199
2020-06-15,1451,1484,-33,-2.22,1199
2020-06-16,1452,1497,-45,-3.01,1199
2020-06-17,1452,1498,-46,-3.07,1199
2020-06-18,1452,1497,-45,-3.01,1199
2020-06-19,1350,1390,-40,-2.88,1199
2020-06-20,518,558,-40,-7.17,1199
2020-06-21,365,417,-52,-12.47,1199
2020-06-22,1451,1481,-30,-2.03,1199
2020-06-23,1452,1492,-40,-2.68,1199
2020-06-24,1452,1491,-39,-2.62,1199
2020-06-25,1452,1488,-36,-2.42,1199
2020-06-26,1350,1378,-28,-2.03,1199
2020-06-27,518,543,-25,-4.6,1199
2020-06-28,365,400,-35,-8.75,1199
2020-06-29,1451,1462,-11,-0.75,1199
2020-06-30,1452,1470,-18,-1.22,1199
2020-07-01,1400,1468,-68,-4.63,1199
2020-07-02,1400,1462,-62,-4.24,1199
2020-07-03,1293,1351,-58,-4.29,1199
2020-07-04,496,515,-19,-3.69,1199
2020-07-05,364,372,-8,-2.15,1199
2020-07-06,1394,1433,-39,-2.72,1199
2020-07-07,1400,1442,-42,-2.91,1199
2020-07-08,1400,1440,-40,-2.78,1199
2020-07-09,1400,1436,-36,-2.51,1199
2020-07-10,1293,1326,-33,-2.49,1199
2020-07-11,496,492,4,0.81,1199
2020-07-12,364,351,13,3.7,1199
2020-07-13,1394,1414,-20,-1.41,1199
2020-07-14,1400,1426,-26,-1.82,1199
2020-07-15,1400,1427,-27,-1.89,1199
2020-07-16,1400,1426,-26,-1.82,1199
2020-07-17,1293,1319,-26,-1.97,1199
2020-07-18,496,488,8,1.64,1199
2020-07-19,364,349,15,4.3,1199
2020-07-20,1394,1415,-21,-1.48,1199
2020-07-21,1400,1429,-29,-2.03,1199
2020-07-22,1400,1432,-32,-2.23,1199
2020-07-23,1400,1432,-32,-2.23,1199
2020-07-24,1293,1326,-33,-2.49,1199
2020-07-25,496,495,1,0.2,1199
2020-07-26,364,357,7,1.96,1199
2020-07-27,1394,1422,-28,-1.97,1199
2020-07-28,1400,1434,-34,-2.37,1199
2020-07-29,1400,1436,-36,-2.51,1199
2020-07-30,1400,1434,-34,-2.37,1199
2020-07-31,1293,1326,-33,-2.49,1199
2020-08-01,492,493,-1,-0.2,1199
2020-08-02,356,351,5,1.42,1199
2020-08-03,1283,1414,-131,-9.26,1199
2020-08-04,1285,1423,-138,-9.7,1199
2020-08-05,1285,1422,-137,-9.63,1199
2020-08-06,1285,1418,-133,-9.38,1199
2020-08-07,1224,1307,-83,-6.35,1199
2020-08-08,492,472,20,4.24,1199
2020-08-09,356,329,27,8.21,1199
2020-08-10,1283,1391,-108,-7.76,1199
2020-08-11,1285,1400,-115,-8.21,1199
2020-08-12,1285,1398,-113,-8.08,1199
2020-08-13,1285,1394,-109,-7.82,1199
2020-08-14,1224,1285,-61,-4.75,1199
2020-08-15,492,451,41,9.09,1199
2020-08-16,356,311,45,14.47,1199
2020-08-17,1283,1375,-92,-6.69,1199
2020-08-18,1285,1387,-102,-7.35,1199
2020-08-19,1285,1389,-104,-7.49,1199
2020-08-20,1285,1389,-104,-7.49,1199
2020-08-21,1224,1284,-60,-4.67,1199
2020-08-22,492,455,37,8.13,1199
2020-08-23,356,318,38,11.95,1199
2020-08-24,1283,1387,-104,-7.5,1199
2020-08-25,1285,1403,-118,-8.41,1199
2020-08-26,1285,1409,-124,-8.8,1199
2020-08-27,1285,1413,-128,-9.06,1199
2020-08-28,1224,1311,-87,-6.64,1199
2020-08-29,492,484,8,1.65,1199
2020-08-30,356,350,6,1.71,1199
2020-08-31,1283,1420,-137,-9.65,1199
2020-09-01,1478,1437,41,2.85,1199
2020-09-02,1478,1443,35,2.43,1199
2020-09-03,1478,1446,32,2.21,1199
2020-09-04,1361,1343,18,1.34,1199
2020-09-05,545,515,30,5.83,1199
2020-09-06,356,379,-23,-6.07,1199
2020-09-07,1384,1446,-62,-4.29,1199
2020-09-08,1478,1460,18,1.23,1199
2020-09-09,1478,1463,15,1.03,1199
2020-09-10,1478,1463,15,1.03,1199
2020-09-11,1361,1356,5,0.37,1199
2020-09-12,545,524,21,4.01,1199
2020-09-13,356,384,-28,-7.29,1199
2020-09-14,1384,1448,-64,-4.42,1199
2020-09-15,1478,1459,19,1.3,1199
2020-09-16,1478,1458,20,1.37,1199
2020-09-17,1478,1455,23,1.58,1199
2020-09-18,1361,1346,15,1.11,1199
2020-09-19,545,512,33,6.45,1199
2020-09-20,356,371,-15,-4.04,1199
2020-09-21,1384,1433,-49,-3.42,1199
2020-09-22,1478,1444,34,2.35,1199
2020-09-23,1478,1443,35,2.43,1199
2020-09-24,1478,1440,38,2.64,1199
2020-09-25,1361,1332,29,2.18,1199
2020-09-26,545,499,46,9.22,1199
2020-09-27,356,359,-3,-0.84,1199
2020-09-28,1384,1423,-39,-2.74,1199
2020-09-29,1478,1435,43,3.0,1199
2020-09-30,1478,1436,42,2.92,1199
2020-10-01,1410,1436,-26,-1.81,1199
2020-10-02,1338,1329,9,0.68,1199
2020-10-03,520,498,22,4.42,1199
2020-10-04,342,359,-17,-4.74,1199
2020-10-05,1455,1424,31,2.18,1199
2020-10-06,1410,1437,-27,-1.88,1199
2020-10-07,1410,1438,-28,-1.95,1199
2020-10-08,1410,1438,-28,-1.95,1199
2020-10-09,1338,1331,7,0.53,1199
2020-10-10,520,499,21,4.21,1199
2020-10-11,342,359,-17,-4.74,1199
2020-10-12,1455,1423,32,2.25,1199
2020-10-13,1410,1434,-24,-1.67,1199
2020-10-14,1410,1434,-24,-1.67,1199
2020-10-15,1410,1432,-22,-1.54,1199
2020-10-16,1338,1323,15,1.13,1199
2020-10-17,520,489,31,6.34,1199
2020-10-18,342,347,-5,-1.44,1199
2020-10-19,1455,1409,46,3.26,1199
2020-10-20,1410,1419,-9,-0.63,1199
2020-10-21,1410,1417,-7,-0.49,1199
2020-10-22,1410,1414,-4,-0.28,1199
2020-10-23,1338,1304,34,2.61,1199
2020-10-24,520,469,51,10.87,1199
2020-10-25,342,327,15,4.59,1199
2020-10-26,1455,1390,65,4.68,1199
2020-10-27,1410,1400,10,0.71,1199
2020-10-28,1410,1400,10,0.71,1199
2020-10-29,1410,1397,13,0.93,1199
2020-10-30,1338,1289,49,3.8,1199
2020-10-31,520,457,63,13.79,1199
2020-11-01,318,317,1,0.32,1199
2020-11-02,1417,1382,35,2.53,1199
2020-11-03,1391,1394,-3,-0.22,1199
2020-11-04,1391,1396,-5,-0.36,1199
2020-11-05,1391,1395,-4,-0.29,1199
2020-11-06,1310,1289,21,1.63,1199
2020-11-07,514,458,56,12.23,1199
2020-11-08,318,319,-1,-0.31,1199
2020-11-09,1417,1385,32,2.31,1199
2020-11-10,1391,1397,-6,-0.43,1199
2020-11-11,1391,1399,-8,-0.57,1199
2020-11-12,1391,1398,-7,-0.5,1199
2020-11-13,1310,1290,20,1.55,1199
2020-11-14,514,457,57,12.47,1199
2020-11-15,318,316,2,0.63,1199
2020-11-16,1417,1379,38,2.76,1199
2020-11-17,1391,1388,3,0.22,1199
2020-11-18,1391,1386,5,0.36,1199
2020-11-19,1391,1381,10,0.72,1199
2020-11-20,1310,1269,41,3.23,1199
2020-11-21,514,432,82,18.98,1199
2020-11-22,318,286,32,11.19,1199
2020-11-23,1417,1344,73,5.43,1199
2020-11-24,1391,1350,41,3.04,1199
2020-11-25,1391,1343,48,3.57,1199
2020-11-26,1391,1335,56,4.19,1199
2020-11-27,1310,1219,91,7.47,1199
2020-11-28,514,379,135,35.62,1199
2020-11-29,318,232,86,37.07,1199
2020-11-30,1417,1288,129,10.02,1199
2020-12-01,1135,1292,-157,-12.15,1199
2020-12-02,1135,1286,-151,-11.74,1199
2020-12-03,1135,1277,-142,-11.12,1199
2020-12-04,1314,1163,151,12.98,1199
2020-12-05,524,325,199,61.23,1199
2020-12-06,306,179,127,70.95,1199
2020-12-07,1227,1238,-11,-0.89,1199
2020-12-08,1135,1245,-110,-8.84,1199
2020-12-09,1135,1242,-107,-8.62,1199
2020-12-10,1135,1237,-102,-8.25,1199
2020-12-11,1314,1127,187,16.59,1199
2020-12-12,524,292,232,79.45,1199
2020-12-13,306,150,156,104.0,1199
2020-12-14,1227,1213,14,1.15,1199
2020-12-15,1135,1224,-89,-7.27,1199
2020-12-16,1135,1224,-89,-7.27,1199
2020-12-17,1135,1221,-86,-7.04,1199
2020-12-18,1314,1113,201,18.06,1199
2020-12-19,524,281,243,86.48,1199
2020-12-20,306,140,166,118.57,1199
2020-12-21,1227,1204,23,1.91,1199
2020-12-22,1135,1215,-80,-6.58,1199
2020-12-23,1135,1214,-79,-6.51,1199
2020-12-24,1135,1211,-76,-6.28,1199
2020-12-25,1314,1102,212,19.24,1199
2020-12-26,524,268,256,95.52,1199
2020-12-27,306,126,180,142.86,1199
2020-12-28,1227,1187,40,3.37,1199
2020-12-29,1135,1196,-61,-5.1,1199
2020-12-30,1135,1194,-59,-4.94,1199
2020-12-31,1135,1188,-53,-4.46,1199
2021-01-01,1128,1077,51,4.74,1199
2021-01-02,437,241,196,81.33,1199
2021-01-03,288,97,191,196.91,1199
2021-01-04,1154,1157,-3,-0.26,1199
2021-01-05,1217,1165,52,4.46,1199
2021-01-06,1217,1162,55,4.73,1199
2021-01-07,1217,1156,61,5.28,1199
2021-01-08,1128,1045,83,7.94,1199
2021-01-09,437,210,227,108.1,1199
2021-01-10,288,67,221,329.85,1199
2021-01-11,1154,1130,24,2.12,1199
2021-01-12,1217,1140,77,6.75,1199
2021-01-13,1217,1139,78,6.85,1199
2021-01-14,1217,1137,80,7.04,1199
2021-01-15,1128,1030,98,9.51,1199
2021-01-16,437,198,239,120.71,1199
2021-01-17,288,60,228,380.0,1199
2021-01-18,1154,1126,28,2.49,1199
2021-01-19,1217,1140,77,6.75,1199
2021-01-20,1217,1143,74,6.47,1199
2021-01-21,1217,1145,72,6.29,1199
2021-01-22,1128,1041,87,8.36,1199
2021-01-23,437,212,225,106.13,1199
2021-01-24,288,76,212,278.95,1199
2021-01-25,1154,1145,9,0.79,1199
2021-01-26,1217,1160,57,4.91,1199
2021-01-27,1217,1165,52,4.46,1199
2021-01-28,1217,1168,49,4.2,1199
2021-01-29,1128,1064,64,6.02,1199
2021-01-30,437,236,201,85.17,1199
2021-01-31,288,99,189,190.91,1199
2021-02-01,1254,1167,87,7.46,1199
2021-02-02,1310,1181,129,10.92,1199
2021-02-03,1310,1185,125,10.55,1199
2021-02-04,1310,1186,124,10.46,1199
2021-02-05,1220,1081,139,12.86,1199
2021-02-06,465,251,214,85.26,1199
2021-02-07,299,113,186,164.6,1199
2021-02-08,1254,1179,75,6.36,1199
2021-02-09,1310,1193,117,9.81,1199
2021-02-10,1310,1196,114,9.53,1199
2021-02-11,1310,1196,114,9.53,1199
2021-02-12,1220,1090,130,11.93,1199
2021-02-13,465,260,205,78.85,1199
2021-02-14,299,123,176,143.09,1199
2021-02-15,1254,1190,64,5.38,1199
2021-02-16,1310,1205,105,8.71,1199
2021-02-17,1310,1209,101,8.35,1199
2021-02-18,1310,1211,99,8.18,1199
2021-02-19,1220,1108,112,10.11,1199
2021-02-20,465,280,185,66.07,1199
2021-02-21,299,145,154,106.21,1199
2021-02-22,1254,1215,39,3.21,1199
2021-02-23,1310,1232,78,6.33,1199
2021-02-24,1310,1239,71,5.73,1199
2021-02-25,1310,1243,67,5.39,1199
2021-02-26,1220,1142,78,6.83,1199
2021-02-27,465,316,149,47.15,1199
2021-02-28,299,183,116,63.39,1199
2021-03-01,1415,1254,161,12.84,1199
2021-03-02,1443,1272,171,13.44,1199
2021-03-03,1443,1279,164,12.82,1199
2021-03-04,1443,1283,160,12.47,1199
2021-03-05,1342,1182,160,13.54,1199
2021-03-06,525,355,170,47.89,1199
2021-03-07,324,220,104,47.27,1199
2021-03-08,1415,1290,125,9.69,1199
2021-03-09,1443,1306,137,10.49,1199
2021-03-10,1443,1311,132,10.07,1199
2021-03-11,1443,1313,130,9.9,1199
2021-03-12,1342,1209,133,11.0,1199
2021-03-13,525,380,145,38.16,1199
2021-03-14,324,242,82,33.88,1199
2021-03-15,1415,1309,106,8.1,1199
2021-03-16,1443,1323,120,9.07,1199
2021-03-17,1443,1325,118,8.91,1199
2021-03-18,1443,1326,117,8.82,1199
2021-03-19,1342,1220,122,10.0,1199
2021-03-20,525,389,136,34.96,1199
2021-03-21,324,251,73,29.08,1199
2021-03-22,1415,1317,98,7.44,1199
2021-03-23,1443,1330,113,8.5,1199
2021-03-24,1443,1333,110,8.25,1199
2021-03-25,1443,1334,109,8.17,1199
2021-03-26,1342,1229,113,9.19,1199
2021-03-27,525,400,125,31.25,1199
2021-03-28,324,263,61,23.19,1199
2021-03-29,1415,1331,84,6.31,1199
2021-03-30,1443,1347,96,7.13,1199
2021-03-31,1443,1351,92,6.81,1199
2021-04-01,1514,1354,160,11.82,1199
2021-04-02,1394,1251,143,11.43,1199
2021-04-03,547,424,123,29.01,1199
2021-04-04,340,288,52,18.06,1199
2021-04-05,1539,1358,181,13.33,1199
2021-04-06,1514,1374,140,10.19,1199
2021-04-07,1514,1380,134,9.71,1199
2021-04-08,1514,1383,131,9.47,1199
2021-04-09,1394,1280,114,8.91,1199
2021-04-10,547,452,95,21.02,1199
2021-04-11,340,317,23,7.26,1199
2021-04-12,1539,1385,154,11.12,1199
2021-04-13,1514,1400,114,8.14,1199
2021-04-14,1514,1404,110,7.83,1199
2021-04-15,1514,1405,109,7.76,1199
2021-04-16,1394,1300,94,7.23,1199
2021-04-17,547,470,77,16.38,1199
2021-04-18,340,332,8,2.41,1199
2021-04-19,1539,1398,141,10.09,1199
2021-04-20,1514,1410,104,7.38,1199
2021-04-21,1514,1412,102,7.22,1199
2021-04-22,1514,1411,103,7.3,1199
2021-04-23,1394,1304,90,6.9,1199
2021-04-24,547,473,74,15.64,1199
2021-04-25,340,333,7,2.1,1199
2021-04-26,1539,1398,141,10.09,1199
2021-04-27,1514,1410,104,7.38,1199
2021-04-28,1514,1411,103,7.3,1199
2021-04-29,1514,1410,104,7.38,1199
2021-04-30,1394,1304,90,6.9,1199
2021-05-01,591,472,119,25.21,1199
2021-05-02,389,334,55,16.47,1199
2021-05-03,1563,1399,164,11.72,1199
2021-05-04,1521,1413,108,7.64,1199
2021-05-05,1521,1416,105,7.42,1199
2021-05-06,1521,1416,105,7.42,1199
2021-05-07,1453,1311,142,10.83,1199
2021-05-08,591,481,110,22.87,1199
2021-05-09,389,344,45,13.08,1199
2021-05-10,1563,1411,152,10.77,1199
2021-05-11,1521,1425,96,6.74,1199
2021-05-12,1521,1429,92,6.44,1199
2021-05-13,1521,1430,91,6.36,1199
2021-05-14,1453,1324,129,9.74,1199
2021-05-15,591,494,97,19.64,1199
2021-05-16,389,357,32,8.96,1199
2021-05-17,1563,1423,140,9.84,1199
2021-05-18,1521,1436,85,5.92,1199
2021-05-19,1521,1438,83,5.77,1199
2021-05-20,1521,1437,84,5.85,1199
2021-05-21,1453,1330,123,9.25,1199
2021-05-22,591,499,92,18.44,1199
2021-05-23,389,359,30,8.36,1199
2021-05-24,1563,1423,140,9.84,1199
2021-05-25,1521,1434,87,6.07,1199
2021-05-26,1521,1434,87,6.07,1199
2021-05-27,1521,1432,89,6.22,1199
2021-05-28,1453,1323,130,9.83,1199
2021-05-29,591,490,101,20.61,1199
2021-05-30,389,349,40,11.46,1199
2021-05-31,1563,1412,151,10.69,1199
2021-06-01,1608,1423,185,13.0,1199
2021-06-02,1608,1423,185,13.0,1199
2021-06-03,1608,1420,188,13.24,1199
2021-06-04,1484,1312,172,13.11,1199
2021-06-05,570,479,91,19.0,1199
2021-06-06,424,339,85,25.07,1199
2021-06-07,1588,1403,185,13.19,1199
2021-06-08,1608,1415,193,13.64,1199
2021-06-09,1608,1416,192,13.56,1199
2021-06-10,1608,1415,193,13.64,1199
2021-06-11,1484,1309,175,13.37,1199
2021-06-12,570,477,93,19.5,1199
2021-06-13,424,338,86,25.44,1199
2021-06-14,1588,1403,185,13.19,1199
2021-06-15,1608,1416,192,13.56,1199
2021-06-16,1608,1418,190,13.4,1199
2021-06-17,1608,1417,191,13.48,1199
2021-06-18,1484,1310,174,13.28,1199
2021-06-19,570,478,92,19.25,1199
2021-06-20,424,338,86,25.44,1199
2021-06-21,1588,1402,186,13.27,1199
2021-06-22,1608,1413,195,13.8,1199
2021-06-23,1608,1413,195,13.8,1199
2021-06-24,1608,1410,198,14.04,1199
2021-06-25,1484,1301,183,14.07,1199
2021-06-26,570,467,103,22.06,1199
2021-06-27,424,324,100,30.86,1199
2021-06-28,1588,1386,202,14.57,1199
2021-06-29,1608,1395,213,15.27,1199
2021-06-30,1608,1392,216,15.52,1199
2021-07-01,1500,1387,113,8.15,1199
2021-07-02,1385,1276,109,8.54,1199
2021-07-03,516,441,75,17.01,1199
2021-07-04,408,297,111,37.37,1199
2021-07-05,1547,1358,189,13.92,1199
2021-07-06,1500,1366,134,9.81,1199
2021-07-07,1500,1364,136,9.97,1199
2021-07-08,1500,1359,141,10.38,1199
2021-07-09,1385,1249,136,10.89,1199
2021-07-10,516,415,101,24.34,1199
2021-07-11,408,273,135,49.45,1199
2021-07-12,1547,1336,211,15.79,1199
2021-07-13,1500,1347,153,11.36,1199
2021-07-14,1500,1347,153,11.36,1199
2021-07-15,1500,1346,154,11.44,1199
2021-07-16,1385,1238,147,11.87,1199
2021-07-17,516,407,109,26.78,1199
2021-07-18,408,268,140,52.24,1199
2021-07-19,1547,1334,213,15.97,1199
2021-07-20,1500,1347,153,11.36,1199
2021-07-21,1500,1350,150,11.11,1199
2021-07-22,1500,1350,150,11.11,1199
2021-07-23,1385,1244,141,11.33,1199
2021-07-24,516,414,102,24.64,1199
2021-07-25,408,275,133,48.36,1199
2021-07-26,1547,1341,206,15.36,1199
2021-07-27,1500,1354,146,10.78,1199
2021-07-28,1500,1356,144,10.62,1199
2021-07-29,1500,1355,145,10.7,1199
2021-07-30,1385,1247,138,11.07,1199
2021-07-31,516,414,102,24.64,1199
2021-08-01,401,273,128,46.89,1199
2021-08-02,1379,1337,42,3.14,1199
2021-08-03,1403,1347,56,4.16,1199
2021-08-04,1403,1345,58,4.31,1199
2021-08-05,1403,1342,61,4.55,1199
2021-08-06,1254,1231,23,1.87,1199
2021-08-07,495,396,99,25.0,1199
2021-08-08,401,253,148,58.5,1199
2021-08-09,1379,1315,64,4.87,1199
2021-08-10,1403,1324,79,5.97,1199
2021-08-11,1403,1322,81,6.13,1199
2021-08-12,1403,1318,85,6.45,1199
2021-08-13,1254,1208,46,3.81,1199
2021-08-14,495,374,121,32.35,1199
2021-08-15,401,232,169,72.84,1199
2021-08-16,1379,1296,83,6.4,1199
2021-08-17,1403,1307,96,7.35,1199
2021-08-18,1403,1308,95,7.26,1199
2021-08-19,1403,1308,95,7.26,1199
2021-08-20,1254,1202,52,4.33,1199
2021-08-21,495,372,123,33.06,1199
2021-08-22,401,235,166,70.64,1199
2021-08-23,1379,1302,77,5.91,1199
2021-08-24,1403,1318,85,6.45,1199
2021-08-25,1403,1323,80,6.05,1199
2021-08-26,1403,1327,76,5.73,1199
2021-08-27,1254,1224,30,2.45,1199
2021-08-28,495,398,97,24.37,1199
2021-08-29,401,263,138,52.47,1199
2021-08-30,1379,1333,46,3.45,1199
2021-08-31,1403,1351,52,3.85,1199
2021-09-01,1554,1357,197,14.52,1199
2021-09-02,1554,1361,193,14.18,1199
2021-09-03,1465,1258,207,16.45,1199
2021-09-04,552,431,121,28.07,1199
2021-09-05,441,295,146,49.49,1199
2021-09-06,1583,1363,220,16.14,1199
2021-09-07,1554,1378,176,12.77,1199
2021-09-08,1554,1381,173,12.53,1199
2021-09-09,1554,1382,172,12.45,1199
2021-09-10,1465,1276,189,14.81,1199
2021-09-11,552,444,108,24.32,1199
2021-09-12,441,305,136,44.59,1199
2021-09-13,1583,1369,214,15.63,1199
2021-09-14,1554,1380,174,12.61,1199
2021-09-15,1554,1380,174,12.61,1199
2021-09-16,1554,1378,176,12.77,1199
2021-09-17,1465,1269,196,15.45,1199
2021-09-18,552,435,117,26.9,1199
2021-09-19,441,293,148,50.51,1199
2021-09-20,1583,1356,227,16.74,1199
2021-09-21,1554,1366,188,13.76,1199
2021-09-22,1554,1365,189,13.85,1199
2021-09-23,1554,1362,192,14.1,1199
2021-09-24,1465,1254,211,16.83,1199
2021-09-25,552,421,131,31.12,1199
2021-09-26,441,280,161,57.5,1199
2021-09-27,1583,1344,239,17.78,1199
2021-09-28,1554,1355,199,14.69,1199
2021-09-29,1554,1357,197,14.52,1199
2021-09-30,1554,1355,199,14.69,1199
2021-10-01,1394,1248,146,11.7,1199
2021-10-02,562,417,145,34.77,1199
2021-10-03,414,278,136,48.92,1199
2021-10-04,1465,1343,122,9.08,1199
2021-10-05,1467,1356,111,8.19,1199
2021-10-06,1467,1358,109,8.03,1199
2021-10-07,1467,1357,110,8.11,1199
2021-10-08,1394,1250,144,11.52,1199
2021-10-09,562,419,143,34.13,1199
2021-10-10,414,279,135,48.39,1199
2021-10-11,1465,1344,121,9.0,1199
2021-10-12,1467,1355,112,8.27,1199
2021-10-13,1467,1356,111,8.19,1199
2021-10-14,1467,1354,113,8.35,1199
2021-10-15,1394,1245,149,11.97,1199
2021-10-16,562,411,151,36.74,1199
2021-10-17,414,270,144,53.33,1199
2021-10-18,1465,1332,133,9.98,1199
2021-10-19,1467,1342,125,9.31,1199
2021-10-20,1467,1341,126,9.4,1199
2021-10-21,1467,1337,130,9.72,1199
2021-10-22,1394,1227,167,13.61,1199
2021-10-23,562,393,169,43.0,1199
2021-10-24,414,251,163,64.94,1199
2021-10-25,1465,1313,152,11.58,1199
2021-10-26,1467,1323,144,10.88,1199
2021-10-27,1467,1322,145,10.97,1199
2021-10-28,1467,1319,148,11.22,1199
2021-10-29,1394,1211,183,15.11,1199
2021-10-30,562,378,184,48.68,1199
2021-10-31,414,237,177,74.68,1199
2021-11-01,1486,1302,184,14.13,1199
2021-11-02,1517,1314,203,15.45,1199
2021-11-03,1517,1315,202,15.36,1199
2021-11-04,1517,1315,202,15.36,1199
2021-11-05,1413,1208,205,16.97,1199
2021-11-06,544,377,167,44.3,1199
2021-11-07,368,238,130,54.62,1199
2021-11-08,1486,1304,182,13.96,1199
2021-11-09,1517,1317,200,15.19,1199
2021-11-10,1517,1319,198,15.01,1199
2021-11-11,1517,1318,199,15.1,1199
2021-11-12,1413,1211,202,16.68,1199
2021-11-13,544,379,165,43.54,1199
2021-11-14,368,238,130,54.62,1199
2021-11-15,1486,1301,185,14.22,1199
2021-11-16,1517,1312,205,15.62,1199
2021-11-17,1517,1310,207,15.8,1199
2021-11-18,1517,1306,211,16.16,1199
2021-11-19,1413,1195,218,18.24,1199
2021-11-20,544,358,186,51.96,1199
2021-11-21,368,214,154,71.96,1199
2021-11-22,1486,1273,213,16.73,1199
2021-11-23,1517,1278,239,18.7,1199
2021-11-24,1517,1273,244,19.17,1199
2021-11-25,1517,1264,253,20.02,1199
2021-11-26,1413,1149,264,22.98,1199
2021-11-27,544,310,234,75.48,1199
2021-11-28,368,162,206,127.16,1199
2021-11-29,1486,1219,267,21.9,1199
2021-11-30,1517,1223,294,24.04,1199
2021-12-01,1182,1216,-34,-2.8,1199
2021-12-02,1182,1207,-25,-2.07,1199
2021-12-03,972,1092,-120,-10.99,1199
2021-12-04,521,253,268,105.93,1199
2021-12-05,347,107,240,224.3,1199
2021-12-06,1290,1165,125,10.73,1199
2021-12-07,1182,1172,10,0.85,1199
2021-12-08,1182,1168,14,1.2,1199
2021-12-09,1182,1162,20,1.72,1199
2021-12-10,972,1051,-79,-7.52,1199
2021-12-11,521,216,305,141.2,1199
2021-12-12,347,73,274,375.34,1199
2021-12-13,1290,1135,155,13.66,1199
2021-12-14,1182,1146,36,3.14,1199
2021-12-15,1182,1145,37,3.23,1199
2021-12-16,1182,1143,39,3.41,1199
2021-12-17,972,1034,-62,-6.0,1199
2021-12-18,521,202,319,157.92,1199
2021-12-19,347,61,286,468.85,1199
2021-12-20,1290,1125,165,14.67,1199
2021-12-21,1182,1136,46,4.05,1199
2021-12-22,1182,1136,46,4.05,1199
2021-12-23,1182,1134,48,4.23,1199
2021-12-24,972,1025,-53,-5.17,1199
2021-12-25,521,191,330,172.77,1199
2021-12-26,347,49,298,608.16,1199
2021-12-27,1290,1111,179,16.11,1199
2021-12-28,1182,1120,62,5.54,1199
2021-12-29,1182,1118,64,5.72,1199
2021-12-30,1182,1113,69,6.2,1199
2021-12-31,972,1002,-30,-2.99,1199
2022-01-01,480,166,314,189.16,1199
2022-01-02,336,22,314,1427.27,1199
2022-01-03,1198,1083,115,10.62,1199
2022-01-04,1191,1090,101,9.27,1199
2022-01-05,1191,1087,104,9.57,1199
2022-01-06,1191,1081,110,10.18,1199
2022-01-07,1113,970,143,14.74,1199
2022-01-08,480,135,345,255.56,1199
2022-01-09,336,74,262,354.05,1199
2022-01-10,1198,1053,145,13.77,1199
2022-01-11,1191,1062,129,12.15,1199
2022-01-12,1191,1062,129,12.15,1199
2022-01-13,1191,1059,132,12.46,1199
2022-01-14,1113,950,163,17.16,1199
2022-01-15,480,118,362,306.78,1199
2022-01-16,336,61,275,450.82,1199
2022-01-17,1198,1044,154,14.75,1199
2022-01-18,1191,1058,133,12.57,1199
2022-01-19,1191,1061,130,12.25,1199
2022-01-20,1191,1062,129,12.15,1199
2022-01-21,1113,957,156,16.3,1199
2022-01-22,480,128,352,275.0,1199
2022-01-23,336,73,263,360.27,1199
2022-01-24,1198,1060,138,13.02,1199
2022-01-25,1191,1076,115,10.69,1199
2022-01-26,1191,1081,110,10.18,1199
2022-01-27,1191,1083,108,9.97,1199
2022-01-28,1113,980,133,13.57,1199
2022-01-29,480,151,329,217.88,1199
2022-01-30,336,15,321,2140.0,1199
2020-02-01,420,343,77,22.45,1212
2020-02-02,285,180,105,58.33,1212
2020-02-03,1203,1305,-102,-7.82,1212
2020-02-04,1260,1302,-42,-3.23,1212
2020-02-05,1260,1305,-45,-3.45,1212
2020-02-06,1260,1304,-44,-3.37,1212
2020-02-07,1134,1122,12,1.07,1212
2020-02-08,420,360,60,16.67,1212
2020-02-09,285,196,89,45.41,1212
2020-02-10,1203,1320,-117,-8.86,1212
2020-02-11,1260,1316,-56,-4.26,1212
2020-02-12,1260,1318,-58,-4.4,1212
2020-02-13,1260,1317,-57,-4.33,1212
2020-02-14,1134,1134,0,0.0,1212
2020-02-15,420,371,49,13.21,1212
2020-02-16,285,206,79,38.35,1212
2020-02-17,1203,1329,-126,-9.48,1212
2020-02-18,1260,1325,-65,-4.91,1212
2020-02-19,1260,1326,-66,-4.98,1212
2020-02-20,1260,1324,-64,-4.83,1212
2020-02-21,1134,1141,-7,-0.61,1212
2020-02-22,420,378,42,11.11,1212
2020-02-23,285,213,72,33.8,1212
2020-02-24,1203,1336,-133,-9.96,1212
2020-02-25,1260,1332,-72,-5.41,1212
2020-02-26,1260,1334,-74,-5.55,1212
2020-02-27,1260,1332,-72,-5.41,1212
2020-02-28,1134,1149,-15,-1.31,1212
2020-02-29,420,386,34,8.81,1212
2020-03-01,263,222,41,18.47,1212
2020-03-02,1061,1345,-284,-21.12,1212
2020-03-03,1065,1341,-276,-20.58,1212
2020-03-04,1065,1343,-278,-20.7,1212
2020-03-05,1065,1341,-276,-20.58,1212
2020-03-06,974,1158,-184,-15.89,1212
2020-03-07,380,396,-16,-4.04,1212
2020-03-08,263,231,32,13.85,1212
2020-03-09,1061,1354,-293,-21.64,1212
2020-03-10,1065,1350,-285,-21.11,1212
2020-03-11,1065,1352,-287,-21.23,1212
2020-03-12,1065,1350,-285,-21.11,1212
2020-03-13,974,1167,-193,-16.54,1212
2020-03-14,380,404,-24,-5.94,1212
2020-03-15,263,239,24,10.04,1212
2020-03-16,1061,1362,-301,-22.1,1212
2020-03-17,1065,1357,-292,-21.52,1212
2020-03-18,1065,1359,-294,-21.63,1212
2020-03-19,1065,1357,-292,-21.52,1212
2020-03-20,974,1174,-200,-17.04,1212
2020-03-21,380,411,-31,-7.54,1212
2020-03-22,263,247,16,6.48,1212
2020-03-23,1061,1370,-309,-22.55,1212
2020-03-24,1065,1366,-301,-22.04,1212
2020-03-25,1065,1369,-304,-22.21,1212
2020-03-26,1065,1367,-302,-22.09,1212
2020-03-27,974,1185,-211,-17.81,1212
2020-03-28,380,423,-43,-10.17,1212
2020-03-29,263,259,4,1.54,1212
2020-03-30,1061,1384,-323,-23.34,1212
2020-03-31,1065,1380,-315,-22.83,1212
2020-04-01,973,1384,-411,-29.7,1212
2020-04-02,973,1383,-410,-29.65,1212
2020-04-03,812,1202,-390,-32.45,1212
2020-04-04,339,440,-101,-22.95,1212
2020-04-05,219,277,-58,-20.94,1212
2020-04-06,971,1402,-431,-30.74,1212
2020-04-07,973,1399,-426,-30.45,1212
2020-04-08,973,1403,-430,-30.65,1212
2020-04-09,973,1402,-429,-30.6,1212
2020-04-10,812,1221,-409,-33.5,1212
2020-04-11,339,459,-120,-26.14,1212
2020-04-12,219,296,-77,-26.01,1212
2020-04-13,971,1420,-449,-31.62,1212
2020-04-14,973,1416,-443,-31.29,1212
2020-04-15,973,1419,-446,-31.43,1212
2020-04-16,973,1418,-445,-31.38,1212
2020-04-17,812,1235,-423,-34.25,1212
2020-04-18,339,472,-133,-28.18,1212
2020-04-19,219,308,-89,-28.9,1212
2020-04-20,971,1431,-460,-32.15,1212
2020-04-21,973,1426,-453,-31.77,1212
2020-04-22,973,1427,-454,-31.81,1212
2020-04-23,973,1425,-452,-31.72,1212
2020-04-24,812,1241,-429,-34.57,1212
2020-04-25,339,478,-139,-29.08,1212
2020-04-26,219,312,-93,-29.81,1212
2020-04-27,971,1434,-463,-32.29,1212
2020-04-28,973,1429,-456,-31.91,1212
2020-04-29,973,1430,-457,-31.96,1212
2020-04-30,973,1427,-454,-31.81,1212
2020-05-01,1122,1244,-122,-9.81,1212
2020-05-02,398,480,-82,-17.08,1212
2020-05-03,258,315,-57,-18.1,1212
2020-05-04,1268,1437,-169,-11.76,1212
2020-05-05,1289,1432,-143,-9.99,1212
2020-05-06,1289,1434,-145,-10.11,1212
2020-05-07,1289,1432,-143,-9.99,1212
2020-05-08,1122,1249,-127,-10.17,1212
2020-05-09,398,485,-87,-17.94,1212
2020-05-10,258,321,-63,-19.63,1212
2020-05-11,1268,1444,-176,-12.19,1212
2020-05-12,1289,1440,-151,-10.49,1212
2020-05-13,1289,1442,-153,-10.61,1212
2020-05-14,1289,1440,-151,-10.49,1212
2020-05-15,1122,1257,-135,-10.74,1212
2020-05-16,398,494,-96,-19.43,1212
2020-05-17,258,329,-71,-21.58,1212
2020-05-18,1268,1452,-184,-12.67,1212
2020-05-19,1289,1447,-158,-10.92,1212
2020-05-20,1289,1449,-160,-11.04,1212
2020-05-21,1289,1446,-157,-10.86,1212
2020-05-22,1122,1262,-140,-11.09,1212
2020-05-23,398,498,-100,-20.08,1212
2020-05-24,258,332,-74,-22.29,1212
2020-05-25,1268,1453,-185,-12.73,1212
2020-05-26,1289,1447,-158,-10.92,1212
2020-05-27,1289,1447,-158,-10.92,1212
2020-05-28,1289,1443,-154,-10.67,1212
2020-05-29,1122,1257,-135,-10.74,1212
2020-05-30,398,492,-94,-19.11,1212
2020-05-31,258,324,-66,-20.37,1212
2020-06-01,1384,1444,-60,-4.16,1212
2020-06-02,1503,1437,66,4.59,1212
2020-06-03,1503,1435,68,4.74,1212
2020-06-04,1503,1430,73,5.1,1212
2020-06-05,1156,1244,-88,-7.07,1212
2020-06-06,461,478,-17,-3.56,1212
2020-06-07,270,310,-40,-12.9,1212
2020-06-08,1384,1430,-46,-3.22,1212
2020-06-09,1503,1423,80,5.62,1212
2020-06-10,1503,1422,81,5.7,1212
2020-06-11,1503,1418,85,5.99,1212
2020-06-12,1156,1233,-77,-6.24,1212
2020-06-13,461,468,-7,-1.5,1212
2020-06-14,270,302,-32,-10.6,1212
2020-06-15,1384,1423,-39,-2.74,1212
2020-06-16,1503,1418,85,5.99,1212
2020-06-17,1503,1419,84,5.92,1212
2020-06-18,1503,1417,86,6.07,1212
2020-06-19,1156,1235,-79,-6.4,1212
2020-06-20,461,472,-11,-2.33,1212
2020-06-21,270,309,-39,-12.62,1212
2020-06-22,1384,1433,-49,-3.42,1212
2020-06-23,1503,1430,73,5.1,1212
2020-06-24,1503,1434,69,4.81,1212
2020-06-25,1503,1434,69,4.81,1212
2020-06-26,1156,1254,-98,-7.81,1212
2020-06-27,461,494,-33,-6.68,1212
2020-06-28,270,332,-62,-18.67,1212
2020-06-29,1384,1458,-74,-5.08,1212
2020-06-30,1503,1456,47,3.23,1212
2020-07-01,1372,1461,-89,-6.09,1212
2020-07-02,1372,1462,-90,-6.16,1212
2020-07-03,1166,1282,-116,-9.05,1212
2020-07-04,440,521,-81,-15.55,1212
2020-07-05,274,359,-85,-23.68,1212
2020-07-06,1352,1485,-133,-8.96,1212
2020-07-07,1372,1482,-110,-7.42,1212
2020-07-08,1372,1486,-114,-7.67,1212
2020-07-09,1372,1486,-114,-7.67,1212
2020-07-10,1166,1304,-138,-10.58,1212
2020-07-11,440,542,-102,-18.82,1212
2020-07-12,274,379,-105,-27.7,1212
2020-07-13,1352,1502,-150,-9.99,1212
2020-07-14,1372,1498,-126,-8.41,1212
2020-07-15,1372,1500,-128,-8.53,1212
2020-07-16,1372,1497,-125,-8.35,1212
2020-07-17,1166,1314,-148,-11.26,1212
2020-07-18,440,550,-110,-20.0,1212
2020-07-19,274,385,-111,-28.83,1212
2020-07-20,1352,1506,-154,-10.23,1212
2020-07-21,1372,1500,-128,-8.53,1212
2020-07-22,1372,1501,-129,-8.59,1212
2020-07-23,1372,1497,-125,-8.35,1212
2020-07-24,1166,1313,-147,-11.2,1212
2020-07-25,440,548,-108,-19.71,1212
2020-07-26,274,382,-108,-28.27,1212
2020-07-27,1352,1503,-151,-10.05,1212
2020-07-28,1372,1497,-125,-8.35,1212
2020-07-29,1372,1497,-125,-8.35,1212
2020-07-30,1372,1493,-121,-8.1,1212
2020-07-31,1166,1309,-143,-10.92,1212
2020-08-01,454,545,-91,-16.7,1212
2020-08-02,287,379,-92,-24.27,1212
2020-08-03,1254,1501,-247,-16.46,1212
2020-08-04,1254,1495,-241,-16.12,1212
2020-08-05,1254,1496,-242,-16.18,1212
2020-08-06,1254,1494,-240,-16.06,1212
2020-08-07,1109,1310,-201,-15.34,1212
2020-08-08,454,546,-92,-16.85,1212
2020-08-09,287,381,-94,-24.67,1212
2020-08-10,1254,1503,-249,-16.57,1212
2020-08-11,1254,1498,-244,-16.29,1212
2020-08-12,1254,1500,-246,-16.4,1212
2020-08-13,1254,1497,-243,-16.23,1212
2020-08-14,1109,1313,-204,-15.54,1212
2020-08-15,454,549,-95,-17.3,1212
2020-08-16,287,383,-96,-25.07,1212
2020-08-17,1254,1505,-251,-16.68,1212
2020-08-18,1254,1499,-245,-16.34,1212
2020-08-19,1254,1499,-245,-16.34,1212
2020-08-20,1254,1495,-241,-16.12,1212
2020-08-21,1109,1309,-200,-15.28,1212
2020-08-22,454,543,-89,-16.39,1212
2020-08-23,287,376,-89,-23.67,1212
2020-08-24,1254,1495,-241,-16.12,1212
2020-08-25,1254,1487,-233,-15.67,1212
2020-08-26,1254,1485,-231,-15.56,1212
2020-08-27,1254,1478,-224,-15.16,1212
2020-08-28,1109,1291,-182,-14.1,1212
2020-08-29,454,523,-69,-13.19,1212
2020-08-30,287,353,-66,-18.7,1212
2020-08-31,1254,1470,-216,-14.69,1212
2020-09-01,1502,1460,42,2.88,1212
2020-09-02,1502,1456,46,3.16,1212
2020-09-03,1502,1449,53,3.66,1212
2020-09-04,1221,1260,-39,-3.1,1212
2020-09-05,420,491,-71,-14.46,1212
2020-09-06,284,321,-37,-11.53,1212
2020-09-07,1454,1438,16,1.11,1212
2020-09-08,1502,1428,74,5.18,1212
2020-09-09,1502,1425,77,5.4,1212
2020-09-10,1502,1418,84,5.92,1212
2020-09-11,1221,1231,-10,-0.81,1212
2020-09-12,420,464,-44,-9.48,1212
2020-09-13,284,295,-11,-3.73,1212
2020-09-14,1454,1414,40,2.83,1212
2020-09-15,1502,1407,95,6.75,1212
2020-09-16,1502,1406,96,6.83,1212
2020-09-17,1502,1402,100,7.13,1212
2020-09-18,1221,1217,4,0.33,1212
2020-09-19,420,453,-33,-7.28,1212
2020-09-20,284,287,-3,-1.05,1212
2020-09-21,1454,1409,45,3.19,1212
2020-09-22,1502,1404,98,6.98,1212
2020-09-23,1502,1406,96,6.83,1212
2020-09-24,1502,1404,98,6.98,1212
2020-09-25,1221,1221,0,0.0,1212
2020-09-26,420,459,-39,-8.5,1212
2020-09-27,284,294,-10,-3.4,1212
2020-09-28,1454,1418,36,2.54,1212
2020-09-29,1502,1414,88,6.22,1212
2020-09-30,1502,1416,86,6.07,1212
2020-10-01,1449,1414,35,2.48,1212
2020-10-02,1175,1231,-56,-4.55,1212
2020-10-03,420,468,-48,-10.26,1212
2020-10-04,270,303,-33,-10.89,1212
2020-10-05,1463,1426,37,2.59,1212
2020-10-06,1449,1420,29,2.04,1212
2020-10-07,1449,1421,28,1.97,1212
2020-10-08,1449,1418,31,2.19,1212
2020-10-09,1175,1233,-58,-4.7,1212
2020-10-10,420,468,-48,-10.26,1212
2020-10-11,270,302,-32,-10.6,1212
2020-10-12,1463,1422,41,2.88,1212
2020-10-13,1449,1415,34,2.4,1212
2020-10-14,1449,1414,35,2.48,1212
2020-10-15,1449,1410,39,2.77,1212
2020-10-16,1175,1224,-49,-4.0,1212
2020-10-17,420,458,-38,-8.3,1212
2020-10-18,270,291,-21,-7.22,1212
2020-10-19,1463,1411,52,3.69,1212
2020-10-20,1449,1404,45,3.21,1212
2020-10-21,1449,1404,45,3.21,1212
2020-10-22,1449,1399,50,3.57,1212
2020-10-23,1175,1215,-40,-3.29,1212
2020-10-24,420,450,-30,-6.67,1212
2020-10-25,270,284,-14,-4.93,1212
2020-10-26,1463,1406,57,4.05,1212
2020-10-27,1449,1401,48,3.43,1212
2020-10-28,1449,1402,47,3.35,1212
2020-10-29,1449,1400,49,3.5,1212
2020-10-30,1175,1217,-42,-3.45,1212
2020-10-31,420,455,-35,-7.69,1212
2020-11-01,263,290,-27,-9.31,1212
2020-11-02,1273,1414,-141,-9.97,1212
2020-11-03,1246,1411,-165,-11.69,1212
2020-11-04,1246,1413,-167,-11.82,1212
2020-11-05,1246,1412,-166,-11.76,1212
2020-11-06,1109,1230,-121,-9.84,1212
2020-11-07,402,468,-66,-14.1,1212
2020-11-08,263,304,-41,-13.49,1212
2020-11-09,1273,1427,-154,-10.79,1212
2020-11-10,1246,1422,-176,-12.38,1212
2020-11-11,1246,1424,-178,-12.5,1212
2020-11-12,1246,1421,-175,-12.32,1212
2020-11-13,1109,1236,-127,-10.28,1212
2020-11-14,402,472,-70,-14.83,1212
2020-11-15,263,305,-42,-13.77,1212
2020-11-16,1273,1425,-152,-10.67,1212
2020-11-17,1246,1417,-171,-12.07,1212
2020-11-18,1246,1415,-169,-11.94,1212
2020-11-19,1246,1408,-162,-11.51,1212
2020-11-20,1109,1220,-111,-9.1,1212
2020-11-21,402,452,-50,-11.06,1212
2020-11-22,263,281,-18,-6.41,1212
2020-11-23,1273,1398,-125,-8.94,1212
2020-11-24,1246,1387,-141,-10.17,1212
2020-11-25,1246,1382,-136,-9.84,1212
2020-11-26,1246,1373,-127,-9.25,1212
2020-11-27,1109,1183,-74,-6.26,1212
2020-11-28,402,412,-10,-2.43,1212
2020-11-29,263,240,23,9.58,1212
2020-11-30,1273,1356,-83,-6.12,1212
2020-12-01,1120,1345,-225,-16.73,1212
2020-12-02,1120,1339,-219,-16.36,1212
2020-12-03,1120,1331,-211,-15.85,1212
2020-12-04,1146,1141,5,0.44,1212
2020-12-05,424,372,52,13.98,1212
2020-12-06,252,201,51,25.37,1212
2020-12-07,1099,1319,-220,-16.68,1212
2020-12-08,1120,1309,-189,-14.44,1212
2020-12-09,1120,1307,-187,-14.31,1212
2020-12-10,1120,1300,-180,-13.85,1212
2020-12-11,1146,1114,32,2.87,1212
2020-12-12,424,347,77,22.19,1212
2020-12-13,252,179,73,40.78,1212
2020-12-14,1099,1299,-200,-15.4,1212
2020-12-15,1120,1292,-172,-13.31,1212
2020-12-16,1120,1292,-172,-13.31,1212
2020-12-17,1120,1288,-168,-13.04,1212
2020-12-18,1146,1103,43,3.9,1212
2020-12-19,424,338,86,25.44,1212
2020-12-20,252,171,81,47.37,1212
2020-12-21,1099,1293,-194,-15.0,1212
2020-12-22,1120,1286,-166,-12.91,1212
2020-12-23,1120,1286,-166,-12.91,1212
2020-12-24,1120,1282,-162,-12.64,1212
2020-12-25,1146,1097,49,4.47,1212
2020-12-26,424,332,92,27.71,1212
2020-12-27,252,165,87,52.73,1212
2020-12-28,1099,1285,-186,-14.47,1212
2020-12-29,1120,1278,-158,-12.36,1212
2020-12-30,1120,1277,-157,-12.29,1212
2020-12-31,1120,1272,-152,-11.95,1212
2021-01-01,982,1085,-103,-9.49,1212
2021-01-02,358,319,39,12.23,1212
2021-01-03,247,151,96,63.58,1212
2021-01-04,1126,1270,-144,-11.34,1212
2021-01-05,1152,1262,-110,-8.72,1212
2021-01-06,1152,1260,-108,-8.57,1212
2021-01-07,1152,1255,-103,-8.21,1212
2021-01-08,982,1069,-87,-8.14,1212
2021-01-09,358,302,56,18.54,1212
2021-01-10,247,135,112,82.96,1212
2021-01-11,1126,1255,-129,-10.28,1212
2021-01-12,1152,1248,-96,-7.69,1212
2021-01-13,1152,1247,-95,-7.62,1212
2021-01-14,1152,1243,-91,-7.32,1212
2021-01-15,982,1059,-77,-7.27,1212
2021-01-16,358,294,64,21.77,1212
2021-01-17,247,129,118,91.47,1212
2021-01-18,1126,1251,-125,-9.99,1212
2021-01-19,1152,1246,-94,-7.54,1212
2021-01-20,1152,1248,-96,-7.69,1212
2021-01-21,1152,1247,-95,-7.62,1212
2021-01-22,982,1064,-82,-7.71,1212
2021-01-23,358,302,56,18.54,1212
2021-01-24,247,139,108,77.7,1212
2021-01-25,1126,1263,-137,-10.85,1212
2021-01-26,1152,1260,-108,-8.57,1212
2021-01-27,1152,1263,-111,-8.79,1212
2021-01-28,1152,1263,-111,-8.79,1212
2021-01-29,982,1082,-100,-9.24,1212
2021-01-30,358,321,37,11.53,1212
2021-01-31,247,158,89,56.33,1212
2021-02-01,1235,1282,-47,-3.67,1212
2021-02-02,1202,1280,-78,-6.09,1212
2021-02-03,1202,1283,-81,-6.31,1212
2021-02-04,1202,1282,-80,-6.24,1212
2021-02-05,1041,1101,-60,-5.45,1212
2021-02-06,371,339,32,9.44,1212
2021-02-07,247,175,72,41.14,1212
2021-02-08,1235,1299,-64,-4.93,1212
2021-02-09,1202,1295,-93,-7.18,1212
2021-02-10,1202,1298,-96,-7.4,1212
2021-02-11,1202,1296,-94,-7.25,1212
2021-02-12,1041,1113,-72,-6.47,1212
2021-02-13,371,351,20,5.7,1212
2021-02-14,247,186,61,32.8,1212
2021-02-15,1235,1309,-74,-5.65,1212
2021-02-16,1202,1304,-102,-7.82,1212
2021-02-17,1202,1306,-104,-7.96,1212
2021-02-18,1202,1304,-102,-7.82,1212
2021-02-19,1041,1121,-80,-7.14,1212
2021-02-20,371,358,13,3.63,1212
2021-02-21,247,193,54,27.98,1212
2021-02-22,1235,1316,-81,-6.16,1212
2021-02-23,1202,1312,-110,-8.38,1212
2021-02-24,1202,1314,-112,-8.52,1212
2021-02-25,1202,1312,-110,-8.38,1212
2021-02-26,1041,1129,-88,-7.79,1212
2021-02-27,371,366,5,1.37,1212
2021-02-28,247,201,46,22.89,1212
2021-03-01,1318,1325,-7,-0.53,1212
2021-03-02,1298,1320,-22,-1.67,1212
2021-03-03,1298,1322,-24,-1.82,1212
2021-03-04,1298,1321,-23,-1.74,1212
2021-03-05,1122,1138,-16,-1.41,1212
2021-03-06,393,375,18,4.8,1212
2021-03-07,272,211,61,28.91,1212
2021-03-08,1318,1334,-16,-1.2,1212
2021-03-09,1298,1329,-31,-2.33,1212
2021-03-10,1298,1331,-33,-2.48,1212
2021-03-11,1298,1329,-31,-2.33,1212
2021-03-12,1122,1147,-25,-2.18,1212
2021-03-13,393,383,10,2.61,1212
2021-03-14,272,219,53,24.2,1212
2021-03-15,1318,1342,-24,-1.79,1212
2021-03-16,1298,1337,-39,-2.92,1212
2021-03-17,1298,1339,-41,-3.06,1212
2021-03-18,1298,1337,-39,-2.92,1212
2021-03-19,1122,1154,-32,-2.77,1212
2021-03-20,393,391,2,0.51,1212
2021-03-21,272,226,46,20.35,1212
2021-03-22,1318,1350,-32,-2.37,1212
2021-03-23,1298,1345,-47,-3.49,1212
2021-03-24,1298,1348,-50,-3.71,1212
2021-03-25,1298,1346,-48,-3.57,1212
2021-03-26,1122,1164,-42,-3.61,1212
2021-03-27,393,402,-9,-2.24,1212
2021-03-28,272,238,34,14.29,1212
2021-03-29,1318,1362,-44,-3.23,1212
2021-03-30,1298,1358,-60,-4.42,1212
2021-03-31,1298,1362,-64,-4.7,1212
2021-04-01,1188,1361,-173,-12.71,1212
2021-04-02,1020,1179,-159,-13.49,1212
2021-04-03,408,418,-10,-2.39,1212
2021-04-04,238,255,-17,-6.67,1212
2021-04-05,1195,1380,-185,-13.41,1212
2021-04-06,1188,1377,-189,-13.73,1212
2021-04-07,1188,1380,-192,-13.91,1212
2021-04-08,1188,1380,-192,-13.91,1212
2021-04-09,1020,1199,-179,-14.93,1212
2021-04-10,408,437,-29,-6.64,1212
2021-04-11,238,274,-36,-13.14,1212
2021-04-12,1195,1398,-203,-14.52,1212
2021-04-13,1188,1395,-207,-14.84,1212
2021-04-14,1188,1398,-210,-15.02,1212
2021-04-15,1188,1396,-208,-14.9,1212
2021-04-16,1020,1214,-194,-15.98,1212
2021-04-17,408,452,-44,-9.73,1212
2021-04-18,238,287,-49,-17.07,1212
2021-04-19,1195,1410,-215,-15.25,1212
2021-04-20,1188,1406,-218,-15.5,1212
2021-04-21,1188,1408,-220,-15.62,1212
2021-04-22,1188,1405,-217,-15.44,1212
2021-04-23,1020,1222,-202,-16.53,1212
2021-04-24,408,458,-50,-10.92,1212
2021-04-25,238,293,-55,-18.77,1212
2021-04-26,1195,1415,-220,-15.55,1212
2021-04-27,1188,1410,-222,-15.74,1212
2021-04-28,1188,1411,-223,-15.8,1212
2021-04-29,1188,1408,-220,-15.62,1212
2021-04-30,1020,1224,-204,-16.67,1212
2021-05-01,410,461,-51,-11.06,1212
2021-05-02,257,295,-38,-12.88,1212
2021-05-03,1199,1418,-219,-15.44,1212
2021-05-04,1181,1413,-232,-16.42,1212
2021-05-05,1181,1414,-233,-16.48,1212
2021-05-06,1181,1412,-231,-16.36,1212
2021-05-07,1030,1228,-198,-16.12,1212
2021-05-08,410,465,-55,-11.83,1212
2021-05-09,257,301,-44,-14.62,1212
2021-05-10,1199,1424,-225,-15.8,1212
2021-05-11,1181,1419,-238,-16.77,1212
2021-05-12,1181,1421,-240,-16.89,1212
2021-05-13,1181,1419,-238,-16.77,1212
2021-05-14,1030,1236,-206,-16.67,1212
2021-05-15,410,474,-64,-13.5,1212
2021-05-16,257,309,-52,-16.83,1212
2021-05-17,1199,1432,-233,-16.27,1212
2021-05-18,1181,1427,-246,-17.24,1212
2021-05-19,1181,1429,-248,-17.35,1212
2021-05-20,1181,1426,-245,-17.18,1212
2021-05-21,1030,1243,-213,-17.14,1212
2021-05-22,410,479,-69,-14.41,1212
2021-05-23,257,313,-56,-17.89,1212
2021-05-24,1199,1435,-236,-16.45,1212
2021-05-25,1181,1429,-248,-17.35,1212
2021-05-26,1181,1429,-248,-17.35,1212
2021-05-27,1181,1425,-244,-17.12,1212
2021-05-28,1030,1240,-210,-16.94,1212
2021-05-29,410,475,-65,-13.68,1212
2021-05-30,257,307,-50,-16.29,1212
2021-05-31,1199,1428,-229,-16.04,1212
2021-06-01,1329,1420,-91,-6.41,1212
2021-06-02,1329,1419,-90,-6.34,1212
2021-06-03,1329,1414,-85,-6.01,1212
2021-06-04,1078,1228,-150,-12.21,1212
2021-06-05,430,461,-31,-6.72,1212
2021-06-06,258,294,-36,-12.24,1212
2021-06-07,1230,1413,-183,-12.95,1212
2021-06-08,1329,1406,-77,-5.48,1212
2021-06-09,1329,1405,-76,-5.41,1212
2021-06-10,1329,1400,-71,-5.07,1212
2021-06-11,1078,1215,-137,-11.28,1212
2021-06-12,430,450,-20,-4.44,1212
2021-06-13,258,283,-25,-8.83,1212
2021-06-14,1230,1405,-175,-12.46,1212
2021-06-15,1329,1399,-70,-5.0,1212
2021-06-16,1329,1400,-71,-5.07,1212
2021-06-17,1329,1397,-68,-4.87,1212
2021-06-18,1078,1214,-136,-11.2,1212
2021-06-19,430,451,-21,-4.66,1212
2021-06-20,258,287,-29,-10.1,1212
2021-06-21,1230,1411,-181,-12.83,1212
2021-06-22,1329,1408,-79,-5.61,1212
2021-06-23,1329,1412,-83,-5.88,1212
2021-06-24,1329,1411,-82,-5.81,1212
2021-06-25,1078,1231,-153,-12.43,1212
2021-06-26,430,470,-40,-8.51,1212
2021-06-27,258,308,-50,-16.23,1212
2021-06-28,1230,1434,-204,-14.23,1212
2021-06-29,1329,1432,-103,-7.19,1212
2021-06-30,1329,1437,-108,-7.52,1212
2021-07-01,1279,1438,-159,-11.06,1212
2021-07-02,1093,1258,-165,-13.12,1212
2021-07-03,435,498,-63,-12.65,1212
2021-07-04,280,336,-56,-16.67,1212
2021-07-05,1318,1461,-143,-9.79,1212
2021-07-06,1279,1459,-180,-12.34,1212
2021-07-07,1279,1463,-184,-12.58,1212
2021-07-08,1279,1463,-184,-12.58,1212
2021-07-09,1093,1282,-189,-14.74,1212
2021-07-10,435,521,-86,-16.51,1212
2021-07-11,280,357,-77,-21.57,1212
2021-07-12,1318,1481,-163,-11.01,1212
2021-07-13,1279,1477,-198,-13.41,1212
2021-07-14,1279,1479,-200,-13.52,1212
2021-07-15,1279,1478,-199,-13.46,1212
2021-07-16,1093,1294,-201,-15.53,1212
2021-07-17,435,531,-96,-18.08,1212
2021-07-18,280,365,-85,-23.29,1212
2021-07-19,1318,1487,-169,-11.37,1212
2021-07-20,1279,1482,-203,-13.7,1212
2021-07-21,1279,1482,-203,-13.7,1212
2021-07-22,1279,1479,-200,-13.52,1212
2021-07-23,1093,1294,-201,-15.53,1212
2021-07-24,435,530,-95,-17.92,1212
2021-07-25,280,363,-83,-22.87,1212
2021-07-26,1318,1485,-167,-11.25,1212
2021-07-27,1279,1479,-200,-13.52,1212
2021-07-28,1279,1479,-200,-13.52,1212
2021-07-29,1279,1475,-196,-13.29,1212
2021-07-30,1093,1291,-198,-15.34,1212
2021-07-31,435,526,-91,-17.3,1212
2021-08-01,279,360,-81,-22.5,1212
2021-08-02,1209,1482,-273,-18.42,1212
2021-08-03,1243,1476,-233,-15.79,1212
2021-08-04,1243,1477,-234,-15.84,1212
2021-08-05,1243,1474,-231,-15.67,1212
2021-08-06,1016,1290,-274,-21.24,1212
2021-08-07,404,527,-123,-23.34,1212
2021-08-08,279,361,-82,-22.71,1212
2021-08-09,1209,1484,-275,-18.53,1212
2021-08-10,1243,1479,-236,-15.96,1212
2021-08-11,1243,1480,-237,-16.01,1212
2021-08-12,1243,1477,-234,-15.84,1212
2021-08-13,1016,1294,-278,-21.48,1212
2021-08-14,404,530,-126,-23.77,1212
2021-08-15,279,364,-85,-23.35,1212
2021-08-16,1209,1486,-277,-18.64,1212
2021-08-17,1243,1480,-237,-16.01,1212
2021-08-18,1243,1481,-238,-16.07,1212
2021-08-19,1243,1477,-234,-15.84,1212
2021-08-20,1016,1292,-276,-21.36,1212
2021-08-21,404,527,-123,-23.34,1212
2021-08-22,279,359,-80,-22.28,1212
2021-08-23,1209,1479,-270,-18.26,1212
2021-08-24,1243,1471,-228,-15.5,1212
2021-08-25,1243,1469,-226,-15.38,1212
2021-08-26,1243,1463,-220,-15.04,1212
2021-08-27,1016,1276,-260,-20.38,1212
2021-08-28,404,508,-104,-20.47,1212
2021-08-29,279,339,-60,-17.7,1212
2021-08-30,1209,1457,-248,-17.02,1212
2021-08-31,1243,1447,-204,-14.1,1212
2021-09-01,1409,1443,-34,-2.36,1212
2021-09-02,1409,1436,-27,-1.88,1212
2021-09-03,1159,1247,-88,-7.06,1212
2021-09-04,430,478,-48,-10.04,1212
2021-09-05,308,308,0,0.0,1212
2021-09-06,1438,1425,13,0.91,1212
2021-09-07,1409,1415,-6,-0.42,1212
2021-09-08,1409,1411,-2,-0.14,1212
2021-09-09,1409,1404,5,0.36,1212
2021-09-10,1159,1216,-57,-4.69,1212
2021-09-11,430,449,-19,-4.23,1212
2021-09-12,308,280,28,10.0,1212
2021-09-13,1438,1399,39,2.79,1212
2021-09-14,1409,1391,18,1.29,1212
2021-09-15,1409,1389,20,1.44,1212
2021-09-16,1409,1384,25,1.81,1212
2021-09-17,1159,1199,-40,-3.34,1212
2021-09-18,430,434,-4,-0.92,1212
2021-09-19,308,268,40,14.93,1212
2021-09-20,1438,1390,48,3.45,1212
2021-09-21,1409,1385,24,1.73,1212
2021-09-22,1409,1386,23,1.66,1212
2021-09-23,1409,1384,25,1.81,1212
2021-09-24,1159,1201,-42,-3.5,1212
2021-09-25,430,438,-8,-1.83,1212
2021-09-26,308,273,35,12.82,1212
2021-09-27,1438,1397,41,2.93,1212
2021-09-28,1409,1393,16,1.15,1212
2021-09-29,1409,1395,14,1.0,1212
2021-09-30,1409,1394,15,1.08,1212
2021-10-01,1152,1211,-59,-4.87,1212
2021-10-02,455,448,7,1.56,1212
2021-10-03,276,283,-7,-2.47,1212
2021-10-04,1313,1406,-93,-6.61,1212
2021-10-05,1408,1401,7,0.5,1212
2021-10-06,1408,1402,6,0.43,1212
2021-10-07,1408,1399,9,0.64,1212
2021-10-08,1152,1215,-63,-5.19,1212
2021-10-09,455,450,5,1.11,1212
2021-10-10,276,284,-8,-2.82,1212
2021-10-11,1313,1405,-92,-6.55,1212
2021-10-12,1408,1398,10,0.72,1212
2021-10-13,1408,1397,11,0.79,1212
2021-10-14,1408,1393,15,1.08,1212
2021-10-15,1152,1207,-55,-4.56,1212
2021-10-16,455,441,14,3.17,1212
2021-10-17,276,274,2,0.73,1212
2021-10-18,1313,1394,-81,-5.81,1212
2021-10-19,1408,1387,21,1.51,1212
2021-10-20,1408,1386,22,1.59,1212
2021-10-21,1408,1382,26,1.88,1212
2021-10-22,1152,1197,-45,-3.76,1212
2021-10-23,455,432,23,5.32,1212
2021-10-24,276,265,11,4.15,1212
2021-10-25,1313,1387,-74,-5.34,1212
2021-10-26,1408,1381,27,1.96,1212
2021-10-27,1408,1382,26,1.88,1212
2021-10-28,1408,1380,28,2.03,1212
2021-10-29,1152,1197,-45,-3.76,1212
2021-10-30,455,434,21,4.84,1212
2021-10-31,276,270,6,2.22,1212
2021-11-01,1246,1393,-147,-10.55,1212
2021-11-02,1370,1389,-19,-1.37,1212
2021-11-03,1370,1392,-22,-1.58,1212
2021-11-04,1370,1391,-21,-1.51,1212
2021-11-05,1170,1209,-39,-3.23,1212
2021-11-06,445,447,-2,-0.45,1212
2021-11-07,276,283,-7,-2.47,1212
2021-11-08,1246,1406,-160,-11.38,1212
2021-11-09,1370,1402,-32,-2.28,1212
2021-11-10,1370,1404,-34,-2.42,1212
2021-11-11,1370,1401,-31,-2.21,1212
2021-11-12,1170,1218,-48,-3.94,1212
2021-11-13,445,454,-9,-1.98,1212
2021-11-14,276,287,-11,-3.83,1212
2021-11-15,1246,1408,-162,-11.51,1212
2021-11-16,1370,1401,-31,-2.21,1212
2021-11-17,1370,1399,-29,-2.07,1212
2021-11-18,1370,1394,-24,-1.72,1212
2021-11-19,1170,1206,-36,-2.99,1212
2021-11-20,445,438,7,1.6,1212
2021-11-21,276,268,8,2.99,1212
2021-11-22,1246,1386,-140,-10.1,1212
2021-11-23,1370,1375,-5,-0.36,1212
2021-11-24,1370,1370,0,0.0,1212
2021-11-25,1370,1362,8,0.59,1212
2021-11-26,1170,1172,-2,-0.17,1212
2021-11-27,445,401,44,10.97,1212
2021-11-28,276,229,47,20.52,1212
2021-11-29,1246,1345,-99,-7.36,1212
2021-11-30,1370,1333,37,2.78,1212
2021-12-01,1144,1328,-184,-13.86,1212
2021-12-02,1144,1319,-175,-13.27,1212
2021-12-03,839,1129,-290,-25.69,1212
2021-12-04,427,359,68,18.94,1212
2021-12-05,260,189,71,37.57,1212
2021-12-06,1142,1306,-164,-12.56,1212
2021-12-07,1144,1296,-152,-11.73,1212
2021-12-08,1144,1292,-148,-11.46,1212
2021-12-09,1144,1286,-142,-11.04,1212
2021-12-10,839,1098,-259,-23.59,1212
2021-12-11,427,331,96,29.0,1212
2021-12-12,260,163,97,59.51,1212
2021-12-13,1142,1283,-141,-10.99,1212
2021-12-14,1144,1275,-131,-10.27,1212
2021-12-15,1144,1275,-131,-10.27,1212
2021-12-16,1144,1270,-126,-9.92,1212
2021-12-17,839,1085,-246,-22.67,1212
2021-12-18,427,320,107,33.44,1212
2021-12-19,260,153,107,69.93,1212
2021-12-20,1142,1275,-133,-10.43,1212
2021-12-21,1144,1268,-124,-9.78,1212
2021-12-22,1144,1268,-124,-9.78,1212
2021-12-23,1144,1265,-121,-9.57,1212
2021-12-24,839,1080,-241,-22.31,1212
2021-12-25,427,314,113,35.99,1212
2021-12-26,260,148,112,75.68,1212
2021-12-27,1142,1268,-126,-9.94,1212
2021-12-28,1144,1261,-117,-9.28,1212
2021-12-29,1144,1260,-116,-9.21,1212
2021-12-30,1144,1255,-111,-8.84,1212
2021-12-31,839,1069,-230,-21.52,1212
2022-01-01,390,303,87,28.71,1212
2022-01-02,242,135,107,79.26,1212
2022-01-03,1070,1254,-184,-14.67,1212
2022-01-04,1079,1246,-167,-13.4,1212
2022-01-05,1079,1244,-165,-13.26,1212
2022-01-06,1079,1239,-160,-12.91,1212
2022-01-07,962,1053,-91,-8.64,1212
2022-01-08,390,286,104,36.36,1212
2022-01-09,242,118,124,105.08,1212
2022-01-10,1070,1238,-168,-13.57,1212
2022-01-11,1079,1231,-152,-12.35,1212
2022-01-12,1079,1230,-151,-12.28,1212
2022-01-13,1079,1226,-147,-11.99,1212
2022-01-14,962,1041,-79,-7.59,1212
2022-01-15,390,276,114,41.3,1212
2022-01-16,242,110,132,120.0,1212
2022-01-17,1070,1232,-162,-13.15,1212
2022-01-18,1079,1227,-148,-12.06,1212
2022-01-19,1079,1228,-149,-12.13,1212
2022-01-20,1079,1226,-147,-11.99,1212
2022-01-21,962,1043,-81,-7.77,1212
2022-01-22,390,281,109,38.79,1212
2022-01-23,242,117,125,106.84,1212
2022-01-24,1070,1241,-171,-13.78,1212
2022-01-25,1079,1238,-159,-12.84,1212
2022-01-26,1079,1241,-162,-13.05,1212
2022-01-27,1079,1241,-162,-13.05,1212
2022-01-28,962,1060,-98,-9.25,1212
2022-01-29,390,298,92,30.87,1212
2022-01-30,242,135,107,79.26,1212
2020-02-01,503,410,93,22.68,1215
2020-02-02,351,259,92,35.52,1215
2020-02-03,1732,1636,96,5.87,1215
2020-02-04,1764,1634,130,7.96,1215
2020-02-05,1764,1638,126,7.69,1215
2020-02-06,1764,1640,124,7.56,1215
2020-02-07,1584,1413,171,12.1,1215
2020-02-08,503,429,74,17.25,1215
2020-02-09,351,276,75,27.17,1215
2020-02-10,1732,1652,80,4.84,1215
2020-02-11,1764,1649,115,6.97,1215
2020-02-12,1764,1652,112,6.78,1215
2020-02-13,1764,1654,110,6.65,1215
2020-02-14,1584,1427,157,11.0,1215
2020-02-15,503,443,60,13.54,1215
2020-02-16,351,291,60,20.62,1215
2020-02-17,1732,1667,65,3.9,1215
2020-02-18,1764,1666,98,5.88,1215
2020-02-19,1764,1670,94,5.63,1215
2020-02-20,1764,1674,90,5.38,1215
2020-02-21,1584,1449,135,9.32,1215
2020-02-22,503,467,36,7.71,1215
2020-02-23,351,317,34,10.73,1215
2020-02-24,1732,1695,37,2.18,1215
2020-02-25,1764,1696,68,4.01,1215
2020-02-26,1764,1702,62,3.64,1215
2020-02-27,1764,1707,57,3.34,1215
2020-02-28,1584,1483,101,6.81,1215
2020-02-29,503,502,1,0.2,1215
2020-03-01,332,353,-21,-5.95,1215
2020-03-02,1520,1732,-212,-12.24,1215
2020-03-03,1512,1732,-220,-12.7,1215
2020-03-04,1512,1738,-226,-13.0,1215
2020-03-05,1512,1742,-230,-13.2,1215
2020-03-06,1299,1517,-218,-14.37,1215
2020-03-07,461,535,-74,-13.83,1215
2020-03-08,332,384,-52,-13.54,1215
2020-03-09,1520,1760,-240,-13.64,1215
2020-03-10,1512,1758,-246,-13.99,1215
2020-03-11,1512,1762,-250,-14.19,1215
2020-03-12,1512,1764,-252,-14.29,1215
2020-03-13,1299,1537,-238,-15.48,1215
2020-03-14,461,552,-91,-16.49,1215
2020-03-15,332,399,-67,-16.79,1215
2020-03-16,1520,1774,-254,-14.32,1215
2020-03-17,1512,1771,-259,-14.62,1215
2020-03-18,1512,1774,-262,-14.77,1215
2020-03-19,1512,1775,-263,-14.82,1215
2020-03-20,1299,1548,-249,-16.09,1215
2020-03-21,461,563,-102,-18.12,1215
2020-03-22,332,411,-79,-19.22,1215
2020-03-23,1520,1787,-267,-14.94,1215
2020-03-24,1512,1785,-273,-15.29,1215
2020-03-25,1512,1789,-277,-15.48,1215
2020-03-26,1512,1792,-280,-15.62,1215
2020-03-27,1299,1567,-268,-17.1,1215
2020-03-28,461,584,-123,-21.06,1215
2020-03-29,332,434,-102,-23.5,1215
2020-03-30,1520,1812,-292,-16.11,1215
2020-03-31,1512,1813,-301,-16.6,1215
2020-04-01,1559,1819,-260,-14.29,1215
2020-04-02,1559,1824,-265,-14.53,1215
2020-04-03,1328,1600,-272,-17.0,1215
2020-04-04,459,619,-160,-25.85,1215
2020-04-05,306,469,-163,-34.75,1215
2020-04-06,1595,1848,-253,-13.69,1215
2020-04-07,1559,1848,-289,-15.64,1215
2020-04-08,1559,1854,-295,-15.91,1215
2020-04-09,1559,1858,-299,-16.09,1215
2020-04-10,1328,1633,-305,-18.68,1215
2020-04-11,459,650,-191,-29.38,1215
2020-04-12,306,499,-193,-38.68,1215
2020-04-13,1595,1875,-280,-14.93,1215
2020-04-14,1559,1873,-314,-16.76,1215
2020-04-15,1559,1876,-317,-16.9,1215
2020-04-16,1559,1877,-318,-16.94,1215
2020-04-17,1328,1649,-321,-19.47,1215
2020-04-18,459,664,-205,-30.87,1215
2020-04-19,306,510,-204,-40.0,1215
2020-04-20,1595,1884,-289,-15.34,1215
2020-04-21,1559,1879,-320,-17.03,1215
2020-04-22,1559,1880,-321,-17.07,1215
2020-04-23,1559,1880,-321,-17.07,1215
2020-04-24,1328,1651,-323,-19.56,1215
2020-04-25,459,664,-205,-30.87,1215
2020-04-26,306,510,-204,-40.0,1215
2020-04-27,1595,1883,-288,-15.29,1215
2020-04-28,1559,1879,-320,-17.03,1215
2020-04-29,1559,1881,-322,-17.12,1215
2020-04-30,1559,1882,-323,-17.16,1215
2020-05-01,1672,1654,18,1.09,1215
2020-05-02,548,669,-121,-18.09,1215
2020-05-03,358,516,-158,-30.62,1215
2020-05-04,1924,1891,33,1.75,1215
2020-05-05,1931,1888,43,2.28,1215
2020-05-06,1931,1892,39,2.06,1215
2020-05-07,1931,1894,37,1.95,1215
2020-05-08,1672,1667,5,0.3,1215
2020-05-09,548,683,-135,-19.77,1215
2020-05-10,358,531,-173,-32.58,1215
2020-05-11,1924,1906,18,0.94,1215
2020-05-12,1931,1904,27,1.42,1215
2020-05-13,1931,1907,24,1.26,1215
2020-05-14,1931,1908,23,1.21,1215
2020-05-15,1672,1680,-8,-0.48,1215
2020-05-16,548,695,-147,-21.15,1215
2020-05-17,358,541,-183,-33.83,1215
2020-05-18,1924,1915,9,0.47,1215
2020-05-19,1931,1910,21,1.1,1215
2020-05-20,1931,1911,20,1.05,1215
2020-05-21,1931,1910,21,1.1,1215
2020-05-22,1672,1680,-8,-0.48,1215
2020-05-23,548,693,-145,-20.92,1215
2020-05-24,358,537,-179,-33.33,1215
2020-05-25,1924,1909,15,0.79,1215
2020-05-26,1931,1903,28,1.47,1215
2020-05-27,1931,1903,28,1.47,1215
2020-05-28,1931,1901,30,1.58,1215
2020-05-29,1672,1671,1,0.06,1215
2020-05-30,548,683,-135,-19.77,1215
2020-05-31,358,528,-170,-32.2,1215
2020-06-01,1977,1901,76,4.0,1215
2020-06-02,1953,1896,57,3.01,1215
2020-06-03,1953,1897,56,2.95,1215
2020-06-04,1953,1897,56,2.95,1215
2020-06-05,1688,1669,19,1.14,1215
2020-06-06,528,683,-155,-22.69,1215
2020-06-07,378,530,-152,-28.68,1215
2020-06-08,1977,1905,72,3.78,1215
2020-06-09,1953,1901,52,2.74,1215
2020-06-10,1953,1904,49,2.57,1215
2020-06-11,1953,1905,48,2.52,1215
2020-06-12,1688,1677,11,0.66,1215
2020-06-13,528,692,-164,-23.7,1215
2020-06-14,378,538,-160,-29.74,1215
2020-06-15,1977,1912,65,3.4,1215
2020-06-16,1953,1907,46,2.41,1215
2020-06-17,1953,1907,46,2.41,1215
2020-06-18,1953,1906,47,2.47,1215
2020-06-19,1688,1674,14,0.84,1215
2020-06-20,528,685,-157,-22.92,1215
2020-06-21,378,527,-149,-28.27,1215
2020-06-22,1977,1896,81,4.27,1215
2020-06-23,1953,1885,68,3.61,1215
2020-06-24,1953,1880,73,3.88,1215
2020-06-25,1953,1873,80,4.27,1215
2020-06-26,1688,1636,52,3.18,1215
2020-06-27,528,641,-113,-17.63,1215
2020-06-28,378,478,-100,-20.92,1215
2020-06-29,1977,1842,135,7.33,1215
2020-06-30,1953,1828,125,6.84,1215
2020-07-01,1808,1819,-11,-0.6,1215
2020-07-02,1808,1809,-1,-0.06,1215
2020-07-03,1615,1570,45,2.87,1215
2020-07-04,521,574,-53,-9.23,1215
2020-07-05,359,410,-51,-12.44,1215
2020-07-06,1839,1775,64,3.61,1215
2020-07-07,1808,1762,46,2.61,1215
2020-07-08,1808,1756,52,2.96,1215
2020-07-09,1808,1749,59,3.37,1215
2020-07-10,1615,1514,101,6.67,1215
2020-07-11,521,523,-2,-0.38,1215
2020-07-12,359,364,-5,-1.37,1215
2020-07-13,1839,1735,104,5.99,1215
2020-07-14,1808,1728,80,4.63,1215
2020-07-15,1808,1727,81,4.69,1215
2020-07-16,1808,1727,81,4.69,1215
2020-07-17,1615,1498,117,7.81,1215
2020-07-18,521,512,9,1.76,1215
2020-07-19,359,359,0,0.0,1215
2020-07-20,1839,1734,105,6.06,1215
2020-07-21,1808,1731,77,4.45,1215
2020-07-22,1808,1734,74,4.27,1215
2020-07-23,1808,1736,72,4.15,1215
2020-07-24,1615,1508,107,7.1,1215
2020-07-25,521,523,-2,-0.38,1215
2020-07-26,359,370,-11,-2.97,1215
2020-07-27,1839,1744,95,5.45,1215
2020-07-28,1808,1739,69,3.97,1215
2020-07-29,1808,1739,69,3.97,1215
2020-07-30,1808,1738,70,4.03,1215
2020-07-31,1615,1506,109,7.24,1215
2020-08-01,500,517,-17,-3.29,1215
2020-08-02,368,359,9,2.51,1215
2020-08-03,1727,1728,-1,-0.06,1215
2020-08-04,1698,1718,-20,-1.16,1215
2020-08-05,1698,1714,-16,-0.93,1215
2020-08-06,1698,1708,-10,-0.59,1215
2020-08-07,1487,1473,14,0.95,1215
2020-08-08,500,480,20,4.17,1215
2020-08-09,368,319,49,15.36,1215
2020-08-10,1727,1687,40,2.37,1215
2020-08-11,1698,1677,21,1.25,1215
2020-08-12,1698,1673,25,1.49,1215
2020-08-13,1698,1669,29,1.74,1215
2020-08-14,1487,1436,51,3.55,1215
2020-08-15,500,447,53,11.86,1215
2020-08-16,368,290,78,26.9,1215
2020-08-17,1727,1664,63,3.79,1215
2020-08-18,1698,1659,39,2.35,1215
2020-08-19,1698,1662,36,2.17,1215
2020-08-20,1698,1666,32,1.92,1215
2020-08-21,1487,1441,46,3.19,1215
2020-08-22,500,460,40,8.7,1215
2020-08-23,368,312,56,17.95,1215
2020-08-24,1727,1693,34,2.01,1215
2020-08-25,1698,1696,2,0.12,1215
2020-08-26,1698,1707,-9,-0.53,1215
2020-08-27,1698,1717,-19,-1.11,1215
2020-08-28,1487,1498,-11,-0.73,1215
2020-08-29,500,522,-22,-4.21,1215
2020-08-30,368,378,-10,-2.65,1215
2020-08-31,1727,1763,-36,-2.04,1215
2020-09-01,1964,1768,196,11.09,1215
2020-09-02,1964,1780,184,10.34,1215
2020-09-03,1964,1790,174,9.72,1215
2020-09-04,1657,1569,88,5.61,1215
2020-09-05,543,591,-48,-8.12,1215
2020-09-06,362,444,-82,-18.47,1215
2020-09-07,1932,1824,108,5.92,1215
2020-09-08,1964,1825,139,7.62,1215
2020-09-09,1964,1831,133,7.26,1215
2020-09-10,1964,1835,129,7.03,1215
2020-09-11,1657,1608,49,3.05,1215
2020-09-12,543,623,-80,-12.84,1215
2020-09-13,362,470,-108,-22.98,1215
2020-09-14,1932,1843,89,4.83,1215
2020-09-15,1964,1838,126,6.86,1215
2020-09-16,1964,1837,127,6.91,1215
2020-09-17,1964,1836,128,6.97,1215
2020-09-18,1657,1604,53,3.3,1215
2020-09-19,543,615,-72,-11.71,1215
2020-09-20,362,458,-96,-20.96,1215
2020-09-21,1932,1828,104,5.69,1215
2020-09-22,1964,1821,143,7.85,1215
2020-09-23,1964,1819,145,7.97,1215
2020-09-24,1964,1817,147,8.09,1215
2020-09-25,1657,1586,71,4.48,1215
2020-09-26,543,598,-55,-9.2,1215
2020-09-27,362,442,-80,-18.1,1215
2020-09-28,1932,1814,118,6.5,1215
2020-09-29,1964,1809,155,8.57,1215
2020-09-30,1964,1810,154,8.51,1215
2020-10-01,1897,1811,86,4.75,1215
2020-10-02,1635,1582,53,3.35,1215
2020-10-03,559,596,-37,-6.21,1215
2020-10-04,363,443,-80,-18.06,1215
2020-10-05,1979,1817,162,8.92,1215
2020-10-06,1897,1814,83,4.58,1215
2020-10-07,1897,1816,81,4.46,1215
2020-10-08,1897,1817,80,4.4,1215
2020-10-09,1635,1589,46,2.89,1215
2020-10-10,559,603,-44,-7.3,1215
2020-10-11,363,449,-86,-19.15,1215
2020-10-12,1979,1823,156,8.56,1215
2020-10-13,1897,1817,80,4.4,1215
2020-10-14,1897,1818,79,4.35,1215
2020-10-15,1897,1817,80,4.4,1215
2020-10-16,1635,1586,49,3.09,1215
2020-10-17,559,598,-39,-6.52,1215
2020-10-18,363,441,-78,-17.69,1215
2020-10-19,1979,1812,167,9.22,1215
2020-10-20,1897,1805,92,5.1,1215
2020-10-21,1897,1803,94,5.21,1215
2020-10-22,1897,1800,97,5.39,1215
2020-10-23,1635,1568,67,4.27,1215
2020-10-24,559,579,-20,-3.45,1215
2020-10-25,363,421,-58,-13.78,1215
2020-10-26,1979,1793,186,10.37,1215
2020-10-27,1897,1786,111,6.22,1215
2020-10-28,1897,1785,112,6.27,1215
2020-10-29,1897,1784,113,6.33,1215
2020-10-30,1635,1554,81,5.21,1215
2020-10-31,559,567,-8,-1.41,1215
2020-11-01,345,412,-67,-16.26,1215
2020-11-02,2006,1786,220,12.32,1215
2020-11-03,1939,1782,157,8.81,1215
2020-11-04,1939,1784,155,8.69,1215
2020-11-05,1939,1786,153,8.57,1215
2020-11-06,1667,1558,109,7.0,1215
2020-11-07,543,573,-30,-5.24,1215
2020-11-08,345,421,-76,-18.05,1215
2020-11-09,2006,1796,210,11.69,1215
2020-11-10,1939,1793,146,8.14,1215
2020-11-11,1939,1795,144,8.02,1215
2020-11-12,1939,1796,143,7.96,1215
2020-11-13,1667,1567,100,6.38,1215
2020-11-14,543,580,-37,-6.38,1215
2020-11-15,345,424,-79,-18.63,1215
2020-11-16,2006,1796,210,11.69,1215
2020-11-17,1939,1788,151,8.45,1215
2020-11-18,1939,1786,153,8.57,1215
2020-11-19,1939,1781,158,8.87,1215
2020-11-20,1667,1547,120,7.76,1215
2020-11-21,543,554,-11,-1.99,1215
2020-11-22,345,393,-48,-12.21,1215
2020-11-23,2006,1758,248,14.11,1215
2020-11-24,1939,1745,194,11.12,1215
2020-11-25,1939,1737,202,11.63,1215
2020-11-26,1939,1727,212,12.28,1215
2020-11-27,1667,1488,179,12.03,1215
2020-11-28,543,491,52,10.59,1215
2020-11-29,345,326,19,5.83,1215
2020-11-30,2006,1689,317,18.77,1215
2020-12-01,1472,1674,-202,-12.07,1215
2020-12-02,1472,1665,-193,-11.59,1215
2020-12-03,1472,1655,-183,-11.06,1215
2020-12-04,1723,1417,306,21.59,1215
2020-12-05,549,422,127,30.09,1215
2020-12-06,329,259,70,27.03,1215
2020-12-07,1540,1625,-85,-5.23,1215
2020-12-08,1472,1614,-142,-8.8,1215
2020-12-09,1472,1609,-137,-8.51,1215
2020-12-10,1472,1605,-133,-8.29,1215
2020-12-11,1723,1371,352,25.67,1215
2020-12-12,549,381,168,44.09,1215
2020-12-13,329,224,105,46.88,1215
2020-12-14,1540,1596,-56,-3.51,1215
2020-12-15,1472,1590,-118,-7.42,1215
2020-12-16,1472,1590,-118,-7.42,1215
2020-12-17,1472,1590,-118,-7.42,1215
2020-12-18,1723,1360,363,26.69,1215
2020-12-19,549,374,175,46.79,1215
2020-12-20,329,220,109,49.55,1215
2020-12-21,1540,1594,-54,-3.39,1215
2020-12-22,1472,1590,-118,-7.42,1215
2020-12-23,1472,1591,-119,-7.48,1215
2020-12-24,1472,1591,-119,-7.48,1215
2020-12-25,1723,1361,362,26.6,1215
2020-12-26,549,374,175,46.79,1215
2020-12-27,329,219,110,50.23,1215
2020-12-28,1540,1591,-51,-3.21,1215
2020-12-29,1472,1584,-112,-7.07,1215
2020-12-30,1472,1583,-111,-7.01,1215
2020-12-31,1472,1581,-109,-6.89,1215
2021-01-01,1396,1349,47,3.48,1215
2021-01-02,450,359,91,25.35,1215
2021-01-03,320,201,119,59.2,1215
2021-01-04,1492,1571,-79,-5.03,1215
2021-01-05,1584,1563,21,1.34,1215
2021-01-06,1584,1561,23,1.47,1215
2021-01-07,1584,1558,26,1.67,1215
2021-01-08,1396,1325,71,5.36,1215
2021-01-09,450,336,114,33.93,1215
2021-01-10,320,179,141,78.77,1215
2021-01-11,1492,1551,-59,-3.8,1215
2021-01-12,1584,1544,40,2.59,1215
2021-01-13,1584,1544,40,2.59,1215
2021-01-14,1584,1544,40,2.59,1215
2021-01-15,1396,1315,81,6.16,1215
2021-01-16,450,329,121,36.78,1215
2021-01-17,320,176,144,81.82,1215
2021-01-18,1492,1551,-59,-3.8,1215
2021-01-19,1584,1548,36,2.33,1215
2021-01-20,1584,1552,32,2.06,1215
2021-01-21,1584,1555,29,1.86,1215
2021-01-22,1396,1329,67,5.04,1215
2021-01-23,450,347,103,29.68,1215
2021-01-24,320,196,124,63.27,1215
2021-01-25,1492,1574,-82,-5.21,1215
2021-01-26,1584,1573,11,0.7,1215
2021-01-27,1584,1579,5,0.32,1215
2021-01-28,1584,1583,1,0.06,1215
2021-01-29,1396,1357,39,2.87,1215
2021-01-30,450,375,75,20.0,1215
2021-01-31,320,224,96,42.86,1215
2021-02-01,1762,1601,161,10.06,1215
2021-02-02,1770,1599,171,10.69,1215
2021-02-03,1770,1603,167,10.42,1215
2021-02-04,1770,1606,164,10.21,1215
2021-02-05,1565,1379,186,13.49,1215
2021-02-06,492,395,97,24.56,1215
2021-02-07,328,243,85,34.98,1215
2021-02-08,1762,1618,144,8.9,1215
2021-02-09,1770,1616,154,9.53,1215
2021-02-10,1770,1618,152,9.39,1215
2021-02-11,1770,1621,149,9.19,1215
2021-02-12,1565,1393,172,12.35,1215
2021-02-13,492,409,83,20.29,1215
2021-02-14,328,257,71,27.63,1215
2021-02-15,1762,1633,129,7.9,1215
2021-02-16,1770,1631,139,8.52,1215
2021-02-17,1770,1635,135,8.26,1215
2021-02-18,1770,1638,132,8.06,1215
2021-02-19,1565,1413,152,10.76,1215
2021-02-20,492,430,62,14.42,1215
2021-02-21,328,280,48,17.14,1215
2021-02-22,1762,1658,104,6.27,1215
2021-02-23,1770,1658,112,6.76,1215
2021-02-24,1770,1664,106,6.37,1215
2021-02-25,1770,1670,100,5.99,1215
2021-02-26,1565,1446,119,8.23,1215
2021-02-27,492,465,27,5.81,1215
2021-02-28,328,315,13,4.13,1215
2021-03-01,2060,1694,366,21.61,1215
2021-03-02,1993,1695,298,17.58,1215
2021-03-03,1993,1701,292,17.17,1215
2021-03-04,1993,1706,287,16.82,1215
2021-03-05,1732,1481,251,16.95,1215
2021-03-06,552,499,53,10.62,1215
2021-03-07,329,348,-19,-5.46,1215
2021-03-08,2060,1725,335,19.42,1215
2021-03-09,1993,1724,269,15.6,1215
2021-03-10,1993,1728,265,15.34,1215
2021-03-11,1993,1731,262,15.14,1215
2021-03-12,1732,1504,228,15.16,1215
2021-03-13,552,519,33,6.36,1215
2021-03-14,329,366,-37,-10.11,1215
2021-03-15,2060,1742,318,18.25,1215
2021-03-16,1993,1738,255,14.67,1215
2021-03-17,1993,1741,252,14.47,1215
2021-03-18,1993,1743,250,14.34,1215
2021-03-19,1732,1515,217,14.32,1215
2021-03-20,552,530,22,4.15,1215
2021-03-21,329,377,-48,-12.73,1215
2021-03-22,2060,1753,307,17.51,1215
2021-03-23,1993,1750,243,13.89,1215
2021-03-24,1993,1754,239,13.63,1215
2021-03-25,1993,1757,236,13.43,1215
2021-03-26,1732,1531,201,13.13,1215
2021-03-27,552,548,4,0.73,1215
2021-03-28,329,398,-69,-17.34,1215
2021-03-29,2060,1776,284,15.99,1215
2021-03-30,1993,1776,217,12.22,1215
2021-03-31,1993,1781,212,11.9,1215
2021-04-01,2050,1787,263,14.72,1215
2021-04-02,1754,1562,192,12.29,1215
2021-04-03,550,581,-31,-5.34,1215
2021-04-04,325,432,-107,-24.77,1215
2021-04-05,2107,1811,296,16.34,1215
2021-04-06,2050,1811,239,13.2,1215
2021-04-07,2050,1817,233,12.82,1215
2021-04-08,2050,1822,228,12.51,1215
2021-04-09,1754,1597,157,9.83,1215
2021-04-10,550,615,-65,-10.57,1215
2021-04-11,325,464,-139,-29.96,1215
2021-04-12,2107,1841,266,14.45,1215
2021-04-13,2050,1839,211,11.47,1215
2021-04-14,2050,1842,208,11.29,1215
2021-04-15,2050,1845,205,11.11,1215
2021-04-16,1754,1617,137,8.47,1215
2021-04-17,550,632,-82,-12.97,1215
2021-04-18,325,478,-153,-32.01,1215
2021-04-19,2107,1852,255,13.77,1215
2021-04-20,2050,1848,202,10.93,1215
2021-04-21,2050,1849,201,10.87,1215
2021-04-22,2050,1849,201,10.87,1215
2021-04-23,1754,1620,134,8.27,1215
2021-04-24,550,633,-83,-13.11,1215
2021-04-25,325,479,-154,-32.15,1215
2021-04-26,2107,1852,255,13.77,1215
2021-04-27,2050,1848,202,10.93,1215
2021-04-28,2050,1849,201,10.87,1215
2021-04-29,2050,1850,200,10.81,1215
2021-04-30,1754,1621,133,8.2,1215
2021-05-01,581,636,-55,-8.65,1215
2021-05-02,368,483,-115,-23.81,1215
2021-05-03,1990,1858,132,7.1,1215
2021-05-04,2016,1855,161,8.68,1215
2021-05-05,2016,1858,158,8.5,1215
2021-05-06,2016,1860,156,8.39,1215
2021-05-07,1762,1633,129,7.9,1215
2021-05-08,581,649,-68,-10.48,1215
2021-05-09,368,497,-129,-25.96,1215
2021-05-10,1990,1873,117,6.25,1215
2021-05-11,2016,1870,146,7.81,1215
2021-05-12,2016,1873,143,7.63,1215
2021-05-13,2016,1875,141,7.52,1215
2021-05-14,1762,1648,114,6.92,1215
2021-05-15,581,663,-82,-12.37,1215
2021-05-16,368,509,-141,-27.7,1215
2021-05-17,1990,1883,107,5.68,1215
2021-05-18,2016,1879,137,7.29,1215
2021-05-19,2016,1880,136,7.23,1215
2021-05-20,2016,1880,136,7.23,1215
2021-05-21,1762,1650,112,6.79,1215
2021-05-22,581,663,-82,-12.37,1215
2021-05-23,368,507,-139,-27.42,1215
2021-05-24,1990,1880,110,5.85,1215
2021-05-25,2016,1874,142,7.58,1215
2021-05-26,2016,1873,143,7.63,1215
2021-05-27,2016,1872,144,7.69,1215
2021-05-28,1762,1641,121,7.37,1215
2021-05-29,581,654,-73,-11.16,1215
2021-05-30,368,498,-130,-26.1,1215
2021-05-31,1990,1871,119,6.36,1215
2021-06-01,2025,1865,160,8.58,1215
2021-06-02,2025,1866,159,8.52,1215
2021-06-03,2025,1866,159,8.52,1215
2021-06-04,1710,1637,73,4.46,1215
2021-06-05,570,651,-81,-12.44,1215
2021-06-06,393,497,-104,-20.93,1215
2021-06-07,1983,1872,111,5.93,1215
2021-06-08,2025,1869,156,8.35,1215
2021-06-09,2025,1871,154,8.23,1215
2021-06-10,2025,1873,152,8.12,1215
2021-06-11,1710,1645,65,3.95,1215
2021-06-12,570,660,-90,-13.64,1215
2021-06-13,393,506,-113,-22.33,1215
2021-06-14,1983,1881,102,5.42,1215
2021-06-15,2025,1876,149,7.94,1215
2021-06-16,2025,1877,148,7.88,1215
2021-06-17,2025,1877,148,7.88,1215
2021-06-18,1710,1646,64,3.89,1215
2021-06-19,570,658,-88,-13.37,1215
2021-06-20,393,500,-107,-21.4,1215
2021-06-21,1983,1870,113,6.04,1215
2021-06-22,2025,1861,164,8.81,1215
2021-06-23,2025,1857,168,9.05,1215
2021-06-24,2025,1851,174,9.4,1215
2021-06-25,1710,1615,95,5.88,1215
2021-06-26,570,621,-51,-8.21,1215
2021-06-27,393,458,-65,-14.19,1215
2021-06-28,1983,1823,160,8.78,1215
2021-06-29,2025,1809,216,11.94,1215
2021-06-30,2025,1800,225,12.5,1215
2021-07-01,1864,1791,73,4.08,1215
2021-07-02,1608,1551,57,3.68,1215
2021-07-03,528,555,-27,-4.86,1215
2021-07-04,394,391,3,0.77,1215
2021-07-05,1888,1755,133,7.58,1215
2021-07-06,1864,1742,122,7.0,1215
2021-07-07,1864,1734,130,7.5,1215
2021-07-08,1864,1727,137,7.93,1215
2021-07-09,1608,1491,117,7.85,1215
2021-07-10,528,498,30,6.02,1215
2021-07-11,394,338,56,16.57,1215
2021-07-12,1888,1708,180,10.54,1215
2021-07-13,1864,1700,164,9.65,1215
2021-07-14,1864,1698,166,9.78,1215
2021-07-15,1864,1697,167,9.84,1215
2021-07-16,1608,1467,141,9.61,1215
2021-07-17,528,480,48,10.0,1215
2021-07-18,394,326,68,20.86,1215
2021-07-19,1888,1701,187,10.99,1215
2021-07-20,1864,1698,166,9.78,1215
2021-07-21,1864,1701,163,9.58,1215
2021-07-22,1864,1703,161,9.45,1215
2021-07-23,1608,1475,133,9.02,1215
2021-07-24,528,491,37,7.54,1215
2021-07-25,394,338,56,16.57,1215
2021-07-26,1888,1712,176,10.28,1215
2021-07-27,1864,1708,156,9.13,1215
2021-07-28,1864,1709,155,9.07,1215
2021-07-29,1864,1709,155,9.07,1215
2021-07-30,1608,1478,130,8.8,1215
2021-07-31,528,489,39,7.98,1215
2021-08-01,366,332,34,10.24,1215
2021-08-02,1735,1702,33,1.94,1215
2021-08-03,1732,1693,39,2.3,1215
2021-08-04,1732,1689,43,2.55,1215
2021-08-05,1732,1684,48,2.85,1215
2021-08-06,1454,1449,5,0.35,1215
2021-08-07,483,457,26,5.69,1215
2021-08-08,366,296,70,23.65,1215
2021-08-09,1735,1664,71,4.27,1215
2021-08-10,1732,1653,79,4.78,1215
2021-08-11,1732,1648,84,5.1,1215
2021-08-12,1732,1643,89,5.42,1215
2021-08-13,1454,1409,45,3.19,1215
2021-08-14,483,419,64,15.27,1215
2021-08-15,366,262,104,39.69,1215
2021-08-16,1735,1633,102,6.25,1215
2021-08-17,1732,1628,104,6.39,1215
2021-08-18,1732,1629,103,6.32,1215
2021-08-19,1732,1631,101,6.19,1215
2021-08-20,1454,1404,50,3.56,1215
2021-08-21,483,422,61,14.45,1215
2021-08-22,366,273,93,34.07,1215
2021-08-23,1735,1652,83,5.02,1215
2021-08-24,1732,1655,77,4.65,1215
2021-08-25,1732,1664,68,4.09,1215
2021-08-26,1732,1674,58,3.46,1215
2021-08-27,1454,1454,0,0.0,1215
2021-08-28,483,478,5,1.05,1215
2021-08-29,366,334,32,9.58,1215
2021-08-30,1735,1718,17,0.99,1215
2021-08-31,1732,1724,8,0.46,1215
2021-09-01,1907,1736,171,9.85,1215
2021-09-02,1907,1746,161,9.22,1215
2021-09-03,1676,1527,149,9.76,1215
2021-09-04,522,550,-28,-5.09,1215
2021-09-05,391,404,-13,-3.22,1215
2021-09-06,1942,1785,157,8.8,1215
2021-09-07,1907,1787,120,6.72,1215
2021-09-08,1907,1794,113,6.3,1215
2021-09-09,1907,1799,108,6.0,1215
2021-09-10,1676,1574,102,6.48,1215
2021-09-11,522,590,-68,-11.53,1215
2021-09-12,391,438,-47,-10.73,1215
2021-09-13,1942,1812,130,7.17,1215
2021-09-14,1907,1808,99,5.48,1215
2021-09-15,1907,1808,99,5.48,1215
2021-09-16,1907,1807,100,5.53,1215
2021-09-17,1676,1576,100,6.35,1215
2021-09-18,522,587,-65,-11.07,1215
2021-09-19,391,430,-39,-9.07,1215
2021-09-20,1942,1801,141,7.83,1215
2021-09-21,1907,1793,114,6.36,1215
2021-09-22,1907,1792,115,6.42,1215
2021-09-23,1907,1789,118,6.6,1215
2021-09-24,1676,1557,119,7.64,1215
2021-09-25,522,569,-47,-8.26,1215
2021-09-26,391,413,-22,-5.33,1215
2021-09-27,1942,1785,157,8.8,1215
2021-09-28,1907,1779,128,7.2,1215
2021-09-29,1907,1779,128,7.2,1215
2021-09-30,1907,1779,128,7.2,1215
2021-10-01,1652,1550,102,6.58,1215
2021-10-02,537,564,-27,-4.79,1215
2021-10-03,383,410,-27,-6.59,1215
2021-10-04,1838,1785,53,2.97,1215
2021-10-05,1891,1781,110,6.18,1215
2021-10-06,1891,1784,107,6.0,1215
2021-10-07,1891,1785,106,5.94,1215
2021-10-08,1652,1557,95,6.1,1215
2021-10-09,537,571,-34,-5.95,1215
2021-10-10,383,417,-34,-8.15,1215
2021-10-11,1838,1791,47,2.62,1215
2021-10-12,1891,1787,104,5.82,1215
2021-10-13,1891,1788,103,5.76,1215
2021-10-14,1891,1787,104,5.82,1215
2021-10-15,1652,1557,95,6.1,1215
2021-10-16,537,569,-32,-5.62,1215
2021-10-17,383,413,-30,-7.26,1215
2021-10-18,1838,1784,54,3.03,1215
2021-10-19,1891,1777,114,6.42,1215
2021-10-20,1891,1775,116,6.54,1215
2021-10-21,1891,1773,118,6.66,1215
2021-10-22,1652,1541,111,7.2,1215
2021-10-23,537,551,-14,-2.54,1215
2021-10-24,383,394,-11,-2.79,1215
2021-10-25,1838,1765,73,4.14,1215
2021-10-26,1891,1758,133,7.57,1215
2021-10-27,1891,1756,135,7.69,1215
2021-10-28,1891,1755,136,7.75,1215
2021-10-29,1652,1524,128,8.4,1215
2021-10-30,537,536,1,0.19,1215
2021-10-31,383,381,2,0.52,1215
2021-11-01,1852,1755,97,5.53,1215
2021-11-02,1898,1750,148,8.46,1215
2021-11-03,1898,1752,146,8.33,1215
2021-11-04,1898,1753,145,8.27,1215
2021-11-05,1679,1525,154,10.1,1215
2021-11-06,519,540,-21,-3.89,1215
2021-11-07,370,387,-17,-4.39,1215
2021-11-08,1852,1763,89,5.05,1215
2021-11-09,1898,1760,138,7.84,1215
2021-11-10,1898,1762,136,7.72,1215
2021-11-11,1898,1764,134,7.6,1215
2021-11-12,1679,1535,144,9.38,1215
2021-11-13,519,549,-30,-5.46,1215
2021-11-14,370,394,-24,-6.09,1215
2021-11-15,1852,1767,85,4.81,1215
2021-11-16,1898,1761,137,7.78,1215
2021-11-17,1898,1759,139,7.9,1215
2021-11-18,1898,1756,142,8.09,1215
2021-11-19,1679,1522,157,10.32,1215
2021-11-20,519,531,-12,-2.26,1215
2021-11-21,370,370,0,0.0,1215
2021-11-22,1852,1737,115,6.62,1215
2021-11-23,1898,1725,173,10.03,1215
2021-11-24,1898,1717,181,10.54,1215
2021-11-25,1898,1708,190,11.12,1215
2021-11-26,1679,1470,209,14.22,1215
2021-11-27,519,473,46,9.73,1215
2021-11-28,370,308,62,20.13,1215
2021-11-29,1852,1671,181,10.83,1215
2021-11-30,1898,1656,242,14.61,1215
2021-12-01,1507,1647,-140,-8.5,1215
2021-12-02,1507,1637,-130,-7.94,1215
2021-12-03,1192,1398,-206,-14.74,1215
2021-12-04,562,402,160,39.8,1215
2021-12-05,327,238,89,37.39,1215
2021-12-06,1639,1604,35,2.18,1215
2021-12-07,1507,1591,-84,-5.28,1215
2021-12-08,1507,1586,-79,-4.98,1215
2021-12-09,1507,1580,-73,-4.62,1215
2021-12-10,1192,1345,-153,-11.38,1215
2021-12-11,562,355,207,58.31,1215
2021-12-12,327,197,130,65.99,1215
2021-12-13,1639,1567,72,4.59,1215
2021-12-14,1507,1560,-53,-3.4,1215
2021-12-15,1507,1560,-53,-3.4,1215
2021-12-16,1507,1559,-52,-3.34,1215
2021-12-17,1192,1330,-138,-10.38,1215
2021-12-18,562,343,219,63.85,1215
2021-12-19,327,189,138,73.02,1215
2021-12-20,1639,1563,76,4.86,1215
2021-12-21,1507,1558,-51,-3.27,1215
2021-12-22,1507,1560,-53,-3.4,1215
2021-12-23,1507,1560,-53,-3.4,1215
2021-12-24,1192,1331,-139,-10.44,1215
2021-12-25,562,344,218,63.37,1215
2021-12-26,327,189,138,73.02,1215
2021-12-27,1639,1562,77,4.93,1215
2021-12-28,1507,1556,-49,-3.15,1215
2021-12-29,1507,1555,-48,-3.09,1215
2021-12-30,1507,1553,-46,-2.96,1215
2021-12-31,1192,1321,-129,-9.77,1215
2022-01-01,477,332,145,43.67,1215
2022-01-02,323,174,149,85.63,1215
2022-01-03,1509,1545,-36,-2.33,1215
2022-01-04,1536,1537,-1,-0.07,1215
2022-01-05,1536,1534,2,0.13,1215
2022-01-06,1536,1531,5,0.33,1215
2022-01-07,1355,1298,57,4.39,1215
2022-01-08,477,309,168,54.37,1215
2022-01-09,323,151,172,113.91,1215
2022-01-10,1509,1522,-13,-0.85,1215
2022-01-11,1536,1515,21,1.39,1215
2022-01-12,1536,1515,21,1.39,1215
2022-01-13,1536,1514,22,1.45,1215
2022-01-14,1355,1284,71,5.53,1215
2022-01-15,477,297,180,60.61,1215
2022-01-16,323,143,180,125.87,1215
2022-01-17,1509,1518,-9,-0.59,1215
2022-01-18,1536,1515,21,1.39,1215
2022-01-19,1536,1518,18,1.19,1215
2022-01-20,1536,1521,15,0.99,1215
2022-01-21,1355,1294,61,4.71,1215
2022-01-22,477,311,166,53.38,1215
2022-01-23,323,160,163,101.88,1215
2022-01-24,1509,1538,-29,-1.89,1215
2022-01-25,1536,1537,-1,-0.07,1215
2022-01-26,1536,1542,-6,-0.39,1215
2022-01-27,1536,1547,-11,-0.71,1215
2022-01-28,1355,1321,34,2.57,1215
2022-01-29,477,339,138,40.71,1215
2022-01-30,323,188,135,71.81,1215
2020-02-01,206,36,170,472.22,1224
2020-02-02,95,7,88,1257.14,1224
2020-02-03,965,886,79,8.92,1224
2020-02-04,964,883,81,9.17,1224
2020-02-05,964,864,100,11.57,1224
2020-02-06,964,851,113,13.28,1224
2020-02-07,855,608,247,40.62,1224
2020-02-08,206,17,189,1111.76,1224
2020-02-09,95,17,78,458.82,1224
2020-02-10,965,769,196,25.49,1224
2020-02-11,964,769,195,25.36,1224
2020-02-12,964,753,211,28.02,1224
2020-02-13,964,745,219,29.4,1224
2020-02-14,855,510,345,67.65,1224
2020-02-15,206,510,-304,-59.61,1224
2020-02-16,95,510,-415,-81.37,1224
2020-02-17,965,705,260,36.88,1224
2020-02-18,964,718,246,34.26,1224
2020-02-19,964,717,247,34.45,1224
2020-02-20,964,724,240,33.15,1224
2020-02-21,855,503,352,69.98,1224
2020-02-22,206,503,-297,-59.05,1224
2020-02-23,95,503,-408,-81.11,1224
2020-02-24,965,740,225,30.41,1224
2020-02-25,964,765,199,26.01,1224
2020-02-26,964,774,190,24.55,1224
2020-02-27,964,789,175,22.18,1224
2020-02-28,855,575,280,48.7,1224
2020-02-29,206,13,193,1484.62,1224
2020-03-01,90,13,77,592.31,1224
2020-03-02,833,815,18,2.21,1224
2020-03-03,878,836,42,5.02,1224
2020-03-04,878,839,39,4.65,1224
2020-03-05,878,845,33,3.91,1224
2020-03-06,651,620,31,5.0,1224
2020-03-07,168,34,134,394.12,1224
2020-03-08,90,34,56,164.71,1224
2020-03-09,833,818,15,1.83,1224
2020-03-10,878,823,55,6.68,1224
2020-03-11,878,809,69,8.53,1224
2020-03-12,878,800,78,9.75,1224
2020-03-13,651,558,93,16.67,1224
2020-03-14,168,558,-390,-69.89,1224
2020-03-15,90,558,-468,-83.87,1224
2020-03-16,833,715,118,16.5,1224
2020-03-17,878,709,169,23.84,1224
2020-03-18,878,687,191,27.8,1224
2020-03-19,878,671,207,30.85,1224
2020-03-20,651,426,225,52.82,1224
2020-03-21,168,426,-258,-60.56,1224
2020-03-22,90,426,-336,-78.87,1224
2020-03-23,833,587,246,41.91,1224
2020-03-24,878,588,290,49.32,1224
2020-03-25,878,575,303,52.7,1224
2020-03-26,878,569,309,54.31,1224
2020-03-27,651,337,314,93.18,1224
2020-03-28,168,337,-169,-50.15,1224
2020-03-29,90,337,-247,-73.29,1224
2020-03-30,833,541,292,53.97,1224
2020-03-31,878,556,322,57.91,1224
2020-04-01,736,557,179,32.14,1224
2020-04-02,736,566,170,30.04,1224
2020-04-03,590,346,244,70.52,1224
2020-04-04,158,346,-188,-54.34,1224
2020-04-05,63,346,-283,-81.79,1224
2020-04-06,733,578,155,26.82,1224
2020-04-07,736,599,137,22.87,1224
2020-04-08,736,602,134,22.26,1224
2020-04-09,736,611,125,20.46,1224
2020-04-10,590,389,201,51.67,1224
2020-04-11,158,389,-231,-59.38,1224
2020-04-12,63,389,-326,-83.8,1224
2020-04-13,733,601,132,21.96,1224
2020-04-14,736,612,124,20.26,1224
2020-04-15,736,604,132,21.85,1224
2020-04-16,736,600,136,22.67,1224
2020-04-17,590,365,225,61.64,1224
2020-04-18,158,365,-207,-56.71,1224
2020-04-19,63,365,-302,-82.74,1224
2020-04-20,733,536,197,36.75,1224
2020-04-21,736,534,202,37.83,1224
2020-04-22,736,515,221,42.91,1224
2020-04-23,736,502,234,46.61,1224
2020-04-24,590,258,332,128.68,1224
2020-04-25,158,258,-100,-38.76,1224
2020-04-26,63,258,-195,-75.58,1224
2020-04-27,733,419,314,74.94,1224
2020-04-28,736,418,318,76.08,1224
2020-04-29,736,402,334,83.08,1224
2020-04-30,736,394,342,86.8,1224
2020-05-01,839,158,681,431.01,1224
2020-05-02,218,158,60,37.97,1224
2020-05-03,84,158,-74,-46.84,1224
2020-05-04,1087,351,736,209.69,1224
2020-05-05,1107,363,744,204.96,1224
2020-05-06,1107,361,746,206.65,1224
2020-05-07,1107,366,741,202.46,1224
2020-05-08,839,143,696,486.71,1224
2020-05-09,218,143,75,52.45,1224
2020-05-10,84,143,-59,-41.26,1224
2020-05-11,1087,368,719,195.38,1224
2020-05-12,1107,389,718,184.58,1224
2020-05-13,1107,392,715,182.4,1224
2020-05-14,1107,401,706,176.06,1224
2020-05-15,839,180,659,366.11,1224
2020-05-16,218,180,38,21.11,1224
2020-05-17,84,180,-96,-53.33,1224
2020-05-18,1087,397,690,173.8,1224
2020-05-19,1107,410,697,170.0,1224
2020-05-20,1107,405,702,173.33,1224
2020-05-21,1107,404,703,174.01,1224
2020-05-22,839,171,668,390.64,1224
2020-05-23,218,171,47,27.49,1224
2020-05-24,84,171,-87,-50.88,1224
2020-05-25,1087,350,737,210.57,1224
2020-05-26,1107,351,756,215.38,1224
2020-05-27,1107,333,774,232.43,1224
2020-05-28,1107,321,786,244.86,1224
2020-05-29,839,79,760,962.03,1224
2020-05-30,218,79,139,175.95,1224
2020-05-31,84,79,5,6.33,1224
2020-06-01,1257,239,1018,425.94,1224
2020-06-02,1275,237,1038,437.97,1224
2020-06-03,1275,220,1055,479.55,1224
2020-06-04,1275,210,1065,507.14,1224
2020-06-05,941,45,896,1991.11,1224
2020-06-06,266,45,221,491.11,1224
2020-06-07,99,45,54,120.0,1224
2020-06-08,1257,158,1099,695.57,1224
2020-06-09,1275,168,1107,658.93,1224
2020-06-10,1275,162,1113,687.04,1224
2020-06-11,1275,166,1109,668.07,1224
2020-06-12,941,25,916,3664.0,1224
2020-06-13,266,25,241,964.0,1224
2020-06-14,99,25,74,296.0,1224
2020-06-15,1257,163,1094,671.17,1224
2020-06-16,1275,183,1092,596.72,1224
2020-06-17,1275,187,1088,581.82,1224
2020-06-18,1275,196,1079,550.51,1224
2020-06-19,941,45,896,1991.11,1224
2020-06-20,266,45,221,491.11,1224
2020-06-21,99,45,54,120.0,1224
2020-06-22,1257,199,1058,531.66,1224
2020-06-23,1275,215,1060,493.02,1224
2020-06-24,1275,212,1063,501.42,1224
2020-06-25,1275,213,1062,498.59,1224
2020-06-26,941,46,895,1945.65,1224
2020-06-27,266,46,220,478.26,1224
2020-06-28,99,46,53,115.22,1224
2020-06-29,1257,168,1089,648.21,1224
2020-06-30,1275,170,1105,650.0,1224
2020-07-01,1199,153,1046,683.66,1224
2020-07-02,1199,142,1057,744.37,1224
2020-07-03,966,7,959,13700.0,1224
2020-07-04,218,7,211,3014.29,1224
2020-07-05,102,7,95,1357.14,1224
2020-07-06,1176,57,1119,1963.16,1224
2020-07-07,1199,54,1145,2120.37,1224
2020-07-08,1199,34,1165,3426.47,1224
2020-07-09,1199,22,1177,5350.0,1224
2020-07-10,966,22,944,4290.91,1224
2020-07-11,218,22,196,890.91,1224
2020-07-12,102,22,80,363.64,1224
2020-07-13,1176,36,1140,3166.67,1224
2020-07-14,1199,40,1159,2897.5,1224
2020-07-15,1199,32,1167,3646.88,1224
2020-07-16,1199,36,1163,3230.56,1224
2020-07-17,966,36,930,2583.33,1224
2020-07-18,218,36,182,505.56,1224
2020-07-19,102,36,66,183.33,1224
2020-07-20,1176,31,1145,3693.55,1224
2020-07-21,1199,39,1160,2974.36,1224
2020-07-22,1199,45,1154,2564.44,1224
2020-07-23,1199,51,1148,2250.98,1224
2020-07-24,966,51,915,1794.12,1224
2020-07-25,218,51,167,327.45,1224
2020-07-26,102,51,51,100.0,1224
2020-07-27,1176,3,1173,39100.0,1224
2020-07-28,1199,22,1177,5350.0,1224
2020-07-29,1199,23,1176,5113.04,1224
2020-07-30,1199,28,1171,4182.14,1224
2020-07-31,966,28,938,3350.0,1224
2020-08-01,232,28,204,728.57,1224
2020-08-02,101,28,73,260.71,1224
2020-08-03,1022,53,969,1828.3,1224
2020-08-04,1064,58,1006,1734.48,1224
2020-08-05,1064,48,1016,2116.67,1224
2020-08-06,1064,44,1020,2318.18,1224
2020-08-07,871,44,827,1879.55,1224
2020-08-08,232,44,188,427.27,1224
2020-08-09,101,44,57,129.55,1224
2020-08-10,1022,44,978,2222.73,1224
2020-08-11,1064,44,1020,2318.18,1224
2020-08-12,1064,44,1020,2318.18,1224
2020-08-13,1064,44,1020,2318.18,1224
2020-08-14,871,44,827,1879.55,1224
2020-08-15,232,44,188,427.27,1224
2020-08-16,101,44,57,129.55,1224
2020-08-17,1022,44,978,2222.73,1224
2020-08-18,1064,44,1020,2318.18,1224
2020-08-19,1064,44,1020,2318.18,1224
2020-08-20,1064,44,1020,2318.18,1224
2020-08-21,871,44,827,1879.55,1224
2020-08-22,232,44,188,427.27,1224
2020-08-23,101,44,57,129.55,1224
2020-08-24,1022,44,978,2222.73,1224
2020-08-25,1064,44,1020,2318.18,1224
2020-08-26,1064,44,1020,2318.18,1224
2020-08-27,1064,44,1020,2318.18,1224
2020-08-28,871,44,827,1879.55,1224
2020-08-29,232,44,188,427.27,1224
2020-08-30,101,44,57,129.55,1224
2020-08-31,1022,44,978,2222.73,1224
2020-09-01,1233,44,1189,2702.27,1224
2020-09-02,1233,44,1189,2702.27,1224
2020-09-03,1233,44,1189,2702.27,1224
2020-09-04,890,44,846,1922.73,1224
2020-09-05,220,44,176,400.0,1224
2020-09-06,98,44,54,122.73,1224
2020-09-07,1157,44,1113,2529.55,1224
2020-09-08,1233,44,1189,2702.27,1224
2020-09-09,1233,44,1189,2702.27,1224
2020-09-10,1233,44,1189,2702.27,1224
2020-09-11,890,44,846,1922.73,1224
2020-09-12,220,44,176,400.0,1224
2020-09-13,98,44,54,122.73,1224
2020-09-14,1157,44,1113,2529.55,1224
2020-09-15,1233,44,1189,2702.27,1224
2020-09-16,1233,44,1189,2702.27,1224
2020-09-17,1233,44,1189,2702.27,1224
2020-09-18,890,44,846,1922.73,1224
2020-09-19,220,44,176,400.0,1224
2020-09-20,98,44,54,122.73,1224
2020-09-21,1157,44,1113,2529.55,1224
2020-09-22,1233,44,1189,2702.27,1224
2020-09-23,1233,44,1189,2702.27,1224
2020-09-24,1233,44,1189,2702.27,1224
2020-09-25,890,44,846,1922.73,1224
2020-09-26,220,44,176,400.0,1224
2020-09-27,98,44,54,122.73,1224
2020-09-28,1157,44,1113,2529.55,1224
2020-09-29,1233,44,1189,2702.27,1224
2020-09-30,1233,44,1189,2702.27,1224
2020-10-01,1214,44,1170,2659.09,1224
2020-10-02,949,44,905,2056.82,1224
2020-10-03,224,44,180,409.09,1224
2020-10-04,91,44,47,106.82,1224
2020-10-05,1203,44,1159,2634.09,1224
2020-10-06,1214,44,1170,2659.09,1224
2020-10-07,1214,44,1170,2659.09,1224
2020-10-08,1214,44,1170,2659.09,1224
2020-10-09,949,44,905,2056.82,1224
2020-10-10,224,44,180,409.09,1224
2020-10-11,91,44,47,106.82,1224
2020-10-12,1203,44,1159,2634.09,1224
2020-10-13,1214,44,1170,2659.09,1224
2020-10-14,1214,44,1170,2659.09,1224
2020-10-15,1214,44,1170,2659.09,1224
2020-10-16,949,44,905,2056.82,1224
2020-10-17,224,44,180,409.09,1224
2020-10-18,91,44,47,106.82,1224
2020-10-19,1203,44,1159,2634.09,1224
2020-10-20,1214,44,1170,2659.09,1224
2020-10-21,1214,44,1170,2659.09,1224
2020-10-22,1214,44,1170,2659.09,1224
2020-10-23,949,44,905,2056.82,1224
2020-10-24,224,44,180,409.09,1224
2020-10-25,91,44,47,106.82,1224
2020-10-26,1203,44,1159,2634.09,1224
2020-10-27,1214,44,1170,2659.09,1224
2020-10-28,1214,44,1170,2659.09,1224
2020-10-29,1214,44,1170,2659.09,1224
2020-10-30,949,44,905,2056.82,1224
2020-10-31,224,44,180,409.09,1224
2020-11-01,84,44,40,90.91,1224
2020-11-02,1002,44,958,2177.27,1224
2020-11-03,988,44,944,2145.45,1224
2020-11-04,988,44,944,2145.45,1224
2020-11-05,988,44,944,2145.45,1224
2020-11-06,820,44,776,1763.64,1224
2020-11-07,187,44,143,325.0,1224
2020-11-08,84,44,40,90.91,1224
2020-11-09,1002,44,958,2177.27,1224
2020-11-10,988,44,944,2145.45,1224
2020-11-11,988,44,944,2145.45,1224
2020-11-12,988,44,944,2145.45,1224
2020-11-13,820,44,776,1763.64,1224
2020-11-14,187,44,143,325.0,1224
2020-11-15,84,44,40,90.91,1224
2020-11-16,1002,44,958,2177.27,1224
2020-11-17,988,44,944,2145.45,1224
2020-11-18,988,44,944,2145.45,1224
2020-11-19,988,44,944,2145.45,1224
2020-11-20,820,44,776,1763.64,1224
2020-11-21,187,44,143,325.0,1224
2020-11-22,84,44,40,90.91,1224
2020-11-23,1002,44,958,2177.27,1224
2020-11-24,988,44,944,2145.45,1224
2020-11-25,988,44,944,2145.45,1224
2020-11-26,988,44,944,2145.45,1224
2020-11-27,820,44,776,1763.64,1224
2020-11-28,187,44,143,325.0,1224
2020-11-29,84,44,40,90.91,1224
2020-11-30,1002,44,958,2177.27,1224
2020-12-01,780,44,736,1672.73,1224
2020-12-02,780,44,736,1672.73,1224
2020-12-03,780,44,736,1672.73,1224
2020-12-04,858,44,814,1850.0,1224
2020-12-05,204,44,160,363.64,1224
2020-12-06,87,44,43,97.73,1224
2020-12-07,719,44,675,1534.09,1224
2020-12-08,780,44,736,1672.73,1224
2020-12-09,780,44,736,1672.73,1224
2020-12-10,780,44,736,1672.73,1224
2020-12-11,858,44,814,1850.0,1224
2020-12-12,204,44,160,363.64,1224
2020-12-13,87,44,43,97.73,1224
2020-12-14,719,44,675,1534.09,1224
2020-12-15,780,44,736,1672.73,1224
2020-12-16,780,44,736,1672.73,1224
2020-12-17,780,44,736,1672.73,1224
2020-12-18,858,44,814,1850.0,1224
2020-12-19,204,44,160,363.64,1224
2020-12-20,87,44,43,97.73,1224
2020-12-21,719,44,675,1534.09,1224
2020-12-22,780,44,736,1672.73,1224
2020-12-23,780,44,736,1672.73,1224
2020-12-24,780,44,736,1672.73,1224
2020-12-25,858,44,814,1850.0,1224
2020-12-26,204,44,160,363.64,1224
2020-12-27,87,44,43,97.73,1224
2020-12-28,719,44,675,1534.09,1224
2020-12-29,780,44,736,1672.73,1224
2020-12-30,780,44,736,1672.73,1224
2020-12-31,780,44,736,1672.73,1224
2021-01-01,595,44,551,1252.27,1224
2021-01-02,163,44,119,270.45,1224
2021-01-03,94,44,50,113.64,1224
2021-01-04,674,44,630,1431.82,1224
2021-01-05,724,44,680,1545.45,1224
2021-01-06,724,44,680,1545.45,1224
2021-01-07,724,44,680,1545.45,1224
2021-01-08,595,44,551,1252.27,1224
2021-01-09,163,44,119,270.45,1224
2021-01-10,94,44,50,113.64,1224
2021-01-11,674,44,630,1431.82,1224
2021-01-12,724,44,680,1545.45,1224
2021-01-13,724,44,680,1545.45,1224
2021-01-14,724,44,680,1545.45,1224
2021-01-15,595,44,551,1252.27,1224
2021-01-16,163,44,119,270.45,1224
2021-01-17,94,44,50,113.64,1224
2021-01-18,674,44,630,1431.82,1224
2021-01-19,724,44,680,1545.45,1224
2021-01-20,724,44,680,1545.45,1224
2021-01-21,724,44,680,1545.45,1224
2021-01-22,595,44,551,1252.27,1224
2021-01-23,163,44,119,270.45,1224
2021-01-24,94,44,50,113.64,1224
2021-01-25,674,44,630,1431.82,1224
2021-01-26,724,44,680,1545.45,1224
2021-01-27,724,44,680,1545.45,1224
2021-01-28,724,44,680,1545.45,1224
2021-01-29,595,44,551,1252.27,1224
2021-01-30,163,44,119,270.45,1224
2021-01-31,94,44,50,113.64,1224
2021-02-01,869,44,825,1875.0,1224
2021-02-02,916,44,872,1981.82,1224
2021-02-03,916,44,872,1981.82,1224
2021-02-04,916,44,872,1981.82,1224
2021-02-05,739,44,695,1579.55,1224
2021-02-06,175,44,131,297.73,1224
2021-02-07,84,44,40,90.91,1224
2021-02-08,869,44,825,1875.0,1224
2021-02-09,916,44,872,1981.82,1224
2021-02-10,916,44,872,1981.82,1224
2021-02-11,916,44,872,1981.82,1224
2021-02-12,739,44,695,1579.55,1224
2021-02-13,175,44,131,297.73,1224
2021-02-14,84,44,40,90.91,1224
2021-02-15,869,44,825,1875.0,1224
2021-02-16,916,44,872,1981.82,1224
2021-02-17,916,44,872,1981.82,1224
2021-02-18,916,44,872,1981.82,1224
2021-02-19,739,44,695,1579.55,1224
2021-02-20,175,44,131,297.73,1224
2021-02-21,84,44,40,90.91,1224
2021-02-22,869,44,825,1875.0,1224
2021-02-23,916,44,872,1981.82,1224
2021-02-24,916,44,872,1981.82,1224
2021-02-25,916,44,872,1981.82,1224
2021-02-26,739,44,695,1579.55,1224
2021-02-27,175,44,131,297.73,1224
2021-02-28,84,44,40,90.91,1224
2021-03-01,1050,44,1006,2286.36,1224
2021-03-02,1041,44,997,2265.91,1224
2021-03-03,1041,44,997,2265.91,1224
2021-03-04,1041,44,997,2265.91,1224
2021-03-05,854,44,810,1840.91,1224
2021-03-06,194,44,150,340.91,1224
2021-03-07,92,44,48,109.09,1224
2021-03-08,1050,44,1006,2286.36,1224
2021-03-09,1041,44,997,2265.91,1224
2021-03-10,1041,44,997,2265.91,1224
2021-03-11,1041,44,997,2265.91,1224
2021-03-12,854,44,810,1840.91,1224
2021-03-13,194,44,150,340.91,1224
2021-03-14,92,44,48,109.09,1224
2021-03-15,1050,44,1006,2286.36,1224
2021-03-16,1041,44,997,2265.91,1224
2021-03-17,1041,44,997,2265.91,1224
2021-03-18,1041,44,997,2265.91,1224
2021-03-19,854,44,810,1840.91,1224
2021-03-20,194,44,150,340.91,1224
2021-03-21,92,44,48,109.09,1224
2021-03-22,1050,44,1006,2286.36,1224
2021-03-23,1041,44,997,2265.91,1224
2021-03-24,1041,44,997,2265.91,1224
2021-03-25,1041,44,997,2265.91,1224
2021-03-26,854,44,810,1840.91,1224
2021-03-27,194,44,150,340.91,1224
2021-03-28,92,44,48,109.09,1224
2021-03-29,1050,44,1006,2286.36,1224
2021-03-30,1041,44,997,2265.91,1224
2021-03-31,1041,44,997,2265.91,1224
2021-04-01,981,44,937,2129.55,1224
2021-04-02,750,44,706,1604.55,1224
2021-04-03,195,44,151,343.18,1224
2021-04-04,92,44,48,109.09,1224
2021-04-05,1094,44,1050,2386.36,1224
2021-04-06,981,44,937,2129.55,1224
2021-04-07,981,44,937,2129.55,1224
2021-04-08,981,44,937,2129.55,1224
2021-04-09,750,44,706,1604.55,1224
2021-04-10,195,44,151,343.18,1224
2021-04-11,92,44,48,109.09,1224
2021-04-12,1094,44,1050,2386.36,1224
2021-04-13,981,44,937,2129.55,1224
2021-04-14,981,44,937,2129.55,1224
2021-04-15,981,44,937,2129.55,1224
2021-04-16,750,44,706,1604.55,1224
2021-04-17,195,44,151,343.18,1224
2021-04-18,92,44,48,109.09,1224
2021-04-19,1094,44,1050,2386.36,1224
2021-04-20,981,44,937,2129.55,1224
2021-04-21,981,44,937,2129.55,1224
2021-04-22,981,44,937,2129.55,1224
2021-04-23,750,44,706,1604.55,1224
2021-04-24,195,44,151,343.18,1224
2021-04-25,92,44,48,109.09,1224
2021-04-26,1094,44,1050,2386.36,1224
2021-04-27,981,44,937,2129.55,1224
2021-04-28,981,44,937,2129.55,1224
2021-04-29,981,44,937,2129.55,1224
2021-04-30,750,44,706,1604.55,1224
2021-05-01,229,44,185,420.45,1224
2021-05-02,90,44,46,104.55,1224
2021-05-03,1147,44,1103,2506.82,1224
2021-05-04,1155,44,1111,2525.0,1224
2021-05-05,1155,44,1111,2525.0,1224
2021-05-06,1155,44,1111,2525.0,1224
2021-05-07,856,44,812,1845.45,1224
2021-05-08,229,44,185,420.45,1224
2021-05-09,90,44,46,104.55,1224
2021-05-10,1147,44,1103,2506.82,1224
2021-05-11,1155,44,1111,2525.0,1224
2021-05-12,1155,44,1111,2525.0,1224
2021-05-13,1155,44,1111,2525.0,1224
2021-05-14,856,44,812,1845.45,1224
2021-05-15,229,44,185,420.45,1224
2021-05-16,90,44,46,104.55,1224
2021-05-17,1147,44,1103,2506.82,1224
2021-05-18,1155,44,1111,2525.0,1224
2021-05-19,1155,44,1111,2525.0,1224
2021-05-20,1155,44,1111,2525.0,1224
2021-05-21,856,44,812,1845.45,1224
2021-05-22,229,44,185,420.45,1224
2021-05-23,90,44,46,104.55,1224
2021-05-24,1147,44,1103,2506.82,1224
2021-05-25,1155,44,1111,2525.0,1224
2021-05-26,1155,44,1111,2525.0,1224
2021-05-27,1155,44,1111,2525.0,1224
2021-05-28,856,44,812,1845.45,1224
2021-05-29,229,44,185,420.45,1224
2021-05-30,90,44,46,104.55,1224
2021-05-31,1147,44,1103,2506.82,1224
2021-06-01,1276,44,1232,2800.0,1224
2021-06-02,1276,44,1232,2800.0,1224
2021-06-03,1276,44,1232,2800.0,1224
2021-06-04,882,44,838,1904.55,1224
2021-06-05,243,44,199,452.27,1224
2021-06-06,115,44,71,161.36,1224
2021-06-07,1240,44,1196,2718.18,1224
2021-06-08,1276,44,1232,2800.0,1224
2021-06-09,1276,44,1232,2800.0,1224
2021-06-10,1276,44,1232,2800.0,1224
2021-06-11,882,44,838,1904.55,1224
2021-06-12,243,44,199,452.27,1224
2021-06-13,115,44,71,161.36,1224
2021-06-14,1240,44,1196,2718.18,1224
2021-06-15,1276,44,1232,2800.0,1224
2021-06-16,1276,44,1232,2800.0,1224
2021-06-17,1276,44,1232,2800.0,1224
2021-06-18,882,44,838,1904.55,1224
2021-06-19,243,44,199,452.27,1224
2021-06-20,115,44,71,161.36,1224
2021-06-21,1240,44,1196,2718.18,1224
2021-06-22,1276,44,1232,2800.0,1224
2021-06-23,1276,44,1232,2800.0,1224
2021-06-24,1276,44,1232,2800.0,1224
2021-06-25,882,44,838,1904.55,1224
2021-06-26,243,44,199,452.27,1224
2021-06-27,115,44,71,161.36,1224
2021-06-28,1240,44,1196,2718.18,1224
2021-06-29,1276,44,1232,2800.0,1224
2021-06-30,1276,44,1232,2800.0,1224
2021-07-01,1139,44,1095,2488.64,1224
2021-07-02,841,44,797,1811.36,1224
2021-07-03,165,44,121,275.0,1224
2021-07-04,93,44,49,111.36,1224
2021-07-05,1158,44,1114,2531.82,1224
2021-07-06,1139,44,1095,2488.64,1224
2021-07-07,1139,44,1095,2488.64,1224
2021-07-08,1139,44,1095,2488.64,1224
2021-07-09,841,44,797,1811.36,1224
2021-07-10,165,44,121,275.0,1224
2021-07-11,93,44,49,111.36,1224
2021-07-12,1158,44,1114,2531.82,1224
2021-07-13,1139,44,1095,2488.64,1224
2021-07-14,1139,44,1095,2488.64,1224
2021-07-15,1139,44,1095,2488.64,1224
2021-07-16,841,44,797,1811.36,1224
2021-07-17,165,44,121,275.0,1224
2021-07-18,93,44,49,111.36,1224
2021-07-19,1158,44,1114,2531.82,1224
2021-07-20,1139,44,1095,2488.64,1224
2021-07-21,1139,44,1095,2488.64,1224
2021-07-22,1139,44,1095,2488.64,1224
2021-07-23,841,44,797,1811.36,1224
2021-07-24,165,44,121,275.0,1224
2021-07-25,93,44,49,111.36,1224
2021-07-26,1158,44,1114,2531.82,1224
2021-07-27,1139,44,1095,2488.64,1224
2021-07-28,1139,44,1095,2488.64,1224
2021-07-29,1139,44,1095,2488.64,1224
2021-07-30,841,44,797,1811.36,1224
2021-07-31,165,44,121,275.0,1224
2021-08-01,94,44,50,113.64,1224
2021-08-02,975,44,931,2115.91,1224
2021-08-03,1022,44,978,2222.73,1224
2021-08-04,1022,44,978,2222.73,1224
2021-08-05,1022,44,978,2222.73,1224
2021-08-06,789,44,745,1693.18,1224
2021-08-07,195,44,151,343.18,1224
2021-08-08,94,44,50,113.64,1224
2021-08-09,975,44,931,2115.91,1224
2021-08-10,1022,44,978,2222.73,1224
2021-08-11,1022,44,978,2222.73,1224
2021-08-12,1022,44,978,2222.73,1224
2021-08-13,789,44,745,1693.18,1224
2021-08-14,195,44,151,343.18,1224
2021-08-15,94,44,50,113.64,1224
2021-08-16,975,44,931,2115.91,1224
2021-08-17,1022,44,978,2222.73,1224
2021-08-18,1022,44,978,2222.73,1224
2021-08-19,1022,44,978,2222.73,1224
2021-08-20,789,44,745,1693.18,1224
2021-08-21,195,44,151,343.18,1224
2021-08-22,94,44,50,113.64,1224
2021-08-23,975,44,931,2115.91,1224
2021-08-24,1022,44,978,2222.73,1224
2021-08-25,1022,44,978,2222.73,1224
2021-08-26,1022,44,978,2222.73,1224
2021-08-27,789,44,745,1693.18,1224
2021-08-28,195,44,151,343.18,1224
2021-08-29,94,44,50,113.64,1224
2021-08-30,975,44,931,2115.91,1224
2021-08-31,1022,44,978,2222.73,1224
2021-09-01,1157,44,1113,2529.55,1224
2021-09-02,1157,44,1113,2529.55,1224
2021-09-03,965,44,921,2093.18,1224
2021-09-04,209,44,165,375.0,1224
2021-09-05,87,44,43,97.73,1224
2021-09-06,1264,44,1220,2772.73,1224
2021-09-07,1157,44,1113,2529.55,1224
2021-09-08,1157,44,1113,2529.55,1224
2021-09-09,1157,44,1113,2529.55,1224
2021-09-10,965,44,921,2093.18,1224
2021-09-11,209,44,165,375.0,1224
2021-09-12,87,44,43,97.73,1224
2021-09-13,1264,44,1220,2772.73,1224
2021-09-14,1157,44,1113,2529.55,1224
2021-09-15,1157,44,1113,2529.55,1224
2021-09-16,1157,44,1113,2529.55,1224
2021-09-17,965,44,921,2093.18,1224
2021-09-18,209,44,165,375.0,1224
2021-09-19,87,44,43,97.73,1224
2021-09-20,1264,44,1220,2772.73,1224
2021-09-21,1157,44,1113,2529.55,1224
2021-09-22,1157,44,1113,2529.55,1224
2021-09-23,1157,44,1113,2529.55,1224
2021-09-24,965,44,921,2093.18,1224
2021-09-25,209,44,165,375.0,1224
2021-09-26,87,44,43,97.73,1224
2021-09-27,1264,44,1220,2772.73,1224
2021-09-28,1157,44,1113,2529.55,1224
2021-09-29,1157,44,1113,2529.55,1224
2021-09-30,1157,44,1113,2529.55,1224
2021-10-01,946,44,902,2050.0,1224
2021-10-02,216,44,172,390.91,1224
2021-10-03,95,44,51,115.91,1224
2021-10-04,1093,44,1049,2384.09,1224
2021-10-05,1172,44,1128,2563.64,1224
2021-10-06,1172,44,1128,2563.64,1224
2021-10-07,1172,44,1128,2563.64,1224
2021-10-08,946,44,902,2050.0,1224
2021-10-09,216,44,172,390.91,1224
2021-10-10,95,44,51,115.91,1224
2021-10-11,1093,44,1049,2384.09,1224
2021-10-12,1172,44,1128,2563.64,1224
2021-10-13,1172,44,1128,2563.64,1224
2021-10-14,1172,44,1128,2563.64,1224
2021-10-15,946,44,902,2050.0,1224
2021-10-16,216,44,172,390.91,1224
2021-10-17,95,44,51,115.91,1224
2021-10-18,1093,44,1049,2384.09,1224
2021-10-19,1172,44,1128,2563.64,1224
2021-10-20,1172,44,1128,2563.64,1224
2021-10-21,1172,44,1128,2563.64,1224
2021-10-22,946,44,902,2050.0,1224
2021-10-23,216,44,172,390.91,1224
2021-10-24,95,44,51,115.91,1224
2021-10-25,1093,44,1049,2384.09,1224
2021-10-26,1172,44,1128,2563.64,1224
2021-10-27,1172,44,1128,2563.64,1224
2021-10-28,1172,44,1128,2563.64,1224
2021-10-29,946,44,902,2050.0,1224
2021-10-30,216,44,172,390.91,1224
2021-10-31,95,44,51,115.91,1224
2021-11-01,1061,44,1017,2311.36,1224
2021-11-02,1167,44,1123,2552.27,1224
2021-11-03,1167,44,1123,2552.27,1224
2021-11-04,1167,44,1123,2552.27,1224
2021-11-05,997,44,953,2165.91,1224
2021-11-06,196,44,152,345.45,1224
2021-11-07,90,44,46,104.55,1224
2021-11-08,1061,44,1017,2311.36,1224
2021-11-09,1167,44,1123,2552.27,1224
2021-11-10,1167,44,1123,2552.27,1224
2021-11-11,1167,44,1123,2552.27,1224
2021-11-12,997,44,953,2165.91,1224
2021-11-13,196,44,152,345.45,1224
2021-11-14,90,44,46,104.55,1224
2021-11-15,1061,44,1017,2311.36,1224
2021-11-16,1167,44,1123,2552.27,1224
2021-11-17,1167,44,1123,2552.27,1224
2021-11-18,1167,44,1123,2552.27,1224
2021-11-19,997,44,953,2165.91,1224
2021-11-20,196,44,152,345.45,1224
2021-11-21,90,44,46,104.55,1224
2021-11-22,1061,44,1017,2311.36,1224
2021-11-23,1167,44,1123,2552.27,1224
2021-11-24,1167,44,1123,2552.27,1224
2021-11-25,1167,44,1123,2552.27,1224
2021-11-26,997,44,953,2165.91,1224
2021-11-27,196,44,152,345.45,1224
2021-11-28,90,44,46,104.55,1224
2021-11-29,1061,44,1017,2311.36,1224
2021-11-30,1167,44,1123,2552.27,1224
2021-12-01,760,44,716,1627.27,1224
2021-12-02,760,44,716,1627.27,1224
2021-12-03,547,44,503,1143.18,1224
2021-12-04,181,44,137,311.36,1224
2021-12-05,86,44,42,95.45,1224
2021-12-06,850,44,806,1831.82,1224
2021-12-07,760,44,716,1627.27,1224
2021-12-08,760,44,716,1627.27,1224
2021-12-09,760,44,716,1627.27,1224
2021-12-10,547,44,503,1143.18,1224
2021-12-11,181,44,137,311.36,1224
2021-12-12,86,44,42,95.45,1224
2021-12-13,850,44,806,1831.82,1224
2021-12-14,760,44,716,1627.27,1224
2021-12-15,760,44,716,1627.27,1224
2021-12-16,760,44,716,1627.27,1224
2021-12-17,547,44,503,1143.18,1224
2021-12-18,181,44,137,311.36,1224
2021-12-19,86,44,42,95.45,1224
2021-12-20,850,44,806,1831.82,1224
2021-12-21,760,44,716,1627.27,1224
2021-12-22,760,44,716,1627.27,1224
2021-12-23,760,44,716,1627.27,1224
2021-12-24,547,44,503,1143.18,1224
2021-12-25,181,44,137,311.36,1224
2021-12-26,86,44,42,95.45,1224
2021-12-27,850,44,806,1831.82,1224
2021-12-28,760,44,716,1627.27,1224
2021-12-29,760,44,716,1627.27,1224
2021-12-30,760,44,716,1627.27,1224
2021-12-31,547,44,503,1143.18,1224
2022-01-01,160,44,116,263.64,1224
2022-01-02,76,44,32,72.73,1224
2022-01-03,736,44,692,1572.73,1224
2022-01-04,702,44,658,1495.45,1224
2022-01-05,702,44,658,1495.45,1224
2022-01-06,702,44,658,1495.45,1224
2022-01-07,658,44,614,1395.45,1224
2022-01-08,160,44,116,263.64,1224
2022-01-09,76,44,32,72.73,1224
2022-01-10,736,44,692,1572.73,1224
2022-01-11,702,44,658,1495.45,1224
2022-01-12,702,44,658,1495.45,1224
2022-01-13,702,44,658,1495.45,1224
2022-01-14,658,44,614,1395.45,1224
2022-01-15,160,44,116,263.64,1224
2022-01-16,76,44,32,72.73,1224
2022-01-17,736,44,692,1572.73,1224
2022-01-18,702,44,658,1495.45,1224
2022-01-19,702,44,658,1495.45,1224
2022-01-20,702,44,658,1495.45,1224
2022-01-21,658,44,614,1395.45,1224
2022-01-22,160,44,116,263.64,1224
2022-01-23,76,44,32,72.73,1224
2022-01-24,736,44,692,1572.73,1224
2022-01-25,702,44,658,1495.45,1224
2022-01-26,702,44,658,1495.45,1224
2022-01-27,702,44,658,1495.45,1224
2022-01-28,658,44,614,1395.45,1224
2022-01-29,160,44,116,263.64,1224
2022-01-30,76,44,32,72.73,1224
2020-02-01,214,163,51,31.29,1603
2020-02-02,142,39,103,264.1,1603
2020-02-03,564,581,-17,-2.93,1603
2020-02-04,578,570,8,1.4,1603
2020-02-05,578,572,6,1.05,1603
2020-02-06,578,572,6,1.05,1603
2020-02-07,526,492,34,6.91,1603
2020-02-08,214,167,47,28.14,1603
2020-02-09,142,41,101,246.34,1603
2020-02-10,564,583,-19,-3.26,1603
2020-02-11,578,571,7,1.23,1603
2020-02-12,578,571,7,1.23,1603
2020-02-13,578,571,7,1.23,1603
2020-02-14,526,491,35,7.13,1603
2020-02-15,214,166,48,28.92,1603
2020-02-16,142,41,101,246.34,1603
2020-02-17,564,582,-18,-3.09,1603
2020-02-18,578,571,7,1.23,1603
2020-02-19,578,573,5,0.87,1603
2020-02-20,578,574,4,0.7,1603
2020-02-21,526,496,30,6.05,1603
2020-02-22,214,172,42,24.42,1603
2020-02-23,142,49,93,189.8,1603
2020-02-24,564,592,-28,-4.73,1603
2020-02-25,578,582,-4,-0.69,1603
2020-02-26,578,586,-8,-1.37,1603
2020-02-27,578,588,-10,-1.7,1603
2020-02-28,526,511,15,2.94,1603
2020-02-29,214,188,26,13.83,1603
2020-03-01,128,65,63,96.92,1603
2020-03-02,461,609,-148,-24.3,1603
2020-03-03,453,599,-146,-24.37,1603
2020-03-04,453,602,-149,-24.75,1603
2020-03-05,453,604,-151,-25.0,1603
2020-03-06,399,526,-127,-24.14,1603
2020-03-07,189,202,-13,-6.44,1603
2020-03-08,128,78,50,64.1,1603
2020-03-09,461,620,-159,-25.65,1603
2020-03-10,453,609,-156,-25.62,1603
2020-03-11,453,610,-157,-25.74,1603
2020-03-12,453,611,-158,-25.86,1603
2020-03-13,399,530,-131,-24.72,1603
2020-03-14,189,205,-16,-7.8,1603
2020-03-15,128,79,49,62.03,1603
2020-03-16,461,620,-159,-25.65,1603
2020-03-17,453,607,-154,-25.37,1603
2020-03-18,453,607,-154,-25.37,1603
2020-03-19,453,607,-154,-25.37,1603
2020-03-20,399,526,-127,-24.14,1603
2020-03-21,189,200,-11,-5.5,1603
2020-03-22,128,74,54,72.97,1603
2020-03-23,461,615,-154,-25.04,1603
2020-03-24,453,604,-151,-25.0,1603
2020-03-25,453,604,-151,-25.0,1603
2020-03-26,453,605,-152,-25.12,1603
2020-03-27,399,525,-126,-24.0,1603
2020-03-28,189,201,-12,-5.97,1603
2020-03-29,128,77,51,66.23,1603
2020-03-30,461,619,-158,-25.53,1603
2020-03-31,453,609,-156,-25.62,1603
2020-04-01,439,611,-172,-28.15,1603
2020-04-02,439,613,-174,-28.38,1603
2020-04-03,365,535,-170,-31.78,1603
2020-04-04,149,211,-62,-29.38,1603
2020-04-05,109,88,21,23.86,1603
2020-04-06,442,631,-189,-29.95,1603
2020-04-07,439,621,-182,-29.31,1603
2020-04-08,439,623,-184,-29.53,1603
2020-04-09,439,624,-185,-29.65,1603
2020-04-10,365,546,-181,-33.15,1603
2020-04-11,149,221,-72,-32.58,1603
2020-04-12,109,96,13,13.54,1603
2020-04-13,442,638,-196,-30.72,1603
2020-04-14,439,626,-187,-29.87,1603
2020-04-15,439,626,-187,-29.87,1603
2020-04-16,439,626,-187,-29.87,1603
2020-04-17,365,545,-180,-33.03,1603
2020-04-18,149,218,-69,-31.65,1603
2020-04-19,109,91,18,19.78,1603
2020-04-20,442,631,-189,-29.95,1603
2020-04-21,439,617,-178,-28.85,1603
2020-04-22,439,616,-177,-28.73,1603
2020-04-23,439,614,-175,-28.5,1603
2020-04-24,365,532,-167,-31.39,1603
2020-04-25,149,204,-55,-26.96,1603
2020-04-26,109,77,32,41.56,1603
2020-04-27,442,616,-174,-28.25,1603
2020-04-28,439,602,-163,-27.08,1603
2020-04-29,439,601,-162,-26.96,1603
2020-04-30,439,600,-161,-26.83,1603
2020-05-01,500,519,-19,-3.66,1603
2020-05-02,188,192,-4,-2.08,1603
2020-05-03,112,66,46,69.7,1603
2020-05-04,533,606,-73,-12.05,1603
2020-05-05,539,594,-55,-9.26,1603
2020-05-06,539,594,-55,-9.26,1603
2020-05-07,539,594,-55,-9.26,1603
2020-05-08,500,514,-14,-2.72,1603
2020-05-09,188,189,-1,-0.53,1603
2020-05-10,112,63,49,77.78,1603
2020-05-11,533,604,-71,-11.75,1603
2020-05-12,539,593,-54,-9.11,1603
2020-05-13,539,593,-54,-9.11,1603
2020-05-14,539,593,-54,-9.11,1603
2020-05-15,500,513,-13,-2.53,1603
2020-05-16,188,187,1,0.53,1603
2020-05-17,112,61,51,83.61,1603
2020-05-18,533,602,-69,-11.46,1603
2020-05-19,539,589,-50,-8.49,1603
2020-05-20,539,588,-49,-8.33,1603
2020-05-21,539,586,-47,-8.02,1603
2020-05-22,500,505,-5,-0.99,1603
2020-05-23,188,177,11,6.21,1603
2020-05-24,112,49,63,128.57,1603
2020-05-25,533,588,-55,-9.35,1603
2020-05-26,539,573,-34,-5.93,1603
2020-05-27,539,571,-32,-5.6,1603
2020-05-28,539,568,-29,-5.11,1603
2020-05-29,500,486,14,2.88,1603
2020-05-30,188,157,31,19.75,1603
2020-05-31,112,29,83,286.21,1603
2020-06-01,506,567,-61,-10.76,1603
2020-06-02,482,553,-71,-12.84,1603
2020-06-03,482,551,-69,-12.52,1603
2020-06-04,482,548,-66,-12.04,1603
2020-06-05,430,466,-36,-7.73,1603
2020-06-06,160,139,21,15.11,1603
2020-06-07,82,11,71,645.45,1603
2020-06-08,506,551,-45,-8.17,1603
2020-06-09,482,538,-56,-10.41,1603
2020-06-10,482,537,-55,-10.24,1603
2020-06-11,482,536,-54,-10.07,1603
2020-06-12,430,455,-25,-5.49,1603
2020-06-13,160,129,31,24.03,1603
2020-06-14,82,3,79,2633.33,1603
2020-06-15,506,544,-38,-6.99,1603
2020-06-16,482,531,-49,-9.23,1603
2020-06-17,482,531,-49,-9.23,1603
2020-06-18,482,531,-49,-9.23,1603
2020-06-19,430,450,-20,-4.44,1603
2020-06-20,160,123,37,30.08,1603
2020-06-21,82,26,56,215.38,1603
2020-06-22,506,537,-31,-5.77,1603
2020-06-23,482,524,-42,-8.02,1603
2020-06-24,482,522,-40,-7.66,1603
2020-06-25,482,521,-39,-7.49,1603
2020-06-26,430,438,-8,-1.83,1603
2020-06-27,160,110,50,45.45,1603
2020-06-28,82,19,63,331.58,1603
2020-06-29,506,521,-15,-2.88,1603
2020-06-30,482,506,-24,-4.74,1603
2020-07-01,454,504,-50,-9.92,1603
2020-07-02,454,501,-47,-9.38,1603
2020-07-03,405,418,-13,-3.11,1603
2020-07-04,154,89,65,73.03,1603
2020-07-05,82,8,74,925.0,1603
2020-07-06,461,499,-38,-7.62,1603
2020-07-07,454,484,-30,-6.2,1603
2020-07-08,454,482,-28,-5.81,1603
2020-07-09,454,480,-26,-5.42,1603
2020-07-10,405,398,7,1.76,1603
2020-07-11,154,71,83,116.9,1603
2020-07-12,82,2,80,4000.0,1603
2020-07-13,461,483,-22,-4.55,1603
2020-07-14,454,471,-17,-3.61,1603
2020-07-15,454,470,-16,-3.4,1603
2020-07-16,454,470,-16,-3.4,1603
2020-07-17,405,390,15,3.85,1603
2020-07-18,154,64,90,140.62,1603
2020-07-19,82,64,18,28.12,1603
2020-07-20,461,480,-19,-3.96,1603
2020-07-21,454,468,-14,-2.99,1603
2020-07-22,454,469,-15,-3.2,1603
2020-07-23,454,469,-15,-3.2,1603
2020-07-24,405,389,16,4.11,1603
2020-07-25,154,64,90,140.62,1603
2020-07-26,82,64,18,28.12,1603
2020-07-27,461,479,-18,-3.76,1603
2020-07-28,454,466,-12,-2.58,1603
2020-07-29,454,466,-12,-2.58,1603
2020-07-30,454,464,-10,-2.16,1603
2020-07-31,405,383,22,5.74,1603
2020-08-01,129,56,73,130.36,1603
2020-08-02,81,56,25,44.64,1603
2020-08-03,436,467,-31,-6.64,1603
2020-08-04,388,453,-65,-14.35,1603
2020-08-05,388,451,-63,-13.97,1603
2020-08-06,388,448,-60,-13.39,1603
2020-08-07,340,365,-25,-6.85,1603
2020-08-08,129,37,92,248.65,1603
2020-08-09,81,37,44,118.92,1603
2020-08-10,436,448,-12,-2.68,1603
2020-08-11,388,434,-46,-10.6,1603
2020-08-12,388,433,-45,-10.39,1603
2020-08-13,388,431,-43,-9.98,1603
2020-08-14,340,350,-10,-2.86,1603
2020-08-15,129,24,105,437.5,1603
2020-08-16,81,24,57,237.5,1603
2020-08-17,436,440,-4,-0.91,1603
2020-08-18,388,429,-41,-9.56,1603
2020-08-19,388,431,-43,-9.98,1603
2020-08-20,388,432,-44,-10.19,1603
2020-08-21,340,355,-15,-4.23,1603
2020-08-22,129,32,97,303.12,1603
2020-08-23,81,32,49,153.12,1603
2020-08-24,436,455,-19,-4.18,1603
2020-08-25,388,447,-59,-13.2,1603
2020-08-26,388,452,-64,-14.16,1603
2020-08-27,388,457,-69,-15.1,1603
2020-08-28,340,382,-42,-10.99,1603
2020-08-29,129,61,68,111.48,1603
2020-08-30,81,61,20,32.79,1603
2020-08-31,436,487,-51,-10.47,1603
2020-09-01,475,480,-5,-1.04,1603
2020-09-02,475,485,-10,-2.06,1603
2020-09-03,475,490,-15,-3.06,1603
2020-09-04,412,414,-2,-0.48,1603
2020-09-05,150,92,58,63.04,1603
2020-09-06,100,14,86,614.29,1603
2020-09-07,488,515,-27,-5.24,1603
2020-09-08,475,506,-31,-6.13,1603
2020-09-09,475,509,-34,-6.68,1603
2020-09-10,475,511,-36,-7.05,1603
2020-09-11,412,432,-20,-4.63,1603
2020-09-12,150,108,42,38.89,1603
2020-09-13,100,21,79,376.19,1603
2020-09-14,488,526,-38,-7.22,1603
2020-09-15,475,514,-39,-7.59,1603
2020-09-16,475,516,-41,-7.95,1603
2020-09-17,475,516,-41,-7.95,1603
2020-09-18,412,436,-24,-5.5,1603
2020-09-19,150,111,39,35.14,1603
2020-09-20,100,20,80,400.0,1603
2020-09-21,488,528,-40,-7.58,1603
2020-09-22,475,517,-42,-8.12,1603
2020-09-23,475,518,-43,-8.3,1603
2020-09-24,475,519,-44,-8.48,1603
2020-09-25,412,440,-28,-6.36,1603
2020-09-26,150,117,33,28.21,1603
2020-09-27,100,25,75,300.0,1603
2020-09-28,488,536,-48,-8.96,1603
2020-09-29,475,526,-51,-9.7,1603
2020-09-30,475,529,-54,-10.21,1603
2020-10-01,479,532,-53,-9.96,1603
2020-10-02,432,454,-22,-4.85,1603
2020-10-03,160,132,28,21.21,1603
2020-10-04,97,9,88,977.78,1603
2020-10-05,493,553,-60,-10.85,1603
2020-10-06,479,544,-65,-11.95,1603
2020-10-07,479,547,-68,-12.43,1603
2020-10-08,479,549,-70,-12.75,1603
2020-10-09,432,471,-39,-8.28,1603
2020-10-10,160,148,12,8.11,1603
2020-10-11,97,24,73,304.17,1603
2020-10-12,493,567,-74,-13.05,1603
2020-10-13,479,556,-77,-13.85,1603
2020-10-14,479,558,-79,-14.16,1603
2020-10-15,479,559,-80,-14.31,1603
2020-10-16,432,479,-47,-9.81,1603
2020-10-17,160,154,6,3.9,1603
2020-10-18,97,28,69,246.43,1603
2020-10-19,493,569,-76,-13.36,1603
2020-10-20,479,557,-78,-14.0,1603
2020-10-21,479,557,-78,-14.0,1603
2020-10-22,479,557,-78,-14.0,1603
2020-10-23,432,477,-45,-9.43,1603
2020-10-24,160,151,9,5.96,1603
2020-10-25,97,25,72,288.0,1603
2020-10-26,493,566,-73,-12.9,1603
2020-10-27,479,555,-76,-13.69,1603
2020-10-28,479,556,-77,-13.85,1603
2020-10-29,479,556,-77,-13.85,1603
2020-10-30,432,477,-45,-9.43,1603
2020-10-31,160,152,8,5.26,1603
2020-11-01,102,28,74,264.29,1603
2020-11-02,500,571,-71,-12.43,1603
2020-11-03,492,561,-69,-12.3,1603
2020-11-04,492,563,-71,-12.61,1603
2020-11-05,492,565,-73,-12.92,1603
2020-11-06,432,488,-56,-11.48,1603
2020-11-07,154,164,-10,-6.1,1603
2020-11-08,102,41,61,148.78,1603
2020-11-09,500,584,-84,-14.38,1603
2020-11-10,492,575,-83,-14.43,1603
2020-11-11,492,577,-85,-14.73,1603
2020-11-12,492,579,-87,-15.03,1603
2020-11-13,432,500,-68,-13.6,1603
2020-11-14,154,176,-22,-12.5,1603
2020-11-15,102,51,51,100.0,1603
2020-11-16,500,593,-93,-15.68,1603
2020-11-17,492,581,-89,-15.32,1603
2020-11-18,492,581,-89,-15.32,1603
2020-11-19,492,580,-88,-15.17,1603
2020-11-20,432,499,-67,-13.43,1603
2020-11-21,154,171,-17,-9.94,1603
2020-11-22,102,44,58,131.82,1603
2020-11-23,500,583,-83,-14.24,1603
2020-11-24,492,568,-76,-13.38,1603
2020-11-25,492,566,-74,-13.07,1603
2020-11-26,492,563,-71,-12.61,1603
2020-11-27,432,479,-47,-9.81,1603
2020-11-28,154,150,4,2.67,1603
2020-11-29,102,22,80,363.64,1603
2020-11-30,500,559,-59,-10.55,1603
2020-12-01,422,544,-122,-22.43,1603
2020-12-02,422,542,-120,-22.14,1603
2020-12-03,422,539,-117,-21.71,1603
2020-12-04,459,456,3,0.66,1603
2020-12-05,193,129,64,49.61,1603
2020-12-06,110,1,109,10900.0,1603
2020-12-07,457,540,-83,-15.37,1603
2020-12-08,422,527,-105,-19.92,1603
2020-12-09,422,527,-105,-19.92,1603
2020-12-10,422,526,-104,-19.77,1603
2020-12-11,459,445,14,3.15,1603
2020-12-12,193,119,74,62.18,1603
2020-12-13,110,24,86,358.33,1603
2020-12-14,457,535,-78,-14.58,1603
2020-12-15,422,523,-101,-19.31,1603
2020-12-16,422,524,-102,-19.47,1603
2020-12-17,422,524,-102,-19.47,1603
2020-12-18,459,444,15,3.38,1603
2020-12-19,193,119,74,62.18,1603
2020-12-20,110,26,84,323.08,1603
2020-12-21,457,533,-76,-14.26,1603
2020-12-22,422,521,-99,-19.0,1603
2020-12-23,422,520,-98,-18.85,1603
2020-12-24,422,519,-97,-18.69,1603
2020-12-25,459,437,22,5.03,1603
2020-12-26,193,110,83,75.45,1603
2020-12-27,110,19,91,478.95,1603
2020-12-28,457,520,-63,-12.12,1603
2020-12-29,422,506,-84,-16.6,1603
2020-12-30,422,503,-81,-16.1,1603
2020-12-31,422,499,-77,-15.43,1603
2021-01-01,498,416,82,19.71,1603
2021-01-02,229,87,142,163.22,1603
2021-01-03,163,7,156,2228.57,1603
2021-01-04,565,495,70,14.14,1603
2021-01-05,550,480,70,14.58,1603
2021-01-06,550,477,73,15.3,1603
2021-01-07,550,473,77,16.28,1603
2021-01-08,498,390,108,27.69,1603
2021-01-09,229,62,167,269.35,1603
2021-01-10,163,62,101,162.9,1603
2021-01-11,565,474,91,19.2,1603
2021-01-12,550,461,89,19.31,1603
2021-01-13,550,461,89,19.31,1603
2021-01-14,550,460,90,19.57,1603
2021-01-15,498,380,118,31.05,1603
2021-01-16,229,55,174,316.36,1603
2021-01-17,163,55,108,196.36,1603
2021-01-18,565,473,92,19.45,1603
2021-01-19,550,463,87,18.79,1603
2021-01-20,550,465,85,18.28,1603
2021-01-21,550,468,82,17.52,1603
2021-01-22,498,390,108,27.69,1603
2021-01-23,229,67,162,241.79,1603
2021-01-24,163,2,161,8050.0,1603
2021-01-25,565,488,77,15.78,1603
2021-01-26,550,479,71,14.82,1603
2021-01-27,550,482,68,14.11,1603
2021-01-28,550,484,66,13.64,1603
2021-01-29,498,407,91,22.36,1603
2021-01-30,229,83,146,175.9,1603
2021-01-31,163,8,155,1937.5,1603
2021-02-01,687,502,185,36.85,1603
2021-02-02,629,492,137,27.85,1603
2021-02-03,629,493,136,27.59,1603
2021-02-04,629,494,135,27.33,1603
2021-02-05,608,414,194,46.86,1603
2021-02-06,242,89,153,171.91,1603
2021-02-07,174,12,162,1350.0,1603
2021-02-08,687,505,182,36.04,1603
2021-02-09,629,493,136,27.59,1603
2021-02-10,629,494,135,27.33,1603
2021-02-11,629,494,135,27.33,1603
2021-02-12,608,414,194,46.86,1603
2021-02-13,242,88,154,175.0,1603
2021-02-14,174,9,165,1833.33,1603
2021-02-15,687,504,183,36.31,1603
2021-02-16,629,493,136,27.59,1603
2021-02-17,629,494,135,27.33,1603
2021-02-18,629,495,134,27.07,1603
2021-02-19,608,416,192,46.15,1603
2021-02-20,242,92,150,163.04,1603
2021-02-21,174,11,163,1481.82,1603
2021-02-22,687,512,175,34.18,1603
2021-02-23,629,502,127,25.3,1603
2021-02-24,629,505,124,24.55,1603
2021-02-25,629,507,122,24.06,1603
2021-02-26,608,430,178,41.4,1603
2021-02-27,242,107,135,126.17,1603
2021-02-28,174,22,152,690.91,1603
2021-03-01,723,528,195,36.93,1603
2021-03-02,662,519,143,27.55,1603
2021-03-03,662,522,140,26.82,1603
2021-03-04,662,524,138,26.34,1603
2021-03-05,651,446,205,45.96,1603
2021-03-06,251,123,128,104.07,1603
2021-03-07,168,32,136,425.0,1603
2021-03-08,723,541,182,33.64,1603
2021-03-09,662,531,131,24.67,1603
2021-03-10,662,532,130,24.44,1603
2021-03-11,662,533,129,24.2,1603
2021-03-12,651,453,198,43.71,1603
2021-03-13,251,128,123,96.09,1603
2021-03-14,168,2,166,8300.0,1603
2021-03-15,723,543,180,33.15,1603
2021-03-16,662,531,131,24.67,1603
2021-03-17,662,531,131,24.67,1603
2021-03-18,662,530,132,24.91,1603
2021-03-19,651,449,202,44.99,1603
2021-03-20,251,123,128,104.07,1603
2021-03-21,168,27,141,522.22,1603
2021-03-22,723,538,185,34.39,1603
2021-03-23,662,526,136,25.86,1603
2021-03-24,662,527,135,25.62,1603
2021-03-25,662,527,135,25.62,1603
2021-03-26,651,447,204,45.64,1603
2021-03-27,251,122,129,105.74,1603
2021-03-28,168,28,140,500.0,1603
2021-03-29,723,540,183,33.89,1603
2021-03-30,662,530,132,24.91,1603
2021-03-31,662,532,130,24.44,1603
2021-04-01,669,533,136,25.52,1603
2021-04-02,658,455,203,44.62,1603
2021-04-03,259,132,127,96.21,1603
2021-04-04,155,8,147,1837.5,1603
2021-04-05,735,551,184,33.39,1603
2021-04-06,669,541,128,23.66,1603
2021-04-07,669,544,125,22.98,1603
2021-04-08,669,545,124,22.75,1603
2021-04-09,658,467,191,40.9,1603
2021-04-10,259,142,117,82.39,1603
2021-04-11,155,18,137,761.11,1603
2021-04-12,735,560,175,31.25,1603
2021-04-13,669,548,121,22.08,1603
2021-04-14,669,549,120,21.86,1603
2021-04-15,669,549,120,21.86,1603
2021-04-16,658,468,190,40.6,1603
2021-04-17,259,142,117,82.39,1603
2021-04-18,155,16,139,868.75,1603
2021-04-19,735,555,180,32.43,1603
2021-04-20,669,542,127,23.43,1603
2021-04-21,669,541,128,23.66,1603
2021-04-22,669,539,130,24.12,1603
2021-04-23,658,457,201,43.98,1603
2021-04-24,259,130,129,99.23,1603
2021-04-25,155,2,153,7650.0,1603
2021-04-26,735,541,194,35.86,1603
2021-04-27,669,527,142,26.94,1603
2021-04-28,669,526,143,27.19,1603
2021-04-29,669,524,145,27.67,1603
2021-04-30,658,443,215,48.53,1603
2021-05-01,199,116,83,71.55,1603
2021-05-02,111,24,87,362.5,1603
2021-05-03,558,530,28,5.28,1603
2021-05-04,567,517,50,9.67,1603
2021-05-05,567,517,50,9.67,1603
2021-05-06,567,517,50,9.67,1603
2021-05-07,548,436,112,25.69,1603
2021-05-08,199,111,88,79.28,1603
2021-05-09,111,20,91,455.0,1603
2021-05-10,558,527,31,5.88,1603
2021-05-11,567,515,52,10.1,1603
2021-05-12,567,516,51,9.88,1603
2021-05-13,567,516,51,9.88,1603
2021-05-14,548,436,112,25.69,1603
2021-05-15,199,110,89,80.91,1603
2021-05-16,111,19,92,484.21,1603
2021-05-17,558,525,33,6.29,1603
2021-05-18,567,512,55,10.74,1603
2021-05-19,567,512,55,10.74,1603
2021-05-20,567,511,56,10.96,1603
2021-05-21,548,429,119,27.74,1603
2021-05-22,199,102,97,95.1,1603
2021-05-23,111,18,93,516.67,1603
2021-05-24,558,514,44,8.56,1603
2021-05-25,567,499,68,13.63,1603
2021-05-26,567,497,70,14.08,1603
2021-05-27,567,495,72,14.55,1603
2021-05-28,548,412,136,33.01,1603
2021-05-29,199,83,116,139.76,1603
2021-05-30,111,9,102,1133.33,1603
2021-05-31,558,493,65,13.18,1603
2021-06-01,581,479,102,21.29,1603
2021-06-02,581,476,105,22.06,1603
2021-06-03,581,474,107,22.57,1603
2021-06-04,534,391,143,36.57,1603
2021-06-05,206,64,142,221.88,1603
2021-06-06,136,0,136,inf,1603
2021-06-07,563,475,88,18.53,1603
2021-06-08,581,462,119,25.76,1603
2021-06-09,581,461,120,26.03,1603
2021-06-10,581,460,121,26.3,1603
2021-06-11,534,379,155,40.9,1603
2021-06-12,206,53,153,288.68,1603
2021-06-13,136,53,83,156.6,1603
2021-06-14,563,467,96,20.56,1603
2021-06-15,581,454,127,27.97,1603
2021-06-16,581,455,126,27.69,1603
2021-06-17,581,454,127,27.97,1603
2021-06-18,534,373,161,43.16,1603
2021-06-19,206,47,159,338.3,1603
2021-06-20,136,47,89,189.36,1603
2021-06-21,563,461,102,22.13,1603
2021-06-22,581,448,133,29.69,1603
2021-06-23,581,447,134,29.98,1603
2021-06-24,581,445,136,30.56,1603
2021-06-25,534,363,171,47.11,1603
2021-06-26,206,36,170,472.22,1603
2021-06-27,136,36,100,277.78,1603
2021-06-28,563,447,116,25.95,1603
2021-06-29,581,432,149,34.49,1603
2021-06-30,581,430,151,35.12,1603
2021-07-01,546,427,119,27.87,1603
2021-07-02,514,344,170,49.42,1603
2021-07-03,197,15,182,1213.33,1603
2021-07-04,125,15,110,733.33,1603
2021-07-05,524,425,99,23.29,1603
2021-07-06,546,410,136,33.17,1603
2021-07-07,546,408,138,33.82,1603
2021-07-08,546,406,140,34.48,1603
2021-07-09,514,323,191,59.13,1603
2021-07-10,197,29,168,579.31,1603
2021-07-11,125,29,96,331.03,1603
2021-07-12,524,408,116,28.43,1603
2021-07-13,546,394,152,38.58,1603
2021-07-14,546,394,152,38.58,1603
2021-07-15,546,393,153,38.93,1603
2021-07-16,514,313,201,64.22,1603
2021-07-17,197,22,175,795.45,1603
2021-07-18,125,22,103,468.18,1603
2021-07-19,524,402,122,30.35,1603
2021-07-20,546,391,155,39.64,1603
2021-07-21,546,391,155,39.64,1603
2021-07-22,546,391,155,39.64,1603
2021-07-23,514,312,202,64.74,1603
2021-07-24,197,21,176,838.1,1603
2021-07-25,125,21,104,495.24,1603
2021-07-26,524,402,122,30.35,1603
2021-07-27,546,389,157,40.36,1603
2021-07-28,546,389,157,40.36,1603
2021-07-29,546,388,158,40.72,1603
2021-07-30,514,307,207,67.43,1603
2021-07-31,197,23,174,756.52,1603
2021-08-01,141,23,118,513.04,1603
2021-08-02,501,392,109,27.81,1603
2021-08-03,513,378,135,35.71,1603
2021-08-04,513,377,136,36.07,1603
2021-08-05,513,374,139,37.17,1603
2021-08-06,474,291,183,62.89,1603
2021-08-07,223,9,214,2377.78,1603
2021-08-08,141,9,132,1466.67,1603
2021-08-09,501,374,127,33.96,1603
2021-08-10,513,359,154,42.9,1603
2021-08-11,513,358,155,43.3,1603
2021-08-12,513,356,157,44.1,1603
2021-08-13,474,274,200,72.99,1603
2021-08-14,223,3,220,7333.33,1603
2021-08-15,141,3,138,4600.0,1603
2021-08-16,501,362,139,38.4,1603
2021-08-17,513,350,163,46.57,1603
2021-08-18,513,351,162,46.15,1603
2021-08-19,513,353,160,45.33,1603
2021-08-20,474,274,200,72.99,1603
2021-08-21,223,7,216,3085.71,1603
2021-08-22,141,7,134,1914.29,1603
2021-08-23,501,373,128,34.32,1603
2021-08-24,513,365,148,40.55,1603
2021-08-25,513,369,144,39.02,1603
2021-08-26,513,374,139,37.17,1603
2021-08-27,474,298,176,59.06,1603
2021-08-28,223,19,204,1073.68,1603
2021-08-29,141,19,122,642.11,1603
2021-08-30,501,403,98,24.32,1603
2021-08-31,513,397,116,29.22,1603
2021-09-01,597,402,195,48.51,1603
2021-09-02,597,407,190,46.68,1603
2021-09-03,514,331,183,55.29,1603
2021-09-04,239,10,229,2290.0,1603
2021-09-05,128,10,118,1180.0,1603
2021-09-06,590,433,157,36.26,1603
2021-09-07,597,425,172,40.47,1603
2021-09-08,597,428,169,39.49,1603
2021-09-09,597,431,166,38.52,1603
2021-09-10,514,353,161,45.61,1603
2021-09-11,239,29,210,724.14,1603
2021-09-12,128,29,99,341.38,1603
2021-09-13,590,447,143,31.99,1603
2021-09-14,597,436,161,36.93,1603
2021-09-15,597,437,160,36.61,1603
2021-09-16,597,438,159,36.3,1603
2021-09-17,514,358,156,43.58,1603
2021-09-18,239,33,206,624.24,1603
2021-09-19,128,33,95,287.88,1603
2021-09-20,590,450,140,31.11,1603
2021-09-21,597,438,159,36.3,1603
2021-09-22,597,440,157,35.68,1603
2021-09-23,597,440,157,35.68,1603
2021-09-24,514,361,153,42.38,1603
2021-09-25,239,37,202,545.95,1603
2021-09-26,128,37,91,245.95,1603
2021-09-27,590,456,134,29.39,1603
2021-09-28,597,446,151,33.86,1603
2021-09-29,597,449,148,32.96,1603
2021-09-30,597,451,146,32.37,1603
2021-10-01,551,374,177,47.33,1603
2021-10-02,242,51,191,374.51,1603
2021-10-03,120,51,69,135.29,1603
2021-10-04,600,472,128,27.12,1603
2021-10-05,634,463,171,36.93,1603
2021-10-06,634,466,168,36.05,1603
2021-10-07,634,469,165,35.18,1603
2021-10-08,551,391,160,40.92,1603
2021-10-09,242,68,174,255.88,1603
2021-10-10,120,3,117,3900.0,1603
2021-10-11,600,487,113,23.2,1603
2021-10-12,634,477,157,32.91,1603
2021-10-13,634,479,155,32.36,1603
2021-10-14,634,480,154,32.08,1603
2021-10-15,551,401,150,37.41,1603
2021-10-16,242,76,166,218.42,1603
2021-10-17,120,6,114,1900.0,1603
2021-10-18,600,492,108,21.95,1603
2021-10-19,634,480,154,32.08,1603
2021-10-20,634,480,154,32.08,1603
2021-10-21,634,480,154,32.08,1603
2021-10-22,551,400,151,37.75,1603
2021-10-23,242,74,168,227.03,1603
2021-10-24,120,6,114,1900.0,1603
2021-10-25,600,489,111,22.7,1603
2021-10-26,634,477,157,32.91,1603
2021-10-27,634,478,156,32.64,1603
2021-10-28,634,478,156,32.64,1603
2021-10-29,551,398,153,38.44,1603
2021-10-30,242,74,168,227.03,1603
2021-10-31,120,6,114,1900.0,1603
2021-11-01,617,492,125,25.41,1603
2021-11-02,627,481,146,30.35,1603
2021-11-03,627,484,143,29.55,1603
2021-11-04,627,485,142,29.28,1603
2021-11-05,530,407,123,30.22,1603
2021-11-06,232,84,148,176.19,1603
2021-11-07,147,12,135,1125.0,1603
2021-11-08,617,504,113,22.42,1603
2021-11-09,627,495,132,26.67,1603
2021-11-10,627,497,130,26.16,1603
2021-11-11,627,499,128,25.65,1603
2021-11-12,530,421,109,25.89,1603
2021-11-13,232,97,135,139.18,1603
2021-11-14,147,19,128,673.68,1603
2021-11-15,617,515,102,19.81,1603
2021-11-16,627,503,124,24.65,1603
2021-11-17,627,504,123,24.4,1603
2021-11-18,627,504,123,24.4,1603
2021-11-19,530,423,107,25.3,1603
2021-11-20,232,96,136,141.67,1603
2021-11-21,147,16,131,818.75,1603
2021-11-22,617,508,109,21.46,1603
2021-11-23,627,494,133,26.92,1603
2021-11-24,627,492,135,27.44,1603
2021-11-25,627,489,138,28.22,1603
2021-11-26,530,406,124,30.54,1603
2021-11-27,232,77,155,201.3,1603
2021-11-28,147,5,142,2840.0,1603
2021-11-29,617,486,131,26.95,1603
2021-11-30,627,471,156,33.12,1603
2021-12-01,513,468,45,9.62,1603
2021-12-02,513,465,48,10.32,1603
2021-12-03,368,382,-14,-3.66,1603
2021-12-04,233,54,179,331.48,1603
2021-12-05,118,54,64,118.52,1603
2021-12-06,542,465,77,16.56,1603
2021-12-07,513,452,61,13.5,1603
2021-12-08,513,451,62,13.75,1603
2021-12-09,513,449,64,14.25,1603
2021-12-10,368,368,0,0.0,1603
2021-12-11,233,42,191,454.76,1603
2021-12-12,118,42,76,180.95,1603
2021-12-13,542,458,84,18.34,1603
2021-12-14,513,446,67,15.02,1603
2021-12-15,513,446,67,15.02,1603
2021-12-16,513,446,67,15.02,1603
2021-12-17,368,367,1,0.27,1603
2021-12-18,233,41,192,468.29,1603
2021-12-19,118,41,77,187.8,1603
2021-12-20,542,457,85,18.6,1603
2021-12-21,513,444,69,15.54,1603
2021-12-22,513,444,69,15.54,1603
2021-12-23,513,443,70,15.8,1603
2021-12-24,368,362,6,1.66,1603
2021-12-25,233,35,198,565.71,1603
2021-12-26,118,35,83,237.14,1603
2021-12-27,542,446,96,21.52,1603
2021-12-28,513,432,81,18.75,1603
2021-12-29,513,429,84,19.58,1603
2021-12-30,513,426,87,20.42,1603
2021-12-31,368,343,25,7.29,1603
2022-01-01,445,14,431,3078.57,1603
2022-01-02,214,14,200,1428.57,1603
2022-01-03,865,422,443,104.98,1603
2022-01-04,874,407,467,114.74,1603
2022-01-05,874,404,470,116.34,1603
2022-01-06,874,400,474,118.5,1603
2022-01-07,714,317,397,125.24,1603
2022-01-08,445,25,420,1680.0,1603
2022-01-09,214,25,189,756.0,1603
2022-01-10,865,399,466,116.79,1603
2022-01-11,874,385,489,127.01,1603
2022-01-12,874,384,490,127.6,1603
2022-01-13,874,383,491,128.2,1603
2022-01-14,714,303,411,135.64,1603
2022-01-15,445,21,424,2019.05,1603
2022-01-16,214,21,193,919.05,1603
2022-01-17,865,394,471,119.54,1603
2022-01-18,874,383,491,128.2,1603
2022-01-19,874,385,489,127.01,1603
2022-01-20,874,387,487,125.84,1603
2022-01-21,714,309,405,131.07,1603
2022-01-22,445,26,419,1611.54,1603
2022-01-23,214,26,188,723.08,1603
2022-01-24,865,407,458,112.53,1603
2022-01-25,874,398,476,119.6,1603
2022-01-26,874,401,473,117.96,1603
2022-01-27,874,404,470,116.34,1603
2022-01-28,714,326,388,119.02,1603
2022-01-29,445,3,442,14733.33,1603
2022-01-30,214,3,211,7033.33,1603
2020-02-01,339,254,85,33.46,1623
2020-02-02,202,111,91,81.98,1623
2020-02-03,1067,1075,-8,-0.74,1623
2020-02-04,1147,1117,30,2.69,1623
2020-02-05,1147,1123,24,2.14,1623
2020-02-06,1147,1133,14,1.24,1623
2020-02-07,989,989,0,0.0,1623
2020-02-08,339,298,41,13.76,1623
2020-02-09,202,149,53,35.57,1623
2020-02-10,1067,1109,-42,-3.79,1623
2020-02-11,1147,1146,1,0.09,1623
2020-02-12,1147,1148,-1,-0.09,1623
2020-02-13,1147,1155,-8,-0.69,1623
2020-02-14,989,1007,-18,-1.79,1623
2020-02-15,339,313,26,8.31,1623
2020-02-16,202,163,39,23.93,1623
2020-02-17,1067,1121,-54,-4.82,1623
2020-02-18,1147,1158,-11,-0.95,1623
2020-02-19,1147,1160,-13,-1.12,1623
2020-02-20,1147,1167,-20,-1.71,1623
2020-02-21,989,1020,-31,-3.04,1623
2020-02-22,339,328,11,3.35,1623
2020-02-23,202,179,23,12.85,1623
2020-02-24,1067,1139,-72,-6.32,1623
2020-02-25,1147,1178,-31,-2.63,1623
2020-02-26,1147,1181,-34,-2.88,1623
2020-02-27,1147,1190,-43,-3.61,1623
2020-02-28,989,1045,-56,-5.36,1623
2020-02-29,339,354,-15,-4.24,1623
2020-03-01,204,206,-2,-0.97,1623
2020-03-02,889,1166,-277,-23.76,1623
2020-03-03,945,1205,-260,-21.58,1623
2020-03-04,945,1208,-263,-21.77,1623
2020-03-05,945,1216,-271,-22.29,1623
2020-03-06,782,1069,-287,-26.85,1623
2020-03-07,296,377,-81,-21.49,1623
2020-03-08,204,226,-22,-9.73,1623
2020-03-09,889,1184,-295,-24.92,1623
2020-03-10,945,1221,-276,-22.6,1623
2020-03-11,945,1222,-277,-22.67,1623
2020-03-12,945,1227,-282,-22.98,1623
2020-03-13,782,1078,-296,-27.46,1623
2020-03-14,296,383,-87,-22.72,1623
2020-03-15,204,231,-27,-11.69,1623
2020-03-16,889,1187,-298,-25.11,1623
2020-03-17,945,1222,-277,-22.67,1623
2020-03-18,945,1222,-277,-22.67,1623
2020-03-19,945,1227,-282,-22.98,1623
2020-03-20,782,1078,-296,-27.46,1623
2020-03-21,296,383,-87,-22.72,1623
2020-03-22,204,233,-29,-12.45,1623
2020-03-23,889,1191,-302,-25.36,1623
2020-03-24,945,1228,-283,-23.05,1623
2020-03-25,945,1231,-286,-23.23,1623
2020-03-26,945,1238,-293,-23.67,1623
2020-03-27,782,1093,-311,-28.45,1623
2020-03-28,296,402,-106,-26.37,1623
2020-03-29,204,254,-50,-19.69,1623
2020-03-30,889,1215,-326,-26.83,1623
2020-03-31,945,1256,-311,-24.76,1623
2020-04-01,1170,1261,-91,-7.22,1623
2020-04-02,1170,1271,-101,-7.95,1623
2020-04-03,916,1128,-212,-18.79,1623
2020-04-04,235,438,-203,-46.35,1623
2020-04-05,189,292,-103,-35.27,1623
2020-04-06,1166,1253,-87,-6.94,1623
2020-04-07,1170,1294,-124,-9.58,1623
2020-04-08,1170,1298,-128,-9.86,1623
2020-04-09,1170,1306,-136,-10.41,1623
2020-04-10,916,1160,-244,-21.03,1623
2020-04-11,235,468,-233,-49.79,1623
2020-04-12,189,318,-129,-40.57,1623
2020-04-13,1166,1276,-110,-8.62,1623
2020-04-14,1170,1312,-142,-10.82,1623
2020-04-15,1170,1312,-142,-10.82,1623
2020-04-16,1170,1316,-146,-11.09,1623
2020-04-17,916,1166,-250,-21.44,1623
2020-04-18,235,469,-234,-49.89,1623
2020-04-19,189,315,-126,-40.0,1623
2020-04-20,1166,1270,-104,-8.19,1623
2020-04-21,1170,1303,-133,-10.21,1623
2020-04-22,1170,1300,-130,-10.0,1623
2020-04-23,1170,1302,-132,-10.14,1623
2020-04-24,916,1150,-234,-20.35,1623
2020-04-25,235,452,-217,-48.01,1623
2020-04-26,189,298,-109,-36.58,1623
2020-04-27,1166,1253,-87,-6.94,1623
2020-04-28,1170,1287,-117,-9.09,1623
2020-04-29,1170,1285,-115,-8.95,1623
2020-04-30,1170,1289,-119,-9.23,1623
2020-05-01,1010,1139,-129,-11.33,1623
2020-05-02,330,444,-114,-25.68,1623
2020-05-03,207,293,-86,-29.35,1623
2020-05-04,1403,1250,153,12.24,1623
2020-05-05,1324,1286,38,2.95,1623
2020-05-06,1324,1288,36,2.8,1623
2020-05-07,1324,1294,30,2.32,1623
2020-05-08,1010,1146,-136,-11.87,1623
2020-05-09,330,453,-123,-27.15,1623
2020-05-10,207,302,-95,-31.46,1623
2020-05-11,1403,1260,143,11.35,1623
2020-05-12,1324,1297,27,2.08,1623
2020-05-13,1324,1298,26,2.0,1623
2020-05-14,1324,1303,21,1.61,1623
2020-05-15,1010,1154,-144,-12.48,1623
2020-05-16,330,459,-129,-28.1,1623
2020-05-17,207,306,-99,-32.35,1623
2020-05-18,1403,1262,141,11.17,1623
2020-05-19,1324,1296,28,2.16,1623
2020-05-20,1324,1294,30,2.32,1623
2020-05-21,1324,1296,28,2.16,1623
2020-05-22,1010,1144,-134,-11.71,1623
2020-05-23,330,445,-115,-25.84,1623
2020-05-24,207,290,-83,-28.62,1623
2020-05-25,1403,1243,160,12.87,1623
2020-05-26,1324,1275,49,3.84,1623
2020-05-27,1324,1272,52,4.09,1623
2020-05-28,1324,1273,51,4.01,1623
2020-05-29,1010,1121,-111,-9.9,1623
2020-05-30,330,423,-93,-21.99,1623
2020-05-31,207,268,-61,-22.76,1623
2020-06-01,1370,1223,147,12.02,1623
2020-06-02,1361,1257,104,8.27,1623
2020-06-03,1361,1256,105,8.36,1623
2020-06-04,1361,1260,101,8.02,1623
2020-06-05,1061,1110,-49,-4.41,1623
2020-06-06,371,416,-45,-10.82,1623
2020-06-07,213,265,-52,-19.62,1623
2020-06-08,1370,1222,148,12.11,1623
2020-06-09,1361,1259,102,8.1,1623
2020-06-10,1361,1260,101,8.02,1623
2020-06-11,1361,1266,95,7.5,1623
2020-06-12,1061,1118,-57,-5.1,1623
2020-06-13,371,424,-53,-12.5,1623
2020-06-14,213,273,-60,-21.98,1623
2020-06-15,1370,1229,141,11.47,1623
2020-06-16,1361,1264,97,7.67,1623
2020-06-17,1361,1263,98,7.76,1623
2020-06-18,1361,1266,95,7.5,1623
2020-06-19,1061,1113,-52,-4.67,1623
2020-06-20,371,414,-43,-10.39,1623
2020-06-21,213,257,-44,-17.12,1623
2020-06-22,1370,1208,162,13.41,1623
2020-06-23,1361,1236,125,10.11,1623
2020-06-24,1361,1228,133,10.83,1623
2020-06-25,1361,1223,138,11.28,1623
2020-06-26,1061,1064,-3,-0.28,1623
2020-06-27,371,358,13,3.63,1623
2020-06-28,213,194,19,9.79,1623
2020-06-29,1370,1139,231,20.28,1623
2020-06-30,1361,1162,199,17.13,1623
2020-07-01,1352,1149,203,17.67,1623
2020-07-02,1352,1141,211,18.49,1623
2020-07-03,1107,979,128,13.07,1623
2020-07-04,350,272,78,28.68,1623
2020-07-05,219,108,111,102.78,1623
2020-07-06,1250,1054,196,18.6,1623
2020-07-07,1352,1079,273,25.3,1623
2020-07-08,1352,1069,283,26.47,1623
2020-07-09,1352,1065,287,26.95,1623
2020-07-10,1107,909,198,21.78,1623
2020-07-11,350,207,143,69.08,1623
2020-07-12,219,50,169,338.0,1623
2020-07-13,1250,1002,248,24.75,1623
2020-07-14,1352,1035,317,30.63,1623
2020-07-15,1352,1033,319,30.88,1623
2020-07-16,1352,1036,316,30.5,1623
2020-07-17,1107,887,220,24.8,1623
2020-07-18,350,192,158,82.29,1623
2020-07-19,219,42,177,421.43,1623
2020-07-20,1250,1000,250,25.0,1623
2020-07-21,1352,1037,315,30.38,1623
2020-07-22,1352,1039,313,30.13,1623
2020-07-23,1352,1045,307,29.38,1623
2020-07-24,1107,897,210,23.41,1623
2020-07-25,350,203,147,72.41,1623
2020-07-26,219,52,167,321.15,1623
2020-07-27,1250,1009,241,23.89,1623
2020-07-28,1352,1044,308,29.5,1623
2020-07-29,1352,1043,309,29.63,1623
2020-07-30,1352,1045,307,29.38,1623
2020-07-31,1107,893,214,23.96,1623
2020-08-01,285,195,90,46.15,1623
2020-08-02,183,39,144,369.23,1623
2020-08-03,1120,990,130,13.13,1623
2020-08-04,1186,1021,165,16.16,1623
2020-08-05,1186,1015,171,16.85,1623
2020-08-06,1186,1013,173,17.08,1623
2020-08-07,1029,858,171,19.93,1623
2020-08-08,285,156,129,82.69,1623
2020-08-09,183,69,114,165.22,1623
2020-08-10,1120,949,171,18.02,1623
2020-08-11,1186,980,206,21.02,1623
2020-08-12,1186,975,211,21.64,1623
2020-08-13,1186,976,210,21.52,1623
2020-08-14,1029,824,205,24.88,1623
2020-08-15,285,128,157,122.66,1623
2020-08-16,183,56,127,226.79,1623
2020-08-17,1120,932,188,20.17,1623
2020-08-18,1186,969,217,22.39,1623
2020-08-19,1186,972,214,22.02,1623
2020-08-20,1186,981,205,20.9,1623
2020-08-21,1029,836,193,23.09,1623
2020-08-22,285,147,138,93.88,1623
2020-08-23,183,2,181,9050.0,1623
2020-08-24,1120,967,153,15.82,1623
2020-08-25,1186,1011,175,17.31,1623
2020-08-26,1186,1019,167,16.39,1623
2020-08-27,1186,1033,153,14.81,1623
2020-08-28,1029,893,136,15.23,1623
2020-08-29,285,207,78,37.68,1623
2020-08-30,183,64,119,185.94,1623
2020-08-31,1120,1030,90,8.74,1623
2020-09-01,1254,1073,181,16.87,1623
2020-09-02,1254,1081,173,16.0,1623
2020-09-03,1254,1093,161,14.73,1623
2020-09-04,1101,950,151,15.89,1623
2020-09-05,354,260,94,36.15,1623
2020-09-06,211,113,98,86.73,1623
2020-09-07,1175,1073,102,9.51,1623
2020-09-08,1254,1112,142,12.77,1623
2020-09-09,1254,1115,139,12.47,1623
2020-09-10,1254,1121,133,11.86,1623
2020-09-11,1101,973,128,13.16,1623
2020-09-12,354,279,75,26.88,1623
2020-09-13,211,128,83,64.84,1623
2020-09-14,1175,1085,90,8.29,1623
2020-09-15,1254,1121,133,11.86,1623
2020-09-16,1254,1121,133,11.86,1623
2020-09-17,1254,1127,127,11.27,1623
2020-09-18,1101,979,122,12.46,1623
2020-09-19,354,286,68,23.78,1623
2020-09-20,211,137,74,54.01,1623
2020-09-21,1175,1096,79,7.21,1623
2020-09-22,1254,1136,118,10.39,1623
2020-09-23,1254,1140,114,10.0,1623
2020-09-24,1254,1150,104,9.04,1623
2020-09-25,1101,1007,94,9.33,1623
2020-09-26,354,319,35,10.97,1623
2020-09-27,211,175,36,20.57,1623
2020-09-28,1175,1139,36,3.16,1623
2020-09-29,1254,1183,71,6.0,1623
2020-09-30,1254,1192,62,5.2,1623
2020-10-01,1323,1205,118,9.79,1623
2020-10-02,1133,1065,68,6.38,1623
2020-10-03,412,379,33,8.71,1623
2020-10-04,210,236,-26,-11.02,1623
2020-10-05,1263,1201,62,5.16,1623
2020-10-06,1323,1244,79,6.35,1623
2020-10-07,1323,1251,72,5.76,1623
2020-10-08,1323,1262,61,4.83,1623
2020-10-09,1133,1118,15,1.34,1623
2020-10-10,412,427,-15,-3.51,1623
2020-10-11,210,279,-69,-24.73,1623
2020-10-12,1263,1239,24,1.94,1623
2020-10-13,1323,1276,47,3.68,1623
2020-10-14,1323,1277,46,3.6,1623
2020-10-15,1323,1282,41,3.2,1623
2020-10-16,1133,1133,0,0.0,1623
2020-10-17,412,437,-25,-5.72,1623
2020-10-18,210,285,-75,-26.32,1623
2020-10-19,1263,1240,23,1.85,1623
2020-10-20,1323,1275,48,3.76,1623
2020-10-21,1323,1274,49,3.85,1623
2020-10-22,1323,1278,45,3.52,1623
2020-10-23,1133,1128,5,0.44,1623
2020-10-24,412,434,-22,-5.07,1623
2020-10-25,210,283,-73,-25.8,1623
2020-10-26,1263,1242,21,1.69,1623
2020-10-27,1323,1281,42,3.28,1623
2020-10-28,1323,1284,39,3.04,1623
2020-10-29,1323,1294,29,2.24,1623
2020-10-30,1133,1151,-18,-1.56,1623
2020-10-31,412,463,-51,-11.02,1623
2020-11-01,208,319,-111,-34.8,1623
2020-11-02,1419,1284,135,10.51,1623
2020-11-03,1376,1329,47,3.54,1623
2020-11-04,1376,1338,38,2.84,1623
2020-11-05,1376,1353,23,1.7,1623
2020-11-06,1222,1214,8,0.66,1623
2020-11-07,370,529,-159,-30.06,1623
2020-11-08,208,386,-178,-46.11,1623
2020-11-09,1419,1352,67,4.96,1623
2020-11-10,1376,1396,-20,-1.43,1623
2020-11-11,1376,1402,-26,-1.85,1623
2020-11-12,1376,1413,-37,-2.62,1623
2020-11-13,1222,1268,-46,-3.63,1623
2020-11-14,370,576,-206,-35.76,1623
2020-11-15,208,425,-217,-51.06,1623
2020-11-16,1419,1381,38,2.75,1623
2020-11-17,1376,1414,-38,-2.69,1623
2020-11-18,1376,1409,-33,-2.34,1623
2020-11-19,1376,1407,-31,-2.2,1623
2020-11-20,1222,1250,-28,-2.24,1623
2020-11-21,370,545,-175,-32.11,1623
2020-11-22,208,382,-174,-45.55,1623
2020-11-23,1419,1326,93,7.01,1623
2020-11-24,1376,1348,28,2.08,1623
2020-11-25,1376,1333,43,3.23,1623
2020-11-26,1376,1322,54,4.08,1623
2020-11-27,1222,1156,66,5.71,1623
2020-11-28,370,445,-75,-16.85,1623
2020-11-29,208,276,-68,-24.64,1623
2020-11-30,1419,1216,203,16.69,1623
2020-12-01,960,1236,-276,-22.33,1623
2020-12-02,960,1221,-261,-21.38,1623
2020-12-03,960,1211,-251,-20.73,1623
2020-12-04,1087,1048,39,3.72,1623
2020-12-05,384,341,43,12.61,1623
2020-12-06,204,178,26,14.61,1623
2020-12-07,1000,1125,-125,-11.11,1623
2020-12-08,960,1152,-192,-16.67,1623
2020-12-09,960,1145,-185,-16.16,1623
2020-12-10,960,1144,-184,-16.08,1623
2020-12-11,1087,990,97,9.8,1623
2020-12-12,384,292,92,31.51,1623
2020-12-13,204,137,67,48.91,1623
2020-12-14,1000,1092,-92,-8.42,1623
2020-12-15,960,1127,-167,-14.82,1623
2020-12-16,960,1126,-166,-14.74,1623
2020-12-17,960,1130,-170,-15.04,1623
2020-12-18,1087,980,107,10.92,1623
2020-12-19,384,284,100,35.21,1623
2020-12-20,204,131,73,55.73,1623
2020-12-21,1000,1086,-86,-7.92,1623
2020-12-22,960,1119,-159,-14.21,1623
2020-12-23,960,1116,-156,-13.98,1623
2020-12-24,960,1116,-156,-13.98,1623
2020-12-25,1087,962,125,12.99,1623
2020-12-26,384,261,123,47.13,1623
2020-12-27,204,101,103,101.98,1623
2020-12-28,1000,1050,-50,-4.76,1623
2020-12-29,960,1076,-116,-10.78,1623
2020-12-30,960,1065,-105,-9.86,1623
2020-12-31,960,1059,-99,-9.35,1623
2021-01-01,786,898,-112,-12.47,1623
2021-01-02,305,191,114,59.69,1623
2021-01-03,202,27,175,648.15,1623
2021-01-04,812,971,-159,-16.37,1623
2021-01-05,936,995,-59,-5.93,1623
2021-01-06,936,983,-47,-4.78,1623
2021-01-07,936,977,-41,-4.2,1623
2021-01-08,786,817,-31,-3.79,1623
2021-01-09,305,113,192,169.91,1623
2021-01-10,202,49,153,312.24,1623
2021-01-11,812,902,-90,-9.98,1623
2021-01-12,936,933,3,0.32,1623
2021-01-13,936,928,8,0.86,1623
2021-01-14,936,930,6,0.65,1623
2021-01-15,786,780,6,0.77,1623
2021-01-16,305,86,219,254.65,1623
2021-01-17,202,42,160,380.95,1623
2021-01-18,812,896,-84,-9.38,1623
2021-01-19,936,937,-1,-0.11,1623
2021-01-20,936,943,-7,-0.74,1623
2021-01-21,936,955,-19,-1.99,1623
2021-01-22,786,814,-28,-3.44,1623
2021-01-23,305,128,177,138.28,1623
2021-01-24,202,68,134,197.06,1623
2021-01-25,812,952,-140,-14.71,1623
2021-01-26,936,998,-62,-6.21,1623
2021-01-27,936,1008,-72,-7.14,1623
2021-01-28,936,1023,-87,-8.5,1623
2021-01-29,786,884,-98,-11.09,1623
2021-01-30,305,199,106,53.27,1623
2021-01-31,202,56,146,260.71,1623
2021-02-01,1160,1021,139,13.61,1623
2021-02-02,1166,1064,102,9.59,1623
2021-02-03,1166,1071,95,8.87,1623
2021-02-04,1166,1082,84,7.76,1623
2021-02-05,1042,938,104,11.09,1623
2021-02-06,345,248,97,39.11,1623
2021-02-07,203,100,103,103.0,1623
2021-02-08,1160,1060,100,9.43,1623
2021-02-09,1166,1099,67,6.1,1623
2021-02-10,1166,1101,65,5.9,1623
2021-02-11,1166,1108,58,5.23,1623
2021-02-12,1042,960,82,8.54,1623
2021-02-13,345,267,78,29.21,1623
2021-02-14,203,116,87,75.0,1623
2021-02-15,1160,1074,86,8.01,1623
2021-02-16,1166,1111,55,4.95,1623
2021-02-17,1166,1113,53,4.76,1623
2021-02-18,1166,1119,47,4.2,1623
2021-02-19,1042,972,70,7.2,1623
2021-02-20,345,280,65,23.21,1623
2021-02-21,203,130,73,56.15,1623
2021-02-22,1160,1090,70,6.42,1623
2021-02-23,1166,1129,37,3.28,1623
2021-02-24,1166,1132,34,3.0,1623
2021-02-25,1166,1140,26,2.28,1623
2021-02-26,1042,995,47,4.72,1623
2021-02-27,345,304,41,13.49,1623
2021-02-28,203,156,47,30.13,1623
2021-03-01,1333,1117,216,19.34,1623
2021-03-02,1343,1156,187,16.18,1623
2021-03-03,1343,1159,184,15.88,1623
2021-03-04,1343,1167,176,15.08,1623
2021-03-05,1177,1021,156,15.28,1623
2021-03-06,376,329,47,14.29,1623
2021-03-07,206,179,27,15.08,1623
2021-03-08,1333,1138,195,17.14,1623
2021-03-09,1343,1175,168,14.3,1623
2021-03-10,1343,1176,167,14.2,1623
2021-03-11,1343,1182,161,13.62,1623
2021-03-12,1177,1033,144,13.94,1623
2021-03-13,376,338,38,11.24,1623
2021-03-14,206,186,20,10.75,1623
2021-03-15,1333,1142,191,16.73,1623
2021-03-16,1343,1178,165,14.01,1623
2021-03-17,1343,1177,166,14.1,1623
2021-03-18,1343,1182,161,13.62,1623
2021-03-19,1177,1033,144,13.94,1623
2021-03-20,376,338,38,11.24,1623
2021-03-21,206,187,19,10.16,1623
2021-03-22,1333,1144,189,16.52,1623
2021-03-23,1343,1181,162,13.72,1623
2021-03-24,1343,1183,160,13.52,1623
2021-03-25,1343,1190,153,12.86,1623
2021-03-26,1177,1044,133,12.74,1623
2021-03-27,376,352,24,6.82,1623
2021-03-28,206,204,2,0.98,1623
2021-03-29,1333,1165,168,14.42,1623
2021-03-30,1343,1205,138,11.45,1623
2021-03-31,1343,1210,133,10.99,1623
2021-04-01,1538,1220,318,26.07,1623
2021-04-02,1277,1076,201,18.68,1623
2021-04-03,380,387,-7,-1.81,1623
2021-04-04,213,240,-27,-11.25,1623
2021-04-05,1529,1202,327,27.2,1623
2021-04-06,1538,1243,295,23.73,1623
2021-04-07,1538,1248,290,23.24,1623
2021-04-08,1538,1257,281,22.35,1623
2021-04-09,1277,1111,166,14.94,1623
2021-04-10,380,420,-40,-9.52,1623
2021-04-11,213,271,-58,-21.4,1623
2021-04-12,1529,1229,300,24.41,1623
2021-04-13,1538,1267,271,21.39,1623
2021-04-14,1538,1267,271,21.39,1623
2021-04-15,1538,1272,266,20.91,1623
2021-04-16,1277,1122,155,13.81,1623
2021-04-17,380,426,-46,-10.8,1623
2021-04-18,213,273,-60,-21.98,1623
2021-04-19,1529,1228,301,24.51,1623
2021-04-20,1538,1261,277,21.97,1623
2021-04-21,1538,1259,279,22.16,1623
2021-04-22,1538,1261,277,21.97,1623
2021-04-23,1277,1109,168,15.15,1623
2021-04-24,380,411,-31,-7.54,1623
2021-04-25,213,256,-43,-16.8,1623
2021-04-26,1529,1211,318,26.26,1623
2021-04-27,1538,1244,294,23.63,1623
2021-04-28,1538,1242,296,23.83,1623
2021-04-29,1538,1245,293,23.53,1623
2021-04-30,1277,1095,182,16.62,1623
2021-05-01,420,400,20,5.0,1623
2021-05-02,222,248,-26,-10.48,1623
2021-05-03,1548,1204,344,28.57,1623
2021-05-04,1617,1241,376,30.3,1623
2021-05-05,1617,1241,376,30.3,1623
2021-05-06,1617,1247,370,29.67,1623
2021-05-07,1266,1099,167,15.2,1623
2021-05-08,420,406,14,3.45,1623
2021-05-09,222,256,-34,-13.28,1623
2021-05-10,1548,1214,334,27.51,1623
2021-05-11,1617,1251,366,29.26,1623
2021-05-12,1617,1252,365,29.15,1623
2021-05-13,1617,1258,359,28.54,1623
2021-05-14,1266,1109,157,14.16,1623
2021-05-15,420,415,5,1.2,1623
2021-05-16,222,263,-41,-15.59,1623
2021-05-17,1548,1219,329,26.99,1623
2021-05-18,1617,1253,364,29.05,1623
2021-05-19,1617,1251,366,29.26,1623
2021-05-20,1617,1254,363,28.95,1623
2021-05-21,1266,1102,164,14.88,1623
2021-05-22,420,405,15,3.7,1623
2021-05-23,222,250,-28,-11.2,1623
2021-05-24,1548,1203,345,28.68,1623
2021-05-25,1617,1235,382,30.93,1623
2021-05-26,1617,1231,386,31.36,1623
2021-05-27,1617,1233,384,31.14,1623
2021-05-28,1266,1080,186,17.22,1623
2021-05-29,420,382,38,9.95,1623
2021-05-30,222,227,-5,-2.2,1623
2021-05-31,1548,1181,367,31.08,1623
2021-06-01,1336,1214,122,10.05,1623
2021-06-02,1336,1213,123,10.14,1623
2021-06-03,1336,1216,120,9.87,1623
2021-06-04,1052,1066,-14,-1.31,1623
2021-06-05,403,371,32,8.63,1623
2021-06-06,224,219,5,2.28,1623
2021-06-07,1248,1176,72,6.12,1623
2021-06-08,1336,1213,123,10.14,1623
2021-06-09,1336,1214,122,10.05,1623
2021-06-10,1336,1220,116,9.51,1623
2021-06-11,1052,1072,-20,-1.87,1623
2021-06-12,403,378,25,6.61,1623
2021-06-13,224,227,-3,-1.32,1623
2021-06-14,1248,1185,63,5.32,1623
2021-06-15,1336,1220,116,9.51,1623
2021-06-16,1336,1220,116,9.51,1623
2021-06-17,1336,1223,113,9.24,1623
2021-06-18,1052,1072,-20,-1.87,1623
2021-06-19,403,374,29,7.75,1623
2021-06-20,224,219,5,2.28,1623
2021-06-21,1248,1170,78,6.67,1623
2021-06-22,1336,1200,136,11.33,1623
2021-06-23,1336,1193,143,11.99,1623
2021-06-24,1336,1190,146,12.27,1623
2021-06-25,1052,1032,20,1.94,1623
2021-06-26,403,327,76,23.24,1623
2021-06-27,224,164,60,36.59,1623
2021-06-28,1248,1109,139,12.53,1623
2021-06-29,1336,1133,203,17.92,1623
2021-06-30,1336,1120,216,19.29,1623
2021-07-01,1218,1112,106,9.53,1623
2021-07-02,974,950,24,2.53,1623
2021-07-03,409,243,166,68.31,1623
2021-07-04,214,79,135,170.89,1623
2021-07-05,1154,1023,131,12.81,1623
2021-07-06,1218,1047,171,16.33,1623
2021-07-07,1218,1037,181,17.45,1623
2021-07-08,1218,1031,187,18.14,1623
2021-07-09,974,873,101,11.57,1623
2021-07-10,409,171,238,139.18,1623
2021-07-11,214,12,202,1683.33,1623
2021-07-12,1154,963,191,19.83,1623
2021-07-13,1218,994,224,22.54,1623
2021-07-14,1218,991,227,22.91,1623
2021-07-15,1218,993,225,22.66,1623
2021-07-16,974,843,131,15.54,1623
2021-07-17,409,147,262,178.23,1623
2021-07-18,214,82,132,160.98,1623
2021-07-19,1154,953,201,21.09,1623
2021-07-20,1218,990,228,23.03,1623
2021-07-21,1218,992,226,22.78,1623
2021-07-22,1218,998,220,22.04,1623
2021-07-23,974,851,123,14.45,1623
2021-07-24,409,157,252,160.51,1623
2021-07-25,214,7,207,2957.14,1623
2021-07-26,1154,964,190,19.71,1623
2021-07-27,1218,1000,218,21.8,1623
2021-07-28,1218,1000,218,21.8,1623
2021-07-29,1218,1003,215,21.44,1623
2021-07-30,974,852,122,14.32,1623
2021-07-31,409,154,255,165.58,1623
2021-08-01,199,83,116,139.76,1623
2021-08-02,1089,952,137,14.39,1623
2021-08-03,1070,983,87,8.85,1623
2021-08-04,1070,977,93,9.52,1623
2021-08-05,1070,976,94,9.63,1623
2021-08-06,808,821,-13,-1.58,1623
2021-08-07,280,120,160,133.33,1623
2021-08-08,199,65,134,206.15,1623
2021-08-09,1089,912,177,19.41,1623
2021-08-10,1070,942,128,13.59,1623
2021-08-11,1070,936,134,14.32,1623
2021-08-12,1070,936,134,14.32,1623
2021-08-13,808,783,25,3.19,1623
2021-08-14,280,85,195,229.41,1623
2021-08-15,199,51,148,290.2,1623
2021-08-16,1089,887,202,22.77,1623
2021-08-17,1070,923,147,15.93,1623
2021-08-18,1070,924,146,15.8,1623
2021-08-19,1070,931,139,14.93,1623
2021-08-20,808,786,22,2.8,1623
2021-08-21,280,95,185,194.74,1623
2021-08-22,199,50,149,298.0,1623
2021-08-23,1089,913,176,19.28,1623
2021-08-24,1070,956,114,11.92,1623
2021-08-25,1070,964,106,11.0,1623
2021-08-26,1070,977,93,9.52,1623
2021-08-27,808,837,-29,-3.46,1623
2021-08-28,280,151,129,85.43,1623
2021-08-29,199,8,191,2387.5,1623
2021-08-30,1089,974,115,11.81,1623
2021-08-31,1070,1018,52,5.11,1623
2021-09-01,1215,1027,188,18.31,1623
2021-09-02,1215,1039,176,16.94,1623
2021-09-03,936,897,39,4.35,1623
2021-09-04,296,209,87,41.63,1623
2021-09-05,207,62,145,233.87,1623
2021-09-06,1230,1024,206,20.12,1623
2021-09-07,1215,1064,151,14.19,1623
2021-09-08,1215,1067,148,13.87,1623
2021-09-09,1215,1074,141,13.13,1623
2021-09-10,936,927,9,0.97,1623
2021-09-11,296,233,63,27.04,1623
2021-09-12,207,82,125,152.44,1623
2021-09-13,1230,1040,190,18.27,1623
2021-09-14,1215,1076,139,12.92,1623
2021-09-15,1215,1076,139,12.92,1623
2021-09-16,1215,1081,134,12.4,1623
2021-09-17,936,933,3,0.32,1623
2021-09-18,296,239,57,23.85,1623
2021-09-19,207,89,118,132.58,1623
2021-09-20,1230,1048,182,17.37,1623
2021-09-21,1215,1086,129,11.88,1623
2021-09-22,1215,1090,125,11.47,1623
2021-09-23,1215,1099,116,10.56,1623
2021-09-24,936,955,-19,-1.99,1623
2021-09-25,296,266,30,11.28,1623
2021-09-26,207,121,86,71.07,1623
2021-09-27,1230,1085,145,13.36,1623
2021-09-28,1215,1128,87,7.71,1623
2021-09-29,1215,1136,79,6.95,1623
2021-09-30,1215,1150,65,5.65,1623
2021-10-01,984,1009,-25,-2.48,1623
2021-10-02,301,323,-22,-6.81,1623
2021-10-03,216,180,36,20.0,1623
2021-10-04,1246,1146,100,8.73,1623
2021-10-05,1268,1190,78,6.55,1623
2021-10-06,1268,1197,71,5.93,1623
2021-10-07,1268,1209,59,4.88,1623
2021-10-08,984,1066,-82,-7.69,1623
2021-10-09,301,377,-76,-20.16,1623
2021-10-10,216,230,-14,-6.09,1623
2021-10-11,1246,1190,56,4.71,1623
2021-10-12,1268,1229,39,3.17,1623
2021-10-13,1268,1231,37,3.01,1623
2021-10-14,1268,1237,31,2.51,1623
2021-10-15,984,1088,-104,-9.56,1623
2021-10-16,301,394,-93,-23.6,1623
2021-10-17,216,241,-25,-10.37,1623
2021-10-18,1246,1197,49,4.09,1623
2021-10-19,1268,1231,37,3.01,1623
2021-10-20,1268,1230,38,3.09,1623
2021-10-21,1268,1234,34,2.76,1623
2021-10-22,984,1084,-100,-9.23,1623
2021-10-23,301,389,-88,-22.62,1623
2021-10-24,216,237,-21,-8.86,1623
2021-10-25,1246,1195,51,4.27,1623
2021-10-26,1268,1232,36,2.92,1623
2021-10-27,1268,1235,33,2.67,1623
2021-10-28,1268,1243,25,2.01,1623
2021-10-29,984,1099,-115,-10.46,1623
2021-10-30,301,410,-109,-26.59,1623
2021-10-31,216,265,-49,-18.49,1623
2021-11-01,1219,1229,-10,-0.81,1623
2021-11-02,1242,1273,-31,-2.44,1623
2021-11-03,1242,1282,-40,-3.12,1623
2021-11-04,1242,1296,-54,-4.17,1623
2021-11-05,1060,1157,-97,-8.38,1623
2021-11-06,380,472,-92,-19.49,1623
2021-11-07,221,330,-109,-33.03,1623
2021-11-08,1219,1296,-77,-5.94,1623
2021-11-09,1242,1341,-99,-7.38,1623
2021-11-10,1242,1349,-107,-7.93,1623
2021-11-11,1242,1361,-119,-8.74,1623
2021-11-12,1060,1218,-158,-12.97,1623
2021-11-13,380,527,-147,-27.89,1623
2021-11-14,221,379,-158,-41.69,1623
2021-11-15,1219,1337,-118,-8.83,1623
2021-11-16,1242,1372,-130,-9.48,1623
2021-11-17,1242,1370,-128,-9.34,1623
2021-11-18,1242,1370,-128,-9.34,1623
2021-11-19,1060,1215,-155,-12.76,1623
2021-11-20,380,513,-133,-25.93,1623
2021-11-21,221,352,-131,-37.22,1623
2021-11-22,1219,1297,-78,-6.01,1623
2021-11-23,1242,1320,-78,-5.91,1623
2021-11-24,1242,1307,-65,-4.97,1623
2021-11-25,1242,1296,-54,-4.17,1623
2021-11-26,1060,1132,-72,-6.36,1623
2021-11-27,380,421,-41,-9.74,1623
2021-11-28,221,252,-31,-12.3,1623
2021-11-29,1219,1192,27,2.27,1623
2021-11-30,1242,1211,31,2.56,1623
2021-12-01,979,1195,-216,-18.08,1623
2021-12-02,979,1184,-205,-17.31,1623
2021-12-03,764,1021,-257,-25.17,1623
2021-12-04,352,312,40,12.82,1623
2021-12-05,228,148,80,54.05,1623
2021-12-06,1074,1093,-19,-1.74,1623
2021-12-07,979,1118,-139,-12.43,1623
2021-12-08,979,1110,-131,-11.8,1623
2021-12-09,979,1107,-128,-11.56,1623
2021-12-10,764,952,-188,-19.75,1623
2021-12-11,352,252,100,39.68,1623
2021-12-12,228,96,132,137.5,1623
2021-12-13,1074,1050,24,2.29,1623
2021-12-14,979,1084,-105,-9.69,1623
2021-12-15,979,1082,-103,-9.52,1623
2021-12-16,979,1086,-107,-9.85,1623
2021-12-17,764,936,-172,-18.38,1623
2021-12-18,352,241,111,46.06,1623
2021-12-19,228,88,140,159.09,1623
2021-12-20,1074,1044,30,2.87,1623
2021-12-21,979,1078,-99,-9.18,1623
2021-12-22,979,1075,-96,-8.93,1623
2021-12-23,979,1077,-98,-9.1,1623
2021-12-24,764,924,-160,-17.32,1623
2021-12-25,352,224,128,57.14,1623
2021-12-26,228,66,162,245.45,1623
2021-12-27,1074,1015,59,5.81,1623
2021-12-28,979,1043,-64,-6.14,1623
2021-12-29,979,1033,-54,-5.23,1623
2021-12-30,979,1028,-49,-4.77,1623
2021-12-31,764,868,-104,-11.98,1623
2022-01-01,329,162,167,103.09,1623
2022-01-02,211,86,125,145.35,1623
2022-01-03,895,942,-47,-4.99,1623
2022-01-04,950,966,-16,-1.66,1623
2022-01-05,950,953,-3,-0.31,1623
2022-01-06,950,946,4,0.42,1623
2022-01-07,782,786,-4,-0.51,1623
2022-01-08,329,80,249,311.25,1623
2022-01-09,211,49,162,330.61,1623
2022-01-10,895,867,28,3.23,1623
2022-01-11,950,895,55,6.15,1623
2022-01-12,950,889,61,6.86,1623
2022-01-13,950,889,61,6.86,1623
2022-01-14,782,737,45,6.11,1623
2022-01-15,329,41,288,702.44,1623
2022-01-16,211,29,182,627.59,1623
2022-01-17,895,847,48,5.67,1623
2022-01-18,950,886,64,7.22,1623
2022-01-19,950,891,59,6.62,1623
2022-01-20,950,901,49,5.44,1623
2022-01-21,782,759,23,3.03,1623
2022-01-22,329,72,257,356.94,1623
2022-01-23,211,52,159,305.77,1623
2022-01-24,895,895,0,0.0,1623
2022-01-25,950,941,9,0.96,1623
2022-01-26,950,951,-1,-0.11,1623
2022-01-27,950,966,-16,-1.66,1623
2022-01-28,782,827,-45,-5.44,1623
2022-01-29,329,142,187,131.69,1623
2022-01-30,211,0,211,inf,1623
2020-02-01,797,422,375,88.86,1179
2020-02-02,461,60,401,668.33,1179
2020-02-03,2864,2840,24,0.85,1179
2020-02-04,2906,2855,51,1.79,1179
2020-02-05,2906,2864,42,1.47,1179
2020-02-06,2906,2870,36,1.25,1179
2020-02-07,2511,2436,75,3.08,1179
2020-02-08,797,471,326,69.21,1179
2020-02-09,461,104,357,343.27,1179
2020-02-10,2864,2878,-14,-0.49,1179
2020-02-11,2906,2889,17,0.59,1179
2020-02-12,2906,2895,11,0.38,1179
2020-02-13,2906,2898,8,0.28,1179
2020-02-14,2511,2463,48,1.95,1179
2020-02-15,797,497,300,60.36,1179
2020-02-16,461,130,331,254.62,1179
2020-02-17,2864,2906,-42,-1.45,1179
2020-02-18,2906,2919,-13,-0.45,1179
2020-02-19,2906,2929,-23,-0.79,1179
2020-02-20,2906,2936,-30,-1.02,1179
2020-02-21,2511,2506,5,0.2,1179
2020-02-22,797,545,252,46.24,1179
2020-02-23,461,185,276,149.19,1179
2020-02-24,2864,2967,-103,-3.47,1179
2020-02-25,2906,2986,-80,-2.68,1179
2020-02-26,2906,3001,-95,-3.17,1179
2020-02-27,2906,3014,-108,-3.58,1179
2020-02-28,2511,2588,-77,-2.98,1179
2020-02-29,797,632,165,26.11,1179
2020-03-01,449,274,175,63.87,1179
2020-03-02,2619,3059,-440,-14.38,1179
2020-03-03,2555,3079,-524,-17.02,1179
2020-03-04,2555,3094,-539,-17.42,1179
2020-03-05,2555,3105,-550,-17.71,1179
2020-03-06,2277,2678,-401,-14.97,1179
2020-03-07,702,718,-16,-2.23,1179
2020-03-08,449,357,92,25.77,1179
2020-03-09,2619,3136,-517,-16.49,1179
2020-03-10,2555,3150,-595,-18.89,1179
2020-03-11,2555,3159,-604,-19.12,1179
2020-03-12,2555,3164,-609,-19.25,1179
2020-03-13,2277,2730,-453,-16.59,1179
2020-03-14,702,764,-62,-8.12,1179
2020-03-15,449,395,54,13.67,1179
2020-03-16,2619,3169,-550,-17.36,1179
2020-03-17,2555,3178,-623,-19.6,1179
2020-03-18,2555,3182,-627,-19.7,1179
2020-03-19,2555,3183,-628,-19.73,1179
2020-03-20,2277,2745,-468,-17.05,1179
2020-03-21,702,777,-75,-9.65,1179
2020-03-22,449,407,42,10.32,1179
2020-03-23,2619,3181,-562,-17.67,1179
2020-03-24,2555,3191,-636,-19.93,1179
2020-03-25,2555,3197,-642,-20.08,1179
2020-03-26,2555,3201,-646,-20.18,1179
2020-03-27,2277,2767,-490,-17.71,1179
2020-03-28,702,803,-101,-12.58,1179
2020-03-29,449,438,11,2.51,1179
2020-03-30,2619,3217,-598,-18.59,1179
2020-03-31,2555,3232,-677,-20.95,1179
2020-04-01,2529,3244,-715,-22.04,1179
2020-04-02,2529,3253,-724,-22.26,1179
2020-04-03,2070,2824,-754,-26.7,1179
2020-04-04,659,864,-205,-23.73,1179
2020-04-05,378,503,-125,-24.85,1179
2020-04-06,2662,3284,-622,-18.94,1179
2020-04-07,2529,3301,-772,-23.39,1179
2020-04-08,2529,3313,-784,-23.66,1179
2020-04-09,2529,3322,-793,-23.87,1179
2020-04-10,2070,2892,-822,-28.42,1179
2020-04-11,659,929,-270,-29.06,1179
2020-04-12,378,565,-187,-33.1,1179
2020-04-13,2662,3342,-680,-20.35,1179
2020-04-14,2529,3354,-825,-24.6,1179
2020-04-15,2529,3360,-831,-24.73,1179
2020-04-16,2529,3362,-833,-24.78,1179
2020-04-17,2070,2925,-855,-29.23,1179
2020-04-18,659,955,-296,-30.99,1179
2020-04-19,378,584,-206,-35.27,1179
2020-04-20,2662,3353,-691,-20.61,1179
2020-04-21,2529,3358,-829,-24.69,1179
2020-04-22,2529,3358,-829,-24.69,1179
2020-04-23,2529,3354,-825,-24.6,1179
2020-04-24,2070,2911,-841,-28.89,1179
2020-04-25,659,938,-279,-29.74,1179
2020-04-26,378,562,-184,-32.74,1179
2020-04-27,2662,3329,-667,-20.04,1179
2020-04-28,2529,3332,-803,-24.1,1179
2020-04-29,2529,3332,-803,-24.1,1179
2020-04-30,2529,3328,-799,-24.01,1179
2020-05-01,2639,2887,-248,-8.59,1179
2020-05-02,860,915,-55,-6.01,1179
2020-05-03,471,542,-71,-13.1,1179
2020-05-04,3086,3312,-226,-6.82,1179
2020-05-05,3131,3319,-188,-5.66,1179
2020-05-06,3131,3322,-191,-5.75,1179
2020-05-07,3131,3323,-192,-5.78,1179
2020-05-08,2639,2886,-247,-8.56,1179
2020-05-09,860,918,-58,-6.32,1179
2020-05-10,471,549,-78,-14.21,1179
2020-05-11,3086,3323,-237,-7.13,1179
2020-05-12,3131,3333,-202,-6.06,1179
2020-05-13,3131,3338,-207,-6.2,1179
2020-05-14,3131,3341,-210,-6.29,1179
2020-05-15,2639,2905,-266,-9.16,1179
2020-05-16,860,937,-77,-8.22,1179
2020-05-17,471,568,-97,-17.08,1179
2020-05-18,3086,3341,-255,-7.63,1179
2020-05-19,3131,3349,-218,-6.51,1179
2020-05-20,3131,3353,-222,-6.62,1179
2020-05-21,3131,3353,-222,-6.62,1179
2020-05-22,2639,2914,-275,-9.44,1179
2020-05-23,860,943,-83,-8.8,1179
2020-05-24,471,571,-100,-17.51,1179
2020-05-25,3086,3340,-254,-7.6,1179
2020-05-26,3131,3345,-214,-6.4,1179
2020-05-27,3131,3346,-215,-6.43,1179
2020-05-28,3131,3343,-212,-6.34,1179
2020-05-29,2639,2902,-263,-9.06,1179
2020-05-30,860,930,-70,-7.53,1179
2020-05-31,471,556,-85,-15.29,1179
2020-06-01,3342,3325,17,0.51,1179
2020-06-02,3250,3330,-80,-2.4,1179
2020-06-03,3250,3332,-82,-2.46,1179
2020-06-04,3250,3330,-80,-2.4,1179
2020-06-05,2798,2891,-93,-3.22,1179
2020-06-06,890,920,-30,-3.26,1179
2020-06-07,512,549,-37,-6.74,1179
2020-06-08,3342,3321,21,0.63,1179
2020-06-09,3250,3329,-79,-2.37,1179
2020-06-10,3250,3333,-83,-2.49,1179
2020-06-11,3250,3333,-83,-2.49,1179
2020-06-12,2798,2896,-98,-3.38,1179
2020-06-13,890,928,-38,-4.09,1179
2020-06-14,512,558,-46,-8.24,1179
2020-06-15,3342,3330,12,0.36,1179
2020-06-16,3250,3338,-88,-2.64,1179
2020-06-17,3250,3341,-91,-2.72,1179
2020-06-18,3250,3341,-91,-2.72,1179
2020-06-19,2798,2901,-103,-3.55,1179
2020-06-20,890,930,-40,-4.3,1179
2020-06-21,512,557,-45,-8.08,1179
2020-06-22,3342,3325,17,0.51,1179
2020-06-23,3250,3328,-78,-2.34,1179
2020-06-24,3250,3326,-76,-2.29,1179
2020-06-25,3250,3320,-70,-2.11,1179
2020-06-26,2798,2875,-77,-2.68,1179
2020-06-27,890,898,-8,-0.89,1179
2020-06-28,512,520,-8,-1.54,1179
2020-06-29,3342,3282,60,1.83,1179
2020-06-30,3250,3281,-31,-0.94,1179
2020-07-01,3162,3275,-113,-3.45,1179
2020-07-02,3162,3265,-103,-3.15,1179
2020-07-03,2773,2818,-45,-1.6,1179
2020-07-04,866,839,27,3.22,1179
2020-07-05,512,459,53,11.55,1179
2020-07-06,3196,3222,-26,-0.81,1179
2020-07-07,3162,3222,-60,-1.86,1179
2020-07-08,3162,3218,-56,-1.74,1179
2020-07-09,3162,3211,-49,-1.53,1179
2020-07-10,2773,2767,6,0.22,1179
2020-07-11,866,793,73,9.21,1179
2020-07-12,512,418,94,22.49,1179
2020-07-13,3196,3186,10,0.31,1179
2020-07-14,3162,3191,-29,-0.91,1179
2020-07-15,3162,3193,-31,-0.97,1179
2020-07-16,3162,3191,-29,-0.91,1179
2020-07-17,2773,2752,21,0.76,1179
2020-07-18,866,782,84,10.74,1179
2020-07-19,512,411,101,24.57,1179
2020-07-20,3196,3182,14,0.44,1179
2020-07-21,3162,3189,-27,-0.85,1179
2020-07-22,3162,3192,-30,-0.94,1179
2020-07-23,3162,3190,-28,-0.88,1179
2020-07-24,2773,2750,23,0.84,1179
2020-07-25,866,778,88,11.31,1179
2020-07-26,512,403,109,27.05,1179
2020-07-27,3196,3170,26,0.82,1179
2020-07-28,3162,3171,-9,-0.28,1179
2020-07-29,3162,3168,-6,-0.19,1179
2020-07-30,3162,3159,3,0.09,1179
2020-07-31,2773,2712,61,2.25,1179
2020-08-01,860,732,128,17.49,1179
2020-08-02,517,350,167,47.71,1179
2020-08-03,2972,3110,-138,-4.44,1179
2020-08-04,2997,3105,-108,-3.48,1179
2020-08-05,2997,3095,-98,-3.17,1179
2020-08-06,2997,3082,-85,-2.76,1179
2020-08-07,2544,2631,-87,-3.31,1179
2020-08-08,860,649,211,32.51,1179
2020-08-09,517,266,251,94.36,1179
2020-08-10,2972,3026,-54,-1.78,1179
2020-08-11,2997,3023,-26,-0.86,1179
2020-08-12,2997,3017,-20,-0.66,1179
2020-08-13,2997,3009,-12,-0.4,1179
2020-08-14,2544,2564,-20,-0.78,1179
2020-08-15,860,590,270,45.76,1179
2020-08-16,517,217,300,138.25,1179
2020-08-17,2972,2987,-15,-0.5,1179
2020-08-18,2997,2996,1,0.03,1179
2020-08-19,2997,3002,-5,-0.17,1179
2020-08-20,2997,3007,-10,-0.33,1179
2020-08-21,2544,2576,-32,-1.24,1179
2020-08-22,860,615,245,39.84,1179
2020-08-23,517,254,263,103.54,1179
2020-08-24,2972,3037,-65,-2.14,1179
2020-08-25,2997,3057,-60,-1.96,1179
2020-08-26,2997,3073,-76,-2.47,1179
2020-08-27,2997,3087,-90,-2.92,1179
2020-08-28,2544,2663,-119,-4.47,1179
2020-08-29,860,708,152,21.47,1179
2020-08-30,517,351,166,47.29,1179
2020-08-31,2972,3136,-164,-5.23,1179
2020-09-01,3340,3156,184,5.83,1179
2020-09-02,3340,3172,168,5.3,1179
2020-09-03,3340,3183,157,4.93,1179
2020-09-04,2945,2754,191,6.94,1179
2020-09-05,911,793,118,14.88,1179
2020-09-06,548,430,118,27.44,1179
2020-09-07,3290,3207,83,2.59,1179
2020-09-08,3340,3219,121,3.76,1179
2020-09-09,3340,3225,115,3.57,1179
2020-09-10,3340,3226,114,3.53,1179
2020-09-11,2945,2789,156,5.59,1179
2020-09-12,911,819,92,11.23,1179
2020-09-13,548,447,101,22.6,1179
2020-09-14,3290,3216,74,2.3,1179
2020-09-15,3340,3221,119,3.69,1179
2020-09-16,3340,3221,119,3.69,1179
2020-09-17,3340,3218,122,3.79,1179
2020-09-18,2945,2777,168,6.05,1179
2020-09-19,911,805,106,13.17,1179
2020-09-20,548,433,115,26.56,1179
2020-09-21,3290,3203,87,2.72,1179
2020-09-22,3340,3210,130,4.05,1179
2020-09-23,3340,3213,127,3.95,1179
2020-09-24,3340,3215,125,3.89,1179
2020-09-25,2945,2779,166,5.97,1179
2020-09-26,911,813,98,12.05,1179
2020-09-27,548,446,102,22.87,1179
2020-09-28,3290,3222,68,2.11,1179
2020-09-29,3340,3236,104,3.21,1179
2020-09-30,3340,3245,95,2.93,1179
2020-10-01,3414,3252,162,4.98,1179
2020-10-02,3055,2821,234,8.29,1179
2020-10-03,964,858,106,12.35,1179
2020-10-04,530,494,36,7.29,1179
2020-10-05,3374,3272,102,3.12,1179
2020-10-06,3414,3286,128,3.9,1179
2020-10-07,3414,3295,119,3.61,1179
2020-10-08,3414,3300,114,3.45,1179
2020-10-09,3055,2865,190,6.63,1179
2020-10-10,964,898,66,7.35,1179
2020-10-11,530,529,1,0.19,1179
2020-10-12,3374,3301,73,2.21,1179
2020-10-13,3414,3308,106,3.2,1179
2020-10-14,3414,3309,105,3.17,1179
2020-10-15,3414,3305,109,3.3,1179
2020-10-16,3055,2863,192,6.71,1179
2020-10-17,964,889,75,8.44,1179
2020-10-18,530,512,18,3.52,1179
2020-10-19,3374,3277,97,2.96,1179
2020-10-20,3414,3278,136,4.15,1179
2020-10-21,3414,3274,140,4.28,1179
2020-10-22,3414,3267,147,4.5,1179
2020-10-23,3055,2823,232,8.22,1179
2020-10-24,964,847,117,13.81,1179
2020-10-25,530,471,59,12.53,1179
2020-10-26,3374,3237,137,4.23,1179
2020-10-27,3414,3241,173,5.34,1179
2020-10-28,3414,3241,173,5.34,1179
2020-10-29,3414,3240,174,5.37,1179
2020-10-30,3055,2801,254,9.07,1179
2020-10-31,964,832,132,15.87,1179
2020-11-01,475,463,12,2.59,1179
2020-11-02,3395,3237,158,4.88,1179
2020-11-03,3319,3248,71,2.19,1179
2020-11-04,3319,3255,64,1.97,1179
2020-11-05,3319,3260,59,1.81,1179
2020-11-06,2960,2827,133,4.7,1179
2020-11-07,903,863,40,4.63,1179
2020-11-08,475,497,-22,-4.43,1179
2020-11-09,3395,3273,122,3.73,1179
2020-11-10,3319,3284,35,1.07,1179
2020-11-11,3319,3290,29,0.88,1179
2020-11-12,3319,3291,28,0.85,1179
2020-11-13,2960,2853,107,3.75,1179
2020-11-14,903,882,21,2.38,1179
2020-11-15,475,508,-33,-6.5,1179
2020-11-16,3395,3274,121,3.7,1179
2020-11-17,3319,3274,45,1.37,1179
2020-11-18,3319,3268,51,1.56,1179
2020-11-19,3319,3256,63,1.93,1179
2020-11-20,2960,2804,156,5.56,1179
2020-11-21,903,819,84,10.26,1179
2020-11-22,475,431,44,10.21,1179
2020-11-23,3395,3183,212,6.66,1179
2020-11-24,3319,3170,149,4.7,1179
2020-11-25,3319,3151,168,5.33,1179
2020-11-26,3319,3128,191,6.11,1179
2020-11-27,2960,2666,294,11.03,1179
2020-11-28,903,672,231,34.38,1179
2020-11-29,475,278,197,70.86,1179
2020-11-30,3395,3025,370,12.23,1179
2020-12-01,2533,3009,-476,-15.82,1179
2020-12-02,2533,2990,-457,-15.28,1179
2020-12-03,2533,2968,-435,-14.66,1179
2020-12-04,3059,2509,550,21.92,1179
2020-12-05,902,521,381,73.13,1179
2020-12-06,470,133,337,253.38,1179
2020-12-07,2554,2888,-334,-11.57,1179
2020-12-08,2533,2882,-349,-12.11,1179
2020-12-09,2533,2873,-340,-11.83,1179
2020-12-10,2533,2862,-329,-11.5,1179
2020-12-11,3059,2414,645,26.72,1179
2020-12-12,902,437,465,106.41,1179
2020-12-13,470,60,410,683.33,1179
2020-12-14,2554,2826,-272,-9.62,1179
2020-12-15,2533,2830,-297,-10.49,1179
2020-12-16,2533,2829,-296,-10.46,1179
2020-12-17,2533,2826,-293,-10.37,1179
2020-12-18,3059,2384,675,28.31,1179
2020-12-19,902,411,491,119.46,1179
2020-12-20,470,37,433,1170.27,1179
2020-12-21,2554,2804,-250,-8.92,1179
2020-12-22,2533,2807,-274,-9.76,1179
2020-12-23,2533,2804,-271,-9.66,1179
2020-12-24,2533,2797,-264,-9.44,1179
2020-12-25,3059,2351,708,30.11,1179
2020-12-26,902,372,530,142.47,1179
2020-12-27,470,85,385,452.94,1179
2020-12-28,2554,2750,-196,-7.13,1179
2020-12-29,2533,2744,-211,-7.69,1179
2020-12-30,2533,2733,-200,-7.32,1179
2020-12-31,2533,2718,-185,-6.81,1179
2021-01-01,2252,2264,-12,-0.53,1179
2021-01-02,669,279,390,139.78,1179
2021-01-03,412,39,373,956.41,1179
2021-01-04,2470,2646,-176,-6.65,1179
2021-01-05,2589,2638,-49,-1.86,1179
2021-01-06,2589,2625,-36,-1.37,1179
2021-01-07,2589,2610,-21,-0.8,1179
2021-01-08,2252,2158,94,4.36,1179
2021-01-09,669,176,493,280.11,1179
2021-01-10,412,176,236,134.09,1179
2021-01-11,2470,2556,-86,-3.36,1179
2021-01-12,2589,2556,33,1.29,1179
2021-01-13,2589,2553,36,1.41,1179
2021-01-14,2589,2549,40,1.57,1179
2021-01-15,2252,2109,143,6.78,1179
2021-01-16,669,139,530,381.29,1179
2021-01-17,412,139,273,196.4,1179
2021-01-18,2470,2546,-76,-2.99,1179
2021-01-19,2589,2559,30,1.17,1179
2021-01-20,2589,2569,20,0.78,1179
2021-01-21,2589,2578,11,0.43,1179
2021-01-22,2252,2149,103,4.79,1179
2021-01-23,669,190,479,252.11,1179
2021-01-24,412,11,401,3645.45,1179
2021-01-25,2470,2614,-144,-5.51,1179
2021-01-26,2589,2633,-44,-1.67,1179
2021-01-27,2589,2648,-59,-2.23,1179
2021-01-28,2589,2660,-71,-2.67,1179
2021-01-29,2252,2233,19,0.85,1179
2021-01-30,669,274,395,144.16,1179
2021-01-31,412,52,360,692.31,1179
2021-02-01,3142,2694,448,16.63,1179
2021-02-02,3108,2710,398,14.69,1179
2021-02-03,3108,2721,387,14.22,1179
2021-02-04,3108,2728,380,13.93,1179
2021-02-05,2636,2295,341,14.86,1179
2021-02-06,807,331,476,143.81,1179
2021-02-07,448,77,371,481.82,1179
2021-02-08,3142,2739,403,14.71,1179
2021-02-09,3108,2750,358,13.02,1179
2021-02-10,3108,2756,352,12.77,1179
2021-02-11,3108,2759,349,12.65,1179
2021-02-12,2636,2324,312,13.43,1179
2021-02-13,807,357,450,126.05,1179
2021-02-14,448,83,365,439.76,1179
2021-02-15,3142,2765,377,13.63,1179
2021-02-16,3108,2777,331,11.92,1179
2021-02-17,3108,2786,322,11.56,1179
2021-02-18,3108,2792,316,11.32,1179
2021-02-19,2636,2361,275,11.65,1179
2021-02-20,807,399,408,102.26,1179
2021-02-21,448,37,411,1110.81,1179
2021-02-22,3142,2818,324,11.5,1179
2021-02-23,3108,2837,271,9.55,1179
2021-02-24,3108,2851,257,9.01,1179
2021-02-25,3108,2863,245,8.56,1179
2021-02-26,2636,2437,199,8.17,1179
2021-02-27,807,481,326,67.78,1179
2021-02-28,448,123,325,264.23,1179
2021-03-01,3380,2907,473,16.27,1179
2021-03-02,3382,2928,454,15.51,1179
2021-03-03,3382,2944,438,14.88,1179
2021-03-04,3382,2956,426,14.41,1179
2021-03-05,2943,2529,414,16.37,1179
2021-03-06,929,571,358,62.7,1179
2021-03-07,459,210,249,118.57,1179
2021-03-08,3380,2991,389,13.01,1179
2021-03-09,3382,3007,375,12.47,1179
2021-03-10,3382,3017,365,12.1,1179
2021-03-11,3382,3023,359,11.88,1179
2021-03-12,2943,2590,353,13.63,1179
2021-03-13,929,625,304,48.64,1179
2021-03-14,459,257,202,78.6,1179
2021-03-15,3380,3031,349,11.51,1179
2021-03-16,3382,3041,341,11.21,1179
2021-03-17,3382,3045,337,11.07,1179
2021-03-18,3382,3046,336,11.03,1179
2021-03-19,2943,2609,334,12.8,1179
2021-03-20,929,641,288,44.93,1179
2021-03-21,459,271,188,69.37,1179
2021-03-22,3380,3043,337,11.07,1179
2021-03-23,3382,3053,329,10.78,1179
2021-03-24,3382,3058,324,10.6,1179
2021-03-25,3382,3061,321,10.49,1179
2021-03-26,2943,2626,317,12.07,1179
2021-03-27,929,661,268,40.54,1179
2021-03-28,459,296,163,55.07,1179
2021-03-29,3380,3073,307,9.99,1179
2021-03-30,3382,3088,294,9.52,1179
2021-03-31,3382,3098,284,9.17,1179
2021-04-01,3405,3107,298,9.59,1179
2021-04-02,3047,2677,370,13.82,1179
2021-04-03,844,717,127,17.71,1179
2021-04-04,461,356,105,29.49,1179
2021-04-05,3612,3137,475,15.14,1179
2021-04-06,3405,3154,251,7.96,1179
2021-04-07,3405,3167,238,7.51,1179
2021-04-08,3405,3176,229,7.21,1179
2021-04-09,3047,2747,300,10.92,1179
2021-04-10,844,785,59,7.52,1179
2021-04-11,461,422,39,9.24,1179
2021-04-12,3612,3200,412,12.88,1179
2021-04-13,3405,3213,192,5.98,1179
2021-04-14,3405,3221,184,5.71,1179
2021-04-15,3405,3224,181,5.61,1179
2021-04-16,3047,2788,259,9.29,1179
2021-04-17,844,820,24,2.93,1179
2021-04-18,461,450,11,2.44,1179
2021-04-19,3612,3220,392,12.17,1179
2021-04-20,3405,3226,179,5.55,1179
2021-04-21,3405,3227,178,5.52,1179
2021-04-22,3405,3224,181,5.61,1179
2021-04-23,3047,2782,265,9.53,1179
2021-04-24,844,808,36,4.46,1179
2021-04-25,461,433,28,6.47,1179
2021-04-26,3612,3200,412,12.88,1179
2021-04-27,3405,3203,202,6.31,1179
2021-04-28,3405,3202,203,6.34,1179
2021-04-29,3405,3198,207,6.47,1179
2021-04-30,3047,2756,291,10.56,1179
2021-05-01,976,783,193,24.65,1179
2021-05-02,499,410,89,21.71,1179
2021-05-03,3466,3179,287,9.03,1179
2021-05-04,3479,3185,294,9.23,1179
2021-05-05,3479,3187,292,9.16,1179
2021-05-06,3479,3187,292,9.16,1179
2021-05-07,3054,2749,305,11.09,1179
2021-05-08,976,781,195,24.97,1179
2021-05-09,499,412,87,21.12,1179
2021-05-10,3466,3185,281,8.82,1179
2021-05-11,3479,3195,284,8.89,1179
2021-05-12,3479,3200,279,8.72,1179
2021-05-13,3479,3203,276,8.62,1179
2021-05-14,3054,2767,287,10.37,1179
2021-05-15,976,800,176,22.0,1179
2021-05-16,499,431,68,15.78,1179
2021-05-17,3466,3204,262,8.18,1179
2021-05-18,3479,3213,266,8.28,1179
2021-05-19,3479,3217,262,8.14,1179
2021-05-20,3479,3218,261,8.11,1179
2021-05-21,3054,2779,275,9.9,1179
2021-05-22,976,809,167,20.64,1179
2021-05-23,499,438,61,13.93,1179
2021-05-24,3466,3208,258,8.04,1179
2021-05-25,3479,3213,266,8.28,1179
2021-05-26,3479,3214,265,8.25,1179
2021-05-27,3479,3212,267,8.31,1179
2021-05-28,3054,2771,283,10.21,1179
2021-05-29,976,798,178,22.31,1179
2021-05-30,499,425,74,17.41,1179
2021-05-31,3466,3193,273,8.55,1179
2021-06-01,3499,3198,301,9.41,1179
2021-06-02,3499,3199,300,9.38,1179
2021-06-03,3499,3197,302,9.45,1179
2021-06-04,2940,2757,183,6.64,1179
2021-06-05,951,786,165,20.99,1179
2021-06-06,565,415,150,36.14,1179
2021-06-07,3544,3186,358,11.24,1179
2021-06-08,3499,3193,306,9.58,1179
2021-06-09,3499,3197,302,9.45,1179
2021-06-10,3499,3197,302,9.45,1179
2021-06-11,2940,2760,180,6.52,1179
2021-06-12,951,792,159,20.08,1179
2021-06-13,565,422,143,33.89,1179
2021-06-14,3544,3194,350,10.96,1179
2021-06-15,3499,3203,296,9.24,1179
2021-06-16,3499,3206,293,9.14,1179
2021-06-17,3499,3206,293,9.14,1179
2021-06-18,2940,2768,172,6.21,1179
2021-06-19,951,797,154,19.32,1179
2021-06-20,565,425,140,32.94,1179
2021-06-21,3544,3194,350,10.96,1179
2021-06-22,3499,3198,301,9.41,1179
2021-06-23,3499,3197,302,9.45,1179
2021-06-24,3499,3192,307,9.62,1179
2021-06-25,2940,2748,192,6.99,1179
2021-06-26,951,773,178,23.03,1179
2021-06-27,565,395,170,43.04,1179
2021-06-28,3544,3158,386,12.22,1179
2021-06-29,3499,3157,342,10.83,1179
2021-06-30,3499,3151,348,11.04,1179
2021-07-01,3339,3142,197,6.27,1179
2021-07-02,2888,2694,194,7.2,1179
2021-07-03,886,716,170,23.74,1179
2021-07-04,538,336,202,60.12,1179
2021-07-05,3314,3098,216,6.97,1179
2021-07-06,3339,3097,242,7.81,1179
2021-07-07,3339,3092,247,7.99,1179
2021-07-08,3339,3085,254,8.23,1179
2021-07-09,2888,2640,248,9.39,1179
2021-07-10,886,664,222,33.43,1179
2021-07-11,538,288,250,86.81,1179
2021-07-12,3314,3055,259,8.48,1179
2021-07-13,3339,3060,279,9.12,1179
2021-07-14,3339,3060,279,9.12,1179
2021-07-15,3339,3058,281,9.19,1179
2021-07-16,2888,2618,270,10.31,1179
2021-07-17,886,648,238,36.73,1179
2021-07-18,538,277,261,94.22,1179
2021-07-19,3314,3048,266,8.73,1179
2021-07-20,3339,3055,284,9.3,1179
2021-07-21,3339,3058,281,9.19,1179
2021-07-22,3339,3057,282,9.22,1179
2021-07-23,2888,2617,271,10.36,1179
2021-07-24,886,646,240,37.15,1179
2021-07-25,538,273,265,97.07,1179
2021-07-26,3314,3041,273,8.98,1179
2021-07-27,3339,3044,295,9.69,1179
2021-07-28,3339,3041,298,9.8,1179
2021-07-29,3339,3034,305,10.05,1179
2021-07-30,2888,2588,300,11.59,1179
2021-07-31,886,610,276,45.25,1179
2021-08-01,528,229,299,130.57,1179
2021-08-02,3102,2990,112,3.75,1179
2021-08-03,3108,2986,122,4.09,1179
2021-08-04,3108,2976,132,4.44,1179
2021-08-05,3108,2964,144,4.86,1179
2021-08-06,2659,2512,147,5.85,1179
2021-08-07,826,530,296,55.85,1179
2021-08-08,528,146,382,261.64,1179
2021-08-09,3102,2905,197,6.78,1179
2021-08-10,3108,2901,207,7.14,1179
2021-08-11,3108,2894,214,7.39,1179
2021-08-12,3108,2884,224,7.77,1179
2021-08-13,2659,2437,222,9.11,1179
2021-08-14,826,461,365,79.18,1179
2021-08-15,528,86,442,513.95,1179
2021-08-16,3102,2854,248,8.69,1179
2021-08-17,3108,2860,248,8.67,1179
2021-08-18,3108,2864,244,8.52,1179
2021-08-19,3108,2866,242,8.44,1179
2021-08-20,2659,2433,226,9.29,1179
2021-08-21,826,470,356,75.74,1179
2021-08-22,528,107,421,393.46,1179
2021-08-23,3102,2888,214,7.41,1179
2021-08-24,3108,2906,202,6.95,1179
2021-08-25,3108,2922,186,6.37,1179
2021-08-26,3108,2935,173,5.89,1179
2021-08-27,2659,2510,149,5.94,1179
2021-08-28,826,555,271,48.83,1179
2021-08-29,528,198,330,166.67,1179
2021-08-30,3102,2984,118,3.95,1179
2021-08-31,3108,3005,103,3.43,1179
2021-09-01,3480,3021,459,15.19,1179
2021-09-02,3480,3034,446,14.7,1179
2021-09-03,3016,2607,409,15.69,1179
2021-09-04,974,648,326,50.31,1179
2021-09-05,569,286,283,98.95,1179
2021-09-06,3406,3064,342,11.16,1179
2021-09-07,3480,3078,402,13.06,1179
2021-09-08,3480,3086,394,12.77,1179
2021-09-09,3480,3089,391,12.66,1179
2021-09-10,3016,2653,363,13.68,1179
2021-09-11,974,684,290,42.4,1179
2021-09-12,569,313,256,81.79,1179
2021-09-13,3406,3083,323,10.48,1179
2021-09-14,3480,3089,391,12.66,1179
2021-09-15,3480,3090,390,12.62,1179
2021-09-16,3480,3087,393,12.73,1179
2021-09-17,3016,2646,370,13.98,1179
2021-09-18,974,673,301,44.73,1179
2021-09-19,569,300,269,89.67,1179
2021-09-20,3406,3069,337,10.98,1179
2021-09-21,3480,3076,404,13.13,1179
2021-09-22,3480,3078,402,13.06,1179
2021-09-23,3480,3078,402,13.06,1179
2021-09-24,3016,2641,375,14.2,1179
2021-09-25,974,674,300,44.51,1179
2021-09-26,569,306,263,85.95,1179
2021-09-27,3406,3081,325,10.55,1179
2021-09-28,3480,3094,386,12.48,1179
2021-09-29,3480,3102,378,12.19,1179
2021-09-30,3480,3108,372,11.97,1179
2021-10-01,3206,2677,529,19.76,1179
2021-10-02,993,714,279,39.08,1179
2021-10-03,566,351,215,61.25,1179
2021-10-04,3504,3129,375,11.98,1179
2021-10-05,3569,3143,426,13.55,1179
2021-10-06,3569,3153,416,13.19,1179
2021-10-07,3569,3159,410,12.98,1179
2021-10-08,3206,2725,481,17.65,1179
2021-10-09,993,760,233,30.66,1179
2021-10-10,566,392,174,44.39,1179
2021-10-11,3504,3165,339,10.71,1179
2021-10-12,3569,3173,396,12.48,1179
2021-10-13,3569,3176,393,12.37,1179
2021-10-14,3569,3174,395,12.44,1179
2021-10-15,3206,2733,473,17.31,1179
2021-10-16,993,760,233,30.66,1179
2021-10-17,566,384,182,47.4,1179
2021-10-18,3504,3150,354,11.24,1179
2021-10-19,3569,3151,418,13.27,1179
2021-10-20,3569,3148,421,13.37,1179
2021-10-21,3569,3141,428,13.63,1179
2021-10-22,3206,2696,510,18.92,1179
2021-10-23,993,720,273,37.92,1179
2021-10-24,566,343,223,65.01,1179
2021-10-25,3504,3108,396,12.74,1179
2021-10-26,3569,3111,458,14.72,1179
2021-10-27,3569,3110,459,14.76,1179
2021-10-28,3569,3107,462,14.87,1179
2021-10-29,3206,2667,539,20.21,1179
2021-10-30,993,697,296,42.47,1179
2021-10-31,566,326,240,73.62,1179
2021-11-01,3394,3099,295,9.52,1179
2021-11-02,3454,3109,345,11.1,1179
2021-11-03,3454,3115,339,10.88,1179
2021-11-04,3454,3119,335,10.74,1179
2021-11-05,2988,2686,302,11.24,1179
2021-11-06,940,721,219,30.37,1179
2021-11-07,534,356,178,50.0,1179
2021-11-08,3394,3132,262,8.37,1179
2021-11-09,3454,3144,310,9.86,1179
2021-11-10,3454,3151,303,9.62,1179
2021-11-11,3454,3154,300,9.51,1179
2021-11-12,2988,2718,270,9.93,1179
2021-11-13,940,749,191,25.5,1179
2021-11-14,534,377,157,41.64,1179
2021-11-15,3394,3146,248,7.88,1179
2021-11-16,3454,3148,306,9.72,1179
2021-11-17,3454,3145,309,9.83,1179
2021-11-18,3454,3136,318,10.14,1179
2021-11-19,2988,2686,302,11.24,1179
2021-11-20,940,704,236,33.52,1179
2021-11-21,534,318,216,67.92,1179
2021-11-22,3394,3072,322,10.48,1179
2021-11-23,3454,3061,393,12.84,1179
2021-11-24,3454,3043,411,13.51,1179
2021-11-25,3454,3021,433,14.33,1179
2021-11-26,2988,2560,428,16.72,1179
2021-11-27,940,568,372,65.49,1179
2021-11-28,534,173,361,208.67,1179
2021-11-29,3394,2920,474,16.23,1179
2021-11-30,3454,2904,550,18.94,1179
2021-12-01,2607,2883,-276,-9.57,1179
2021-12-02,2607,2860,-253,-8.85,1179
2021-12-03,2042,2400,-358,-14.92,1179
2021-12-04,881,410,471,114.88,1179
2021-12-05,443,20,423,2115.0,1179
2021-12-06,2868,2773,95,3.43,1179
2021-12-07,2607,2765,-158,-5.71,1179
2021-12-08,2607,2753,-146,-5.3,1179
2021-12-09,2607,2740,-133,-4.85,1179
2021-12-10,2042,2291,-249,-10.87,1179
2021-12-11,881,312,569,182.37,1179
2021-12-12,443,67,376,561.19,1179
2021-12-13,2868,2698,170,6.3,1179
2021-12-14,2607,2700,-93,-3.44,1179
2021-12-15,2607,2699,-92,-3.41,1179
2021-12-16,2607,2695,-88,-3.27,1179
2021-12-17,2042,2253,-211,-9.37,1179
2021-12-18,881,281,600,213.52,1179
2021-12-19,443,46,397,863.04,1179
2021-12-20,2868,2674,194,7.26,1179
2021-12-21,2607,2678,-71,-2.65,1179
2021-12-22,2607,2676,-69,-2.58,1179
2021-12-23,2607,2671,-64,-2.4,1179
2021-12-24,2042,2226,-184,-8.27,1179
2021-12-25,881,248,633,255.24,1179
2021-12-26,443,40,403,1007.5,1179
2021-12-27,2868,2629,239,9.09,1179
2021-12-28,2607,2626,-19,-0.72,1179
2021-12-29,2607,2616,-9,-0.34,1179
2021-12-30,2607,2602,5,0.19,1179
2021-12-31,2042,2149,-107,-4.98,1179
2022-01-01,726,164,562,342.68,1179
2022-01-02,420,164,256,156.1,1179
2022-01-03,2430,2532,-102,-4.03,1179
2022-01-04,2550,2523,27,1.07,1179
2022-01-05,2550,2510,40,1.59,1179
2022-01-06,2550,2494,56,2.25,1179
2022-01-07,2242,2041,201,9.85,1179
2022-01-08,726,57,669,1173.68,1179
2022-01-09,420,57,363,636.84,1179
2022-01-10,2430,2433,-3,-0.12,1179
2022-01-11,2550,2431,119,4.9,1179
2022-01-12,2550,2426,124,5.11,1179
2022-01-13,2550,2419,131,5.42,1179
2022-01-14,2242,1976,266,13.46,1179
2022-01-15,726,5,721,14420.0,1179
2022-01-16,420,5,415,8300.0,1179
2022-01-17,2430,2406,24,1.0,1179
2022-01-18,2550,2417,133,5.5,1179
2022-01-19,2550,2426,124,5.11,1179
2022-01-20,2550,2432,118,4.85,1179
2022-01-21,2242,2002,240,11.99,1179
2022-01-22,726,42,684,1628.57,1179
2022-01-23,420,42,378,900.0,1179
2022-01-24,2430,2464,-34,-1.38,1179
2022-01-25,2550,2483,67,2.7,1179
2022-01-26,2550,2498,52,2.08,1179
2022-01-27,2550,2510,40,1.59,1179
2022-01-28,2242,2084,158,7.58,1179
2022-01-29,726,126,600,476.19,1179
2022-01-30,420,126,294,233.33,1179
2020-02-01,228,202,26,12.87,1180
2020-02-02,169,138,31,22.46,1180
2020-02-03,533,511,22,4.31,1180
2020-02-04,547,528,19,3.6,1180
2020-02-05,547,529,18,3.4,1180
2020-02-06,547,529,18,3.4,1180
2020-02-07,508,476,32,6.72,1180
2020-02-08,228,206,22,10.68,1180
2020-02-09,169,141,28,19.86,1180
2020-02-10,533,513,20,3.9,1180
2020-02-11,547,530,17,3.21,1180
2020-02-12,547,531,16,3.01,1180
2020-02-13,547,531,16,3.01,1180
2020-02-14,508,479,29,6.05,1180
2020-02-15,228,209,19,9.09,1180
2020-02-16,169,145,24,16.55,1180
2020-02-17,533,519,14,2.7,1180
2020-02-18,547,536,11,2.05,1180
2020-02-19,547,539,8,1.48,1180
2020-02-20,547,540,7,1.3,1180
2020-02-21,508,489,19,3.89,1180
2020-02-22,228,221,7,3.17,1180
2020-02-23,169,159,10,6.29,1180
2020-02-24,533,534,-1,-0.19,1180
2020-02-25,547,553,-6,-1.08,1180
2020-02-26,547,556,-9,-1.62,1180
2020-02-27,547,559,-12,-2.15,1180
2020-02-28,508,509,-1,-0.2,1180
2020-02-29,228,241,-13,-5.39,1180
2020-03-01,163,179,-16,-8.94,1180
2020-03-02,474,554,-80,-14.44,1180
2020-03-03,489,573,-84,-14.66,1180
2020-03-04,489,575,-86,-14.96,1180
2020-03-05,489,577,-88,-15.25,1180
2020-03-06,452,526,-74,-14.07,1180
2020-03-07,219,257,-38,-14.79,1180
2020-03-08,163,194,-31,-15.98,1180
2020-03-09,474,567,-93,-16.4,1180
2020-03-10,489,585,-96,-16.41,1180
2020-03-11,489,586,-97,-16.55,1180
2020-03-12,489,586,-97,-16.55,1180
2020-03-13,452,534,-82,-15.36,1180
2020-03-14,219,264,-45,-17.05,1180
2020-03-15,163,199,-36,-18.09,1180
2020-03-16,474,572,-98,-17.13,1180
2020-03-17,489,588,-99,-16.84,1180
2020-03-18,489,589,-100,-16.98,1180
2020-03-19,489,589,-100,-16.98,1180
2020-03-20,452,536,-84,-15.67,1180
2020-03-21,219,267,-48,-17.98,1180
2020-03-22,163,203,-40,-19.7,1180
2020-03-23,474,575,-101,-17.57,1180
2020-03-24,489,593,-104,-17.54,1180
2020-03-25,489,595,-106,-17.82,1180
2020-03-26,489,596,-107,-17.95,1180
2020-03-27,452,544,-92,-16.91,1180
2020-03-28,219,276,-57,-20.65,1180
2020-03-29,163,213,-50,-23.47,1180
2020-03-30,474,587,-113,-19.25,1180
2020-03-31,489,606,-117,-19.31,1180
2020-04-01,494,608,-114,-18.75,1180
2020-04-02,494,610,-116,-19.02,1180
2020-04-03,450,560,-110,-19.64,1180
2020-04-04,216,291,-75,-25.77,1180
2020-04-05,145,229,-84,-36.68,1180
2020-04-06,504,603,-99,-16.42,1180
2020-04-07,494,622,-128,-20.58,1180
2020-04-08,494,624,-130,-20.83,1180
2020-04-09,494,626,-132,-21.09,1180
2020-04-10,450,574,-124,-21.6,1180
2020-04-11,216,305,-89,-29.18,1180
2020-04-12,145,241,-96,-39.83,1180
2020-04-13,504,614,-110,-17.92,1180
2020-04-14,494,631,-137,-21.71,1180
2020-04-15,494,633,-139,-21.96,1180
2020-04-16,494,633,-139,-21.96,1180
2020-04-17,450,580,-130,-22.41,1180
2020-04-18,216,309,-93,-30.1,1180
2020-04-19,145,245,-100,-40.82,1180
2020-04-20,504,616,-112,-18.18,1180
2020-04-21,494,632,-138,-21.84,1180
2020-04-22,494,633,-139,-21.96,1180
2020-04-23,494,632,-138,-21.84,1180
2020-04-24,450,579,-129,-22.28,1180
2020-04-25,216,308,-92,-29.87,1180
2020-04-26,145,243,-98,-40.33,1180
2020-04-27,504,615,-111,-18.05,1180
2020-04-28,494,632,-138,-21.84,1180
2020-04-29,494,632,-138,-21.84,1180
2020-04-30,494,632,-138,-21.84,1180
2020-05-01,533,580,-47,-8.1,1180
2020-05-02,245,310,-65,-20.97,1180
2020-05-03,169,246,-77,-31.3,1180
2020-05-04,541,619,-78,-12.6,1180
2020-05-05,560,636,-76,-11.95,1180
2020-05-06,560,637,-77,-12.09,1180
2020-05-07,560,638,-78,-12.23,1180
2020-05-08,533,586,-53,-9.04,1180
2020-05-09,245,316,-71,-22.47,1180
2020-05-10,169,252,-83,-32.94,1180
2020-05-11,541,625,-84,-13.44,1180
2020-05-12,560,642,-82,-12.77,1180
2020-05-13,560,643,-83,-12.91,1180
2020-05-14,560,643,-83,-12.91,1180
2020-05-15,533,591,-58,-9.81,1180
2020-05-16,245,321,-76,-23.68,1180
2020-05-17,169,256,-87,-33.98,1180
2020-05-18,541,628,-87,-13.85,1180
2020-05-19,560,644,-84,-13.04,1180
2020-05-20,560,645,-85,-13.18,1180
2020-05-21,560,644,-84,-13.04,1180
2020-05-22,533,591,-58,-9.81,1180
2020-05-23,245,320,-75,-23.44,1180
2020-05-24,169,255,-86,-33.73,1180
2020-05-25,541,627,-86,-13.72,1180
2020-05-26,560,643,-83,-12.91,1180
2020-05-27,560,643,-83,-12.91,1180
2020-05-28,560,643,-83,-12.91,1180
2020-05-29,533,590,-57,-9.66,1180
2020-05-30,245,320,-75,-23.44,1180
2020-05-31,169,256,-87,-33.98,1180
2020-06-01,572,629,-57,-9.06,1180
2020-06-02,593,646,-53,-8.2,1180
2020-06-03,593,648,-55,-8.49,1180
2020-06-04,593,649,-56,-8.63,1180
2020-06-05,515,597,-82,-13.74,1180
2020-06-06,260,328,-68,-20.73,1180
2020-06-07,174,266,-92,-34.59,1180
2020-06-08,572,639,-67,-10.49,1180
2020-06-09,593,657,-64,-9.74,1180
2020-06-10,593,659,-66,-10.02,1180
2020-06-11,593,661,-68,-10.29,1180
2020-06-12,515,609,-94,-15.44,1180
2020-06-13,260,339,-79,-23.3,1180
2020-06-14,174,276,-102,-36.96,1180
2020-06-15,572,648,-76,-11.73,1180
2020-06-16,593,664,-71,-10.69,1180
2020-06-17,593,664,-71,-10.69,1180
2020-06-18,593,663,-70,-10.56,1180
2020-06-19,515,609,-94,-15.44,1180
2020-06-20,260,336,-76,-22.62,1180
2020-06-21,174,269,-95,-35.32,1180
2020-06-22,572,638,-66,-10.34,1180
2020-06-23,593,651,-58,-8.91,1180
2020-06-24,593,647,-54,-8.35,1180
2020-06-25,593,642,-49,-7.63,1180
2020-06-26,515,585,-70,-11.97,1180
2020-06-27,260,309,-49,-15.86,1180
2020-06-28,174,239,-65,-27.2,1180
2020-06-29,572,605,-33,-5.45,1180
2020-06-30,593,615,-22,-3.58,1180
2020-07-01,567,610,-43,-7.05,1180
2020-07-02,567,604,-37,-6.13,1180
2020-07-03,513,545,-32,-5.87,1180
2020-07-04,221,269,-48,-17.84,1180
2020-07-05,168,198,-30,-15.15,1180
2020-07-06,566,565,1,0.18,1180
2020-07-07,567,577,-10,-1.73,1180
2020-07-08,567,573,-6,-1.05,1180
2020-07-09,567,569,-2,-0.35,1180
2020-07-10,513,513,0,0.0,1180
2020-07-11,221,239,-18,-7.53,1180
2020-07-12,168,172,-4,-2.33,1180
2020-07-13,566,543,23,4.24,1180
2020-07-14,567,558,9,1.61,1180
2020-07-15,567,558,9,1.61,1180
2020-07-16,567,557,10,1.8,1180
2020-07-17,513,504,9,1.79,1180
2020-07-18,221,234,-13,-5.56,1180
2020-07-19,168,170,-2,-1.18,1180
2020-07-20,566,543,23,4.24,1180
2020-07-21,567,561,6,1.07,1180
2020-07-22,567,562,5,0.89,1180
2020-07-23,567,563,4,0.71,1180
2020-07-24,513,511,2,0.39,1180
2020-07-25,221,242,-21,-8.68,1180
2020-07-26,168,178,-10,-5.62,1180
2020-07-27,566,551,15,2.72,1180
2020-07-28,567,567,0,0.0,1180
2020-07-29,567,568,-1,-0.18,1180
2020-07-30,567,567,0,0.0,1180
2020-07-31,513,513,0,0.0,1180
2020-08-01,236,242,-6,-2.48,1180
2020-08-02,173,176,-3,-1.7,1180
2020-08-03,505,547,-42,-7.68,1180
2020-08-04,522,561,-39,-6.95,1180
2020-08-05,522,560,-38,-6.79,1180
2020-08-06,522,557,-35,-6.28,1180
2020-08-07,455,502,-47,-9.36,1180
2020-08-08,236,229,7,3.06,1180
2020-08-09,173,162,11,6.79,1180
2020-08-10,505,532,-27,-5.08,1180
2020-08-11,522,547,-25,-4.57,1180
2020-08-12,522,545,-23,-4.22,1180
2020-08-13,522,544,-22,-4.04,1180
2020-08-14,455,490,-35,-7.14,1180
2020-08-15,236,218,18,8.26,1180
2020-08-16,173,153,20,13.07,1180
2020-08-17,505,526,-21,-3.99,1180
2020-08-18,522,543,-21,-3.87,1180
2020-08-19,522,545,-23,-4.22,1180
2020-08-20,522,546,-24,-4.4,1180
2020-08-21,455,495,-40,-8.08,1180
2020-08-22,236,227,9,3.96,1180
2020-08-23,173,166,7,4.22,1180
2020-08-24,505,541,-36,-6.65,1180
2020-08-25,522,561,-39,-6.95,1180
2020-08-26,522,566,-44,-7.77,1180
2020-08-27,522,570,-48,-8.42,1180
2020-08-28,455,521,-66,-12.67,1180
2020-08-29,236,255,-19,-7.45,1180
2020-08-30,173,195,-22,-11.28,1180
2020-08-31,505,572,-67,-11.71,1180
2020-09-01,570,592,-22,-3.72,1180
2020-09-02,570,597,-27,-4.52,1180
2020-09-03,570,600,-30,-5.0,1180
2020-09-04,539,551,-12,-2.18,1180
2020-09-05,233,284,-51,-17.96,1180
2020-09-06,182,222,-40,-18.02,1180
2020-09-07,574,597,-23,-3.85,1180
2020-09-08,570,615,-45,-7.32,1180
2020-09-09,570,617,-47,-7.62,1180
2020-09-10,570,618,-48,-7.77,1180
2020-09-11,539,567,-28,-4.94,1180
2020-09-12,233,297,-64,-21.55,1180
2020-09-13,182,232,-50,-21.55,1180
2020-09-14,574,605,-31,-5.12,1180
2020-09-15,570,621,-51,-8.21,1180
2020-09-16,570,621,-51,-8.21,1180
2020-09-17,570,620,-50,-8.06,1180
2020-09-18,539,566,-27,-4.77,1180
2020-09-19,233,295,-62,-21.02,1180
2020-09-20,182,229,-47,-20.52,1180
2020-09-21,574,600,-26,-4.33,1180
2020-09-22,570,616,-46,-7.47,1180
2020-09-23,570,616,-46,-7.47,1180
2020-09-24,570,614,-44,-7.17,1180
2020-09-25,539,561,-22,-3.92,1180
2020-09-26,233,290,-57,-19.66,1180
2020-09-27,182,225,-43,-19.11,1180
2020-09-28,574,596,-22,-3.69,1180
2020-09-29,570,612,-42,-6.86,1180
2020-09-30,570,612,-42,-6.86,1180
2020-10-01,576,612,-36,-5.88,1180
2020-10-02,548,559,-11,-1.97,1180
2020-10-03,248,288,-40,-13.89,1180
2020-10-04,174,223,-49,-21.97,1180
2020-10-05,578,595,-17,-2.86,1180
2020-10-06,576,611,-35,-5.73,1180
2020-10-07,576,611,-35,-5.73,1180
2020-10-08,576,611,-35,-5.73,1180
2020-10-09,548,558,-10,-1.79,1180
2020-10-10,248,287,-39,-13.59,1180
2020-10-11,174,222,-48,-21.62,1180
2020-10-12,578,593,-15,-2.53,1180
2020-10-13,576,609,-33,-5.42,1180
2020-10-14,576,609,-33,-5.42,1180
2020-10-15,576,608,-32,-5.26,1180
2020-10-16,548,555,-7,-1.26,1180
2020-10-17,248,284,-36,-12.68,1180
2020-10-18,174,219,-45,-20.55,1180
2020-10-19,578,591,-13,-2.2,1180
2020-10-20,576,607,-31,-5.11,1180
2020-10-21,576,608,-32,-5.26,1180
2020-10-22,576,608,-32,-5.26,1180
2020-10-23,548,555,-7,-1.26,1180
2020-10-24,248,286,-38,-13.29,1180
2020-10-25,174,222,-48,-21.62,1180
2020-10-26,578,596,-18,-3.02,1180
2020-10-27,576,614,-38,-6.19,1180
2020-10-28,576,617,-41,-6.65,1180
2020-10-29,576,619,-43,-6.95,1180
2020-10-30,548,569,-21,-3.69,1180
2020-10-31,248,301,-53,-17.61,1180
2020-11-01,169,240,-71,-29.58,1180
2020-11-02,579,615,-36,-5.85,1180
2020-11-03,574,635,-61,-9.61,1180
2020-11-04,574,639,-65,-10.17,1180
2020-11-05,574,642,-68,-10.59,1180
2020-11-06,519,592,-73,-12.33,1180
2020-11-07,240,325,-85,-26.15,1180
2020-11-08,169,263,-94,-35.74,1180
2020-11-09,579,638,-59,-9.25,1180
2020-11-10,574,657,-83,-12.63,1180
2020-11-11,574,659,-85,-12.9,1180
2020-11-12,574,660,-86,-13.03,1180
2020-11-13,519,608,-89,-14.64,1180
2020-11-14,240,339,-99,-29.2,1180
2020-11-15,169,274,-105,-38.32,1180
2020-11-16,579,645,-66,-10.23,1180
2020-11-17,574,661,-87,-13.16,1180
2020-11-18,574,660,-86,-13.03,1180
2020-11-19,574,657,-83,-12.63,1180
2020-11-20,519,602,-83,-13.79,1180
2020-11-21,240,328,-88,-26.83,1180
2020-11-22,169,260,-91,-35.0,1180
2020-11-23,579,628,-49,-7.8,1180
2020-11-24,574,640,-66,-10.31,1180
2020-11-25,574,637,-63,-9.89,1180
2020-11-26,574,632,-58,-9.18,1180
2020-11-27,519,574,-55,-9.58,1180
2020-11-28,240,299,-59,-19.73,1180
2020-11-29,169,230,-61,-26.52,1180
2020-11-30,579,598,-19,-3.18,1180
2020-12-01,474,610,-136,-22.3,1180
2020-12-02,474,607,-133,-21.91,1180
2020-12-03,474,603,-129,-21.39,1180
2020-12-04,529,546,-17,-3.11,1180
2020-12-05,225,273,-48,-17.58,1180
2020-12-06,160,206,-46,-22.33,1180
2020-12-07,469,575,-106,-18.43,1180
2020-12-08,474,590,-116,-19.66,1180
2020-12-09,474,588,-114,-19.39,1180
2020-12-10,474,587,-113,-19.25,1180
2020-12-11,529,533,-4,-0.75,1180
2020-12-12,225,261,-36,-13.79,1180
2020-12-13,160,196,-36,-18.37,1180
2020-12-14,469,568,-99,-17.43,1180
2020-12-15,474,584,-110,-18.84,1180
2020-12-16,474,584,-110,-18.84,1180
2020-12-17,474,583,-109,-18.7,1180
2020-12-18,529,529,0,0.0,1180
2020-12-19,225,258,-33,-12.79,1180
2020-12-20,160,193,-33,-17.1,1180
2020-12-21,469,564,-95,-16.84,1180
2020-12-22,474,579,-105,-18.13,1180
2020-12-23,474,578,-104,-17.99,1180
2020-12-24,474,575,-101,-17.57,1180
2020-12-25,529,520,9,1.73,1180
2020-12-26,225,247,-22,-8.91,1180
2020-12-27,160,180,-20,-11.11,1180
2020-12-28,469,549,-80,-14.57,1180
2020-12-29,474,562,-88,-15.66,1180
2020-12-30,474,560,-86,-15.36,1180
2020-12-31,474,556,-82,-14.75,1180
2021-01-01,441,499,-58,-11.62,1180
2021-01-02,221,225,-4,-1.78,1180
2021-01-03,168,157,11,7.01,1180
2021-01-04,453,526,-73,-13.88,1180
2021-01-05,487,539,-52,-9.65,1180
2021-01-06,487,536,-49,-9.14,1180
2021-01-07,487,533,-46,-8.63,1180
2021-01-08,441,477,-36,-7.55,1180
2021-01-09,221,205,16,7.8,1180
2021-01-10,168,138,30,21.74,1180
2021-01-11,453,509,-56,-11.0,1180
2021-01-12,487,524,-37,-7.06,1180
2021-01-13,487,524,-37,-7.06,1180
2021-01-14,487,523,-36,-6.88,1180
2021-01-15,441,470,-29,-6.17,1180
2021-01-16,221,200,21,10.5,1180
2021-01-17,168,136,32,23.53,1180
2021-01-18,453,509,-56,-11.0,1180
2021-01-19,487,527,-40,-7.59,1180
2021-01-20,487,529,-42,-7.94,1180
2021-01-21,487,530,-43,-8.11,1180
2021-01-22,441,479,-38,-7.93,1180
2021-01-23,221,210,11,5.24,1180
2021-01-24,168,148,20,13.51,1180
2021-01-25,453,522,-69,-13.22,1180
2021-01-26,487,540,-53,-9.81,1180
2021-01-27,487,542,-55,-10.15,1180
2021-01-28,487,543,-56,-10.31,1180
2021-01-29,441,492,-51,-10.37,1180
2021-01-30,221,223,-2,-0.9,1180
2021-01-31,168,159,9,5.66,1180
2021-02-01,516,532,-16,-3.01,1180
2021-02-02,544,549,-5,-0.91,1180
2021-02-03,544,550,-6,-1.09,1180
2021-02-04,544,550,-6,-1.09,1180
2021-02-05,495,497,-2,-0.4,1180
2021-02-06,221,227,-6,-2.64,1180
2021-02-07,170,163,7,4.29,1180
2021-02-08,516,535,-19,-3.55,1180
2021-02-09,544,551,-7,-1.27,1180
2021-02-10,544,552,-8,-1.45,1180
2021-02-11,544,552,-8,-1.45,1180
2021-02-12,495,500,-5,-1.0,1180
2021-02-13,221,230,-9,-3.91,1180
2021-02-14,170,166,4,2.41,1180
2021-02-15,516,539,-23,-4.27,1180
2021-02-16,544,556,-12,-2.16,1180
2021-02-17,544,558,-14,-2.51,1180
2021-02-18,544,559,-15,-2.68,1180
2021-02-19,495,508,-13,-2.56,1180
2021-02-20,221,240,-19,-7.92,1180
2021-02-21,170,178,-8,-4.49,1180
2021-02-22,516,552,-36,-6.52,1180
2021-02-23,544,571,-27,-4.73,1180
2021-02-24,544,574,-30,-5.23,1180
2021-02-25,544,577,-33,-5.72,1180
2021-02-26,495,527,-32,-6.07,1180
2021-02-27,221,259,-38,-14.67,1180
2021-02-28,170,197,-27,-13.71,1180
2021-03-01,555,572,-17,-2.97,1180
2021-03-02,577,591,-14,-2.37,1180
2021-03-03,577,594,-17,-2.86,1180
2021-03-04,577,596,-19,-3.19,1180
2021-03-05,542,545,-3,-0.55,1180
2021-03-06,245,277,-32,-11.55,1180
2021-03-07,176,214,-38,-17.76,1180
2021-03-08,555,587,-32,-5.45,1180
2021-03-09,577,605,-28,-4.63,1180
2021-03-10,577,607,-30,-4.94,1180
2021-03-11,577,607,-30,-4.94,1180
2021-03-12,542,555,-13,-2.34,1180
2021-03-13,245,285,-40,-14.04,1180
2021-03-14,176,221,-45,-20.36,1180
2021-03-15,555,593,-38,-6.41,1180
2021-03-16,577,610,-33,-5.41,1180
2021-03-17,577,610,-33,-5.41,1180
2021-03-18,577,610,-33,-5.41,1180
2021-03-19,542,558,-16,-2.87,1180
2021-03-20,245,288,-43,-14.93,1180
2021-03-21,176,223,-47,-21.08,1180
2021-03-22,555,596,-41,-6.88,1180
2021-03-23,577,613,-36,-5.87,1180
2021-03-24,577,615,-38,-6.18,1180
2021-03-25,577,616,-39,-6.33,1180
2021-03-26,542,564,-22,-3.9,1180
2021-03-27,245,295,-50,-16.95,1180
2021-03-28,176,232,-56,-24.14,1180
2021-03-29,555,606,-51,-8.42,1180
2021-03-30,577,624,-47,-7.53,1180
2021-03-31,577,627,-50,-7.97,1180
2021-04-01,585,629,-44,-7.0,1180
2021-04-02,517,578,-61,-10.55,1180
2021-04-03,249,310,-61,-19.68,1180
2021-04-04,174,248,-74,-29.84,1180
2021-04-05,568,622,-54,-8.68,1180
2021-04-06,585,641,-56,-8.74,1180
2021-04-07,585,643,-58,-9.02,1180
2021-04-08,585,645,-60,-9.3,1180
2021-04-09,517,594,-77,-12.96,1180
2021-04-10,249,325,-76,-23.38,1180
2021-04-11,174,262,-88,-33.59,1180
2021-04-12,568,635,-67,-10.55,1180
2021-04-13,585,652,-67,-10.28,1180
2021-04-14,585,654,-69,-10.55,1180
2021-04-15,585,654,-69,-10.55,1180
2021-04-16,517,601,-84,-13.98,1180
2021-04-17,249,331,-82,-24.77,1180
2021-04-18,174,266,-92,-34.59,1180
2021-04-19,568,638,-70,-10.97,1180
2021-04-20,585,654,-69,-10.55,1180
2021-04-21,585,655,-70,-10.69,1180
2021-04-22,585,654,-69,-10.55,1180
2021-04-23,517,601,-84,-13.98,1180
2021-04-24,249,330,-81,-24.55,1180
2021-04-25,174,265,-91,-34.34,1180
2021-04-26,568,637,-69,-10.83,1180
2021-04-27,585,653,-68,-10.41,1180
2021-04-28,585,654,-69,-10.55,1180
2021-04-29,585,654,-69,-10.55,1180
2021-04-30,517,601,-84,-13.98,1180
2021-05-01,261,331,-70,-21.15,1180
2021-05-02,172,267,-95,-35.58,1180
2021-05-03,582,640,-58,-9.06,1180
2021-05-04,602,657,-55,-8.37,1180
2021-05-05,602,658,-56,-8.51,1180
2021-05-06,602,658,-56,-8.51,1180
2021-05-07,558,606,-48,-7.92,1180
2021-05-08,261,337,-76,-22.55,1180
2021-05-09,172,273,-101,-37.0,1180
2021-05-10,582,646,-64,-9.91,1180
2021-05-11,602,663,-61,-9.2,1180
2021-05-12,602,664,-62,-9.34,1180
2021-05-13,602,665,-63,-9.47,1180
2021-05-14,558,612,-54,-8.82,1180
2021-05-15,261,342,-81,-23.68,1180
2021-05-16,172,278,-106,-38.13,1180
2021-05-17,582,650,-68,-10.46,1180
2021-05-18,602,666,-64,-9.61,1180
2021-05-19,602,666,-64,-9.61,1180
2021-05-20,602,666,-64,-9.61,1180
2021-05-21,558,613,-55,-8.97,1180
2021-05-22,261,342,-81,-23.68,1180
2021-05-23,172,277,-105,-37.91,1180
2021-05-24,582,649,-67,-10.32,1180
2021-05-25,602,665,-63,-9.47,1180
2021-05-26,602,665,-63,-9.47,1180
2021-05-27,602,664,-62,-9.34,1180
2021-05-28,558,612,-54,-8.82,1180
2021-05-29,261,341,-80,-23.46,1180
2021-05-30,172,277,-105,-37.91,1180
2021-05-31,582,650,-68,-10.46,1180
2021-06-01,620,667,-47,-7.05,1180
2021-06-02,620,668,-48,-7.19,1180
2021-06-03,620,669,-49,-7.32,1180
2021-06-04,556,617,-61,-9.89,1180
2021-06-05,251,348,-97,-27.87,1180
2021-06-06,175,285,-110,-38.6,1180
2021-06-07,604,659,-55,-8.35,1180
2021-06-08,620,677,-57,-8.42,1180
2021-06-09,620,679,-59,-8.69,1180
2021-06-10,620,680,-60,-8.82,1180
2021-06-11,556,629,-73,-11.61,1180
2021-06-12,251,360,-109,-30.28,1180
2021-06-13,175,296,-121,-40.88,1180
2021-06-14,604,669,-65,-9.72,1180
2021-06-15,620,686,-66,-9.62,1180
2021-06-16,620,687,-67,-9.75,1180
2021-06-17,620,686,-66,-9.62,1180
2021-06-18,556,632,-76,-12.03,1180
2021-06-19,251,360,-109,-30.28,1180
2021-06-20,175,294,-119,-40.48,1180
2021-06-21,604,664,-60,-9.04,1180
2021-06-22,620,677,-57,-8.42,1180
2021-06-23,620,674,-54,-8.01,1180
2021-06-24,620,670,-50,-7.46,1180
2021-06-25,556,612,-56,-9.15,1180
2021-06-26,251,337,-86,-25.52,1180
2021-06-27,175,267,-92,-34.46,1180
2021-06-28,604,634,-30,-4.73,1180
2021-06-29,620,644,-24,-3.73,1180
2021-06-30,620,639,-19,-2.97,1180
2021-07-01,558,633,-75,-11.85,1180
2021-07-02,512,574,-62,-10.8,1180
2021-07-03,227,297,-70,-23.57,1180
2021-07-04,170,227,-57,-25.11,1180
2021-07-05,547,594,-47,-7.91,1180
2021-07-06,558,605,-47,-7.77,1180
2021-07-07,558,600,-42,-7.0,1180
2021-07-08,558,596,-38,-6.38,1180
2021-07-09,512,539,-27,-5.01,1180
2021-07-10,227,265,-38,-14.34,1180
2021-07-11,170,197,-27,-13.71,1180
2021-07-12,547,567,-20,-3.53,1180
2021-07-13,558,581,-23,-3.96,1180
2021-07-14,558,580,-22,-3.79,1180
2021-07-15,558,579,-21,-3.63,1180
2021-07-16,512,526,-14,-2.66,1180
2021-07-17,227,255,-28,-10.98,1180
2021-07-18,170,191,-21,-10.99,1180
2021-07-19,547,564,-17,-3.01,1180
2021-07-20,558,581,-23,-3.96,1180
2021-07-21,558,582,-24,-4.12,1180
2021-07-22,558,583,-25,-4.29,1180
2021-07-23,512,531,-19,-3.58,1180
2021-07-24,227,262,-35,-13.36,1180
2021-07-25,170,199,-29,-14.57,1180
2021-07-26,547,571,-24,-4.2,1180
2021-07-27,558,588,-30,-5.1,1180
2021-07-28,558,589,-31,-5.26,1180
2021-07-29,558,589,-31,-5.26,1180
2021-07-30,512,536,-24,-4.48,1180
2021-07-31,227,265,-38,-14.34,1180
2021-08-01,167,199,-32,-16.08,1180
2021-08-02,562,570,-8,-1.4,1180
2021-08-03,536,585,-49,-8.38,1180
2021-08-04,536,584,-48,-8.22,1180
2021-08-05,536,581,-45,-7.75,1180
2021-08-06,480,526,-46,-8.75,1180
2021-08-07,230,254,-24,-9.45,1180
2021-08-08,167,187,-20,-10.7,1180
2021-08-09,562,557,5,0.9,1180
2021-08-10,536,571,-35,-6.13,1180
2021-08-11,536,569,-33,-5.8,1180
2021-08-12,536,567,-31,-5.47,1180
2021-08-13,480,513,-33,-6.43,1180
2021-08-14,230,241,-11,-4.56,1180
2021-08-15,167,176,-9,-5.11,1180
2021-08-16,562,547,15,2.74,1180
2021-08-17,536,564,-28,-4.96,1180
2021-08-18,536,565,-29,-5.13,1180
2021-08-19,536,566,-30,-5.3,1180
2021-08-20,480,514,-34,-6.61,1180
2021-08-21,230,246,-16,-6.5,1180
2021-08-22,167,184,-17,-9.24,1180
2021-08-23,562,559,3,0.54,1180
2021-08-24,536,578,-42,-7.27,1180
2021-08-25,536,583,-47,-8.06,1180
2021-08-26,536,586,-50,-8.53,1180
2021-08-27,480,537,-57,-10.61,1180
2021-08-28,230,271,-41,-15.13,1180
2021-08-29,167,211,-44,-20.85,1180
2021-08-30,562,588,-26,-4.42,1180
2021-08-31,536,608,-72,-11.84,1180
2021-09-01,603,613,-10,-1.63,1180
2021-09-02,603,617,-14,-2.27,1180
2021-09-03,542,568,-26,-4.58,1180
2021-09-04,253,301,-48,-15.95,1180
2021-09-05,186,240,-54,-22.5,1180
2021-09-06,616,615,1,0.16,1180
2021-09-07,603,634,-31,-4.89,1180
2021-09-08,603,637,-34,-5.34,1180
2021-09-09,603,638,-35,-5.49,1180
2021-09-10,542,587,-45,-7.67,1180
2021-09-11,253,318,-65,-20.44,1180
2021-09-12,186,254,-68,-26.77,1180
2021-09-13,616,626,-10,-1.6,1180
2021-09-14,603,643,-40,-6.22,1180
2021-09-15,603,643,-40,-6.22,1180
2021-09-16,603,642,-39,-6.07,1180
2021-09-17,542,589,-47,-7.98,1180
2021-09-18,253,318,-65,-20.44,1180
2021-09-19,186,252,-66,-26.19,1180
2021-09-20,616,623,-7,-1.12,1180
2021-09-21,603,639,-36,-5.63,1180
2021-09-22,603,638,-35,-5.49,1180
2021-09-23,603,637,-34,-5.34,1180
2021-09-24,542,583,-41,-7.03,1180
2021-09-25,253,312,-59,-18.91,1180
2021-09-26,186,247,-61,-24.7,1180
2021-09-27,616,618,-2,-0.32,1180
2021-09-28,603,634,-31,-4.89,1180
2021-09-29,603,634,-31,-4.89,1180
2021-09-30,603,634,-31,-4.89,1180
2021-10-01,569,581,-12,-2.07,1180
2021-10-02,259,310,-51,-16.45,1180
2021-10-03,187,245,-58,-23.67,1180
2021-10-04,592,617,-25,-4.05,1180
2021-10-05,617,633,-16,-2.53,1180
2021-10-06,617,633,-16,-2.53,1180
2021-10-07,617,633,-16,-2.53,1180
2021-10-08,569,580,-11,-1.9,1180
2021-10-09,259,309,-50,-16.18,1180
2021-10-10,187,244,-57,-23.36,1180
2021-10-11,592,615,-23,-3.74,1180
2021-10-12,617,631,-14,-2.22,1180
2021-10-13,617,631,-14,-2.22,1180
2021-10-14,617,630,-13,-2.06,1180
2021-10-15,569,577,-8,-1.39,1180
2021-10-16,259,306,-47,-15.36,1180
2021-10-17,187,241,-54,-22.41,1180
2021-10-18,592,612,-20,-3.27,1180
2021-10-19,617,629,-12,-1.91,1180
2021-10-20,617,629,-12,-1.91,1180
2021-10-21,617,629,-12,-1.91,1180
2021-10-22,569,576,-7,-1.22,1180
2021-10-23,259,306,-47,-15.36,1180
2021-10-24,187,243,-56,-23.05,1180
2021-10-25,592,616,-24,-3.9,1180
2021-10-26,617,634,-17,-2.68,1180
2021-10-27,617,636,-19,-2.99,1180
2021-10-28,617,638,-21,-3.29,1180
2021-10-29,569,587,-18,-3.07,1180
2021-10-30,259,319,-60,-18.81,1180
2021-10-31,187,258,-71,-27.52,1180
2021-11-01,573,633,-60,-9.48,1180
2021-11-02,592,652,-60,-9.2,1180
2021-11-03,592,656,-64,-9.76,1180
2021-11-04,592,659,-67,-10.17,1180
2021-11-05,563,610,-47,-7.7,1180
2021-11-06,256,343,-87,-25.36,1180
2021-11-07,179,281,-102,-36.3,1180
2021-11-08,573,656,-83,-12.65,1180
2021-11-09,592,675,-83,-12.3,1180
2021-11-10,592,678,-86,-12.68,1180
2021-11-11,592,680,-88,-12.94,1180
2021-11-12,563,629,-66,-10.49,1180
2021-11-13,256,359,-103,-28.69,1180
2021-11-14,179,295,-116,-39.32,1180
2021-11-15,573,668,-95,-14.22,1180
2021-11-16,592,684,-92,-13.45,1180
2021-11-17,592,683,-91,-13.32,1180
2021-11-18,592,681,-89,-13.07,1180
2021-11-19,563,626,-63,-10.06,1180
2021-11-20,256,353,-97,-27.48,1180
2021-11-21,179,286,-107,-37.41,1180
2021-11-22,573,655,-82,-12.52,1180
2021-11-23,592,667,-75,-11.24,1180
2021-11-24,592,664,-72,-10.84,1180
2021-11-25,592,659,-67,-10.17,1180
2021-11-26,563,602,-39,-6.48,1180
2021-11-27,256,327,-71,-21.71,1180
2021-11-28,179,258,-79,-30.62,1180
2021-11-29,573,625,-52,-8.32,1180
2021-11-30,592,637,-45,-7.06,1180
2021-12-01,496,633,-137,-21.64,1180
2021-12-02,496,629,-133,-21.14,1180
2021-12-03,399,572,-173,-30.24,1180
2021-12-04,228,298,-70,-23.49,1180
2021-12-05,164,231,-67,-29.0,1180
2021-12-06,529,600,-71,-11.83,1180
2021-12-07,496,614,-118,-19.22,1180
2021-12-08,496,612,-116,-18.95,1180
2021-12-09,496,610,-114,-18.69,1180
2021-12-10,399,556,-157,-28.24,1180
2021-12-11,228,284,-56,-19.72,1180
2021-12-12,164,219,-55,-25.11,1180
2021-12-13,529,590,-61,-10.34,1180
2021-12-14,496,606,-110,-18.15,1180
2021-12-15,496,606,-110,-18.15,1180
2021-12-16,496,605,-109,-18.02,1180
2021-12-17,399,552,-153,-27.72,1180
2021-12-18,228,281,-53,-18.86,1180
2021-12-19,164,215,-51,-23.72,1180
2021-12-20,529,587,-58,-9.88,1180
2021-12-21,496,602,-106,-17.61,1180
2021-12-22,496,601,-105,-17.47,1180
2021-12-23,496,599,-103,-17.2,1180
2021-12-24,399,545,-146,-26.79,1180
2021-12-25,228,272,-44,-16.18,1180
2021-12-26,164,205,-41,-20.0,1180
2021-12-27,529,574,-45,-7.84,1180
2021-12-28,496,588,-92,-15.65,1180
2021-12-29,496,585,-89,-15.21,1180
2021-12-30,496,582,-86,-14.78,1180
2021-12-31,399,525,-126,-24.0,1180
2022-01-01,221,251,-30,-11.95,1180
2022-01-02,162,183,-21,-11.48,1180
2022-01-03,459,552,-93,-16.85,1180
2022-01-04,482,565,-83,-14.69,1180
2022-01-05,482,562,-80,-14.23,1180
2022-01-06,482,558,-76,-13.62,1180
2022-01-07,446,502,-56,-11.16,1180
2022-01-08,221,229,-8,-3.49,1180
2022-01-09,162,162,0,0.0,1180
2022-01-10,459,532,-73,-13.72,1180
2022-01-11,482,547,-65,-11.88,1180
2022-01-12,482,546,-64,-11.72,1180
2022-01-13,482,545,-63,-11.56,1180
2022-01-14,446,492,-46,-9.35,1180
2022-01-15,221,221,0,0.0,1180
2022-01-16,162,157,5,3.18,1180
2022-01-17,459,530,-71,-13.4,1180
2022-01-18,482,547,-65,-11.88,1180
2022-01-19,482,549,-67,-12.2,1180
2022-01-20,482,550,-68,-12.36,1180
2022-01-21,446,499,-53,-10.62,1180
2022-01-22,221,230,-9,-3.91,1180
2022-01-23,162,167,-5,-2.99,1180
2022-01-24,459,541,-82,-15.16,1180
2022-01-25,482,559,-77,-13.77,1180
2022-01-26,482,562,-80,-14.23,1180
2022-01-27,482,563,-81,-14.39,1180
2022-01-28,446,512,-66,-12.89,1180
2022-01-29,221,243,-22,-9.05,1180
2022-01-30,162,179,-17,-9.5,1180
2020-02-01,222,178,44,24.72,1181
2020-02-02,152,91,61,67.03,1181
2020-02-03,455,427,28,6.56,1181
2020-02-04,446,439,7,1.59,1181
2020-02-05,446,439,7,1.59,1181
2020-02-06,446,439,7,1.59,1181
2020-02-07,429,423,6,1.42,1181
2020-02-08,222,180,42,23.33,1181
2020-02-09,152,92,60,65.22,1181
2020-02-10,455,428,27,6.31,1181
2020-02-11,446,440,6,1.36,1181
2020-02-12,446,440,6,1.36,1181
2020-02-13,446,441,5,1.13,1181
2020-02-14,429,425,4,0.94,1181
2020-02-15,222,183,39,21.31,1181
2020-02-16,152,97,55,56.7,1181
2020-02-17,455,434,21,4.84,1181
2020-02-18,446,447,-1,-0.22,1181
2020-02-19,446,449,-3,-0.67,1181
2020-02-20,446,450,-4,-0.89,1181
2020-02-21,429,436,-7,-1.61,1181
2020-02-22,222,196,26,13.27,1181
2020-02-23,152,111,41,36.94,1181
2020-02-24,455,450,5,1.11,1181
2020-02-25,446,464,-18,-3.88,1181
2020-02-26,446,466,-20,-4.29,1181
2020-02-27,446,469,-23,-4.9,1181
2020-02-28,429,456,-27,-5.92,1181
2020-02-29,222,216,6,2.78,1181
2020-03-01,141,131,10,7.63,1181
2020-03-02,444,470,-26,-5.53,1181
2020-03-03,459,483,-24,-4.97,1181
2020-03-04,459,486,-27,-5.56,1181
2020-03-05,459,488,-29,-5.94,1181
2020-03-06,442,474,-32,-6.75,1181
2020-03-07,210,233,-23,-9.87,1181
2020-03-08,141,147,-6,-4.08,1181
2020-03-09,444,484,-40,-8.26,1181
2020-03-10,459,497,-38,-7.65,1181
2020-03-11,459,498,-39,-7.83,1181
2020-03-12,459,499,-40,-8.02,1181
2020-03-13,442,484,-42,-8.68,1181
2020-03-14,210,241,-31,-12.86,1181
2020-03-15,141,155,-14,-9.03,1181
2020-03-16,444,491,-47,-9.57,1181
2020-03-17,459,503,-44,-8.75,1181
2020-03-18,459,504,-45,-8.93,1181
2020-03-19,459,505,-46,-9.11,1181
2020-03-20,442,489,-47,-9.61,1181
2020-03-21,210,247,-37,-14.98,1181
2020-03-22,141,161,-20,-12.42,1181
2020-03-23,444,498,-54,-10.84,1181
2020-03-24,459,511,-52,-10.18,1181
2020-03-25,459,513,-54,-10.53,1181
2020-03-26,459,514,-55,-10.7,1181
2020-03-27,442,500,-58,-11.6,1181
2020-03-28,210,260,-50,-19.23,1181
2020-03-29,141,175,-34,-19.43,1181
2020-03-30,444,513,-69,-13.45,1181
2020-03-31,459,527,-68,-12.9,1181
2020-04-01,528,530,-2,-0.38,1181
2020-04-02,528,532,-4,-0.75,1181
2020-04-03,517,519,-2,-0.39,1181
2020-04-04,226,279,-53,-19.0,1181
2020-04-05,120,195,-75,-38.46,1181
2020-04-06,555,534,21,3.93,1181
2020-04-07,528,548,-20,-3.65,1181
2020-04-08,528,550,-22,-4.0,1181
2020-04-09,528,552,-24,-4.35,1181
2020-04-10,517,539,-22,-4.08,1181
2020-04-11,226,298,-72,-24.16,1181
2020-04-12,120,212,-92,-43.4,1181
2020-04-13,555,550,5,0.91,1181
2020-04-14,528,562,-34,-6.05,1181
2020-04-15,528,564,-36,-6.38,1181
2020-04-16,528,564,-36,-6.38,1181
2020-04-17,517,549,-32,-5.83,1181
2020-04-18,226,306,-80,-26.14,1181
2020-04-19,120,220,-100,-45.45,1181
2020-04-20,555,556,-1,-0.18,1181
2020-04-21,528,567,-39,-6.88,1181
2020-04-22,528,567,-39,-6.88,1181
2020-04-23,528,566,-38,-6.71,1181
2020-04-24,517,550,-33,-6.0,1181
2020-04-25,226,307,-81,-26.38,1181
2020-04-26,120,219,-99,-45.21,1181
2020-04-27,555,555,0,0.0,1181
2020-04-28,528,566,-38,-6.71,1181
2020-04-29,528,566,-38,-6.71,1181
2020-04-30,528,566,-38,-6.71,1181
2020-05-01,566,550,16,2.91,1181
2020-05-02,284,307,-23,-7.49,1181
2020-05-03,162,220,-58,-26.36,1181
2020-05-04,578,556,22,3.96,1181
2020-05-05,584,568,16,2.82,1181
2020-05-06,584,568,16,2.82,1181
2020-05-07,584,569,15,2.64,1181
2020-05-08,566,554,12,2.17,1181
2020-05-09,284,311,-27,-8.68,1181
2020-05-10,162,225,-63,-28.0,1181
2020-05-11,578,562,16,2.85,1181
2020-05-12,584,574,10,1.74,1181
2020-05-13,584,575,9,1.57,1181
2020-05-14,584,575,9,1.57,1181
2020-05-15,566,560,6,1.07,1181
2020-05-16,284,318,-34,-10.69,1181
2020-05-17,162,231,-69,-29.87,1181
2020-05-18,578,567,11,1.94,1181
2020-05-19,584,579,5,0.86,1181
2020-05-20,584,580,4,0.69,1181
2020-05-21,584,580,4,0.69,1181
2020-05-22,566,564,2,0.35,1181
2020-05-23,284,321,-37,-11.53,1181
2020-05-24,162,234,-72,-30.77,1181
2020-05-25,578,570,8,1.4,1181
2020-05-26,584,581,3,0.52,1181
2020-05-27,584,581,3,0.52,1181
2020-05-28,584,581,3,0.52,1181
2020-05-29,566,565,1,0.18,1181
2020-05-30,284,323,-39,-12.07,1181
2020-05-31,162,236,-74,-31.36,1181
2020-06-01,584,572,12,2.1,1181
2020-06-02,607,583,24,4.12,1181
2020-06-03,607,584,23,3.94,1181
2020-06-04,607,584,23,3.94,1181
2020-06-05,574,569,5,0.88,1181
2020-06-06,280,326,-46,-14.11,1181
2020-06-07,176,240,-64,-26.67,1181
2020-06-08,584,576,8,1.39,1181
2020-06-09,607,589,18,3.06,1181
2020-06-10,607,589,18,3.06,1181
2020-06-11,607,590,17,2.88,1181
2020-06-12,574,575,-1,-0.17,1181
2020-06-13,280,332,-52,-15.66,1181
2020-06-14,176,246,-70,-28.46,1181
2020-06-15,584,582,2,0.34,1181
2020-06-16,607,594,13,2.19,1181
2020-06-17,607,594,13,2.19,1181
2020-06-18,607,594,13,2.19,1181
2020-06-19,574,578,-4,-0.69,1181
2020-06-20,280,335,-55,-16.42,1181
2020-06-21,176,247,-71,-28.74,1181
2020-06-22,584,582,2,0.34,1181
2020-06-23,607,593,14,2.36,1181
2020-06-24,607,591,16,2.71,1181
2020-06-25,607,590,17,2.88,1181
2020-06-26,574,572,2,0.35,1181
2020-06-27,280,328,-48,-14.63,1181
2020-06-28,176,239,-63,-26.36,1181
2020-06-29,584,573,11,1.92,1181
2020-06-30,607,583,24,4.12,1181
2020-07-01,580,581,-1,-0.17,1181
2020-07-02,580,579,1,0.17,1181
2020-07-03,544,561,-17,-3.03,1181
2020-07-04,273,316,-43,-13.61,1181
2020-07-05,168,227,-59,-25.99,1181
2020-07-06,560,561,-1,-0.18,1181
2020-07-07,580,571,9,1.58,1181
2020-07-08,580,570,10,1.75,1181
2020-07-09,580,568,12,2.11,1181
2020-07-10,544,551,-7,-1.27,1181
2020-07-11,273,307,-34,-11.07,1181
2020-07-12,168,220,-52,-23.64,1181
2020-07-13,560,555,5,0.9,1181
2020-07-14,580,566,14,2.47,1181
2020-07-15,580,566,14,2.47,1181
2020-07-16,580,566,14,2.47,1181
2020-07-17,544,550,-6,-1.09,1181
2020-07-18,273,307,-34,-11.07,1181
2020-07-19,168,220,-52,-23.64,1181
2020-07-20,560,556,4,0.72,1181
2020-07-21,580,567,13,2.29,1181
2020-07-22,580,567,13,2.29,1181
2020-07-23,580,567,13,2.29,1181
2020-07-24,544,550,-6,-1.09,1181
2020-07-25,273,307,-34,-11.07,1181
2020-07-26,168,219,-51,-23.29,1181
2020-07-27,560,554,6,1.08,1181
2020-07-28,580,565,15,2.65,1181
2020-07-29,580,563,17,3.02,1181
2020-07-30,580,562,18,3.2,1181
2020-07-31,544,544,0,0.0,1181
2020-08-01,271,300,-29,-9.67,1181
2020-08-02,171,210,-39,-18.57,1181
2020-08-03,548,544,4,0.74,1181
2020-08-04,540,553,-13,-2.35,1181
2020-08-05,540,551,-11,-2.0,1181
2020-08-06,540,549,-9,-1.64,1181
2020-08-07,537,530,7,1.32,1181
2020-08-08,271,285,-14,-4.91,1181
2020-08-09,171,196,-25,-12.76,1181
2020-08-10,548,530,18,3.4,1181
2020-08-11,540,539,1,0.19,1181
2020-08-12,540,538,2,0.37,1181
2020-08-13,540,536,4,0.75,1181
2020-08-14,537,519,18,3.47,1181
2020-08-15,271,276,-5,-1.81,1181
2020-08-16,171,188,-17,-9.04,1181
2020-08-17,548,524,24,4.58,1181
2020-08-18,540,535,5,0.93,1181
2020-08-19,540,536,4,0.75,1181
2020-08-20,540,536,4,0.75,1181
2020-08-21,537,521,16,3.07,1181
2020-08-22,271,279,-8,-2.87,1181
2020-08-23,171,194,-23,-11.86,1181
2020-08-24,548,531,17,3.2,1181
2020-08-25,540,544,-4,-0.74,1181
2020-08-26,540,546,-6,-1.1,1181
2020-08-27,540,548,-8,-1.46,1181
2020-08-28,537,534,3,0.56,1181
2020-08-29,271,293,-22,-7.51,1181
2020-08-30,171,208,-37,-17.79,1181
2020-08-31,548,546,2,0.37,1181
2020-09-01,581,559,22,3.94,1181
2020-09-02,581,560,21,3.75,1181
2020-09-03,581,561,20,3.57,1181
2020-09-04,562,547,15,2.74,1181
2020-09-05,269,304,-35,-11.51,1181
2020-09-06,188,218,-30,-13.76,1181
2020-09-07,572,554,18,3.25,1181
2020-09-08,581,566,15,2.65,1181
2020-09-09,581,566,15,2.65,1181
2020-09-10,581,565,16,2.83,1181
2020-09-11,562,549,13,2.37,1181
2020-09-12,269,305,-36,-11.8,1181
2020-09-13,188,217,-29,-13.36,1181
2020-09-14,572,552,20,3.62,1181
2020-09-15,581,563,18,3.2,1181
2020-09-16,581,562,19,3.38,1181
2020-09-17,581,561,20,3.57,1181
2020-09-18,562,544,18,3.31,1181
2020-09-19,269,300,-31,-10.33,1181
2020-09-20,188,212,-24,-11.32,1181
2020-09-21,572,547,25,4.57,1181
2020-09-22,581,558,23,4.12,1181
2020-09-23,581,557,24,4.31,1181
2020-09-24,581,557,24,4.31,1181
2020-09-25,562,540,22,4.07,1181
2020-09-26,269,297,-28,-9.43,1181
2020-09-27,188,210,-22,-10.48,1181
2020-09-28,572,546,26,4.76,1181
2020-09-29,581,558,23,4.12,1181
2020-09-30,581,558,23,4.12,1181
2020-10-01,590,558,32,5.73,1181
2020-10-02,574,542,32,5.9,1181
2020-10-03,278,300,-22,-7.33,1181
2020-10-04,172,213,-41,-19.25,1181
2020-10-05,574,549,25,4.55,1181
2020-10-06,590,560,30,5.36,1181
2020-10-07,590,560,30,5.36,1181
2020-10-08,590,560,30,5.36,1181
2020-10-09,574,544,30,5.51,1181
2020-10-10,278,301,-23,-7.64,1181
2020-10-11,172,213,-41,-19.25,1181
2020-10-12,574,548,26,4.74,1181
2020-10-13,590,558,32,5.73,1181
2020-10-14,590,557,33,5.92,1181
2020-10-15,590,556,34,6.12,1181
2020-10-16,574,539,35,6.49,1181
2020-10-17,278,295,-17,-5.76,1181
2020-10-18,172,206,-34,-16.5,1181
2020-10-19,574,540,34,6.3,1181
2020-10-20,590,550,40,7.27,1181
2020-10-21,590,549,41,7.47,1181
2020-10-22,590,548,42,7.66,1181
2020-10-23,574,530,44,8.3,1181
2020-10-24,278,286,-8,-2.8,1181
2020-10-25,172,198,-26,-13.13,1181
2020-10-26,574,533,41,7.69,1181
2020-10-27,590,544,46,8.46,1181
2020-10-28,590,543,47,8.66,1181
2020-10-29,590,543,47,8.66,1181
2020-10-30,574,527,47,8.92,1181
2020-10-31,278,284,-6,-2.11,1181
2020-11-01,152,197,-45,-22.84,1181
2020-11-02,553,533,20,3.75,1181
2020-11-03,551,545,6,1.1,1181
2020-11-04,551,546,5,0.92,1181
2020-11-05,551,546,5,0.92,1181
2020-11-06,558,531,27,5.08,1181
2020-11-07,260,288,-28,-9.72,1181
2020-11-08,152,202,-50,-24.75,1181
2020-11-09,553,538,15,2.79,1181
2020-11-10,551,549,2,0.36,1181
2020-11-11,551,549,2,0.36,1181
2020-11-12,551,549,2,0.36,1181
2020-11-13,558,533,25,4.69,1181
2020-11-14,260,289,-29,-10.03,1181
2020-11-15,152,201,-49,-24.38,1181
2020-11-16,553,536,17,3.17,1181
2020-11-17,551,546,5,0.92,1181
2020-11-18,551,544,7,1.29,1181
2020-11-19,551,541,10,1.85,1181
2020-11-20,558,523,35,6.69,1181
2020-11-21,260,278,-18,-6.47,1181
2020-11-22,152,188,-36,-19.15,1181
2020-11-23,553,521,32,6.14,1181
2020-11-24,551,529,22,4.16,1181
2020-11-25,551,526,25,4.75,1181
2020-11-26,551,522,29,5.56,1181
2020-11-27,558,503,55,10.93,1181
2020-11-28,260,256,4,1.56,1181
2020-11-29,152,166,-14,-8.43,1181
2020-11-30,553,499,54,10.82,1181
2020-12-01,445,507,-62,-12.23,1181
2020-12-02,445,504,-59,-11.71,1181
2020-12-03,445,501,-56,-11.18,1181
2020-12-04,516,483,33,6.83,1181
2020-12-05,262,238,24,10.08,1181
2020-12-06,145,148,-3,-2.03,1181
2020-12-07,459,482,-23,-4.77,1181
2020-12-08,445,492,-47,-9.55,1181
2020-12-09,445,491,-46,-9.37,1181
2020-12-10,445,489,-44,-9.0,1181
2020-12-11,516,472,44,9.32,1181
2020-12-12,262,228,34,14.91,1181
2020-12-13,145,140,5,3.57,1181
2020-12-14,459,475,-16,-3.37,1181
2020-12-15,445,486,-41,-8.44,1181
2020-12-16,445,485,-40,-8.25,1181
2020-12-17,445,484,-39,-8.06,1181
2020-12-18,516,467,49,10.49,1181
2020-12-19,262,223,39,17.49,1181
2020-12-20,145,135,10,7.41,1181
2020-12-21,459,469,-10,-2.13,1181
2020-12-22,445,479,-34,-7.1,1181
2020-12-23,445,477,-32,-6.71,1181
2020-12-24,445,475,-30,-6.32,1181
2020-12-25,516,457,59,12.91,1181
2020-12-26,262,212,50,23.58,1181
2020-12-27,145,122,23,18.85,1181
2020-12-28,459,455,4,0.88,1181
2020-12-29,445,464,-19,-4.09,1181
2020-12-30,445,461,-16,-3.47,1181
2020-12-31,445,458,-13,-2.84,1181
2021-01-01,421,439,-18,-4.1,1181
2021-01-02,199,193,6,3.11,1181
2021-01-03,140,103,37,35.92,1181
2021-01-04,414,436,-22,-5.05,1181
2021-01-05,435,445,-10,-2.25,1181
2021-01-06,435,442,-7,-1.58,1181
2021-01-07,435,440,-5,-1.14,1181
2021-01-08,421,422,-1,-0.24,1181
2021-01-09,199,177,22,12.43,1181
2021-01-10,140,88,52,59.09,1181
2021-01-11,414,423,-9,-2.13,1181
2021-01-12,435,433,2,0.46,1181
2021-01-13,435,432,3,0.69,1181
2021-01-14,435,432,3,0.69,1181
2021-01-15,421,416,5,1.2,1181
2021-01-16,199,173,26,15.03,1181
2021-01-17,140,86,54,62.79,1181
2021-01-18,414,423,-9,-2.13,1181
2021-01-19,435,435,0,0.0,1181
2021-01-20,435,435,0,0.0,1181
2021-01-21,435,436,-1,-0.23,1181
2021-01-22,421,421,0,0.0,1181
2021-01-23,199,179,20,11.17,1181
2021-01-24,140,93,47,50.54,1181
2021-01-25,414,430,-16,-3.72,1181
2021-01-26,435,443,-8,-1.81,1181
2021-01-27,435,444,-9,-2.03,1181
2021-01-28,435,444,-9,-2.03,1181
2021-01-29,421,429,-8,-1.86,1181
2021-01-30,199,187,12,6.42,1181
2021-01-31,140,100,40,40.0,1181
2021-02-01,498,436,62,14.22,1181
2021-02-02,494,448,46,10.27,1181
2021-02-03,494,448,46,10.27,1181
2021-02-04,494,448,46,10.27,1181
2021-02-05,508,432,76,17.59,1181
2021-02-06,227,189,38,20.11,1181
2021-02-07,154,102,52,50.98,1181
2021-02-08,498,437,61,13.96,1181
2021-02-09,494,449,45,10.02,1181
2021-02-10,494,449,45,10.02,1181
2021-02-11,494,449,45,10.02,1181
2021-02-12,508,434,74,17.05,1181
2021-02-13,227,191,36,18.85,1181
2021-02-14,154,105,49,46.67,1181
2021-02-15,498,442,56,12.67,1181
2021-02-16,494,454,40,8.81,1181
2021-02-17,494,456,38,8.33,1181
2021-02-18,494,457,37,8.1,1181
2021-02-19,508,443,65,14.67,1181
2021-02-20,227,202,25,12.38,1181
2021-02-21,154,117,37,31.62,1181
2021-02-22,498,456,42,9.21,1181
2021-02-23,494,470,24,5.11,1181
2021-02-24,494,472,22,4.66,1181
2021-02-25,494,475,19,4.0,1181
2021-02-26,508,462,46,9.96,1181
2021-02-27,227,221,6,2.71,1181
2021-02-28,154,137,17,12.41,1181
2021-03-01,610,476,134,28.15,1181
2021-03-02,603,490,113,23.06,1181
2021-03-03,603,492,111,22.56,1181
2021-03-04,603,494,109,22.06,1181
2021-03-05,605,480,125,26.04,1181
2021-03-06,305,240,65,27.08,1181
2021-03-07,163,154,9,5.84,1181
2021-03-08,610,492,118,23.98,1181
2021-03-09,603,505,98,19.41,1181
2021-03-10,603,506,97,19.17,1181
2021-03-11,603,507,96,18.93,1181
2021-03-12,605,492,113,22.97,1181
2021-03-13,305,250,55,22.0,1181
2021-03-14,163,163,0,0.0,1181
2021-03-15,610,500,110,22.0,1181
2021-03-16,603,512,91,17.77,1181
2021-03-17,603,512,91,17.77,1181
2021-03-18,603,513,90,17.54,1181
2021-03-19,605,498,107,21.49,1181
2021-03-20,305,255,50,19.61,1181
2021-03-21,163,169,-6,-3.55,1181
2021-03-22,610,506,104,20.55,1181
2021-03-23,603,519,84,16.18,1181
2021-03-24,603,520,83,15.96,1181
2021-03-25,603,521,82,15.74,1181
2021-03-26,605,507,98,19.33,1181
2021-03-27,305,266,39,14.66,1181
2021-03-28,163,181,-18,-9.94,1181
2021-03-29,610,519,91,17.53,1181
2021-03-30,603,533,70,13.13,1181
2021-03-31,603,536,67,12.5,1181
2021-04-01,623,538,85,15.8,1181
2021-04-02,603,525,78,14.86,1181
2021-04-03,286,285,1,0.35,1181
2021-04-04,168,201,-33,-16.42,1181
2021-04-05,599,539,60,11.13,1181
2021-04-06,623,553,70,12.66,1181
2021-04-07,623,556,67,12.05,1181
2021-04-08,623,559,64,11.45,1181
2021-04-09,603,545,58,10.64,1181
2021-04-10,286,304,-18,-5.92,1181
2021-04-11,168,219,-51,-23.29,1181
2021-04-12,599,557,42,7.54,1181
2021-04-13,623,570,53,9.3,1181
2021-04-14,623,571,52,9.11,1181
2021-04-15,623,572,51,8.92,1181
2021-04-16,603,557,46,8.26,1181
2021-04-17,286,315,-29,-9.21,1181
2021-04-18,168,228,-60,-26.32,1181
2021-04-19,599,565,34,6.02,1181
2021-04-20,623,576,47,8.16,1181
2021-04-21,623,576,47,8.16,1181
2021-04-22,623,576,47,8.16,1181
2021-04-23,603,560,43,7.68,1181
2021-04-24,286,316,-30,-9.49,1181
2021-04-25,168,229,-61,-26.64,1181
2021-04-26,599,565,34,6.02,1181
2021-04-27,623,576,47,8.16,1181
2021-04-28,623,575,48,8.35,1181
2021-04-29,623,575,48,8.35,1181
2021-04-30,603,559,44,7.87,1181
2021-05-01,319,316,3,0.95,1181
2021-05-02,183,229,-46,-20.09,1181
2021-05-03,629,565,64,11.33,1181
2021-05-04,666,577,89,15.42,1181
2021-05-05,666,577,89,15.42,1181
2021-05-06,666,577,89,15.42,1181
2021-05-07,629,562,67,11.92,1181
2021-05-08,319,320,-1,-0.31,1181
2021-05-09,183,233,-50,-21.46,1181
2021-05-10,629,570,59,10.35,1181
2021-05-11,666,582,84,14.43,1181
2021-05-12,666,583,83,14.24,1181
2021-05-13,666,583,83,14.24,1181
2021-05-14,629,568,61,10.74,1181
2021-05-15,319,326,-7,-2.15,1181
2021-05-16,183,240,-57,-23.75,1181
2021-05-17,629,576,53,9.2,1181
2021-05-18,666,588,78,13.27,1181
2021-05-19,666,588,78,13.27,1181
2021-05-20,666,589,77,13.07,1181
2021-05-21,629,573,56,9.77,1181
2021-05-22,319,330,-11,-3.33,1181
2021-05-23,183,243,-60,-24.69,1181
2021-05-24,629,579,50,8.64,1181
2021-05-25,666,591,75,12.69,1181
2021-05-26,666,591,75,12.69,1181
2021-05-27,666,591,75,12.69,1181
2021-05-28,629,575,54,9.39,1181
2021-05-29,319,332,-13,-3.92,1181
2021-05-30,183,245,-62,-25.31,1181
2021-05-31,629,581,48,8.26,1181
2021-06-01,679,592,87,14.7,1181
2021-06-02,679,593,86,14.5,1181
2021-06-03,679,593,86,14.5,1181
2021-06-04,654,577,77,13.34,1181
2021-06-05,306,335,-29,-8.66,1181
2021-06-06,202,248,-46,-18.55,1181
2021-06-07,674,585,89,15.21,1181
2021-06-08,679,597,82,13.74,1181
2021-06-09,679,598,81,13.55,1181
2021-06-10,679,598,81,13.55,1181
2021-06-11,654,583,71,12.18,1181
2021-06-12,306,341,-35,-10.26,1181
2021-06-13,202,254,-52,-20.47,1181
2021-06-14,674,591,83,14.04,1181
2021-06-15,679,603,76,12.6,1181
2021-06-16,679,603,76,12.6,1181
2021-06-17,679,603,76,12.6,1181
2021-06-18,654,587,67,11.41,1181
2021-06-19,306,344,-38,-11.05,1181
2021-06-20,202,257,-55,-21.4,1181
2021-06-21,674,592,82,13.85,1181
2021-06-22,679,603,76,12.6,1181
2021-06-23,679,602,77,12.79,1181
2021-06-24,679,601,78,12.98,1181
2021-06-25,654,584,70,11.99,1181
2021-06-26,306,339,-33,-9.73,1181
2021-06-27,202,250,-48,-19.2,1181
2021-06-28,674,585,89,15.21,1181
2021-06-29,679,594,85,14.31,1181
2021-06-30,679,592,87,14.7,1181
2021-07-01,600,590,10,1.69,1181
2021-07-02,599,572,27,4.72,1181
2021-07-03,290,327,-37,-11.31,1181
2021-07-04,182,238,-56,-23.53,1181
2021-07-05,587,572,15,2.62,1181
2021-07-06,600,582,18,3.09,1181
2021-07-07,600,581,19,3.27,1181
2021-07-08,600,579,21,3.63,1181
2021-07-09,599,562,37,6.58,1181
2021-07-10,290,318,-28,-8.81,1181
2021-07-11,182,230,-48,-20.87,1181
2021-07-12,587,565,22,3.89,1181
2021-07-13,600,576,24,4.17,1181
2021-07-14,600,575,25,4.35,1181
2021-07-15,600,575,25,4.35,1181
2021-07-16,599,559,40,7.16,1181
2021-07-17,290,316,-26,-8.23,1181
2021-07-18,182,229,-47,-20.52,1181
2021-07-19,587,565,22,3.89,1181
2021-07-20,600,576,24,4.17,1181
2021-07-21,600,576,24,4.17,1181
2021-07-22,600,576,24,4.17,1181
2021-07-23,599,560,39,6.96,1181
2021-07-24,290,317,-27,-8.52,1181
2021-07-25,182,229,-47,-20.52,1181
2021-07-26,587,564,23,4.08,1181
2021-07-27,600,575,25,4.35,1181
2021-07-28,600,574,26,4.53,1181
2021-07-29,600,573,27,4.71,1181
2021-07-30,599,555,44,7.93,1181
2021-07-31,290,311,-21,-6.75,1181
2021-08-01,185,222,-37,-16.67,1181
2021-08-02,566,556,10,1.8,1181
2021-08-03,554,565,-11,-1.95,1181
2021-08-04,554,563,-9,-1.6,1181
2021-08-05,554,561,-7,-1.25,1181
2021-08-06,528,543,-15,-2.76,1181
2021-08-07,250,297,-47,-15.82,1181
2021-08-08,185,208,-23,-11.06,1181
2021-08-09,566,542,24,4.43,1181
2021-08-10,554,551,3,0.54,1181
2021-08-11,554,549,5,0.91,1181
2021-08-12,554,547,7,1.28,1181
2021-08-13,528,530,-2,-0.38,1181
2021-08-14,250,286,-36,-12.59,1181
2021-08-15,185,198,-13,-6.57,1181
2021-08-16,566,533,33,6.19,1181
2021-08-17,554,544,10,1.84,1181
2021-08-18,554,544,10,1.84,1181
2021-08-19,554,544,10,1.84,1181
2021-08-20,528,529,-1,-0.19,1181
2021-08-21,250,287,-37,-12.89,1181
2021-08-22,185,201,-16,-7.96,1181
2021-08-23,566,538,28,5.2,1181
2021-08-24,554,551,3,0.54,1181
2021-08-25,554,553,1,0.18,1181
2021-08-26,554,555,-1,-0.18,1181
2021-08-27,528,541,-13,-2.4,1181
2021-08-28,250,300,-50,-16.67,1181
2021-08-29,185,215,-30,-13.95,1181
2021-08-30,566,553,13,2.35,1181
2021-08-31,554,566,-12,-2.12,1181
2021-09-01,617,568,49,8.63,1181
2021-09-02,617,569,48,8.44,1181
2021-09-03,577,554,23,4.15,1181
2021-09-04,300,313,-13,-4.15,1181
2021-09-05,208,226,-18,-7.96,1181
2021-09-06,613,563,50,8.88,1181
2021-09-07,617,575,42,7.3,1181
2021-09-08,617,575,42,7.3,1181
2021-09-09,617,575,42,7.3,1181
2021-09-10,577,558,19,3.41,1181
2021-09-11,300,315,-15,-4.76,1181
2021-09-12,208,227,-19,-8.37,1181
2021-09-13,613,562,51,9.07,1181
2021-09-14,617,573,44,7.68,1181
2021-09-15,617,572,45,7.87,1181
2021-09-16,617,571,46,8.06,1181
2021-09-17,577,554,23,4.15,1181
2021-09-18,300,310,-10,-3.23,1181
2021-09-19,208,222,-14,-6.31,1181
2021-09-20,613,557,56,10.05,1181
2021-09-21,617,568,49,8.63,1181
2021-09-22,617,567,50,8.82,1181
2021-09-23,617,566,51,9.01,1181
2021-09-24,577,550,27,4.91,1181
2021-09-25,300,307,-7,-2.28,1181
2021-09-26,208,219,-11,-5.02,1181
2021-09-27,613,555,58,10.45,1181
2021-09-28,617,567,50,8.82,1181
2021-09-29,617,567,50,8.82,1181
2021-09-30,617,567,50,8.82,1181
2021-10-01,591,551,40,7.26,1181
2021-10-02,301,309,-8,-2.59,1181
2021-10-03,184,222,-38,-17.12,1181
2021-10-04,603,558,45,8.06,1181
2021-10-05,615,570,45,7.89,1181
2021-10-06,615,570,45,7.89,1181
2021-10-07,615,570,45,7.89,1181
2021-10-08,591,553,38,6.87,1181
2021-10-09,301,310,-9,-2.9,1181
2021-10-10,184,223,-39,-17.49,1181
2021-10-11,603,558,45,8.06,1181
2021-10-12,615,569,46,8.08,1181
2021-10-13,615,568,47,8.27,1181
2021-10-14,615,567,48,8.47,1181
2021-10-15,591,550,41,7.45,1181
2021-10-16,301,305,-4,-1.31,1181
2021-10-17,184,217,-33,-15.21,1181
2021-10-18,603,551,52,9.44,1181
2021-10-19,615,561,54,9.63,1181
2021-10-20,615,560,55,9.82,1181
2021-10-21,615,558,57,10.22,1181
2021-10-22,591,541,50,9.24,1181
2021-10-23,301,297,4,1.35,1181
2021-10-24,184,209,-25,-11.96,1181
2021-10-25,603,543,60,11.05,1181
2021-10-26,615,554,61,11.01,1181
2021-10-27,615,553,62,11.21,1181
2021-10-28,615,553,62,11.21,1181
2021-10-29,591,536,55,10.26,1181
2021-10-30,301,293,8,2.73,1181
2021-10-31,184,206,-22,-10.68,1181
2021-11-01,566,542,24,4.43,1181
2021-11-02,601,554,47,8.48,1181
2021-11-03,601,554,47,8.48,1181
2021-11-04,601,555,46,8.29,1181
2021-11-05,589,539,50,9.28,1181
2021-11-06,270,297,-27,-9.09,1181
2021-11-07,172,210,-38,-18.1,1181
2021-11-08,566,547,19,3.47,1181
2021-11-09,601,558,43,7.71,1181
2021-11-10,601,559,42,7.51,1181
2021-11-11,601,559,42,7.51,1181
2021-11-12,589,542,47,8.67,1181
2021-11-13,270,299,-29,-9.7,1181
2021-11-14,172,211,-39,-18.48,1181
2021-11-15,566,546,20,3.66,1181
2021-11-16,601,557,44,7.9,1181
2021-11-17,601,555,46,8.29,1181
2021-11-18,601,553,48,8.68,1181
2021-11-19,589,535,54,10.09,1181
2021-11-20,270,290,-20,-6.9,1181
2021-11-21,172,200,-28,-14.0,1181
2021-11-22,566,533,33,6.19,1181
2021-11-23,601,542,59,10.89,1181
2021-11-24,601,539,62,11.5,1181
2021-11-25,601,535,66,12.34,1181
2021-11-26,589,516,73,14.15,1181
2021-11-27,270,270,0,0.0,1181
2021-11-28,172,179,-7,-3.91,1181
2021-11-29,566,512,54,10.55,1181
2021-11-30,601,520,81,15.58,1181
2021-12-01,469,517,-48,-9.28,1181
2021-12-02,469,514,-45,-8.75,1181
2021-12-03,400,495,-95,-19.19,1181
2021-12-04,251,250,1,0.4,1181
2021-12-05,150,160,-10,-6.25,1181
2021-12-06,484,494,-10,-2.02,1181
2021-12-07,469,504,-35,-6.94,1181
2021-12-08,469,502,-33,-6.57,1181
2021-12-09,469,500,-31,-6.2,1181
2021-12-10,400,483,-83,-17.18,1181
2021-12-11,251,239,12,5.02,1181
2021-12-12,150,151,-1,-0.66,1181
2021-12-13,484,486,-2,-0.41,1181
2021-12-14,469,496,-27,-5.44,1181
2021-12-15,469,495,-26,-5.25,1181
2021-12-16,469,494,-25,-5.06,1181
2021-12-17,400,478,-78,-16.32,1181
2021-12-18,251,234,17,7.26,1181
2021-12-19,150,145,5,3.45,1181
2021-12-20,484,480,4,0.83,1181
2021-12-21,469,490,-21,-4.29,1181
2021-12-22,469,489,-20,-4.09,1181
2021-12-23,469,487,-18,-3.7,1181
2021-12-24,400,469,-69,-14.71,1181
2021-12-25,251,224,27,12.05,1181
2021-12-26,150,135,15,11.11,1181
2021-12-27,484,468,16,3.42,1181
2021-12-28,469,477,-8,-1.68,1181
2021-12-29,469,474,-5,-1.05,1181
2021-12-30,469,471,-2,-0.42,1181
2021-12-31,400,452,-52,-11.5,1181
2022-01-01,216,206,10,4.85,1181
2022-01-02,151,116,35,30.17,1181
2022-01-03,425,449,-24,-5.35,1181
2022-01-04,459,457,2,0.44,1181
2022-01-05,459,455,4,0.88,1181
2022-01-06,459,452,7,1.55,1181
2022-01-07,424,434,-10,-2.3,1181
2022-01-08,216,189,27,14.29,1181
2022-01-09,151,99,52,52.53,1181
2022-01-10,425,434,-9,-2.07,1181
2022-01-11,459,444,15,3.38,1181
2022-01-12,459,443,16,3.61,1181
2022-01-13,459,442,17,3.85,1181
2022-01-14,424,425,-1,-0.24,1181
2022-01-15,216,182,34,18.68,1181
2022-01-16,151,95,56,58.95,1181
2022-01-17,425,431,-6,-1.39,1181
2022-01-18,459,443,16,3.61,1181
2022-01-19,459,444,15,3.38,1181
2022-01-20,459,444,15,3.38,1181
2022-01-21,424,429,-5,-1.17,1181
2022-01-22,216,187,29,15.51,1181
2022-01-23,151,101,50,49.5,1181
2022-01-24,425,438,-13,-2.97,1181
2022-01-25,459,451,8,1.77,1181
2022-01-26,459,452,7,1.55,1181
2022-01-27,459,452,7,1.55,1181
2022-01-28,424,437,-13,-2.97,1181
2022-01-29,216,195,21,10.77,1181
2022-01-30,151,109,42,38.53,1181
2020-02-01,258,148,110,74.32,1187
2020-02-02,116,25,91,364.0,1187
2020-02-03,1010,989,21,2.12,1187
2020-02-04,1000,986,14,1.42,1187
2020-02-05,1000,990,10,1.01,1187
2020-02-06,1000,991,9,0.91,1187
2020-02-07,889,831,58,6.98,1187
2020-02-08,258,164,94,57.32,1187
2020-02-09,116,33,83,251.52,1187
2020-02-10,1010,1002,8,0.8,1187
2020-02-11,1000,999,1,0.1,1187
2020-02-12,1000,1001,-1,-0.1,1187
2020-02-13,1000,1001,-1,-0.1,1187
2020-02-14,889,841,48,5.71,1187
2020-02-15,258,174,84,48.28,1187
2020-02-16,116,6,110,1833.33,1187
2020-02-17,1010,1012,-2,-0.2,1187
2020-02-18,1000,1010,-10,-0.99,1187
2020-02-19,1000,1013,-13,-1.28,1187
2020-02-20,1000,1015,-15,-1.48,1187
2020-02-21,889,856,33,3.86,1187
2020-02-22,258,191,67,35.08,1187
2020-02-23,116,24,92,383.33,1187
2020-02-24,1010,1033,-23,-2.23,1187
2020-02-25,1000,1032,-32,-3.1,1187
2020-02-26,1000,1037,-37,-3.57,1187
2020-02-27,1000,1040,-40,-3.85,1187
2020-02-28,889,883,6,0.68,1187
2020-02-29,258,219,39,17.81,1187
2020-03-01,88,53,35,66.04,1187
2020-03-02,841,1062,-221,-20.81,1187
2020-03-03,818,1061,-243,-22.9,1187
2020-03-04,818,1066,-248,-23.26,1187
2020-03-05,818,1069,-251,-23.48,1187
2020-03-06,691,911,-220,-24.15,1187
2020-03-07,187,246,-59,-23.98,1187
2020-03-08,88,79,9,11.39,1187
2020-03-09,841,1087,-246,-22.63,1187
2020-03-10,818,1085,-267,-24.61,1187
2020-03-11,818,1088,-270,-24.82,1187
2020-03-12,818,1089,-271,-24.89,1187
2020-03-13,691,929,-238,-25.62,1187
2020-03-14,187,262,-75,-28.63,1187
2020-03-15,88,93,-5,-5.38,1187
2020-03-16,841,1099,-258,-23.48,1187
2020-03-17,818,1095,-277,-25.3,1187
2020-03-18,818,1097,-279,-25.43,1187
2020-03-19,818,1097,-279,-25.43,1187
2020-03-20,691,936,-245,-26.18,1187
2020-03-21,187,268,-81,-30.22,1187
2020-03-22,88,99,-11,-11.11,1187
2020-03-23,841,1105,-264,-23.89,1187
2020-03-24,818,1101,-283,-25.7,1187
2020-03-25,818,1103,-285,-25.84,1187
2020-03-26,818,1104,-286,-25.91,1187
2020-03-27,691,944,-253,-26.8,1187
2020-03-28,187,278,-91,-32.73,1187
2020-03-29,88,110,-22,-20.0,1187
2020-03-30,841,1117,-276,-24.71,1187
2020-03-31,818,1115,-297,-26.64,1187
2020-04-01,802,1118,-316,-28.26,1187
2020-04-02,802,1120,-318,-28.39,1187
2020-04-03,633,961,-328,-34.13,1187
2020-04-04,187,295,-108,-36.61,1187
2020-04-05,59,128,-69,-53.91,1187
2020-04-06,868,1136,-268,-23.59,1187
2020-04-07,802,1134,-332,-29.28,1187
2020-04-08,802,1138,-336,-29.53,1187
2020-04-09,802,1140,-338,-29.65,1187
2020-04-10,633,980,-347,-35.41,1187
2020-04-11,187,314,-127,-40.45,1187
2020-04-12,59,146,-87,-59.59,1187
2020-04-13,868,1153,-285,-24.72,1187
2020-04-14,802,1150,-348,-30.26,1187
2020-04-15,802,1152,-350,-30.38,1187
2020-04-16,802,1153,-351,-30.44,1187
2020-04-17,633,992,-359,-36.19,1187
2020-04-18,187,324,-137,-42.28,1187
2020-04-19,59,155,-96,-61.94,1187
2020-04-20,868,1160,-292,-25.17,1187
2020-04-21,802,1155,-353,-30.56,1187
2020-04-22,802,1156,-354,-30.62,1187
2020-04-23,802,1156,-354,-30.62,1187
2020-04-24,633,994,-361,-36.32,1187
2020-04-25,187,325,-138,-42.46,1187
2020-04-26,59,156,-97,-62.18,1187
2020-04-27,868,1160,-292,-25.17,1187
2020-04-28,802,1156,-354,-30.62,1187
2020-04-29,802,1157,-355,-30.68,1187
2020-04-30,802,1156,-354,-30.62,1187
2020-05-01,822,995,-173,-17.39,1187
2020-05-02,254,327,-73,-22.32,1187
2020-05-03,100,158,-58,-36.71,1187
2020-05-04,1058,1164,-106,-9.11,1187
2020-05-05,1003,1160,-157,-13.53,1187
2020-05-06,1003,1162,-159,-13.68,1187
2020-05-07,1003,1162,-159,-13.68,1187
2020-05-08,822,1001,-179,-17.88,1187
2020-05-09,254,334,-80,-23.95,1187
2020-05-10,100,166,-66,-39.76,1187
2020-05-11,1058,1172,-114,-9.73,1187
2020-05-12,1003,1168,-165,-14.13,1187
2020-05-13,1003,1170,-167,-14.27,1187
2020-05-14,1003,1171,-168,-14.35,1187
2020-05-15,822,1010,-188,-18.61,1187
2020-05-16,254,342,-88,-25.73,1187
2020-05-17,100,173,-73,-42.2,1187
2020-05-18,1058,1178,-120,-10.19,1187
2020-05-19,1003,1174,-171,-14.57,1187
2020-05-20,1003,1175,-172,-14.64,1187
2020-05-21,1003,1175,-172,-14.64,1187
2020-05-22,822,1013,-191,-18.85,1187
2020-05-23,254,345,-91,-26.38,1187
2020-05-24,100,175,-75,-42.86,1187
2020-05-25,1058,1180,-122,-10.34,1187
2020-05-26,1003,1175,-172,-14.64,1187
2020-05-27,1003,1176,-173,-14.71,1187
2020-05-28,1003,1175,-172,-14.64,1187
2020-05-29,822,1013,-191,-18.85,1187
2020-05-30,254,345,-91,-26.38,1187
2020-05-31,100,175,-75,-42.86,1187
2020-06-01,1072,1180,-108,-9.15,1187
2020-06-02,1047,1176,-129,-10.97,1187
2020-06-03,1047,1177,-130,-11.05,1187
2020-06-04,1047,1178,-131,-11.12,1187
2020-06-05,861,1017,-156,-15.34,1187
2020-06-06,280,349,-69,-19.77,1187
2020-06-07,110,180,-70,-38.89,1187
2020-06-08,1072,1186,-114,-9.61,1187
2020-06-09,1047,1183,-136,-11.5,1187
2020-06-10,1047,1185,-138,-11.65,1187
2020-06-11,1047,1185,-138,-11.65,1187
2020-06-12,861,1024,-163,-15.92,1187
2020-06-13,280,357,-77,-21.57,1187
2020-06-14,110,188,-78,-41.49,1187
2020-06-15,1072,1193,-121,-10.14,1187
2020-06-16,1047,1189,-142,-11.94,1187
2020-06-17,1047,1190,-143,-12.02,1187
2020-06-18,1047,1189,-142,-11.94,1187
2020-06-19,861,1026,-165,-16.08,1187
2020-06-20,280,357,-77,-21.57,1187
2020-06-21,110,186,-76,-40.86,1187
2020-06-22,1072,1189,-117,-9.84,1187
2020-06-23,1047,1183,-136,-11.5,1187
2020-06-24,1047,1181,-134,-11.35,1187
2020-06-25,1047,1178,-131,-11.12,1187
2020-06-26,861,1014,-153,-15.09,1187
2020-06-27,280,343,-63,-18.37,1187
2020-06-28,110,169,-59,-34.91,1187
2020-06-29,1072,1171,-99,-8.45,1187
2020-06-30,1047,1163,-116,-9.97,1187
2020-07-01,1059,1160,-101,-8.71,1187
2020-07-02,1059,1156,-97,-8.39,1187
2020-07-03,874,991,-117,-11.81,1187
2020-07-04,242,320,-78,-24.38,1187
2020-07-05,115,147,-32,-21.77,1187
2020-07-06,1048,1149,-101,-8.79,1187
2020-07-07,1059,1142,-83,-7.27,1187
2020-07-08,1059,1140,-81,-7.11,1187
2020-07-09,1059,1138,-79,-6.94,1187
2020-07-10,874,974,-100,-10.27,1187
2020-07-11,242,305,-63,-20.66,1187
2020-07-12,115,134,-19,-14.18,1187
2020-07-13,1048,1138,-90,-7.91,1187
2020-07-14,1059,1132,-73,-6.45,1187
2020-07-15,1059,1133,-74,-6.53,1187
2020-07-16,1059,1132,-73,-6.45,1187
2020-07-17,874,970,-96,-9.9,1187
2020-07-18,242,302,-60,-19.87,1187
2020-07-19,115,131,-16,-12.21,1187
2020-07-20,1048,1136,-88,-7.75,1187
2020-07-21,1059,1131,-72,-6.37,1187
2020-07-22,1059,1131,-72,-6.37,1187
2020-07-23,1059,1130,-71,-6.28,1187
2020-07-24,874,966,-92,-9.52,1187
2020-07-25,242,297,-55,-18.52,1187
2020-07-26,115,125,-10,-8.0,1187
2020-07-27,1048,1127,-79,-7.01,1187
2020-07-28,1059,1119,-60,-5.36,1187
2020-07-29,1059,1117,-58,-5.19,1187
2020-07-30,1059,1113,-54,-4.85,1187
2020-07-31,874,947,-73,-7.71,1187
2020-08-01,253,274,-21,-7.66,1187
2020-08-02,120,99,21,21.21,1187
2020-08-03,1001,1099,-98,-8.92,1187
2020-08-04,994,1089,-95,-8.72,1187
2020-08-05,994,1085,-91,-8.39,1187
2020-08-06,994,1079,-85,-7.88,1187
2020-08-07,820,912,-92,-10.09,1187
2020-08-08,253,239,14,5.86,1187
2020-08-09,120,65,55,84.62,1187
2020-08-10,1001,1065,-64,-6.01,1187
2020-08-11,994,1056,-62,-5.87,1187
2020-08-12,994,1054,-60,-5.69,1187
2020-08-13,994,1051,-57,-5.42,1187
2020-08-14,820,886,-66,-7.45,1187
2020-08-15,253,217,36,16.59,1187
2020-08-16,120,46,74,160.87,1187
2020-08-17,1001,1051,-50,-4.76,1187
2020-08-18,994,1047,-53,-5.06,1187
2020-08-19,994,1049,-55,-5.24,1187
2020-08-20,994,1050,-56,-5.33,1187
2020-08-21,820,891,-71,-7.97,1187
2020-08-22,253,226,27,11.95,1187
2020-08-23,120,60,60,100.0,1187
2020-08-24,1001,1069,-68,-6.36,1187
2020-08-25,994,1069,-75,-7.02,1187
2020-08-26,994,1074,-80,-7.45,1187
2020-08-27,994,1079,-85,-7.88,1187
2020-08-28,820,922,-102,-11.06,1187
2020-08-29,253,258,-5,-1.94,1187
2020-08-30,120,93,27,29.03,1187
2020-08-31,1001,1103,-102,-9.25,1187
2020-09-01,1012,1103,-91,-8.25,1187
2020-09-02,1012,1108,-96,-8.66,1187
2020-09-03,1012,1111,-99,-8.91,1187
2020-09-04,870,952,-82,-8.61,1187
2020-09-05,266,287,-21,-7.32,1187
2020-09-06,112,119,-7,-5.88,1187
2020-09-07,1038,1126,-88,-7.82,1187
2020-09-08,1012,1122,-110,-9.8,1187
2020-09-09,1012,1124,-112,-9.96,1187
2020-09-10,1012,1124,-112,-9.96,1187
2020-09-11,870,962,-92,-9.56,1187
2020-09-12,266,294,-28,-9.52,1187
2020-09-13,112,123,-11,-8.94,1187
2020-09-14,1038,1127,-89,-7.9,1187
2020-09-15,1012,1122,-110,-9.8,1187
2020-09-16,1012,1122,-110,-9.8,1187
2020-09-17,1012,1120,-108,-9.64,1187
2020-09-18,870,957,-87,-9.09,1187
2020-09-19,266,288,-22,-7.64,1187
2020-09-20,112,118,-6,-5.08,1187
2020-09-21,1038,1123,-85,-7.57,1187
2020-09-22,1012,1118,-106,-9.48,1187
2020-09-23,1012,1119,-107,-9.56,1187
2020-09-24,1012,1119,-107,-9.56,1187
2020-09-25,870,958,-88,-9.19,1187
2020-09-26,266,291,-25,-8.59,1187
2020-09-27,112,123,-11,-8.94,1187
2020-09-28,1038,1130,-92,-8.14,1187
2020-09-29,1012,1127,-115,-10.2,1187
2020-09-30,1012,1130,-118,-10.44,1187
2020-10-01,1002,1132,-130,-11.48,1187
2020-10-02,907,973,-66,-6.78,1187
2020-10-03,251,307,-56,-18.24,1187
2020-10-04,107,140,-33,-23.57,1187
2020-10-05,1067,1147,-80,-6.97,1187
2020-10-06,1002,1144,-142,-12.41,1187
2020-10-07,1002,1147,-145,-12.64,1187
2020-10-08,1002,1148,-146,-12.72,1187
2020-10-09,907,987,-80,-8.11,1187
2020-10-10,251,320,-69,-21.56,1187
2020-10-11,107,151,-44,-29.14,1187
2020-10-12,1067,1156,-89,-7.7,1187
2020-10-13,1002,1151,-149,-12.95,1187
2020-10-14,1002,1151,-149,-12.95,1187
2020-10-15,1002,1149,-147,-12.79,1187
2020-10-16,907,986,-79,-8.01,1187
2020-10-17,251,316,-65,-20.57,1187
2020-10-18,107,144,-37,-25.69,1187
2020-10-19,1067,1147,-80,-6.97,1187
2020-10-20,1002,1140,-138,-12.11,1187
2020-10-21,1002,1138,-136,-11.95,1187
2020-10-22,1002,1135,-133,-11.72,1187
2020-10-23,907,971,-64,-6.59,1187
2020-10-24,251,301,-50,-16.61,1187
2020-10-25,107,129,-22,-17.05,1187
2020-10-26,1067,1132,-65,-5.74,1187
2020-10-27,1002,1126,-124,-11.01,1187
2020-10-28,1002,1126,-124,-11.01,1187
2020-10-29,1002,1125,-123,-10.93,1187
2020-10-30,907,962,-55,-5.72,1187
2020-10-31,251,294,-43,-14.63,1187
2020-11-01,93,125,-32,-25.6,1187
2020-11-02,1063,1130,-67,-5.93,1187
2020-11-03,994,1126,-132,-11.72,1187
2020-11-04,994,1128,-134,-11.88,1187
2020-11-05,994,1129,-135,-11.96,1187
2020-11-06,881,969,-88,-9.08,1187
2020-11-07,250,302,-52,-17.22,1187
2020-11-08,93,134,-41,-30.6,1187
2020-11-09,1063,1140,-77,-6.75,1187
2020-11-10,994,1136,-142,-12.5,1187
2020-11-11,994,1138,-144,-12.65,1187
2020-11-12,994,1137,-143,-12.58,1187
2020-11-13,881,975,-94,-9.64,1187
2020-11-14,250,307,-57,-18.57,1187
2020-11-15,93,136,-43,-31.62,1187
2020-11-16,1063,1139,-76,-6.67,1187
2020-11-17,994,1132,-138,-12.19,1187
2020-11-18,994,1130,-136,-12.04,1187
2020-11-19,994,1126,-132,-11.72,1187
2020-11-20,881,959,-78,-8.13,1187
2020-11-21,250,287,-37,-12.89,1187
2020-11-22,93,111,-18,-16.22,1187
2020-11-23,1063,1111,-48,-4.32,1187
2020-11-24,994,1100,-106,-9.64,1187
2020-11-25,994,1094,-100,-9.14,1187
2020-11-26,994,1087,-93,-8.56,1187
2020-11-27,881,918,-37,-4.03,1187
2020-11-28,250,243,7,2.88,1187
2020-11-29,93,66,27,40.91,1187
2020-11-30,1063,1064,-1,-0.09,1187
2020-12-01,764,1053,-289,-27.45,1187
2020-12-02,764,1047,-283,-27.03,1187
2020-12-03,764,1040,-276,-26.54,1187
2020-12-04,837,873,-36,-4.12,1187
2020-12-05,241,199,42,21.11,1187
2020-12-06,89,25,64,256.0,1187
2020-12-07,796,1025,-229,-22.34,1187
2020-12-08,764,1017,-253,-24.88,1187
2020-12-09,764,1014,-250,-24.65,1187
2020-12-10,764,1011,-247,-24.43,1187
2020-12-11,837,846,-9,-1.06,1187
2020-12-12,241,176,65,36.93,1187
2020-12-13,89,4,85,2125.0,1187
2020-12-14,796,1008,-212,-21.03,1187
2020-12-15,764,1002,-238,-23.75,1187
2020-12-16,764,1001,-237,-23.68,1187
2020-12-17,764,1000,-236,-23.6,1187
2020-12-18,837,837,0,0.0,1187
2020-12-19,241,167,74,44.31,1187
2020-12-20,89,31,58,187.1,1187
2020-12-21,796,999,-203,-20.32,1187
2020-12-22,764,992,-228,-22.98,1187
2020-12-23,764,990,-226,-22.83,1187
2020-12-24,764,987,-223,-22.59,1187
2020-12-25,837,822,15,1.82,1187
2020-12-26,241,150,91,60.67,1187
2020-12-27,89,23,66,286.96,1187
2020-12-28,796,977,-181,-18.53,1187
2020-12-29,764,968,-204,-21.07,1187
2020-12-30,764,963,-199,-20.66,1187
2020-12-31,764,958,-194,-20.25,1187
2021-01-01,646,790,-144,-18.23,1187
2021-01-02,182,116,66,56.9,1187
2021-01-03,79,6,73,1216.67,1187
2021-01-04,786,940,-154,-16.38,1187
2021-01-05,787,930,-143,-15.38,1187
2021-01-06,787,926,-139,-15.01,1187
2021-01-07,787,920,-133,-14.46,1187
2021-01-08,646,754,-108,-14.32,1187
2021-01-09,182,82,100,121.95,1187
2021-01-10,79,82,-3,-3.66,1187
2021-01-11,786,910,-124,-13.63,1187
2021-01-12,787,903,-116,-12.85,1187
2021-01-13,787,902,-115,-12.75,1187
2021-01-14,787,900,-113,-12.56,1187
2021-01-15,646,738,-92,-12.47,1187
2021-01-16,182,70,112,160.0,1187
2021-01-17,79,70,9,12.86,1187
2021-01-18,786,907,-121,-13.34,1187
2021-01-19,787,905,-118,-13.04,1187
2021-01-20,787,908,-121,-13.33,1187
2021-01-21,787,910,-123,-13.52,1187
2021-01-22,646,751,-105,-13.98,1187
2021-01-23,182,87,95,109.2,1187
2021-01-24,79,87,-8,-9.2,1187
2021-01-25,786,929,-143,-15.39,1187
2021-01-26,787,929,-142,-15.29,1187
2021-01-27,787,933,-146,-15.65,1187
2021-01-28,787,937,-150,-16.01,1187
2021-01-29,646,778,-132,-16.97,1187
2021-01-30,182,114,68,59.65,1187
2021-01-31,79,9,70,777.78,1187
2021-02-01,974,955,19,1.99,1187
2021-02-02,927,953,-26,-2.73,1187
2021-02-03,927,957,-30,-3.13,1187
2021-02-04,927,959,-32,-3.34,1187
2021-02-05,797,799,-2,-0.25,1187
2021-02-06,215,133,82,61.65,1187
2021-02-07,92,17,75,441.18,1187
2021-02-08,974,971,3,0.31,1187
2021-02-09,927,967,-40,-4.14,1187
2021-02-10,927,969,-42,-4.33,1187
2021-02-11,927,970,-43,-4.43,1187
2021-02-12,797,809,-12,-1.48,1187
2021-02-13,215,142,73,51.41,1187
2021-02-14,92,22,70,318.18,1187
2021-02-15,974,980,-6,-0.61,1187
2021-02-16,927,977,-50,-5.12,1187
2021-02-17,927,980,-53,-5.41,1187
2021-02-18,927,982,-55,-5.6,1187
2021-02-19,797,823,-26,-3.16,1187
2021-02-20,215,157,58,36.94,1187
2021-02-21,92,33,59,178.79,1187
2021-02-22,974,999,-25,-2.5,1187
2021-02-23,927,997,-70,-7.02,1187
2021-02-24,927,1002,-75,-7.49,1187
2021-02-25,927,1005,-78,-7.76,1187
2021-02-26,797,848,-51,-6.01,1187
2021-02-27,215,184,31,16.85,1187
2021-02-28,92,18,74,411.11,1187
2021-03-01,1004,1027,-23,-2.24,1187
2021-03-02,999,1026,-27,-2.63,1187
2021-03-03,999,1031,-32,-3.1,1187
2021-03-04,999,1035,-36,-3.48,1187
2021-03-05,817,877,-60,-6.84,1187
2021-03-06,242,212,30,14.15,1187
2021-03-07,94,46,48,104.35,1187
2021-03-08,1004,1054,-50,-4.74,1187
2021-03-09,999,1052,-53,-5.04,1187
2021-03-10,999,1055,-56,-5.31,1187
2021-03-11,999,1057,-58,-5.49,1187
2021-03-12,817,897,-80,-8.92,1187
2021-03-13,242,230,12,5.22,1187
2021-03-14,94,62,32,51.61,1187
2021-03-15,1004,1068,-64,-5.99,1187
2021-03-16,999,1064,-65,-6.11,1187
2021-03-17,999,1066,-67,-6.29,1187
2021-03-18,999,1066,-67,-6.29,1187
2021-03-19,817,905,-88,-9.72,1187
2021-03-20,242,238,4,1.68,1187
2021-03-21,94,69,25,36.23,1187
2021-03-22,1004,1074,-70,-6.52,1187
2021-03-23,999,1070,-71,-6.64,1187
2021-03-24,999,1072,-73,-6.81,1187
2021-03-25,999,1073,-74,-6.9,1187
2021-03-26,817,912,-95,-10.42,1187
2021-03-27,242,246,-4,-1.63,1187
2021-03-28,94,78,16,20.51,1187
2021-03-29,1004,1084,-80,-7.38,1187
2021-03-30,999,1082,-83,-7.67,1187
2021-03-31,999,1085,-86,-7.93,1187
2021-04-01,997,1087,-90,-8.28,1187
2021-04-02,820,928,-108,-11.64,1187
2021-04-03,231,262,-31,-11.83,1187
2021-04-04,78,95,-17,-17.89,1187
2021-04-05,1001,1103,-102,-9.25,1187
2021-04-06,997,1101,-104,-9.45,1187
2021-04-07,997,1104,-107,-9.69,1187
2021-04-08,997,1107,-110,-9.94,1187
2021-04-09,820,947,-127,-13.41,1187
2021-04-10,231,282,-51,-18.09,1187
2021-04-11,78,114,-36,-31.58,1187
2021-04-12,1001,1121,-120,-10.7,1187
2021-04-13,997,1118,-121,-10.82,1187
2021-04-14,997,1121,-124,-11.06,1187
2021-04-15,997,1121,-124,-11.06,1187
2021-04-16,820,961,-141,-14.67,1187
2021-04-17,231,294,-63,-21.43,1187
2021-04-18,78,124,-46,-37.1,1187
2021-04-19,1001,1130,-129,-11.42,1187
2021-04-20,997,1125,-128,-11.38,1187
2021-04-21,997,1126,-129,-11.46,1187
2021-04-22,997,1126,-129,-11.46,1187
2021-04-23,820,964,-144,-14.94,1187
2021-04-24,231,296,-65,-21.96,1187
2021-04-25,78,126,-48,-38.1,1187
2021-04-26,1001,1131,-130,-11.49,1187
2021-04-27,997,1126,-129,-11.46,1187
2021-04-28,997,1127,-130,-11.54,1187
2021-04-29,997,1126,-129,-11.46,1187
2021-04-30,820,965,-145,-15.03,1187
2021-05-01,261,297,-36,-12.12,1187
2021-05-02,86,127,-41,-32.28,1187
2021-05-03,1026,1133,-107,-9.44,1187
2021-05-04,1024,1129,-105,-9.3,1187
2021-05-05,1024,1131,-107,-9.46,1187
2021-05-06,1024,1131,-107,-9.46,1187
2021-05-07,860,970,-110,-11.34,1187
2021-05-08,261,303,-42,-13.86,1187
2021-05-09,86,134,-48,-35.82,1187
2021-05-10,1026,1140,-114,-10.0,1187
2021-05-11,1024,1137,-113,-9.94,1187
2021-05-12,1024,1139,-115,-10.1,1187
2021-05-13,1024,1139,-115,-10.1,1187
2021-05-14,860,979,-119,-12.16,1187
2021-05-15,261,311,-50,-16.08,1187
2021-05-16,86,142,-56,-39.44,1187
2021-05-17,1026,1148,-122,-10.63,1187
2021-05-18,1024,1144,-120,-10.49,1187
2021-05-19,1024,1145,-121,-10.57,1187
2021-05-20,1024,1145,-121,-10.57,1187
2021-05-21,860,983,-123,-12.51,1187
2021-05-22,261,315,-54,-17.14,1187
2021-05-23,86,145,-59,-40.69,1187
2021-05-24,1026,1150,-124,-10.78,1187
2021-05-25,1024,1145,-121,-10.57,1187
2021-05-26,1024,1146,-122,-10.65,1187
2021-05-27,1024,1145,-121,-10.57,1187
2021-05-28,860,983,-123,-12.51,1187
2021-05-29,261,315,-54,-17.14,1187
2021-05-30,86,145,-59,-40.69,1187
2021-05-31,1026,1150,-124,-10.78,1187
2021-06-01,1056,1146,-90,-7.85,1187
2021-06-02,1056,1147,-91,-7.93,1187
2021-06-03,1056,1147,-91,-7.93,1187
2021-06-04,860,986,-126,-12.78,1187
2021-06-05,245,318,-73,-22.96,1187
2021-06-06,111,149,-38,-25.5,1187
2021-06-07,1032,1155,-123,-10.65,1187
2021-06-08,1056,1151,-95,-8.25,1187
2021-06-09,1056,1153,-97,-8.41,1187
2021-06-10,1056,1154,-98,-8.49,1187
2021-06-11,860,993,-133,-13.39,1187
2021-06-12,245,326,-81,-24.85,1187
2021-06-13,111,157,-46,-29.3,1187
2021-06-14,1032,1163,-131,-11.26,1187
2021-06-15,1056,1159,-103,-8.89,1187
2021-06-16,1056,1160,-104,-8.97,1187
2021-06-17,1056,1159,-103,-8.89,1187
2021-06-18,860,997,-137,-13.74,1187
2021-06-19,245,329,-84,-25.53,1187
2021-06-20,111,158,-47,-29.75,1187
2021-06-21,1032,1162,-130,-11.19,1187
2021-06-22,1056,1155,-99,-8.57,1187
2021-06-23,1056,1154,-98,-8.49,1187
2021-06-24,1056,1152,-96,-8.33,1187
2021-06-25,860,987,-127,-12.87,1187
2021-06-26,245,316,-71,-22.47,1187
2021-06-27,111,144,-33,-22.92,1187
2021-06-28,1032,1145,-113,-9.87,1187
2021-06-29,1056,1137,-81,-7.12,1187
2021-06-30,1056,1135,-79,-6.96,1187
2021-07-01,983,1131,-148,-13.09,1187
2021-07-02,854,966,-112,-11.59,1187
2021-07-03,251,294,-43,-14.63,1187
2021-07-04,106,121,-15,-12.4,1187
2021-07-05,950,1123,-173,-15.41,1187
2021-07-06,983,1115,-132,-11.84,1187
2021-07-07,983,1113,-130,-11.68,1187
2021-07-08,983,1110,-127,-11.44,1187
2021-07-09,854,947,-93,-9.82,1187
2021-07-10,251,277,-26,-9.39,1187
2021-07-11,106,105,1,0.95,1187
2021-07-12,950,1109,-159,-14.34,1187
2021-07-13,983,1103,-120,-10.88,1187
2021-07-14,983,1103,-120,-10.88,1187
2021-07-15,983,1103,-120,-10.88,1187
2021-07-16,854,940,-86,-9.15,1187
2021-07-17,251,272,-21,-7.72,1187
2021-07-18,106,102,4,3.92,1187
2021-07-19,950,1107,-157,-14.18,1187
2021-07-20,983,1102,-119,-10.8,1187
2021-07-21,983,1102,-119,-10.8,1187
2021-07-22,983,1101,-118,-10.72,1187
2021-07-23,854,938,-84,-8.96,1187
2021-07-24,251,269,-18,-6.69,1187
2021-07-25,106,97,9,9.28,1187
2021-07-26,950,1100,-150,-13.64,1187
2021-07-27,983,1093,-110,-10.06,1187
2021-07-28,983,1091,-108,-9.9,1187
2021-07-29,983,1088,-105,-9.65,1187
2021-07-30,854,922,-68,-7.38,1187
2021-07-31,251,250,1,0.4,1187
2021-08-01,108,76,32,42.11,1187
2021-08-02,947,1076,-129,-11.99,1187
2021-08-03,973,1066,-93,-8.72,1187
2021-08-04,973,1062,-89,-8.38,1187
2021-08-05,973,1056,-83,-7.86,1187
2021-08-06,808,889,-81,-9.11,1187
2021-08-07,253,216,37,17.13,1187
2021-08-08,108,41,67,163.41,1187
2021-08-09,947,1041,-94,-9.03,1187
2021-08-10,973,1032,-59,-5.72,1187
2021-08-11,973,1028,-55,-5.35,1187
2021-08-12,973,1024,-51,-4.98,1187
2021-08-13,808,860,-52,-6.05,1187
2021-08-14,253,189,64,33.86,1187
2021-08-15,108,17,91,535.29,1187
2021-08-16,947,1021,-74,-7.25,1187
2021-08-17,973,1016,-43,-4.23,1187
2021-08-18,973,1017,-44,-4.33,1187
2021-08-19,973,1018,-45,-4.42,1187
2021-08-20,808,858,-50,-5.83,1187
2021-08-21,253,192,61,31.77,1187
2021-08-22,108,25,83,332.0,1187
2021-08-23,947,1034,-87,-8.41,1187
2021-08-24,973,1033,-60,-5.81,1187
2021-08-25,973,1038,-65,-6.26,1187
2021-08-26,973,1043,-70,-6.71,1187
2021-08-27,808,886,-78,-8.8,1187
2021-08-28,253,222,31,13.96,1187
2021-08-29,108,58,50,86.21,1187
2021-08-30,947,1067,-120,-11.25,1187
2021-08-31,973,1067,-94,-8.81,1187
2021-09-01,990,1073,-83,-7.74,1187
2021-09-02,990,1076,-86,-7.99,1187
2021-09-03,876,918,-42,-4.58,1187
2021-09-04,276,253,23,9.09,1187
2021-09-05,134,86,48,55.81,1187
2021-09-06,1037,1094,-57,-5.21,1187
2021-09-07,990,1091,-101,-9.26,1187
2021-09-08,990,1093,-103,-9.42,1187
2021-09-09,990,1094,-104,-9.51,1187
2021-09-10,876,932,-56,-6.01,1187
2021-09-11,276,264,12,4.55,1187
2021-09-12,134,94,40,42.55,1187
2021-09-13,1037,1098,-61,-5.56,1187
2021-09-14,990,1093,-103,-9.42,1187
2021-09-15,990,1093,-103,-9.42,1187
2021-09-16,990,1092,-102,-9.34,1187
2021-09-17,876,929,-53,-5.71,1187
2021-09-18,276,260,16,6.15,1187
2021-09-19,134,89,45,50.56,1187
2021-09-20,1037,1093,-56,-5.12,1187
2021-09-21,990,1088,-98,-9.01,1187
2021-09-22,990,1089,-99,-9.09,1187
2021-09-23,990,1089,-99,-9.09,1187
2021-09-24,876,927,-51,-5.5,1187
2021-09-25,276,260,16,6.15,1187
2021-09-26,134,91,43,47.25,1187
2021-09-27,1037,1098,-61,-5.56,1187
2021-09-28,990,1095,-105,-9.59,1187
2021-09-29,990,1098,-108,-9.84,1187
2021-09-30,990,1099,-109,-9.92,1187
2021-10-01,861,940,-79,-8.4,1187
2021-10-02,277,274,3,1.09,1187
2021-10-03,106,107,-1,-0.93,1187
2021-10-04,976,1114,-138,-12.39,1187
2021-10-05,983,1112,-129,-11.6,1187
2021-10-06,983,1115,-132,-11.84,1187
2021-10-07,983,1116,-133,-11.92,1187
2021-10-08,861,956,-95,-9.94,1187
2021-10-09,277,289,-12,-4.15,1187
2021-10-10,106,120,-14,-11.67,1187
2021-10-11,976,1126,-150,-13.32,1187
2021-10-12,983,1121,-138,-12.31,1187
2021-10-13,983,1122,-139,-12.39,1187
2021-10-14,983,1121,-138,-12.31,1187
2021-10-15,861,958,-97,-10.13,1187
2021-10-16,277,288,-11,-3.82,1187
2021-10-17,106,117,-11,-9.4,1187
2021-10-18,976,1120,-144,-12.86,1187
2021-10-19,983,1113,-130,-11.68,1187
2021-10-20,983,1111,-128,-11.52,1187
2021-10-21,983,1108,-125,-11.28,1187
2021-10-22,861,944,-83,-8.79,1187
2021-10-23,277,274,3,1.09,1187
2021-10-24,106,102,4,3.92,1187
2021-10-25,976,1105,-129,-11.67,1187
2021-10-26,983,1098,-115,-10.47,1187
2021-10-27,983,1097,-114,-10.39,1187
2021-10-28,983,1096,-113,-10.31,1187
2021-10-29,861,933,-72,-7.72,1187
2021-10-30,277,265,12,4.53,1187
2021-10-31,106,95,11,11.58,1187
2021-11-01,983,1100,-117,-10.64,1187
2021-11-02,990,1096,-106,-9.67,1187
2021-11-03,990,1097,-107,-9.75,1187
2021-11-04,990,1098,-108,-9.84,1187
2021-11-05,841,937,-96,-10.25,1187
2021-11-06,266,270,-4,-1.48,1187
2021-11-07,106,102,4,3.92,1187
2021-11-08,983,1108,-125,-11.28,1187
2021-11-09,990,1105,-115,-10.41,1187
2021-11-10,990,1107,-117,-10.57,1187
2021-11-11,990,1107,-117,-10.57,1187
2021-11-12,841,946,-105,-11.1,1187
2021-11-13,266,278,-12,-4.32,1187
2021-11-14,106,107,-1,-0.93,1187
2021-11-15,983,1111,-128,-11.52,1187
2021-11-16,990,1105,-115,-10.41,1187
2021-11-17,990,1103,-113,-10.24,1187
2021-11-18,990,1100,-110,-10.0,1187
2021-11-19,841,935,-94,-10.05,1187
2021-11-20,266,263,3,1.14,1187
2021-11-21,106,88,18,20.45,1187
2021-11-22,983,1088,-105,-9.65,1187
2021-11-23,990,1077,-87,-8.08,1187
2021-11-24,990,1072,-82,-7.65,1187
2021-11-25,990,1065,-75,-7.04,1187
2021-11-26,841,897,-56,-6.24,1187
2021-11-27,266,222,44,19.82,1187
2021-11-28,106,45,61,135.56,1187
2021-11-29,983,1043,-60,-5.75,1187
2021-11-30,990,1031,-41,-3.98,1187
2021-12-01,771,1025,-254,-24.78,1187
2021-12-02,771,1018,-247,-24.26,1187
2021-12-03,555,850,-295,-34.71,1187
2021-12-04,253,176,77,43.75,1187
2021-12-05,94,1,93,9300.0,1187
2021-12-06,827,1001,-174,-17.38,1187
2021-12-07,771,992,-221,-22.28,1187
2021-12-08,771,989,-218,-22.04,1187
2021-12-09,771,985,-214,-21.73,1187
2021-12-10,555,820,-265,-32.32,1187
2021-12-11,253,149,104,69.8,1187
2021-12-12,94,24,70,291.67,1187
2021-12-13,827,980,-153,-15.61,1187
2021-12-14,771,974,-203,-20.84,1187
2021-12-15,771,973,-202,-20.76,1187
2021-12-16,771,971,-200,-20.6,1187
2021-12-17,555,808,-253,-31.31,1187
2021-12-18,253,139,114,82.01,1187
2021-12-19,94,20,74,370.0,1187
2021-12-20,827,971,-144,-14.83,1187
2021-12-21,771,965,-194,-20.1,1187
2021-12-22,771,964,-193,-20.02,1187
2021-12-23,771,961,-190,-19.77,1187
2021-12-24,555,796,-241,-30.28,1187
2021-12-25,253,125,128,102.4,1187
2021-12-26,94,13,81,623.08,1187
2021-12-27,827,953,-126,-13.22,1187
2021-12-28,771,944,-173,-18.33,1187
2021-12-29,771,940,-169,-17.98,1187
2021-12-30,771,934,-163,-17.45,1187
2021-12-31,555,767,-212,-27.64,1187
2022-01-01,216,94,122,129.79,1187
2022-01-02,81,94,-13,-13.83,1187
2022-01-03,763,917,-154,-16.79,1187
2022-01-04,765,907,-142,-15.66,1187
2022-01-05,765,903,-138,-15.28,1187
2022-01-06,765,897,-132,-14.72,1187
2022-01-07,654,730,-76,-10.41,1187
2022-01-08,216,57,159,278.95,1187
2022-01-09,81,57,24,42.11,1187
2022-01-10,763,884,-121,-13.69,1187
2022-01-11,765,876,-111,-12.67,1187
2022-01-12,765,875,-110,-12.57,1187
2022-01-13,765,872,-107,-12.27,1187
2022-01-14,654,709,-55,-7.76,1187
2022-01-15,216,40,176,440.0,1187
2022-01-16,81,40,41,102.5,1187
2022-01-17,763,876,-113,-12.9,1187
2022-01-18,765,872,-107,-12.27,1187
2022-01-19,765,875,-110,-12.57,1187
2022-01-20,765,877,-112,-12.77,1187
2022-01-21,654,718,-64,-8.91,1187
2022-01-22,216,53,163,307.55,1187
2022-01-23,81,53,28,52.83,1187
2022-01-24,763,895,-132,-14.75,1187
2022-01-25,765,894,-129,-14.43,1187
2022-01-26,765,899,-134,-14.91,1187
2022-01-27,765,902,-137,-15.19,1187
2022-01-28,654,744,-90,-12.1,1187
2022-01-29,216,80,136,170.0,1187
2022-01-30,81,80,1,1.25,1187
2020-02-01,254,159,95,59.75,1188
2020-02-02,154,32,122,381.25,1188
2020-02-03,1140,1133,7,0.62,1188
2020-02-04,1111,1119,-8,-0.71,1188
2020-02-05,1111,1122,-11,-0.98,1188
2020-02-06,1111,1126,-15,-1.33,1188
2020-02-07,944,915,29,3.17,1188
2020-02-08,254,179,75,41.9,1188
2020-02-09,154,50,104,208.0,1188
2020-02-10,1140,1149,-9,-0.78,1188
2020-02-11,1111,1133,-22,-1.94,1188
2020-02-12,1111,1135,-24,-2.11,1188
2020-02-13,1111,1138,-27,-2.37,1188
2020-02-14,944,928,16,1.72,1188
2020-02-15,254,191,63,32.98,1188
2020-02-16,154,62,92,148.39,1188
2020-02-17,1140,1162,-22,-1.89,1188
2020-02-18,1111,1147,-36,-3.14,1188
2020-02-19,1111,1151,-40,-3.48,1188
2020-02-20,1111,1155,-44,-3.81,1188
2020-02-21,944,946,-2,-0.21,1188
2020-02-22,254,211,43,20.38,1188
2020-02-23,154,84,70,83.33,1188
2020-02-24,1140,1185,-45,-3.8,1188
2020-02-25,1111,1172,-61,-5.2,1188
2020-02-26,1111,1177,-66,-5.61,1188
2020-02-27,1111,1183,-72,-6.09,1188
2020-02-28,944,975,-31,-3.18,1188
2020-02-29,254,240,14,5.83,1188
2020-03-01,149,114,35,30.7,1188
2020-03-02,986,1216,-230,-18.91,1188
2020-03-03,972,1203,-231,-19.2,1188
2020-03-04,972,1207,-235,-19.47,1188
2020-03-05,972,1212,-240,-19.8,1188
2020-03-06,870,1003,-133,-13.26,1188
2020-03-07,238,268,-30,-11.19,1188
2020-03-08,149,140,9,6.43,1188
2020-03-09,986,1240,-254,-20.48,1188
2020-03-10,972,1225,-253,-20.65,1188
2020-03-11,972,1228,-256,-20.85,1188
2020-03-12,972,1231,-259,-21.04,1188
2020-03-13,870,1020,-150,-14.71,1188
2020-03-14,238,283,-45,-15.9,1188
2020-03-15,149,153,-4,-2.61,1188
2020-03-16,986,1252,-266,-21.25,1188
2020-03-17,972,1236,-264,-21.36,1188
2020-03-18,972,1237,-265,-21.42,1188
2020-03-19,972,1240,-268,-21.61,1188
2020-03-20,870,1028,-158,-15.37,1188
2020-03-21,238,291,-53,-18.21,1188
2020-03-22,149,162,-13,-8.02,1188
2020-03-23,986,1261,-275,-21.81,1188
2020-03-24,972,1246,-274,-21.99,1188
2020-03-25,972,1248,-276,-22.12,1188
2020-03-26,972,1252,-280,-22.36,1188
2020-03-27,870,1042,-172,-16.51,1188
2020-03-28,238,306,-68,-22.22,1188
2020-03-29,149,178,-29,-16.29,1188
2020-03-30,986,1279,-293,-22.91,1188
2020-03-31,972,1265,-293,-23.16,1188
2020-04-01,1007,1269,-262,-20.65,1188
2020-04-02,1007,1273,-266,-20.9,1188
2020-04-03,814,1064,-250,-23.5,1188
2020-04-04,225,329,-104,-31.61,1188
2020-04-05,125,202,-77,-38.12,1188
2020-04-06,1102,1303,-201,-15.43,1188
2020-04-07,1007,1289,-282,-21.88,1188
2020-04-08,1007,1292,-285,-22.06,1188
2020-04-09,1007,1296,-289,-22.3,1188
2020-04-10,814,1087,-273,-25.11,1188
2020-04-11,225,350,-125,-35.71,1188
2020-04-12,125,222,-97,-43.69,1188
2020-04-13,1102,1321,-219,-16.58,1188
2020-04-14,1007,1305,-298,-22.84,1188
2020-04-15,1007,1307,-300,-22.95,1188
2020-04-16,1007,1310,-303,-23.13,1188
2020-04-17,814,1098,-284,-25.87,1188
2020-04-18,225,360,-135,-37.5,1188
2020-04-19,125,230,-105,-45.65,1188
2020-04-20,1102,1328,-226,-17.02,1188
2020-04-21,1007,1311,-304,-23.19,1188
2020-04-22,1007,1312,-305,-23.25,1188
2020-04-23,1007,1314,-307,-23.36,1188
2020-04-24,814,1102,-288,-26.13,1188
2020-04-25,225,364,-139,-38.19,1188
2020-04-26,125,234,-109,-46.58,1188
2020-04-27,1102,1332,-230,-17.27,1188
2020-04-28,1007,1316,-309,-23.48,1188
2020-04-29,1007,1318,-311,-23.6,1188
2020-04-30,1007,1320,-313,-23.71,1188
2020-05-01,1054,1110,-56,-5.05,1188
2020-05-02,276,373,-97,-26.01,1188
2020-05-03,155,244,-89,-36.48,1188
2020-05-04,1246,1344,-98,-7.29,1188
2020-05-05,1218,1328,-110,-8.28,1188
2020-05-06,1218,1331,-113,-8.49,1188
2020-05-07,1218,1335,-117,-8.76,1188
2020-05-08,1054,1124,-70,-6.23,1188
2020-05-09,276,388,-112,-28.87,1188
2020-05-10,155,259,-104,-40.15,1188
2020-05-11,1246,1359,-113,-8.31,1188
2020-05-12,1218,1343,-125,-9.31,1188
2020-05-13,1218,1345,-127,-9.44,1188
2020-05-14,1218,1347,-129,-9.58,1188
2020-05-15,1054,1136,-82,-7.22,1188
2020-05-16,276,398,-122,-30.65,1188
2020-05-17,155,267,-112,-41.95,1188
2020-05-18,1246,1365,-119,-8.72,1188
2020-05-19,1218,1347,-129,-9.58,1188
2020-05-20,1218,1347,-129,-9.58,1188
2020-05-21,1218,1348,-130,-9.64,1188
2020-05-22,1054,1135,-81,-7.14,1188
2020-05-23,276,395,-119,-30.13,1188
2020-05-24,155,263,-108,-41.06,1188
2020-05-25,1246,1360,-114,-8.38,1188
2020-05-26,1218,1341,-123,-9.17,1188
2020-05-27,1218,1341,-123,-9.17,1188
2020-05-28,1218,1341,-123,-9.17,1188
2020-05-29,1054,1128,-74,-6.56,1188
2020-05-30,276,389,-113,-29.05,1188
2020-05-31,155,258,-103,-39.92,1188
2020-06-01,1307,1355,-48,-3.54,1188
2020-06-02,1274,1338,-64,-4.78,1188
2020-06-03,1274,1339,-65,-4.85,1188
2020-06-04,1274,1341,-67,-5.0,1188
2020-06-05,1037,1129,-92,-8.15,1188
2020-06-06,279,392,-113,-28.83,1188
2020-06-07,160,262,-102,-38.93,1188
2020-06-08,1307,1361,-54,-3.97,1188
2020-06-09,1274,1345,-71,-5.28,1188
2020-06-10,1274,1347,-73,-5.42,1188
2020-06-11,1274,1350,-76,-5.63,1188
2020-06-12,1037,1139,-102,-8.96,1188
2020-06-13,279,401,-122,-30.42,1188
2020-06-14,160,271,-111,-40.96,1188
2020-06-15,1307,1369,-62,-4.53,1188
2020-06-16,1274,1352,-78,-5.77,1188
2020-06-17,1274,1352,-78,-5.77,1188
2020-06-18,1274,1352,-78,-5.77,1188
2020-06-19,1037,1137,-100,-8.8,1188
2020-06-20,279,397,-118,-29.72,1188
2020-06-21,160,263,-103,-39.16,1188
2020-06-22,1307,1357,-50,-3.68,1188
2020-06-23,1274,1336,-62,-4.64,1188
2020-06-24,1274,1331,-57,-4.28,1188
2020-06-25,1274,1327,-53,-3.99,1188
2020-06-26,1037,1109,-72,-6.49,1188
2020-06-27,279,364,-85,-23.35,1188
2020-06-28,160,227,-67,-29.52,1188
2020-06-29,1307,1318,-11,-0.83,1188
2020-06-30,1274,1293,-19,-1.47,1188
2020-07-01,1282,1287,-5,-0.39,1188
2020-07-02,1282,1281,1,0.08,1188
2020-07-03,1066,1062,4,0.38,1188
2020-07-04,262,317,-55,-17.35,1188
2020-07-05,145,180,-35,-19.44,1188
2020-07-06,1252,1271,-19,-1.49,1188
2020-07-07,1282,1248,34,2.72,1188
2020-07-08,1282,1244,38,3.05,1188
2020-07-09,1282,1241,41,3.3,1188
2020-07-10,1066,1025,41,4.0,1188
2020-07-11,262,283,-21,-7.42,1188
2020-07-12,145,150,-5,-3.33,1188
2020-07-13,1252,1245,7,0.56,1188
2020-07-14,1282,1227,55,4.48,1188
2020-07-15,1282,1227,55,4.48,1188
2020-07-16,1282,1228,54,4.4,1188
2020-07-17,1066,1015,51,5.02,1188
2020-07-18,262,277,-15,-5.42,1188
2020-07-19,145,147,-2,-1.36,1188
2020-07-20,1252,1246,6,0.48,1188
2020-07-21,1282,1229,53,4.31,1188
2020-07-22,1282,1231,51,4.14,1188
2020-07-23,1282,1233,49,3.97,1188
2020-07-24,1066,1021,45,4.41,1188
2020-07-25,262,283,-21,-7.42,1188
2020-07-26,145,152,-7,-4.61,1188
2020-07-27,1252,1249,3,0.24,1188
2020-07-28,1282,1231,51,4.14,1188
2020-07-29,1282,1230,52,4.23,1188
2020-07-30,1282,1229,53,4.31,1188
2020-07-31,1066,1014,52,5.13,1188
2020-08-01,271,273,-2,-0.73,1188
2020-08-02,160,139,21,15.11,1188
2020-08-03,1165,1233,-68,-5.52,1188
2020-08-04,1189,1211,-22,-1.82,1188
2020-08-05,1189,1207,-18,-1.49,1188
2020-08-06,1189,1204,-15,-1.25,1188
2020-08-07,974,987,-13,-1.32,1188
2020-08-08,271,244,27,11.07,1188
2020-08-09,160,109,51,46.79,1188
2020-08-10,1165,1202,-37,-3.08,1188
2020-08-11,1189,1181,8,0.68,1188
2020-08-12,1189,1178,11,0.93,1188
2020-08-13,1189,1177,12,1.02,1188
2020-08-14,974,962,12,1.25,1188
2020-08-15,271,222,49,22.07,1188
2020-08-16,160,91,69,75.82,1188
2020-08-17,1165,1188,-23,-1.94,1188
2020-08-18,1189,1171,18,1.54,1188
2020-08-19,1189,1173,16,1.36,1188
2020-08-20,1189,1177,12,1.02,1188
2020-08-21,974,967,7,0.72,1188
2020-08-22,271,232,39,16.81,1188
2020-08-23,160,106,54,50.94,1188
2020-08-24,1165,1208,-43,-3.56,1188
2020-08-25,1189,1196,-7,-0.59,1188
2020-08-26,1189,1201,-12,-1.0,1188
2020-08-27,1189,1208,-19,-1.57,1188
2020-08-28,974,1002,-28,-2.79,1188
2020-08-29,271,269,2,0.74,1188
2020-08-30,160,144,16,11.11,1188
2020-08-31,1165,1247,-82,-6.58,1188
2020-09-01,1226,1235,-9,-0.73,1188
2020-09-02,1226,1240,-14,-1.13,1188
2020-09-03,1226,1246,-20,-1.61,1188
2020-09-04,1050,1038,12,1.16,1188
2020-09-05,286,303,-17,-5.61,1188
2020-09-06,169,175,-6,-3.43,1188
2020-09-07,1240,1275,-35,-2.75,1188
2020-09-08,1226,1259,-33,-2.62,1188
2020-09-09,1226,1261,-35,-2.78,1188
2020-09-10,1226,1263,-37,-2.93,1188
2020-09-11,1050,1051,-1,-0.1,1188
2020-09-12,286,313,-27,-8.63,1188
2020-09-13,169,182,-13,-7.14,1188
2020-09-14,1240,1279,-39,-3.05,1188
2020-09-15,1226,1260,-34,-2.7,1188
2020-09-16,1226,1260,-34,-2.7,1188
2020-09-17,1226,1260,-34,-2.7,1188
2020-09-18,1050,1047,3,0.29,1188
2020-09-19,286,307,-21,-6.84,1188
2020-09-20,169,176,-7,-3.98,1188
2020-09-21,1240,1273,-33,-2.59,1188
2020-09-22,1226,1256,-30,-2.39,1188
2020-09-23,1226,1257,-31,-2.47,1188
2020-09-24,1226,1258,-32,-2.54,1188
2020-09-25,1050,1047,3,0.29,1188
2020-09-26,286,310,-24,-7.74,1188
2020-09-27,169,181,-12,-6.63,1188
2020-09-28,1240,1280,-40,-3.12,1188
2020-09-29,1226,1265,-39,-3.08,1188
2020-09-30,1226,1267,-41,-3.24,1188
2020-10-01,1211,1271,-60,-4.72,1188
2020-10-02,1071,1061,10,0.94,1188
2020-10-03,298,325,-27,-8.31,1188
2020-10-04,165,197,-32,-16.24,1188
2020-10-05,1215,1297,-82,-6.32,1188
2020-10-06,1211,1282,-71,-5.54,1188
2020-10-07,1211,1284,-73,-5.69,1188
2020-10-08,1211,1287,-76,-5.91,1188
2020-10-09,1071,1076,-5,-0.46,1188
2020-10-10,298,338,-40,-11.83,1188
2020-10-11,165,208,-43,-20.67,1188
2020-10-12,1215,1306,-91,-6.97,1188
2020-10-13,1211,1288,-77,-5.98,1188
2020-10-14,1211,1288,-77,-5.98,1188
2020-10-15,1211,1288,-77,-5.98,1188
2020-10-16,1071,1075,-4,-0.37,1188
2020-10-17,298,335,-37,-11.04,1188
2020-10-18,165,202,-37,-18.32,1188
2020-10-19,1215,1298,-83,-6.39,1188
2020-10-20,1211,1279,-68,-5.32,1188
2020-10-21,1211,1277,-66,-5.17,1188
2020-10-22,1211,1276,-65,-5.09,1188
2020-10-23,1071,1062,9,0.85,1188
2020-10-24,298,322,-24,-7.45,1188
2020-10-25,165,190,-25,-13.16,1188
2020-10-26,1215,1287,-72,-5.59,1188
2020-10-27,1211,1269,-58,-4.57,1188
2020-10-28,1211,1269,-58,-4.57,1188
2020-10-29,1211,1271,-60,-4.72,1188
2020-10-30,1071,1059,12,1.13,1188
2020-10-31,298,322,-24,-7.45,1188
2020-11-01,159,193,-34,-17.62,1188
2020-11-02,1249,1292,-43,-3.33,1188
2020-11-03,1198,1277,-79,-6.19,1188
2020-11-04,1198,1280,-82,-6.41,1188
2020-11-05,1198,1283,-85,-6.63,1188
2020-11-06,1047,1073,-26,-2.42,1188
2020-11-07,296,337,-41,-12.17,1188
2020-11-08,159,209,-50,-23.92,1188
2020-11-09,1249,1309,-60,-4.58,1188
2020-11-10,1198,1293,-95,-7.35,1188
2020-11-11,1198,1295,-97,-7.49,1188
2020-11-12,1198,1297,-99,-7.63,1188
2020-11-13,1047,1085,-38,-3.5,1188
2020-11-14,296,347,-51,-14.7,1188
2020-11-15,159,215,-56,-26.05,1188
2020-11-16,1249,1311,-62,-4.73,1188
2020-11-17,1198,1292,-94,-7.28,1188
2020-11-18,1198,1289,-91,-7.06,1188
2020-11-19,1198,1287,-89,-6.92,1188
2020-11-20,1047,1070,-23,-2.15,1188
2020-11-21,296,326,-30,-9.2,1188
2020-11-22,159,190,-31,-16.32,1188
2020-11-23,1249,1281,-32,-2.5,1188
2020-11-24,1198,1257,-59,-4.69,1188
2020-11-25,1198,1251,-53,-4.24,1188
2020-11-26,1198,1245,-47,-3.78,1188
2020-11-27,1047,1025,22,2.15,1188
2020-11-28,296,279,17,6.09,1188
2020-11-29,159,142,17,11.97,1188
2020-11-30,1249,1232,17,1.38,1188
2020-12-01,956,1208,-252,-20.86,1188
2020-12-02,956,1202,-246,-20.47,1188
2020-12-03,956,1197,-241,-20.13,1188
2020-12-04,1069,978,91,9.3,1188
2020-12-05,307,235,72,30.64,1188
2020-12-06,144,99,45,45.45,1188
2020-12-07,1023,1193,-170,-14.25,1188
2020-12-08,956,1172,-216,-18.43,1188
2020-12-09,956,1169,-213,-18.22,1188
2020-12-10,956,1168,-212,-18.15,1188
2020-12-11,1069,953,116,12.17,1188
2020-12-12,307,212,95,44.81,1188
2020-12-13,144,80,64,80.0,1188
2020-12-14,1023,1176,-153,-13.01,1188
2020-12-15,956,1158,-202,-17.44,1188
2020-12-16,956,1157,-201,-17.37,1188
2020-12-17,956,1157,-201,-17.37,1188
2020-12-18,1069,943,126,13.36,1188
2020-12-19,307,203,104,51.23,1188
2020-12-20,144,71,73,102.82,1188
2020-12-21,1023,1166,-143,-12.26,1188
2020-12-22,956,1146,-190,-16.58,1188
2020-12-23,956,1143,-187,-16.36,1188
2020-12-24,956,1141,-185,-16.21,1188
2020-12-25,1069,924,145,15.69,1188
2020-12-26,307,181,126,69.61,1188
2020-12-27,144,45,99,220.0,1188
2020-12-28,1023,1137,-114,-10.03,1188
2020-12-29,956,1114,-158,-14.18,1188
2020-12-30,956,1108,-152,-13.72,1188
2020-12-31,956,1103,-147,-13.33,1188
2021-01-01,806,884,-78,-8.82,1188
2021-01-02,226,138,88,63.77,1188
2021-01-03,143,1,142,14200.0,1188
2021-01-04,900,1092,-192,-17.58,1188
2021-01-05,920,1068,-148,-13.86,1188
2021-01-06,920,1062,-142,-13.37,1188
2021-01-07,920,1058,-138,-13.04,1188
2021-01-08,806,840,-34,-4.05,1188
2021-01-09,226,97,129,132.99,1188
2021-01-10,143,20,123,615.0,1188
2021-01-11,900,1056,-156,-14.77,1188
2021-01-12,920,1036,-116,-11.2,1188
2021-01-13,920,1035,-115,-11.11,1188
2021-01-14,920,1035,-115,-11.11,1188
2021-01-15,806,822,-16,-1.95,1188
2021-01-16,226,84,142,169.05,1188
2021-01-17,143,17,126,741.18,1188
2021-01-18,900,1054,-154,-14.61,1188
2021-01-19,920,1039,-119,-11.45,1188
2021-01-20,920,1043,-123,-11.79,1188
2021-01-21,920,1048,-128,-12.21,1188
2021-01-22,806,839,-33,-3.93,1188
2021-01-23,226,105,121,115.24,1188
2021-01-24,143,28,115,410.71,1188
2021-01-25,900,1081,-181,-16.74,1188
2021-01-26,920,1068,-148,-13.86,1188
2021-01-27,920,1074,-154,-14.34,1188
2021-01-28,920,1079,-159,-14.74,1188
2021-01-29,806,871,-65,-7.46,1188
2021-01-30,226,137,89,64.96,1188
2021-01-31,143,10,133,1330.0,1188
2021-02-01,1118,1112,6,0.54,1188
2021-02-02,1062,1098,-36,-3.28,1188
2021-02-03,1062,1101,-39,-3.54,1188
2021-02-04,1062,1105,-43,-3.89,1188
2021-02-05,942,895,47,5.25,1188
2021-02-06,251,159,92,57.86,1188
2021-02-07,143,30,113,376.67,1188
2021-02-08,1118,1130,-12,-1.06,1188
2021-02-09,1062,1114,-52,-4.67,1188
2021-02-10,1062,1116,-54,-4.84,1188
2021-02-11,1062,1119,-57,-5.09,1188
2021-02-12,942,908,34,3.74,1188
2021-02-13,251,171,80,46.78,1188
2021-02-14,143,43,100,232.56,1188
2021-02-15,1118,1142,-24,-2.1,1188
2021-02-16,1062,1127,-65,-5.77,1188
2021-02-17,1062,1130,-68,-6.02,1188
2021-02-18,1062,1134,-72,-6.35,1188
2021-02-19,942,924,18,1.95,1188
2021-02-20,251,189,62,32.8,1188
2021-02-21,143,62,81,130.65,1188
2021-02-22,1118,1163,-45,-3.87,1188
2021-02-23,1062,1150,-88,-7.65,1188
2021-02-24,1062,1154,-92,-7.97,1188
2021-02-25,1062,1160,-98,-8.45,1188
2021-02-26,942,952,-10,-1.05,1188
2021-02-27,251,218,33,15.14,1188
2021-02-28,143,92,51,55.43,1188
2021-03-01,1189,1194,-5,-0.42,1188
2021-03-02,1203,1180,23,1.95,1188
2021-03-03,1203,1185,18,1.52,1188
2021-03-04,1203,1190,13,1.09,1188
2021-03-05,1027,982,45,4.58,1188
2021-03-06,306,247,59,23.89,1188
2021-03-07,151,119,32,26.89,1188
2021-03-08,1189,1220,-31,-2.54,1188
2021-03-09,1203,1205,-2,-0.17,1188
2021-03-10,1203,1208,-5,-0.41,1188
2021-03-11,1203,1211,-8,-0.66,1188
2021-03-12,1027,1001,26,2.6,1188
2021-03-13,306,264,42,15.91,1188
2021-03-14,151,135,16,11.85,1188
2021-03-15,1189,1234,-45,-3.65,1188
2021-03-16,1203,1217,-14,-1.15,1188
2021-03-17,1203,1219,-16,-1.31,1188
2021-03-18,1203,1221,-18,-1.47,1188
2021-03-19,1027,1010,17,1.68,1188
2021-03-20,306,272,34,12.5,1188
2021-03-21,151,143,8,5.59,1188
2021-03-22,1189,1242,-53,-4.27,1188
2021-03-23,1203,1226,-23,-1.88,1188
2021-03-24,1203,1229,-26,-2.12,1188
2021-03-25,1203,1232,-29,-2.35,1188
2021-03-26,1027,1021,6,0.59,1188
2021-03-27,306,285,21,7.37,1188
2021-03-28,151,157,-6,-3.82,1188
2021-03-29,1189,1258,-69,-5.48,1188
2021-03-30,1203,1244,-41,-3.3,1188
2021-03-31,1203,1247,-44,-3.53,1188
2021-04-01,1231,1252,-21,-1.68,1188
2021-04-02,1032,1043,-11,-1.05,1188
2021-04-03,300,308,-8,-2.6,1188
2021-04-04,147,181,-34,-18.78,1188
2021-04-05,1239,1282,-43,-3.35,1188
2021-04-06,1231,1268,-37,-2.92,1188
2021-04-07,1231,1271,-40,-3.15,1188
2021-04-08,1231,1276,-45,-3.53,1188
2021-04-09,1032,1066,-34,-3.19,1188
2021-04-10,300,330,-30,-9.09,1188
2021-04-11,147,202,-55,-27.23,1188
2021-04-12,1239,1302,-63,-4.84,1188
2021-04-13,1231,1286,-55,-4.28,1188
2021-04-14,1231,1288,-57,-4.43,1188
2021-04-15,1231,1291,-60,-4.65,1188
2021-04-16,1032,1080,-48,-4.44,1188
2021-04-17,300,342,-42,-12.28,1188
2021-04-18,147,212,-65,-30.66,1188
2021-04-19,1239,1310,-71,-5.42,1188
2021-04-20,1231,1294,-63,-4.87,1188
2021-04-21,1231,1294,-63,-4.87,1188
2021-04-22,1231,1296,-65,-5.02,1188
2021-04-23,1032,1084,-52,-4.8,1188
2021-04-24,300,346,-46,-13.29,1188
2021-04-25,147,216,-69,-31.94,1188
2021-04-26,1239,1314,-75,-5.71,1188
2021-04-27,1231,1298,-67,-5.16,1188
2021-04-28,1231,1299,-68,-5.23,1188
2021-04-29,1231,1302,-71,-5.45,1188
2021-04-30,1032,1090,-58,-5.32,1188
2021-05-01,338,353,-15,-4.25,1188
2021-05-02,166,225,-59,-26.22,1188
2021-05-03,1284,1324,-40,-3.02,1188
2021-05-04,1305,1309,-4,-0.31,1188
2021-05-05,1305,1311,-6,-0.46,1188
2021-05-06,1305,1315,-10,-0.76,1188
2021-05-07,1126,1104,22,1.99,1188
2021-05-08,338,368,-30,-8.15,1188
2021-05-09,166,240,-74,-30.83,1188
2021-05-10,1284,1339,-55,-4.11,1188
2021-05-11,1305,1324,-19,-1.44,1188
2021-05-12,1305,1326,-21,-1.58,1188
2021-05-13,1305,1328,-23,-1.73,1188
2021-05-14,1126,1117,9,0.81,1188
2021-05-15,338,380,-42,-11.05,1188
2021-05-16,166,250,-84,-33.6,1188
2021-05-17,1284,1348,-64,-4.75,1188
2021-05-18,1305,1330,-25,-1.88,1188
2021-05-19,1305,1331,-26,-1.95,1188
2021-05-20,1305,1332,-27,-2.03,1188
2021-05-21,1126,1118,8,0.72,1188
2021-05-22,338,379,-41,-10.82,1188
2021-05-23,166,248,-82,-33.06,1188
2021-05-24,1284,1344,-60,-4.46,1188
2021-05-25,1305,1326,-21,-1.58,1188
2021-05-26,1305,1325,-20,-1.51,1188
2021-05-27,1305,1325,-20,-1.51,1188
2021-05-28,1126,1112,14,1.26,1188
2021-05-29,338,372,-34,-9.14,1188
2021-05-30,166,241,-75,-31.12,1188
2021-05-31,1284,1338,-54,-4.04,1188
2021-06-01,1328,1321,7,0.53,1188
2021-06-02,1328,1321,7,0.53,1188
2021-06-03,1328,1323,5,0.38,1188
2021-06-04,1109,1111,-2,-0.18,1188
2021-06-05,294,373,-79,-21.18,1188
2021-06-06,185,244,-59,-24.18,1188
2021-06-07,1299,1342,-43,-3.2,1188
2021-06-08,1328,1326,2,0.15,1188
2021-06-09,1328,1328,0,0.0,1188
2021-06-10,1328,1331,-3,-0.23,1188
2021-06-11,1109,1120,-11,-0.98,1188
2021-06-12,294,383,-89,-23.24,1188
2021-06-13,185,253,-68,-26.88,1188
2021-06-14,1299,1351,-52,-3.85,1188
2021-06-15,1328,1334,-6,-0.45,1188
2021-06-16,1328,1335,-7,-0.52,1188
2021-06-17,1328,1336,-8,-0.6,1188
2021-06-18,1109,1122,-13,-1.16,1188
2021-06-19,294,382,-88,-23.04,1188
2021-06-20,185,249,-64,-25.7,1188
2021-06-21,1299,1344,-45,-3.35,1188
2021-06-22,1328,1323,5,0.38,1188
2021-06-23,1328,1320,8,0.61,1188
2021-06-24,1328,1317,11,0.84,1188
2021-06-25,1109,1099,10,0.91,1188
2021-06-26,294,355,-61,-17.18,1188
2021-06-27,185,218,-33,-15.14,1188
2021-06-28,1299,1309,-10,-0.76,1188
2021-06-29,1328,1285,43,3.35,1188
2021-06-30,1328,1279,49,3.83,1188
2021-07-01,1155,1273,-118,-9.27,1188
2021-07-02,1004,1053,-49,-4.65,1188
2021-07-03,267,308,-41,-13.31,1188
2021-07-04,160,170,-10,-5.88,1188
2021-07-05,1156,1262,-106,-8.4,1188
2021-07-06,1155,1238,-83,-6.7,1188
2021-07-07,1155,1233,-78,-6.33,1188
2021-07-08,1155,1229,-74,-6.02,1188
2021-07-09,1004,1012,-8,-0.79,1188
2021-07-10,267,270,-3,-1.11,1188
2021-07-11,160,136,24,17.65,1188
2021-07-12,1156,1231,-75,-6.09,1188
2021-07-13,1155,1211,-56,-4.62,1188
2021-07-14,1155,1210,-55,-4.55,1188
2021-07-15,1155,1211,-56,-4.62,1188
2021-07-16,1004,998,6,0.6,1188
2021-07-17,267,259,8,3.09,1188
2021-07-18,160,129,31,24.03,1188
2021-07-19,1156,1228,-72,-5.86,1188
2021-07-20,1155,1211,-56,-4.62,1188
2021-07-21,1155,1212,-57,-4.7,1188
2021-07-22,1155,1215,-60,-4.94,1188
2021-07-23,1004,1003,1,0.1,1188
2021-07-24,267,265,2,0.75,1188
2021-07-25,160,135,25,18.52,1188
2021-07-26,1156,1233,-77,-6.24,1188
2021-07-27,1155,1215,-60,-4.94,1188
2021-07-28,1155,1214,-59,-4.86,1188
2021-07-29,1155,1214,-59,-4.86,1188
2021-07-30,1004,1000,4,0.4,1188
2021-07-31,267,259,8,3.09,1188
2021-08-01,156,126,30,23.81,1188
2021-08-02,1034,1220,-186,-15.25,1188
2021-08-03,1033,1199,-166,-13.84,1188
2021-08-04,1033,1195,-162,-13.56,1188
2021-08-05,1033,1192,-159,-13.34,1188
2021-08-06,894,975,-81,-8.31,1188
2021-08-07,254,232,22,9.48,1188
2021-08-08,156,97,59,60.82,1188
2021-08-09,1034,1190,-156,-13.11,1188
2021-08-10,1033,1169,-136,-11.63,1188
2021-08-11,1033,1165,-132,-11.33,1188
2021-08-12,1033,1163,-130,-11.18,1188
2021-08-13,894,948,-54,-5.7,1188
2021-08-14,254,207,47,22.71,1188
2021-08-15,156,75,81,108.0,1188
2021-08-16,1034,1171,-137,-11.7,1188
2021-08-17,1033,1153,-120,-10.41,1188
2021-08-18,1033,1154,-121,-10.49,1188
2021-08-19,1033,1157,-124,-10.72,1188
2021-08-20,894,946,-52,-5.5,1188
2021-08-21,254,211,43,20.38,1188
2021-08-22,156,83,73,87.95,1188
2021-08-23,1034,1185,-151,-12.74,1188
2021-08-24,1033,1172,-139,-11.86,1188
2021-08-25,1033,1178,-145,-12.31,1188
2021-08-26,1033,1184,-151,-12.75,1188
2021-08-27,894,977,-83,-8.5,1188
2021-08-28,254,244,10,4.1,1188
2021-08-29,156,120,36,30.0,1188
2021-08-30,1034,1223,-189,-15.45,1188
2021-08-31,1033,1211,-178,-14.7,1188
2021-09-01,1164,1217,-53,-4.35,1188
2021-09-02,1164,1223,-59,-4.82,1188
2021-09-03,1010,1015,-5,-0.49,1188
2021-09-04,290,281,9,3.2,1188
2021-09-05,166,154,12,7.79,1188
2021-09-06,1199,1255,-56,-4.46,1188
2021-09-07,1164,1240,-76,-6.13,1188
2021-09-08,1164,1242,-78,-6.28,1188
2021-09-09,1164,1245,-81,-6.51,1188
2021-09-10,1010,1033,-23,-2.23,1188
2021-09-11,290,295,-5,-1.69,1188
2021-09-12,166,165,1,0.61,1188
2021-09-13,1199,1262,-63,-4.99,1188
2021-09-14,1164,1244,-80,-6.43,1188
2021-09-15,1164,1244,-80,-6.43,1188
2021-09-16,1164,1244,-80,-6.43,1188
2021-09-17,1010,1031,-21,-2.04,1188
2021-09-18,290,291,-1,-0.34,1188
2021-09-19,166,160,6,3.75,1188
2021-09-20,1199,1257,-58,-4.61,1188
2021-09-21,1164,1239,-75,-6.05,1188
2021-09-22,1164,1239,-75,-6.05,1188
2021-09-23,1164,1241,-77,-6.2,1188
2021-09-24,1010,1029,-19,-1.85,1188
2021-09-25,290,291,-1,-0.34,1188
2021-09-26,166,161,5,3.11,1188
2021-09-27,1199,1260,-61,-4.84,1188
2021-09-28,1164,1245,-81,-6.51,1188
2021-09-29,1164,1247,-83,-6.66,1188
2021-09-30,1164,1251,-87,-6.95,1188
2021-10-01,1089,1041,48,4.61,1188
2021-10-02,296,305,-9,-2.95,1188
2021-10-03,162,177,-15,-8.47,1188
2021-10-04,1216,1277,-61,-4.78,1188
2021-10-05,1241,1262,-21,-1.66,1188
2021-10-06,1241,1265,-24,-1.9,1188
2021-10-07,1241,1268,-27,-2.13,1188
2021-10-08,1089,1057,32,3.03,1188
2021-10-09,296,320,-24,-7.5,1188
2021-10-10,162,190,-28,-14.74,1188
2021-10-11,1216,1289,-73,-5.66,1188
2021-10-12,1241,1271,-30,-2.36,1188
2021-10-13,1241,1272,-31,-2.44,1188
2021-10-14,1241,1272,-31,-2.44,1188
2021-10-15,1089,1059,30,2.83,1188
2021-10-16,296,319,-23,-7.21,1188
2021-10-17,162,187,-25,-13.37,1188
2021-10-18,1216,1283,-67,-5.22,1188
2021-10-19,1241,1264,-23,-1.82,1188
2021-10-20,1241,1262,-21,-1.66,1188
2021-10-21,1241,1262,-21,-1.66,1188
2021-10-22,1089,1047,42,4.01,1188
2021-10-23,296,307,-11,-3.58,1188
2021-10-24,162,175,-13,-7.43,1188
2021-10-25,1216,1271,-55,-4.33,1188
2021-10-26,1241,1253,-12,-0.96,1188
2021-10-27,1241,1253,-12,-0.96,1188
2021-10-28,1241,1254,-13,-1.04,1188
2021-10-29,1089,1041,48,4.61,1188
2021-10-30,296,303,-7,-2.31,1188
2021-10-31,162,174,-12,-6.9,1188
2021-11-01,1284,1273,11,0.86,1188
2021-11-02,1251,1257,-6,-0.48,1188
2021-11-03,1251,1260,-9,-0.71,1188
2021-11-04,1251,1263,-12,-0.95,1188
2021-11-05,1068,1053,15,1.42,1188
2021-11-06,305,317,-12,-3.79,1188
2021-11-07,165,189,-24,-12.7,1188
2021-11-08,1284,1289,-5,-0.39,1188
2021-11-09,1251,1274,-23,-1.81,1188
2021-11-10,1251,1276,-25,-1.96,1188
2021-11-11,1251,1279,-28,-2.19,1188
2021-11-12,1068,1068,0,0.0,1188
2021-11-13,305,330,-25,-7.58,1188
2021-11-14,165,199,-34,-17.09,1188
2021-11-15,1284,1296,-12,-0.93,1188
2021-11-16,1251,1277,-26,-2.04,1188
2021-11-17,1251,1276,-25,-1.96,1188
2021-11-18,1251,1274,-23,-1.81,1188
2021-11-19,1068,1058,10,0.95,1188
2021-11-20,305,315,-10,-3.17,1188
2021-11-21,165,180,-15,-8.33,1188
2021-11-22,1284,1272,12,0.94,1188
2021-11-23,1251,1248,3,0.24,1188
2021-11-24,1251,1242,9,0.72,1188
2021-11-25,1251,1237,14,1.13,1188
2021-11-26,1068,1017,51,5.01,1188
2021-11-27,305,271,34,12.55,1188
2021-11-28,165,134,31,23.13,1188
2021-11-29,1284,1224,60,4.9,1188
2021-11-30,1251,1199,52,4.34,1188
2021-12-01,985,1193,-208,-17.44,1188
2021-12-02,985,1187,-202,-17.02,1188
2021-12-03,731,969,-238,-24.56,1188
2021-12-04,295,224,71,31.7,1188
2021-12-05,143,88,55,62.5,1188
2021-12-06,1084,1181,-97,-8.21,1188
2021-12-07,985,1159,-174,-15.01,1188
2021-12-08,985,1156,-171,-14.79,1188
2021-12-09,985,1154,-169,-14.64,1188
2021-12-10,731,939,-208,-22.15,1188
2021-12-11,295,198,97,48.99,1188
2021-12-12,143,65,78,120.0,1188
2021-12-13,1084,1161,-77,-6.63,1188
2021-12-14,985,1142,-157,-13.75,1188
2021-12-15,985,1142,-157,-13.75,1188
2021-12-16,985,1142,-157,-13.75,1188
2021-12-17,731,928,-197,-21.23,1188
2021-12-18,295,188,107,56.91,1188
2021-12-19,143,56,87,155.36,1188
2021-12-20,1084,1152,-68,-5.9,1188
2021-12-21,985,1132,-147,-12.99,1188
2021-12-22,985,1130,-145,-12.83,1188
2021-12-23,985,1128,-143,-12.68,1188
2021-12-24,731,912,-181,-19.85,1188
2021-12-25,295,170,125,73.53,1188
2021-12-26,143,35,108,308.57,1188
2021-12-27,1084,1127,-43,-3.82,1188
2021-12-28,985,1104,-119,-10.78,1188
2021-12-29,985,1099,-114,-10.37,1188
2021-12-30,985,1094,-109,-9.96,1188
2021-12-31,731,875,-144,-16.46,1188
2022-01-01,240,130,110,84.62,1188
2022-01-02,132,44,88,200.0,1188
2022-01-03,968,1083,-115,-10.62,1188
2022-01-04,939,1059,-120,-11.33,1188
2022-01-05,939,1053,-114,-10.83,1188
2022-01-06,939,1048,-109,-10.4,1188
2022-01-07,790,829,-39,-4.7,1188
2022-01-08,240,85,155,182.35,1188
2022-01-09,132,24,108,450.0,1188
2022-01-10,968,1043,-75,-7.19,1188
2022-01-11,939,1022,-83,-8.12,1188
2022-01-12,939,1020,-81,-7.94,1188
2022-01-13,939,1019,-80,-7.85,1188
2022-01-14,790,806,-16,-1.99,1188
2022-01-15,240,67,173,258.21,1188
2022-01-16,132,18,114,633.33,1188
2022-01-17,968,1035,-67,-6.47,1188
2022-01-18,939,1019,-80,-7.85,1188
2022-01-19,939,1022,-83,-8.12,1188
2022-01-20,939,1026,-87,-8.48,1188
2022-01-21,790,817,-27,-3.3,1188
2022-01-22,240,82,158,192.68,1188
2022-01-23,132,26,106,407.69,1188
2022-01-24,968,1058,-90,-8.51,1188
2022-01-25,939,1045,-106,-10.14,1188
2022-01-26,939,1051,-112,-10.66,1188
2022-01-27,939,1056,-117,-11.08,1188
2022-01-28,790,849,-59,-6.95,1188
2022-01-29,240,115,125,108.7,1188
2022-01-30,132,46,86,186.96,1188
2020-02-01,513,351,162,46.15,1200
2020-02-02,346,153,193,126.14,1200
2020-02-03,2454,2328,126,5.41,1200
2020-02-04,2440,2352,88,3.74,1200
2020-02-05,2440,2356,84,3.57,1200
2020-02-06,2440,2358,82,3.48,1200
2020-02-07,2139,2057,82,3.99,1200
2020-02-08,513,361,152,42.11,1200
2020-02-09,346,160,186,116.25,1200
2020-02-10,2454,2334,120,5.14,1200
2020-02-11,2440,2356,84,3.57,1200
2020-02-12,2440,2359,81,3.43,1200
2020-02-13,2440,2360,80,3.39,1200
2020-02-14,2139,2060,79,3.83,1200
2020-02-15,513,365,148,40.55,1200
2020-02-16,346,166,180,108.43,1200
2020-02-17,2454,2342,112,4.78,1200
2020-02-18,2440,2366,74,3.13,1200
2020-02-19,2440,2373,67,2.82,1200
2020-02-20,2440,2377,63,2.65,1200
2020-02-21,2139,2081,58,2.79,1200
2020-02-22,513,389,124,31.88,1200
2020-02-23,346,194,152,78.35,1200
2020-02-24,2454,2373,81,3.41,1200
2020-02-25,2440,2402,38,1.58,1200
2020-02-26,2440,2411,29,1.2,1200
2020-02-27,2440,2419,21,0.87,1200
2020-02-28,2139,2125,14,0.66,1200
2020-02-29,513,435,78,17.93,1200
2020-03-01,362,241,121,50.21,1200
2020-03-02,2204,2421,-217,-8.96,1200
2020-03-03,2220,2450,-230,-9.39,1200
2020-03-04,2220,2459,-239,-9.72,1200
2020-03-05,2220,2465,-245,-9.94,1200
2020-03-06,1942,2169,-227,-10.47,1200
2020-03-07,480,478,2,0.42,1200
2020-03-08,362,281,81,28.83,1200
2020-03-09,2204,2458,-254,-10.33,1200
2020-03-10,2220,2483,-263,-10.59,1200
2020-03-11,2220,2488,-268,-10.77,1200
2020-03-12,2220,2490,-270,-10.84,1200
2020-03-13,1942,2191,-249,-11.36,1200
2020-03-14,480,495,-15,-3.03,1200
2020-03-15,362,294,68,23.13,1200
2020-03-16,2204,2468,-264,-10.7,1200
2020-03-17,2220,2490,-270,-10.84,1200
2020-03-18,2220,2493,-273,-10.95,1200
2020-03-19,2220,2493,-273,-10.95,1200
2020-03-20,1942,2192,-250,-11.41,1200
2020-03-21,480,495,-15,-3.03,1200
2020-03-22,362,294,68,23.13,1200
2020-03-23,2204,2468,-264,-10.7,1200
2020-03-24,2220,2490,-270,-10.84,1200
2020-03-25,2220,2494,-274,-10.99,1200
2020-03-26,2220,2495,-275,-11.02,1200
2020-03-27,1942,2195,-253,-11.53,1200
2020-03-28,480,501,-21,-4.19,1200
2020-03-29,362,302,60,19.87,1200
2020-03-30,2204,2478,-274,-11.06,1200
2020-03-31,2220,2502,-282,-11.27,1200
2020-04-01,2140,2508,-368,-14.67,1200
2020-04-02,2140,2512,-372,-14.81,1200
2020-04-03,1775,2214,-439,-19.83,1200
2020-04-04,437,521,-84,-16.12,1200
2020-04-05,254,323,-69,-21.36,1200
2020-04-06,2092,2500,-408,-16.32,1200
2020-04-07,2140,2526,-386,-15.28,1200
2020-04-08,2140,2532,-392,-15.48,1200
2020-04-09,2140,2535,-395,-15.58,1200
2020-04-10,1775,2237,-462,-20.65,1200
2020-04-11,437,543,-106,-19.52,1200
2020-04-12,254,343,-89,-25.95,1200
2020-04-13,2092,2519,-427,-16.95,1200
2020-04-14,2140,2542,-402,-15.81,1200
2020-04-15,2140,2546,-406,-15.95,1200
2020-04-16,2140,2548,-408,-16.01,1200
2020-04-17,1775,2247,-472,-21.01,1200
2020-04-18,437,551,-114,-20.69,1200
2020-04-19,254,350,-96,-27.43,1200
2020-04-20,2092,2524,-432,-17.12,1200
2020-04-21,2140,2546,-406,-15.95,1200
2020-04-22,2140,2549,-409,-16.05,1200
2020-04-23,2140,2550,-410,-16.08,1200
2020-04-24,1775,2249,-474,-21.08,1200
2020-04-25,437,553,-116,-20.98,1200
2020-04-26,254,353,-99,-28.05,1200
2020-04-27,2092,2527,-435,-17.21,1200
2020-04-28,2140,2551,-411,-16.11,1200
2020-04-29,2140,2555,-415,-16.24,1200
2020-04-30,2140,2558,-418,-16.34,1200
2020-05-01,2114,2259,-145,-6.42,1200
2020-05-02,529,565,-36,-6.37,1200
2020-05-03,331,367,-36,-9.81,1200
2020-05-04,2469,2544,-75,-2.95,1200
2020-05-05,2467,2569,-102,-3.97,1200
2020-05-06,2467,2575,-108,-4.19,1200
2020-05-07,2467,2579,-112,-4.34,1200
2020-05-08,2114,2281,-167,-7.32,1200
2020-05-09,529,588,-59,-10.03,1200
2020-05-10,331,389,-58,-14.91,1200
2020-05-11,2469,2566,-97,-3.78,1200
2020-05-12,2467,2590,-123,-4.75,1200
2020-05-13,2467,2595,-128,-4.93,1200
2020-05-14,2467,2596,-129,-4.97,1200
2020-05-15,2114,2296,-182,-7.93,1200
2020-05-16,529,600,-71,-11.83,1200
2020-05-17,331,398,-67,-16.83,1200
2020-05-18,2469,2571,-102,-3.97,1200
2020-05-19,2467,2592,-125,-4.82,1200
2020-05-20,2467,2592,-125,-4.82,1200
2020-05-21,2467,2590,-123,-4.75,1200
2020-05-22,2114,2286,-172,-7.52,1200
2020-05-23,529,586,-57,-9.73,1200
2020-05-24,331,381,-50,-13.12,1200
2020-05-25,2469,2551,-82,-3.21,1200
2020-05-26,2467,2569,-102,-3.97,1200
2020-05-27,2467,2567,-100,-3.9,1200
2020-05-28,2467,2563,-96,-3.75,1200
2020-05-29,2114,2258,-144,-6.38,1200
2020-05-30,529,558,-29,-5.2,1200
2020-05-31,331,353,-22,-6.23,1200
2020-06-01,2521,2523,-2,-0.08,1200
2020-06-02,2489,2542,-53,-2.08,1200
2020-06-03,2489,2542,-53,-2.08,1200
2020-06-04,2489,2540,-51,-2.01,1200
2020-06-05,2114,2237,-123,-5.5,1200
2020-06-06,507,539,-32,-5.94,1200
2020-06-07,340,337,3,0.89,1200
2020-06-08,2521,2510,11,0.44,1200
2020-06-09,2489,2532,-43,-1.7,1200
2020-06-10,2489,2535,-46,-1.81,1200
2020-06-11,2489,2535,-46,-1.81,1200
2020-06-12,2114,2234,-120,-5.37,1200
2020-06-13,507,538,-31,-5.76,1200
2020-06-14,340,337,3,0.89,1200
2020-06-15,2521,2511,10,0.4,1200
2020-06-16,2489,2532,-43,-1.7,1200
2020-06-17,2489,2534,-45,-1.78,1200
2020-06-18,2489,2533,-44,-1.74,1200
2020-06-19,2114,2231,-117,-5.24,1200
2020-06-20,507,532,-25,-4.7,1200
2020-06-21,340,328,12,3.66,1200
2020-06-22,2521,2498,23,0.92,1200
2020-06-23,2489,2515,-26,-1.03,1200
2020-06-24,2489,2513,-24,-0.96,1200
2020-06-25,2489,2508,-19,-0.76,1200
2020-06-26,2114,2201,-87,-3.95,1200
2020-06-27,507,498,9,1.81,1200
2020-06-28,340,289,51,17.65,1200
2020-06-29,2521,2455,66,2.69,1200
2020-06-30,2489,2470,19,0.77,1200
2020-07-01,2445,2465,-20,-0.81,1200
2020-07-02,2445,2457,-12,-0.49,1200
2020-07-03,2120,2148,-28,-1.3,1200
2020-07-04,487,444,43,9.68,1200
2020-07-05,322,235,87,37.02,1200
2020-07-06,2457,2402,55,2.29,1200
2020-07-07,2445,2418,27,1.12,1200
2020-07-08,2445,2414,31,1.28,1200
2020-07-09,2445,2410,35,1.45,1200
2020-07-10,2120,2104,16,0.76,1200
2020-07-11,487,404,83,20.54,1200
2020-07-12,322,199,123,61.81,1200
2020-07-13,2457,2370,87,3.67,1200
2020-07-14,2445,2390,55,2.3,1200
2020-07-15,2445,2392,53,2.22,1200
2020-07-16,2445,2392,53,2.22,1200
2020-07-17,2120,2090,30,1.44,1200
2020-07-18,487,394,93,23.6,1200
2020-07-19,322,193,129,66.84,1200
2020-07-20,2457,2367,90,3.8,1200
2020-07-21,2445,2389,56,2.34,1200
2020-07-22,2445,2392,53,2.22,1200
2020-07-23,2445,2393,52,2.17,1200
2020-07-24,2120,2091,29,1.39,1200
2020-07-25,487,394,93,23.6,1200
2020-07-26,322,192,130,67.71,1200
2020-07-27,2457,2363,94,3.98,1200
2020-07-28,2445,2383,62,2.6,1200
2020-07-29,2445,2382,63,2.64,1200
2020-07-30,2445,2379,66,2.77,1200
2020-07-31,2120,2073,47,2.27,1200
2020-08-01,486,371,115,31.0,1200
2020-08-02,310,164,146,89.02,1200
2020-08-03,2398,2332,66,2.83,1200
2020-08-04,2388,2347,41,1.75,1200
2020-08-05,2388,2343,45,1.92,1200
2020-08-06,2388,2336,52,2.23,1200
2020-08-07,2038,2028,10,0.49,1200
2020-08-08,486,324,162,50.0,1200
2020-08-09,310,116,194,167.24,1200
2020-08-10,2398,2283,115,5.04,1200
2020-08-11,2388,2299,89,3.87,1200
2020-08-12,2388,2297,91,3.96,1200
2020-08-13,2388,2293,95,4.14,1200
2020-08-14,2038,1988,50,2.52,1200
2020-08-15,486,289,197,68.17,1200
2020-08-16,310,87,223,256.32,1200
2020-08-17,2398,2260,138,6.11,1200
2020-08-18,2388,2283,105,4.6,1200
2020-08-19,2388,2288,100,4.37,1200
2020-08-20,2388,2292,96,4.19,1200
2020-08-21,2038,1995,43,2.16,1200
2020-08-22,486,304,182,59.87,1200
2020-08-23,310,109,201,184.4,1200
2020-08-24,2398,2289,109,4.76,1200
2020-08-25,2388,2319,69,2.98,1200
2020-08-26,2388,2330,58,2.49,1200
2020-08-27,2388,2339,49,2.09,1200
2020-08-28,2038,2047,-9,-0.44,1200
2020-08-29,486,360,126,35.0,1200
2020-08-30,310,167,143,85.63,1200
2020-08-31,2398,2349,49,2.09,1200
2020-09-01,2446,2380,66,2.77,1200
2020-09-02,2446,2390,56,2.34,1200
2020-09-03,2446,2398,48,2.0,1200
2020-09-04,2159,2103,56,2.66,1200
2020-09-05,485,413,72,17.43,1200
2020-09-06,309,216,93,43.06,1200
2020-09-07,2480,2394,86,3.59,1200
2020-09-08,2446,2420,26,1.07,1200
2020-09-09,2446,2425,21,0.87,1200
2020-09-10,2446,2427,19,0.78,1200
2020-09-11,2159,2127,32,1.5,1200
2020-09-12,485,431,54,12.53,1200
2020-09-13,309,230,79,34.35,1200
2020-09-14,2480,2403,77,3.2,1200
2020-09-15,2446,2424,22,0.91,1200
2020-09-16,2446,2425,21,0.87,1200
2020-09-17,2446,2425,21,0.87,1200
2020-09-18,2159,2122,37,1.74,1200
2020-09-19,485,424,61,14.39,1200
2020-09-20,309,222,87,39.19,1200
2020-09-21,2480,2395,85,3.55,1200
2020-09-22,2446,2416,30,1.24,1200
2020-09-23,2446,2419,27,1.12,1200
2020-09-24,2446,2420,26,1.07,1200
2020-09-25,2159,2119,40,1.89,1200
2020-09-26,485,424,61,14.39,1200
2020-09-27,309,224,85,37.95,1200
2020-09-28,2480,2400,80,3.33,1200
2020-09-29,2446,2424,22,0.91,1200
2020-09-30,2446,2429,17,0.7,1200
2020-10-01,2504,2432,72,2.96,1200
2020-10-02,2226,2134,92,4.31,1200
2020-10-03,528,440,88,20.0,1200
2020-10-04,306,242,64,26.45,1200
2020-10-05,2508,2418,90,3.72,1200
2020-10-06,2504,2442,62,2.54,1200
2020-10-07,2504,2447,57,2.33,1200
2020-10-08,2504,2449,55,2.25,1200
2020-10-09,2226,2150,76,3.53,1200
2020-10-10,528,454,74,16.3,1200
2020-10-11,306,253,53,20.95,1200
2020-10-12,2508,2426,82,3.38,1200
2020-10-13,2504,2448,56,2.29,1200
2020-10-14,2504,2450,54,2.2,1200
2020-10-15,2504,2449,55,2.25,1200
2020-10-16,2226,2146,80,3.73,1200
2020-10-17,528,447,81,18.12,1200
2020-10-18,306,243,63,25.93,1200
2020-10-19,2508,2415,93,3.85,1200
2020-10-20,2504,2434,70,2.88,1200
2020-10-21,2504,2435,69,2.83,1200
2020-10-22,2504,2433,71,2.92,1200
2020-10-23,2226,2130,96,4.51,1200
2020-10-24,528,432,96,22.22,1200
2020-10-25,306,230,76,33.04,1200
2020-10-26,2508,2403,105,4.37,1200
2020-10-27,2504,2425,79,3.26,1200
2020-10-28,2504,2429,75,3.09,1200
2020-10-29,2504,2430,74,3.05,1200
2020-10-30,2226,2131,95,4.46,1200
2020-10-31,528,437,91,20.82,1200
2020-11-01,323,239,84,35.15,1200
2020-11-02,2534,2416,118,4.88,1200
2020-11-03,2542,2442,100,4.1,1200
2020-11-04,2542,2449,93,3.8,1200
2020-11-05,2542,2454,88,3.59,1200
2020-11-06,2215,2157,58,2.69,1200
2020-11-07,511,465,46,9.89,1200
2020-11-08,323,268,55,20.52,1200
2020-11-09,2534,2445,89,3.64,1200
2020-11-10,2542,2471,71,2.87,1200
2020-11-11,2542,2476,66,2.67,1200
2020-11-12,2542,2478,64,2.58,1200
2020-11-13,2215,2178,37,1.7,1200
2020-11-14,511,481,30,6.24,1200
2020-11-15,323,279,44,15.77,1200
2020-11-16,2534,2450,84,3.43,1200
2020-11-17,2542,2468,74,3.0,1200
2020-11-18,2542,2467,75,3.04,1200
2020-11-19,2542,2461,81,3.29,1200
2020-11-20,2215,2153,62,2.88,1200
2020-11-21,511,449,62,13.81,1200
2020-11-22,323,239,84,35.15,1200
2020-11-23,2534,2403,131,5.45,1200
2020-11-24,2542,2414,128,5.3,1200
2020-11-25,2542,2406,136,5.65,1200
2020-11-26,2542,2395,147,6.14,1200
2020-11-27,2215,2082,133,6.39,1200
2020-11-28,511,374,137,36.63,1200
2020-11-29,323,161,162,100.62,1200
2020-11-30,2534,2323,211,9.08,1200
2020-12-01,2177,2334,-157,-6.73,1200
2020-12-02,2177,2326,-149,-6.41,1200
2020-12-03,2177,2317,-140,-6.04,1200
2020-12-04,2362,2006,356,17.75,1200
2020-12-05,630,301,329,109.3,1200
2020-12-06,346,92,254,276.09,1200
2020-12-07,2317,2259,58,2.57,1200
2020-12-08,2177,2274,-97,-4.27,1200
2020-12-09,2177,2272,-95,-4.18,1200
2020-12-10,2177,2268,-91,-4.01,1200
2020-12-11,2362,1963,399,20.33,1200
2020-12-12,630,263,367,139.54,1200
2020-12-13,346,59,287,486.44,1200
2020-12-14,2317,2230,87,3.9,1200
2020-12-15,2177,2250,-73,-3.24,1200
2020-12-16,2177,2251,-74,-3.29,1200
2020-12-17,2177,2250,-73,-3.24,1200
2020-12-18,2362,1947,415,21.31,1200
2020-12-19,630,248,382,154.03,1200
2020-12-20,346,44,302,686.36,1200
2020-12-21,2317,2215,102,4.6,1200
2020-12-22,2177,2234,-57,-2.55,1200
2020-12-23,2177,2232,-55,-2.46,1200
2020-12-24,2177,2228,-51,-2.29,1200
2020-12-25,2362,1922,440,22.89,1200
2020-12-26,630,219,411,187.67,1200
2020-12-27,346,12,334,2783.33,1200
2020-12-28,2317,2178,139,6.38,1200
2020-12-29,2177,2192,-15,-0.68,1200
2020-12-30,2177,2187,-10,-0.46,1200
2020-12-31,2177,2179,-2,-0.09,1200
2021-01-01,2028,1869,159,8.51,1200
2021-01-02,451,163,288,176.69,1200
2021-01-03,324,50,274,548.0,1200
2021-01-04,2200,2118,82,3.87,1200
2021-01-05,2266,2131,135,6.34,1200
2021-01-06,2266,2126,140,6.59,1200
2021-01-07,2266,2119,147,6.94,1200
2021-01-08,2028,1810,218,12.04,1200
2021-01-09,451,108,343,317.59,1200
2021-01-10,324,27,297,1100.0,1200
2021-01-11,2200,2070,130,6.28,1200
2021-01-12,2266,2088,178,8.52,1200
2021-01-13,2266,2089,177,8.47,1200
2021-01-14,2266,2087,179,8.58,1200
2021-01-15,2028,1786,242,13.55,1200
2021-01-16,451,89,362,406.74,1200
2021-01-17,324,21,303,1442.86,1200
2021-01-18,2200,2065,135,6.54,1200
2021-01-19,2266,2090,176,8.42,1200
2021-01-20,2266,2096,170,8.11,1200
2021-01-21,2266,2100,166,7.9,1200
2021-01-22,2028,1803,225,12.48,1200
2021-01-23,451,111,340,306.31,1200
2021-01-24,324,36,288,800.0,1200
2021-01-25,2200,2093,107,5.11,1200
2021-01-26,2266,2120,146,6.89,1200
2021-01-27,2266,2127,139,6.54,1200
2021-01-28,2266,2132,134,6.29,1200
2021-01-29,2028,1835,193,10.52,1200
2021-01-30,451,142,309,217.61,1200
2021-01-31,324,45,279,620.0,1200
2021-02-01,2403,2120,283,13.35,1200
2021-02-02,2405,2144,261,12.17,1200
2021-02-03,2405,2149,256,11.91,1200
2021-02-04,2405,2151,254,11.81,1200
2021-02-05,2069,1851,218,11.78,1200
2021-02-06,503,155,348,224.52,1200
2021-02-07,324,54,270,500.0,1200
2021-02-08,2403,2128,275,12.92,1200
2021-02-09,2405,2150,255,11.86,1200
2021-02-10,2405,2153,252,11.7,1200
2021-02-11,2405,2154,251,11.65,1200
2021-02-12,2069,1853,216,11.66,1200
2021-02-13,503,158,345,218.35,1200
2021-02-14,324,59,265,449.15,1200
2021-02-15,2403,2133,270,12.66,1200
2021-02-16,2405,2157,248,11.5,1200
2021-02-17,2405,2163,242,11.19,1200
2021-02-18,2405,2167,238,10.98,1200
2021-02-19,2069,1869,200,10.7,1200
2021-02-20,503,177,326,184.18,1200
2021-02-21,324,73,251,343.84,1200
2021-02-22,2403,2160,243,11.25,1200
2021-02-23,2405,2188,217,9.92,1200
2021-02-24,2405,2197,208,9.47,1200
2021-02-25,2405,2204,201,9.12,1200
2021-02-26,2069,1910,159,8.32,1200
2021-02-27,503,221,282,127.6,1200
2021-02-28,324,27,297,1100.0,1200
2021-03-01,2559,2207,352,15.95,1200
2021-03-02,2547,2236,311,13.91,1200
2021-03-03,2547,2246,301,13.4,1200
2021-03-04,2547,2252,295,13.1,1200
2021-03-05,2230,1957,273,13.95,1200
2021-03-06,536,266,270,101.5,1200
2021-03-07,316,70,246,351.43,1200
2021-03-08,2559,2248,311,13.83,1200
2021-03-09,2547,2273,274,12.05,1200
2021-03-10,2547,2279,268,11.76,1200
2021-03-11,2547,2282,265,11.61,1200
2021-03-12,2230,1983,247,12.46,1200
2021-03-13,536,288,248,86.11,1200
2021-03-14,316,88,228,259.09,1200
2021-03-15,2559,2262,297,13.13,1200
2021-03-16,2547,2285,262,11.47,1200
2021-03-17,2547,2287,260,11.37,1200
2021-03-18,2547,2288,259,11.32,1200
2021-03-19,2230,1986,244,12.29,1200
2021-03-20,536,290,246,84.83,1200
2021-03-21,316,88,228,259.09,1200
2021-03-22,2559,2262,297,13.13,1200
2021-03-23,2547,2284,263,11.51,1200
2021-03-24,2547,2287,260,11.37,1200
2021-03-25,2547,2288,259,11.32,1200
2021-03-26,2230,1988,242,12.17,1200
2021-03-27,536,293,243,82.94,1200
2021-03-28,316,93,223,239.78,1200
2021-03-29,2559,2269,290,12.78,1200
2021-03-30,2547,2293,254,11.08,1200
2021-03-31,2547,2299,248,10.79,1200
2021-04-01,2611,2302,309,13.42,1200
2021-04-02,2253,2004,249,12.43,1200
2021-04-03,542,311,231,74.28,1200
2021-04-04,295,113,182,161.06,1200
2021-04-05,2594,2290,304,13.28,1200
2021-04-06,2611,2316,295,12.74,1200
2021-04-07,2611,2322,289,12.45,1200
2021-04-08,2611,2326,285,12.25,1200
2021-04-09,2253,2028,225,11.09,1200
2021-04-10,542,334,208,62.28,1200
2021-04-11,295,135,160,118.52,1200
2021-04-12,2594,2311,283,12.25,1200
2021-04-13,2611,2335,276,11.82,1200
2021-04-14,2611,2339,272,11.63,1200
2021-04-15,2611,2341,270,11.53,1200
2021-04-16,2253,2041,212,10.39,1200
2021-04-17,542,345,197,57.1,1200
2021-04-18,295,144,151,104.86,1200
2021-04-19,2594,2318,276,11.91,1200
2021-04-20,2611,2340,271,11.58,1200
2021-04-21,2611,2343,268,11.44,1200
2021-04-22,2611,2344,267,11.39,1200
2021-04-23,2253,2043,210,10.28,1200
2021-04-24,542,347,195,56.2,1200
2021-04-25,295,146,149,102.05,1200
2021-04-26,2594,2320,274,11.81,1200
2021-04-27,2611,2343,268,11.44,1200
2021-04-28,2611,2348,263,11.2,1200
2021-04-29,2611,2350,261,11.11,1200
2021-04-30,2253,2050,203,9.9,1200
2021-05-01,571,356,215,60.39,1200
2021-05-02,326,158,168,106.33,1200
2021-05-03,2602,2334,268,11.48,1200
2021-05-04,2606,2359,247,10.47,1200
2021-05-05,2606,2365,241,10.19,1200
2021-05-06,2606,2369,237,10.0,1200
2021-05-07,2344,2071,273,13.18,1200
2021-05-08,571,378,193,51.06,1200
2021-05-09,326,180,146,81.11,1200
2021-05-10,2602,2356,246,10.44,1200
2021-05-11,2606,2381,225,9.45,1200
2021-05-12,2606,2386,220,9.22,1200
2021-05-13,2606,2389,217,9.08,1200
2021-05-14,2344,2089,255,12.21,1200
2021-05-15,571,394,177,44.92,1200
2021-05-16,326,193,133,68.91,1200
2021-05-17,2602,2366,236,9.97,1200
2021-05-18,2606,2388,218,9.13,1200
2021-05-19,2606,2389,217,9.08,1200
2021-05-20,2606,2388,218,9.13,1200
2021-05-21,2344,2084,260,12.48,1200
2021-05-22,571,385,186,48.31,1200
2021-05-23,326,180,146,81.11,1200
2021-05-24,2602,2350,252,10.72,1200
2021-05-25,2606,2368,238,10.05,1200
2021-05-26,2606,2367,239,10.1,1200
2021-05-27,2606,2363,243,10.28,1200
2021-05-28,2344,2058,286,13.9,1200
2021-05-29,571,357,214,59.94,1200
2021-05-30,326,152,174,114.47,1200
2021-05-31,2602,2322,280,12.06,1200
2021-06-01,2611,2340,271,11.58,1200
2021-06-02,2611,2340,271,11.58,1200
2021-06-03,2611,2337,274,11.72,1200
2021-06-04,2246,2034,212,10.42,1200
2021-06-05,552,336,216,64.29,1200
2021-06-06,362,133,229,172.18,1200
2021-06-07,2653,2305,348,15.1,1200
2021-06-08,2611,2327,284,12.2,1200
2021-06-09,2611,2329,282,12.11,1200
2021-06-10,2611,2329,282,12.11,1200
2021-06-11,2246,2028,218,10.75,1200
2021-06-12,552,332,220,66.27,1200
2021-06-13,362,131,231,176.34,1200
2021-06-14,2653,2305,348,15.1,1200
2021-06-15,2611,2327,284,12.2,1200
2021-06-16,2611,2329,282,12.11,1200
2021-06-17,2611,2329,282,12.11,1200
2021-06-18,2246,2027,219,10.8,1200
2021-06-19,552,329,223,67.78,1200
2021-06-20,362,125,237,189.6,1200
2021-06-21,2653,2296,357,15.55,1200
2021-06-22,2611,2315,296,12.79,1200
2021-06-23,2611,2314,297,12.83,1200
2021-06-24,2611,2309,302,13.08,1200
2021-06-25,2246,2003,243,12.13,1200
2021-06-26,552,300,252,84.0,1200
2021-06-27,362,92,270,293.48,1200
2021-06-28,2653,2259,394,17.44,1200
2021-06-29,2611,2274,337,14.82,1200
2021-06-30,2611,2269,342,15.07,1200
2021-07-01,2489,2261,228,10.08,1200
2021-07-02,2174,1952,222,11.37,1200
2021-07-03,526,248,278,112.1,1200
2021-07-04,336,39,297,761.54,1200
2021-07-05,2468,2205,263,11.93,1200
2021-07-06,2489,2220,269,12.12,1200
2021-07-07,2489,2216,273,12.32,1200
2021-07-08,2489,2211,278,12.57,1200
2021-07-09,2174,1904,270,14.18,1200
2021-07-10,526,203,323,159.11,1200
2021-07-11,336,98,238,242.86,1200
2021-07-12,2468,2168,300,13.84,1200
2021-07-13,2489,2187,302,13.81,1200
2021-07-14,2489,2188,301,13.76,1200
2021-07-15,2489,2187,302,13.81,1200
2021-07-16,2174,1885,289,15.33,1200
2021-07-17,526,188,338,179.79,1200
2021-07-18,336,95,241,253.68,1200
2021-07-19,2468,2161,307,14.21,1200
2021-07-20,2489,2183,306,14.02,1200
2021-07-21,2489,2186,303,13.86,1200
2021-07-22,2489,2187,302,13.81,1200
2021-07-23,2174,1886,288,15.27,1200
2021-07-24,526,189,337,178.31,1200
2021-07-25,336,94,242,257.45,1200
2021-07-26,2468,2160,308,14.26,1200
2021-07-27,2489,2180,309,14.17,1200
2021-07-28,2489,2181,308,14.12,1200
2021-07-29,2489,2178,311,14.28,1200
2021-07-30,2174,1873,301,16.07,1200
2021-07-31,526,172,354,205.81,1200
2021-08-01,315,81,234,288.89,1200
2021-08-02,2312,2134,178,8.34,1200
2021-08-03,2324,2150,174,8.09,1200
2021-08-04,2324,2146,178,8.29,1200
2021-08-05,2324,2139,185,8.65,1200
2021-08-06,2018,1831,187,10.21,1200
2021-08-07,496,127,369,290.55,1200
2021-08-08,315,52,263,505.77,1200
2021-08-09,2312,2085,227,10.89,1200
2021-08-10,2324,2101,223,10.61,1200
2021-08-11,2324,2098,226,10.77,1200
2021-08-12,2324,2093,231,11.04,1200
2021-08-13,2018,1787,231,12.93,1200
2021-08-14,496,87,409,470.11,1200
2021-08-15,315,44,271,615.91,1200
2021-08-16,2312,2055,257,12.51,1200
2021-08-17,2324,2076,248,11.95,1200
2021-08-18,2324,2080,244,11.73,1200
2021-08-19,2324,2082,242,11.62,1200
2021-08-20,2018,1784,234,13.12,1200
2021-08-21,496,92,404,439.13,1200
2021-08-22,315,56,259,462.5,1200
2021-08-23,2312,2075,237,11.42,1200
2021-08-24,2324,2104,220,10.46,1200
2021-08-25,2324,2114,210,9.93,1200
2021-08-26,2324,2123,201,9.47,1200
2021-08-27,2018,1830,188,10.27,1200
2021-08-28,496,143,353,246.85,1200
2021-08-29,315,82,233,284.15,1200
2021-08-30,2312,2133,179,8.39,1200
2021-08-31,2324,2164,160,7.39,1200
2021-09-01,2518,2175,343,15.77,1200
2021-09-02,2518,2183,335,15.35,1200
2021-09-03,2193,1889,304,16.09,1200
2021-09-04,527,200,327,163.5,1200
2021-09-05,311,4,307,7675.0,1200
2021-09-06,2537,2183,354,16.22,1200
2021-09-07,2518,2210,308,13.94,1200
2021-09-08,2518,2216,302,13.63,1200
2021-09-09,2518,2219,299,13.47,1200
2021-09-10,2193,1920,273,14.22,1200
2021-09-11,527,225,302,134.22,1200
2021-09-12,311,24,287,1195.83,1200
2021-09-13,2537,2198,339,15.42,1200
2021-09-14,2518,2219,299,13.47,1200
2021-09-15,2518,2221,297,13.37,1200
2021-09-16,2518,2221,297,13.37,1200
2021-09-17,2193,1918,275,14.34,1200
2021-09-18,527,220,307,139.55,1200
2021-09-19,311,18,293,1627.78,1200
2021-09-20,2537,2190,347,15.84,1200
2021-09-21,2518,2211,307,13.89,1200
2021-09-22,2518,2214,304,13.73,1200
2021-09-23,2518,2214,304,13.73,1200
2021-09-24,2193,1913,280,14.64,1200
2021-09-25,527,217,310,142.86,1200
2021-09-26,311,17,294,1729.41,1200
2021-09-27,2537,2192,345,15.74,1200
2021-09-28,2518,2216,302,13.63,1200
2021-09-29,2518,2220,298,13.42,1200
2021-09-30,2518,2223,295,13.27,1200
2021-10-01,2311,1925,386,20.05,1200
2021-10-02,551,231,320,138.53,1200
2021-10-03,312,33,279,845.45,1200
2021-10-04,2525,2209,316,14.31,1200
2021-10-05,2599,2234,365,16.34,1200
2021-10-06,2599,2239,360,16.08,1200
2021-10-07,2599,2242,357,15.92,1200
2021-10-08,2311,1942,369,19.0,1200
2021-10-09,551,247,304,123.08,1200
2021-10-10,312,47,265,563.83,1200
2021-10-11,2525,2221,304,13.69,1200
2021-10-12,2599,2243,356,15.87,1200
2021-10-13,2599,2245,354,15.77,1200
2021-10-14,2599,2245,354,15.77,1200
2021-10-15,2311,1942,369,19.0,1200
2021-10-16,551,244,307,125.82,1200
2021-10-17,312,40,272,680.0,1200
2021-10-18,2525,2212,313,14.15,1200
2021-10-19,2599,2231,368,16.49,1200
2021-10-20,2599,2232,367,16.44,1200
2021-10-21,2599,2230,369,16.55,1200
2021-10-22,2311,1927,384,19.93,1200
2021-10-23,551,228,323,141.67,1200
2021-10-24,312,25,287,1148.0,1200
2021-10-25,2525,2198,327,14.88,1200
2021-10-26,2599,2219,380,17.12,1200
2021-10-27,2599,2222,377,16.97,1200
2021-10-28,2599,2223,376,16.91,1200
2021-10-29,2311,1923,388,20.18,1200
2021-10-30,551,229,322,140.61,1200
2021-10-31,312,30,282,940.0,1200
2021-11-01,2650,2206,444,20.13,1200
2021-11-02,2639,2232,407,18.23,1200
2021-11-03,2639,2238,401,17.92,1200
2021-11-04,2639,2243,396,17.65,1200
2021-11-05,2328,1946,382,19.63,1200
2021-11-06,602,254,348,137.01,1200
2021-11-07,312,57,255,447.37,1200
2021-11-08,2650,2235,415,18.57,1200
2021-11-09,2639,2261,378,16.72,1200
2021-11-10,2639,2267,372,16.41,1200
2021-11-11,2639,2270,369,16.26,1200
2021-11-12,2328,1971,357,18.11,1200
2021-11-13,602,276,326,118.12,1200
2021-11-14,312,74,238,321.62,1200
2021-11-15,2650,2247,403,17.94,1200
2021-11-16,2639,2267,372,16.41,1200
2021-11-17,2639,2267,372,16.41,1200
2021-11-18,2639,2263,376,16.62,1200
2021-11-19,2328,1956,372,19.02,1200
2021-11-20,602,253,349,137.94,1200
2021-11-21,312,44,268,609.09,1200
2021-11-22,2650,2209,441,19.96,1200
2021-11-23,2639,2221,418,18.82,1200
2021-11-24,2639,2214,425,19.2,1200
2021-11-25,2639,2204,435,19.74,1200
2021-11-26,2328,1891,437,23.11,1200
2021-11-27,602,183,419,228.96,1200
2021-11-28,312,109,203,186.24,1200
2021-11-29,2650,2132,518,24.3,1200
2021-11-30,2639,2143,496,23.15,1200
2021-12-01,2272,2134,138,6.47,1200
2021-12-02,2272,2124,148,6.97,1200
2021-12-03,1699,1812,-113,-6.24,1200
2021-12-04,607,106,501,472.64,1200
2021-12-05,284,70,214,305.71,1200
2021-12-06,2472,2062,410,19.88,1200
2021-12-07,2272,2077,195,9.39,1200
2021-12-08,2272,2073,199,9.6,1200
2021-12-09,2272,2068,204,9.86,1200
2021-12-10,1699,1762,-63,-3.58,1200
2021-12-11,607,61,546,895.08,1200
2021-12-12,284,62,222,358.06,1200
2021-12-13,2472,2027,445,21.95,1200
2021-12-14,2272,2047,225,10.99,1200
2021-12-15,2272,2048,224,10.94,1200
2021-12-16,2272,2046,226,11.05,1200
2021-12-17,1699,1743,-44,-2.52,1200
2021-12-18,607,45,562,1248.89,1200
2021-12-19,284,51,233,456.86,1200
2021-12-20,2472,2013,459,22.8,1200
2021-12-21,2272,2032,240,11.81,1200
2021-12-22,2272,2032,240,11.81,1200
2021-12-23,2272,2028,244,12.03,1200
2021-12-24,1699,1723,-24,-1.39,1200
2021-12-25,607,21,586,2790.48,1200
2021-12-26,284,49,235,479.59,1200
2021-12-27,2472,1981,491,24.79,1200
2021-12-28,2272,1996,276,13.83,1200
2021-12-29,2272,1991,281,14.11,1200
2021-12-30,2272,1984,288,14.52,1200
2021-12-31,1699,1674,25,1.49,1200
2022-01-01,492,120,372,310.0,1200
2022-01-02,267,21,246,1171.43,1200
2022-01-03,2259,1923,336,17.47,1200
2022-01-04,2283,1936,347,17.92,1200
2022-01-05,2283,1930,353,18.29,1200
2022-01-06,2283,1923,360,18.72,1200
2022-01-07,2035,1614,421,26.08,1200
2022-01-08,492,86,406,472.09,1200
2022-01-09,267,86,181,210.47,1200
2022-01-10,2259,1870,389,20.8,1200
2022-01-11,2283,1887,396,20.99,1200
2022-01-12,2283,1886,397,21.05,1200
2022-01-13,2283,1884,399,21.18,1200
2022-01-14,2035,1581,454,28.72,1200
2022-01-15,492,72,420,583.33,1200
2022-01-16,267,72,195,270.83,1200
2022-01-17,2259,1857,402,21.65,1200
2022-01-18,2283,1881,402,21.37,1200
2022-01-19,2283,1886,397,21.05,1200
2022-01-20,2283,1890,393,20.79,1200
2022-01-21,2035,1592,443,27.83,1200
2022-01-22,492,86,406,472.09,1200
2022-01-23,267,86,181,210.47,1200
2022-01-24,2259,1881,378,20.1,1200
2022-01-25,2283,1908,375,19.65,1200
2022-01-26,2283,1916,367,19.15,1200
2022-01-27,2283,1921,362,18.84,1200
2022-01-28,2035,1624,411,25.31,1200
2022-01-29,492,107,385,359.81,1200
2022-01-30,267,4,263,6575.0,1200
2020-02-01,392,304,88,28.95,1201
2020-02-02,280,151,129,85.43,1201
2020-02-03,2000,1942,58,2.99,1201
2020-02-04,2036,1951,85,4.36,1201
2020-02-05,2036,1954,82,4.2,1201
2020-02-06,2036,1955,81,4.14,1201
2020-02-07,1786,1741,45,2.58,1201
2020-02-08,392,309,83,26.86,1201
2020-02-09,280,154,126,81.82,1201
2020-02-10,2000,1943,57,2.93,1201
2020-02-11,2036,1951,85,4.36,1201
2020-02-12,2036,1954,82,4.2,1201
2020-02-13,2036,1954,82,4.2,1201
2020-02-14,1786,1740,46,2.64,1201
2020-02-15,392,310,82,26.45,1201
2020-02-16,280,156,124,79.49,1201
2020-02-17,2000,1947,53,2.72,1201
2020-02-18,2036,1958,78,3.98,1201
2020-02-19,2036,1963,73,3.72,1201
2020-02-20,2036,1967,69,3.51,1201
2020-02-21,1786,1756,30,1.71,1201
2020-02-22,392,329,63,19.15,1201
2020-02-23,280,178,102,57.3,1201
2020-02-24,2000,1973,27,1.37,1201
2020-02-25,2036,1986,50,2.52,1201
2020-02-26,2036,1995,41,2.06,1201
2020-02-27,2036,2001,35,1.75,1201
2020-02-28,1786,1792,-6,-0.33,1201
2020-02-29,392,367,25,6.81,1201
2020-03-01,320,218,102,46.79,1201
2020-03-02,1861,2013,-152,-7.55,1201
2020-03-03,1847,2027,-180,-8.88,1201
2020-03-04,1847,2035,-188,-9.24,1201
2020-03-05,1847,2040,-193,-9.46,1201
2020-03-06,1634,1830,-196,-10.71,1201
2020-03-07,405,403,2,0.5,1201
2020-03-08,320,251,69,27.49,1201
2020-03-09,1861,2044,-183,-8.95,1201
2020-03-10,1847,2055,-208,-10.12,1201
2020-03-11,1847,2059,-212,-10.3,1201
2020-03-12,1847,2062,-215,-10.43,1201
2020-03-13,1634,1848,-214,-11.58,1201
2020-03-14,405,418,-13,-3.11,1201
2020-03-15,320,263,57,21.67,1201
2020-03-16,1861,2053,-192,-9.35,1201
2020-03-17,1847,2061,-214,-10.38,1201
2020-03-18,1847,2064,-217,-10.51,1201
2020-03-19,1847,2064,-217,-10.51,1201
2020-03-20,1634,1849,-215,-11.63,1201
2020-03-21,405,417,-12,-2.88,1201
2020-03-22,320,262,58,22.14,1201
2020-03-23,1861,2051,-190,-9.26,1201
2020-03-24,1847,2059,-212,-10.3,1201
2020-03-25,1847,2061,-214,-10.38,1201
2020-03-26,1847,2062,-215,-10.43,1201
2020-03-27,1634,1848,-214,-11.58,1201
2020-03-28,405,417,-12,-2.88,1201
2020-03-29,320,263,57,21.67,1201
2020-03-30,1861,2053,-192,-9.35,1201
2020-03-31,1847,2063,-216,-10.47,1201
2020-04-01,1884,2067,-183,-8.85,1201
2020-04-02,1884,2069,-185,-8.94,1201
2020-04-03,1588,1856,-268,-14.44,1201
2020-04-04,405,426,-21,-4.93,1201
2020-04-05,237,273,-36,-13.19,1201
2020-04-06,1889,2064,-175,-8.48,1201
2020-04-07,1884,2074,-190,-9.16,1201
2020-04-08,1884,2078,-194,-9.34,1201
2020-04-09,1884,2080,-196,-9.42,1201
2020-04-10,1588,1867,-279,-14.94,1201
2020-04-11,405,437,-32,-7.32,1201
2020-04-12,237,283,-46,-16.25,1201
2020-04-13,1889,2073,-184,-8.88,1201
2020-04-14,1884,2083,-199,-9.55,1201
2020-04-15,1884,2086,-202,-9.68,1201
2020-04-16,1884,2087,-203,-9.73,1201
2020-04-17,1588,1873,-285,-15.22,1201
2020-04-18,405,443,-38,-8.58,1201
2020-04-19,237,289,-52,-17.99,1201
2020-04-20,1889,2078,-189,-9.1,1201
2020-04-21,1884,2088,-204,-9.77,1201
2020-04-22,1884,2091,-207,-9.9,1201
2020-04-23,1884,2093,-209,-9.99,1201
2020-04-24,1588,1879,-291,-15.49,1201
2020-04-25,405,449,-44,-9.8,1201
2020-04-26,237,296,-59,-19.93,1201
2020-04-27,1889,2087,-198,-9.49,1201
2020-04-28,1884,2097,-213,-10.16,1201
2020-04-29,1884,2101,-217,-10.33,1201
2020-04-30,1884,2104,-220,-10.46,1201
2020-05-01,1850,1892,-42,-2.22,1201
2020-05-02,458,464,-6,-1.29,1201
2020-05-03,298,311,-13,-4.18,1201
2020-05-04,2112,2103,9,0.43,1201
2020-05-05,2118,2114,4,0.19,1201
2020-05-06,2118,2120,-2,-0.09,1201
2020-05-07,2118,2123,-5,-0.24,1201
2020-05-08,1850,1911,-61,-3.19,1201
2020-05-09,458,482,-24,-4.98,1201
2020-05-10,298,329,-31,-9.42,1201
2020-05-11,2112,2120,-8,-0.38,1201
2020-05-12,2118,2130,-12,-0.56,1201
2020-05-13,2118,2134,-16,-0.75,1201
2020-05-14,2118,2135,-17,-0.8,1201
2020-05-15,1850,1921,-71,-3.7,1201
2020-05-16,458,490,-32,-6.53,1201
2020-05-17,298,335,-37,-11.04,1201
2020-05-18,2112,2124,-12,-0.56,1201
2020-05-19,2118,2131,-13,-0.61,1201
2020-05-20,2118,2133,-15,-0.7,1201
2020-05-21,2118,2132,-14,-0.66,1201
2020-05-22,1850,1915,-65,-3.39,1201
2020-05-23,458,483,-25,-5.18,1201
2020-05-24,298,326,-28,-8.59,1201
2020-05-25,2112,2113,-1,-0.05,1201
2020-05-26,2118,2119,-1,-0.05,1201
2020-05-27,2118,2120,-2,-0.09,1201
2020-05-28,2118,2119,-1,-0.05,1201
2020-05-29,1850,1903,-53,-2.79,1201
2020-05-30,458,470,-12,-2.55,1201
2020-05-31,298,314,-16,-5.1,1201
2020-06-01,2136,2103,33,1.57,1201
2020-06-02,2132,2110,22,1.04,1201
2020-06-03,2132,2113,19,0.9,1201
2020-06-04,2132,2113,19,0.9,1201
2020-06-05,1838,1899,-61,-3.21,1201
2020-06-06,444,468,-24,-5.13,1201
2020-06-07,315,314,1,0.32,1201
2020-06-08,2136,2104,32,1.52,1201
2020-06-09,2132,2113,19,0.9,1201
2020-06-10,2132,2117,15,0.71,1201
2020-06-11,2132,2118,14,0.66,1201
2020-06-12,1838,1904,-66,-3.47,1201
2020-06-13,444,474,-30,-6.33,1201
2020-06-14,315,319,-4,-1.25,1201
2020-06-15,2136,2108,28,1.33,1201
2020-06-16,2132,2116,16,0.76,1201
2020-06-17,2132,2118,14,0.66,1201
2020-06-18,2132,2118,14,0.66,1201
2020-06-19,1838,1901,-63,-3.31,1201
2020-06-20,444,468,-24,-5.13,1201
2020-06-21,315,310,5,1.61,1201
2020-06-22,2136,2096,40,1.91,1201
2020-06-23,2132,2101,31,1.48,1201
2020-06-24,2132,2099,33,1.57,1201
2020-06-25,2132,2095,37,1.77,1201
2020-06-26,1838,1876,-38,-2.03,1201
2020-06-27,444,439,5,1.14,1201
2020-06-28,315,279,36,12.9,1201
2020-06-29,2136,2062,74,3.59,1201
2020-06-30,2132,2065,67,3.24,1201
2020-07-01,2208,2062,146,7.08,1201
2020-07-02,2208,2057,151,7.34,1201
2020-07-03,1903,1836,67,3.65,1201
2020-07-04,463,400,63,15.75,1201
2020-07-05,331,240,91,37.92,1201
2020-07-06,2248,2025,223,11.01,1201
2020-07-07,2208,2029,179,8.82,1201
2020-07-08,2208,2028,180,8.88,1201
2020-07-09,2208,2025,183,9.04,1201
2020-07-10,1903,1807,96,5.31,1201
2020-07-11,463,374,89,23.8,1201
2020-07-12,331,217,114,52.53,1201
2020-07-13,2248,2005,243,12.12,1201
2020-07-14,2208,2012,196,9.74,1201
2020-07-15,2208,2014,194,9.63,1201
2020-07-16,2208,2014,194,9.63,1201
2020-07-17,1903,1799,104,5.78,1201
2020-07-18,463,368,95,25.82,1201
2020-07-19,331,212,119,56.13,1201
2020-07-20,2248,2001,247,12.34,1201
2020-07-21,2208,2009,199,9.91,1201
2020-07-22,2208,2011,197,9.8,1201
2020-07-23,2208,2011,197,9.8,1201
2020-07-24,1903,1795,108,6.02,1201
2020-07-25,463,363,100,27.55,1201
2020-07-26,331,206,125,60.68,1201
2020-07-27,2248,1993,255,12.79,1201
2020-07-28,2208,1998,210,10.51,1201
2020-07-29,2208,1997,211,10.57,1201
2020-07-30,2208,1994,214,10.73,1201
2020-07-31,1903,1775,128,7.21,1201
2020-08-01,462,339,123,36.28,1201
2020-08-02,330,179,151,84.36,1201
2020-08-03,2108,1963,145,7.39,1201
2020-08-04,2192,1966,226,11.5,1201
2020-08-05,2192,1963,229,11.67,1201
2020-08-06,2192,1959,233,11.89,1201
2020-08-07,1838,1738,100,5.75,1201
2020-08-08,462,302,160,52.98,1201
2020-08-09,330,142,188,132.39,1201
2020-08-10,2108,1927,181,9.39,1201
2020-08-11,2192,1931,261,13.52,1201
2020-08-12,2192,1930,262,13.58,1201
2020-08-13,2192,1928,264,13.69,1201
2020-08-14,1838,1711,127,7.42,1201
2020-08-15,462,278,184,66.19,1201
2020-08-16,330,122,208,170.49,1201
2020-08-17,2108,1910,198,10.37,1201
2020-08-18,2192,1919,273,14.23,1201
2020-08-19,2192,1922,270,14.05,1201
2020-08-20,2192,1924,268,13.93,1201
2020-08-21,1838,1712,126,7.36,1201
2020-08-22,462,283,179,63.25,1201
2020-08-23,330,130,200,153.85,1201
2020-08-24,2108,1923,185,9.62,1201
2020-08-25,2192,1934,258,13.34,1201
2020-08-26,2192,1940,252,12.99,1201
2020-08-27,2192,1944,248,12.76,1201
2020-08-28,1838,1733,105,6.06,1201
2020-08-29,462,305,157,51.48,1201
2020-08-30,330,153,177,115.69,1201
2020-08-31,2108,1944,164,8.44,1201
2020-09-01,2019,1955,64,3.27,1201
2020-09-02,2019,1959,60,3.06,1201
2020-09-03,2019,1961,58,2.96,1201
2020-09-04,1895,1748,147,8.41,1201
2020-09-05,383,317,66,20.82,1201
2020-09-06,276,162,114,70.37,1201
2020-09-07,1990,1951,39,2.0,1201
2020-09-08,2019,1959,60,3.06,1201
2020-09-09,2019,1961,58,2.96,1201
2020-09-10,2019,1960,59,3.01,1201
2020-09-11,1895,1744,151,8.66,1201
2020-09-12,383,312,71,22.76,1201
2020-09-13,276,156,120,76.92,1201
2020-09-14,1990,1944,46,2.37,1201
2020-09-15,2019,1951,68,3.49,1201
2020-09-16,2019,1952,67,3.43,1201
2020-09-17,2019,1952,67,3.43,1201
2020-09-18,1895,1737,158,9.1,1201
2020-09-19,383,306,77,25.16,1201
2020-09-20,276,151,125,82.78,1201
2020-09-21,1990,1941,49,2.52,1201
2020-09-22,2019,1950,69,3.54,1201
2020-09-23,2019,1954,65,3.33,1201
2020-09-24,2019,1956,63,3.22,1201
2020-09-25,1895,1744,151,8.66,1201
2020-09-26,383,315,68,21.59,1201
2020-09-27,276,163,113,69.33,1201
2020-09-28,1990,1955,35,1.79,1201
2020-09-29,2019,1967,52,2.64,1201
2020-09-30,2019,1972,47,2.38,1201
2020-10-01,2126,1976,150,7.59,1201
2020-10-02,1904,1764,140,7.94,1201
2020-10-03,443,336,107,31.85,1201
2020-10-04,265,183,82,44.81,1201
2020-10-05,2084,1975,109,5.52,1201
2020-10-06,2126,1985,141,7.1,1201
2020-10-07,2126,1989,137,6.89,1201
2020-10-08,2126,1991,135,6.78,1201
2020-10-09,1904,1777,127,7.15,1201
2020-10-10,443,346,97,28.03,1201
2020-10-11,265,191,74,38.74,1201
2020-10-12,2084,1979,105,5.31,1201
2020-10-13,2126,1987,139,7.0,1201
2020-10-14,2126,1988,138,6.94,1201
2020-10-15,2126,1987,139,7.0,1201
2020-10-16,1904,1771,133,7.51,1201
2020-10-17,443,338,105,31.07,1201
2020-10-18,265,181,84,46.41,1201
2020-10-19,2084,1969,115,5.84,1201
2020-10-20,2126,1976,150,7.59,1201
2020-10-21,2126,1977,149,7.54,1201
2020-10-22,2126,1976,150,7.59,1201
2020-10-23,1904,1761,143,8.12,1201
2020-10-24,443,330,113,34.24,1201
2020-10-25,265,175,90,51.43,1201
2020-10-26,2084,1965,119,6.06,1201
2020-10-27,2126,1975,151,7.65,1201
2020-10-28,2126,1979,147,7.43,1201
2020-10-29,2126,1982,144,7.27,1201
2020-10-30,1904,1770,134,7.57,1201
2020-10-31,443,342,101,29.53,1201
2020-11-01,291,191,100,52.36,1201
2020-11-02,2153,1984,169,8.52,1201
2020-11-03,2146,1996,150,7.52,1201
2020-11-04,2146,2003,143,7.14,1201
2020-11-05,2146,2007,139,6.93,1201
2020-11-06,1896,1796,100,5.57,1201
2020-11-07,442,369,73,19.78,1201
2020-11-08,291,217,74,34.1,1201
2020-11-09,2153,2009,144,7.17,1201
2020-11-10,2146,2020,126,6.24,1201
2020-11-11,2146,2024,122,6.03,1201
2020-11-12,2146,2026,120,5.92,1201
2020-11-13,1896,1811,85,4.69,1201
2020-11-14,442,380,62,16.32,1201
2020-11-15,291,223,68,30.49,1201
2020-11-16,2153,2011,142,7.06,1201
2020-11-17,2146,2016,130,6.45,1201
2020-11-18,2146,2015,131,6.5,1201
2020-11-19,2146,2012,134,6.66,1201
2020-11-20,1896,1792,104,5.8,1201
2020-11-21,442,356,86,24.16,1201
2020-11-22,291,195,96,49.23,1201
2020-11-23,2153,1979,174,8.79,1201
2020-11-24,2146,1981,165,8.33,1201
2020-11-25,2146,1977,169,8.55,1201
2020-11-26,2146,1971,175,8.88,1201
2020-11-27,1896,1751,145,8.28,1201
2020-11-28,442,314,128,40.76,1201
2020-11-29,291,153,138,90.2,1201
2020-11-30,2153,1937,216,11.15,1201
2020-12-01,1878,1941,-63,-3.25,1201
2020-12-02,1878,1939,-61,-3.15,1201
2020-12-03,1878,1936,-58,-3.0,1201
2020-12-04,2088,1718,370,21.54,1201
2020-12-05,569,285,284,99.65,1201
2020-12-06,326,128,198,154.69,1201
2020-12-07,1996,1915,81,4.23,1201
2020-12-08,1878,1923,-45,-2.34,1201
2020-12-09,1878,1924,-46,-2.39,1201
2020-12-10,1878,1924,-46,-2.39,1201
2020-12-11,2088,1709,379,22.18,1201
2020-12-12,569,278,291,104.68,1201
2020-12-13,326,122,204,167.21,1201
2020-12-14,1996,1910,86,4.5,1201
2020-12-15,1878,1918,-40,-2.09,1201
2020-12-16,1878,1919,-41,-2.14,1201
2020-12-17,1878,1917,-39,-2.03,1201
2020-12-18,2088,1700,388,22.82,1201
2020-12-19,569,265,304,114.72,1201
2020-12-20,326,106,220,207.55,1201
2020-12-21,1996,1890,106,5.61,1201
2020-12-22,1878,1892,-14,-0.74,1201
2020-12-23,1878,1888,-10,-0.53,1201
2020-12-24,1878,1881,-3,-0.16,1201
2020-12-25,2088,1658,430,25.93,1201
2020-12-26,569,217,352,162.21,1201
2020-12-27,326,52,274,526.92,1201
2020-12-28,1996,1831,165,9.01,1201
2020-12-29,1878,1829,49,2.68,1201
2020-12-30,1878,1820,58,3.19,1201
2020-12-31,1878,1809,69,3.81,1201
2021-01-01,1748,1583,165,10.42,1201
2021-01-02,430,140,290,207.14,1201
2021-01-03,311,55,256,465.45,1201
2021-01-04,1879,1753,126,7.19,1201
2021-01-05,1915,1751,164,9.37,1201
2021-01-06,1915,1744,171,9.81,1201
2021-01-07,1915,1736,179,10.31,1201
2021-01-08,1748,1513,235,15.53,1201
2021-01-09,430,75,355,473.33,1201
2021-01-10,311,26,285,1096.15,1201
2021-01-11,1879,1698,181,10.66,1201
2021-01-12,1915,1703,212,12.45,1201
2021-01-13,1915,1703,212,12.45,1201
2021-01-14,1915,1702,213,12.51,1201
2021-01-15,1748,1486,262,17.63,1201
2021-01-16,430,56,374,667.86,1201
2021-01-17,311,26,285,1096.15,1201
2021-01-18,1879,1693,186,10.99,1201
2021-01-19,1915,1704,211,12.38,1201
2021-01-20,1915,1710,205,11.99,1201
2021-01-21,1915,1715,200,11.66,1201
2021-01-22,1748,1504,244,16.22,1201
2021-01-23,430,77,353,458.44,1201
2021-01-24,311,35,276,788.57,1201
2021-01-25,1879,1720,159,9.24,1201
2021-01-26,1915,1733,182,10.5,1201
2021-01-27,1915,1739,176,10.12,1201
2021-01-28,1915,1744,171,9.81,1201
2021-01-29,1748,1532,216,14.1,1201
2021-01-30,430,104,326,313.46,1201
2021-01-31,311,47,264,561.7,1201
2021-02-01,1993,1743,250,14.34,1201
2021-02-02,1980,1753,227,12.95,1201
2021-02-03,1980,1756,224,12.76,1201
2021-02-04,1980,1758,222,12.63,1201
2021-02-05,1755,1543,212,13.74,1201
2021-02-06,440,112,328,292.86,1201
2021-02-07,281,50,231,462.0,1201
2021-02-08,1993,1746,247,14.15,1201
2021-02-09,1980,1754,226,12.88,1201
2021-02-10,1980,1757,223,12.69,1201
2021-02-11,1980,1757,223,12.69,1201
2021-02-12,1755,1542,213,13.81,1201
2021-02-13,440,112,328,292.86,1201
2021-02-14,281,49,232,473.47,1201
2021-02-15,1993,1748,245,14.02,1201
2021-02-16,1980,1758,222,12.63,1201
2021-02-17,1980,1762,218,12.37,1201
2021-02-18,1980,1766,214,12.12,1201
2021-02-19,1755,1554,201,12.93,1201
2021-02-20,440,126,314,249.21,1201
2021-02-21,281,60,221,368.33,1201
2021-02-22,1993,1769,224,12.66,1201
2021-02-23,1980,1783,197,11.05,1201
2021-02-24,1980,1790,190,10.61,1201
2021-02-25,1980,1797,183,10.18,1201
2021-02-26,1755,1588,167,10.52,1201
2021-02-27,440,163,277,169.94,1201
2021-02-28,281,13,268,2061.54,1201
2021-03-01,2118,1809,309,17.08,1201
2021-03-02,2105,1823,282,15.47,1201
2021-03-03,2105,1831,274,14.96,1201
2021-03-04,2105,1837,268,14.59,1201
2021-03-05,1878,1627,251,15.43,1201
2021-03-06,466,201,265,131.84,1201
2021-03-07,290,50,240,480.0,1201
2021-03-08,2118,1843,275,14.92,1201
2021-03-09,2105,1854,251,13.54,1201
2021-03-10,2105,1860,245,13.17,1201
2021-03-11,2105,1862,243,13.05,1201
2021-03-12,1878,1649,229,13.89,1201
2021-03-13,466,220,246,111.82,1201
2021-03-14,290,66,224,339.39,1201
2021-03-15,2118,1856,262,14.12,1201
2021-03-16,2105,1864,241,12.93,1201
2021-03-17,2105,1867,238,12.75,1201
2021-03-18,2105,1867,238,12.75,1201
2021-03-19,1878,1652,226,13.68,1201
2021-03-20,466,221,245,110.86,1201
2021-03-21,290,65,225,346.15,1201
2021-03-22,2118,1854,264,14.24,1201
2021-03-23,2105,1862,243,13.05,1201
2021-03-24,2105,1864,241,12.93,1201
2021-03-25,2105,1865,240,12.87,1201
2021-03-26,1878,1650,228,13.82,1201
2021-03-27,466,220,246,111.82,1201
2021-03-28,290,65,225,346.15,1201
2021-03-29,2118,1855,263,14.18,1201
2021-03-30,2105,1864,241,12.93,1201
2021-03-31,2105,1868,237,12.69,1201
2021-04-01,2157,1870,287,15.35,1201
2021-04-02,1922,1656,266,16.06,1201
2021-04-03,480,227,253,111.45,1201
2021-04-04,280,74,206,278.38,1201
2021-04-05,2195,1864,331,17.76,1201
2021-04-06,2157,1875,282,15.04,1201
2021-04-07,2157,1879,278,14.8,1201
2021-04-08,2157,1881,276,14.67,1201
2021-04-09,1922,1668,254,15.23,1201
2021-04-10,480,238,242,101.68,1201
2021-04-11,280,84,196,233.33,1201
2021-04-12,2195,1875,320,17.07,1201
2021-04-13,2157,1884,273,14.49,1201
2021-04-14,2157,1888,269,14.25,1201
2021-04-15,2157,1889,268,14.19,1201
2021-04-16,1922,1675,247,14.75,1201
2021-04-17,480,245,235,95.92,1201
2021-04-18,280,91,189,207.69,1201
2021-04-19,2195,1880,315,16.76,1201
2021-04-20,2157,1890,267,14.13,1201
2021-04-21,2157,1893,264,13.95,1201
2021-04-22,2157,1894,263,13.89,1201
2021-04-23,1922,1680,242,14.4,1201
2021-04-24,480,251,229,91.24,1201
2021-04-25,280,97,183,188.66,1201
2021-04-26,2195,1887,308,16.32,1201
2021-04-27,2157,1897,260,13.71,1201
2021-04-28,2157,1902,255,13.41,1201
2021-04-29,2157,1904,253,13.29,1201
2021-04-30,1922,1692,230,13.59,1201
2021-05-01,521,263,258,98.1,1201
2021-05-02,289,111,178,160.36,1201
2021-05-03,2202,1903,299,15.71,1201
2021-05-04,2216,1914,302,15.78,1201
2021-05-05,2216,1919,297,15.48,1201
2021-05-06,2216,1922,294,15.3,1201
2021-05-07,2008,1710,298,17.43,1201
2021-05-08,521,282,239,84.75,1201
2021-05-09,289,129,160,124.03,1201
2021-05-10,2202,1921,281,14.63,1201
2021-05-11,2216,1931,285,14.76,1201
2021-05-12,2216,1935,281,14.52,1201
2021-05-13,2216,1937,279,14.4,1201
2021-05-14,2008,1723,285,16.54,1201
2021-05-15,521,293,228,77.82,1201
2021-05-16,289,138,151,109.42,1201
2021-05-17,2202,1927,275,14.27,1201
2021-05-18,2216,1935,281,14.52,1201
2021-05-19,2216,1937,279,14.4,1201
2021-05-20,2216,1936,280,14.46,1201
2021-05-21,2008,1720,288,16.74,1201
2021-05-22,521,288,233,80.9,1201
2021-05-23,289,131,158,120.61,1201
2021-05-24,2202,1918,284,14.81,1201
2021-05-25,2216,1925,291,15.12,1201
2021-05-26,2216,1925,291,15.12,1201
2021-05-27,2216,1924,292,15.18,1201
2021-05-28,2008,1708,300,17.56,1201
2021-05-29,521,275,246,89.45,1201
2021-05-30,289,118,171,144.92,1201
2021-05-31,2202,1907,295,15.47,1201
2021-06-01,2248,1914,334,17.45,1201
2021-06-02,2248,1916,332,17.33,1201
2021-06-03,2248,1916,332,17.33,1201
2021-06-04,1931,1701,230,13.52,1201
2021-06-05,497,270,227,84.07,1201
2021-06-06,317,116,201,173.28,1201
2021-06-07,2217,1906,311,16.32,1201
2021-06-08,2248,1915,333,17.39,1201
2021-06-09,2248,1918,330,17.21,1201
2021-06-10,2248,1920,328,17.08,1201
2021-06-11,1931,1706,225,13.19,1201
2021-06-12,497,276,221,80.07,1201
2021-06-13,317,121,196,161.98,1201
2021-06-14,2217,1911,306,16.01,1201
2021-06-15,2248,1920,328,17.08,1201
2021-06-16,2248,1922,326,16.96,1201
2021-06-17,2248,1922,326,16.96,1201
2021-06-18,1931,1706,225,13.19,1201
2021-06-19,497,274,223,81.39,1201
2021-06-20,317,116,201,173.28,1201
2021-06-21,2217,1903,314,16.5,1201
2021-06-22,2248,1908,340,17.82,1201
2021-06-23,2248,1907,341,17.88,1201
2021-06-24,2248,1904,344,18.07,1201
2021-06-25,1931,1685,246,14.6,1201
2021-06-26,497,249,248,99.6,1201
2021-06-27,317,89,228,256.18,1201
2021-06-28,2217,1872,345,18.43,1201
2021-06-29,2248,1875,373,19.89,1201
2021-06-30,2248,1872,376,20.09,1201
2021-07-01,2142,1867,275,14.73,1201
2021-07-02,1933,1646,287,17.44,1201
2021-07-03,483,210,273,130.0,1201
2021-07-04,300,49,251,512.24,1201
2021-07-05,2062,1833,229,12.49,1201
2021-07-06,2142,1837,305,16.6,1201
2021-07-07,2142,1835,307,16.73,1201
2021-07-08,2142,1832,310,16.92,1201
2021-07-09,1933,1614,319,19.76,1201
2021-07-10,483,180,303,168.33,1201
2021-07-11,300,22,278,1263.64,1201
2021-07-12,2062,1810,252,13.92,1201
2021-07-13,2142,1816,326,17.95,1201
2021-07-14,2142,1818,324,17.82,1201
2021-07-15,2142,1817,325,17.89,1201
2021-07-16,1933,1602,331,20.66,1201
2021-07-17,483,171,312,182.46,1201
2021-07-18,300,16,284,1775.0,1201
2021-07-19,2062,1805,257,14.24,1201
2021-07-20,2142,1813,329,18.15,1201
2021-07-21,2142,1815,327,18.02,1201
2021-07-22,2142,1815,327,18.02,1201
2021-07-23,1933,1600,333,20.81,1201
2021-07-24,483,168,315,187.5,1201
2021-07-25,300,11,289,2627.27,1201
2021-07-26,2062,1798,264,14.68,1201
2021-07-27,2142,1804,338,18.74,1201
2021-07-28,2142,1804,338,18.74,1201
2021-07-29,2142,1801,341,18.93,1201
2021-07-30,1933,1583,350,22.11,1201
2021-07-31,483,148,335,226.35,1201
2021-08-01,287,93,194,208.6,1201
2021-08-02,1946,1773,173,9.76,1201
2021-08-03,1972,1776,196,11.04,1201
2021-08-04,1972,1773,199,11.22,1201
2021-08-05,1972,1768,204,11.54,1201
2021-08-06,1774,1548,226,14.6,1201
2021-08-07,437,112,325,290.18,1201
2021-08-08,287,66,221,334.85,1201
2021-08-09,1946,1736,210,12.1,1201
2021-08-10,1972,1739,233,13.4,1201
2021-08-11,1972,1738,234,13.46,1201
2021-08-12,1972,1735,237,13.66,1201
2021-08-13,1774,1517,257,16.94,1201
2021-08-14,437,83,354,426.51,1201
2021-08-15,287,59,228,386.44,1201
2021-08-16,1946,1714,232,13.54,1201
2021-08-17,1972,1722,250,14.52,1201
2021-08-18,1972,1724,248,14.39,1201
2021-08-19,1972,1726,246,14.25,1201
2021-08-20,1774,1512,262,17.33,1201
2021-08-21,437,83,354,426.51,1201
2021-08-22,287,67,220,328.36,1201
2021-08-23,1946,1722,224,13.01,1201
2021-08-24,1972,1733,239,13.79,1201
2021-08-25,1972,1739,233,13.4,1201
2021-08-26,1972,1743,229,13.14,1201
2021-08-27,1774,1531,243,15.87,1201
2021-08-28,437,104,333,320.19,1201
2021-08-29,287,72,215,298.61,1201
2021-08-30,1946,1744,202,11.58,1201
2021-08-31,1972,1755,217,12.36,1201
2021-09-01,2137,1760,377,21.42,1201
2021-09-02,2137,1762,375,21.28,1201
2021-09-03,1905,1549,356,22.98,1201
2021-09-04,454,119,335,281.51,1201
2021-09-05,277,71,206,290.14,1201
2021-09-06,2068,1755,313,17.83,1201
2021-09-07,2137,1763,374,21.21,1201
2021-09-08,2137,1765,372,21.08,1201
2021-09-09,2137,1765,372,21.08,1201
2021-09-10,1905,1549,356,22.98,1201
2021-09-11,454,117,337,288.03,1201
2021-09-12,277,83,194,233.73,1201
2021-09-13,2068,1748,320,18.31,1201
2021-09-14,2137,1755,382,21.77,1201
2021-09-15,2137,1756,381,21.7,1201
2021-09-16,2137,1756,381,21.7,1201
2021-09-17,1905,1540,365,23.7,1201
2021-09-18,454,109,345,316.51,1201
2021-09-19,277,70,207,295.71,1201
2021-09-20,2068,1743,325,18.65,1201
2021-09-21,2137,1752,385,21.97,1201
2021-09-22,2137,1755,382,21.77,1201
2021-09-23,2137,1757,380,21.63,1201
2021-09-24,1905,1544,361,23.38,1201
2021-09-25,454,115,339,294.78,1201
2021-09-26,277,84,193,229.76,1201
2021-09-27,2068,1755,313,17.83,1201
2021-09-28,2137,1766,371,21.01,1201
2021-09-29,2137,1771,366,20.67,1201
2021-09-30,2137,1775,362,20.39,1201
2021-10-01,2078,1563,515,32.95,1201
2021-10-02,508,135,373,276.3,1201
2021-10-03,278,95,183,192.63,1201
2021-10-04,2094,1775,319,17.97,1201
2021-10-05,2261,1786,475,26.6,1201
2021-10-06,2261,1790,471,26.31,1201
2021-10-07,2261,1792,469,26.17,1201
2021-10-08,2078,1579,499,31.6,1201
2021-10-09,508,148,360,243.24,1201
2021-10-10,278,103,175,169.9,1201
2021-10-11,2094,1783,311,17.44,1201
2021-10-12,2261,1791,470,26.24,1201
2021-10-13,2261,1792,469,26.17,1201
2021-10-14,2261,1792,469,26.17,1201
2021-10-15,2078,1576,502,31.85,1201
2021-10-16,508,143,365,255.24,1201
2021-10-17,278,97,181,186.6,1201
2021-10-18,2094,1774,320,18.04,1201
2021-10-19,2261,1780,481,27.02,1201
2021-10-20,2261,1781,480,26.95,1201
2021-10-21,2261,1781,480,26.95,1201
2021-10-22,2078,1565,513,32.78,1201
2021-10-23,508,133,375,281.95,1201
2021-10-24,278,96,182,189.58,1201
2021-10-25,2094,1767,327,18.51,1201
2021-10-26,2261,1776,485,27.31,1201
2021-10-27,2261,1780,481,27.02,1201
2021-10-28,2261,1782,479,26.88,1201
2021-10-29,2078,1570,508,32.36,1201
2021-10-30,508,141,367,260.28,1201
2021-10-31,278,109,169,155.05,1201
2021-11-01,2304,1782,522,29.29,1201
2021-11-02,2285,1794,491,27.37,1201
2021-11-03,2285,1801,484,26.87,1201
2021-11-04,2285,1805,480,26.59,1201
2021-11-05,2074,1594,480,30.11,1201
2021-11-06,529,167,362,216.77,1201
2021-11-07,295,16,279,1743.75,1201
2021-11-08,2304,1808,496,27.43,1201
2021-11-09,2285,1820,465,25.55,1201
2021-11-10,2285,1825,460,25.21,1201
2021-11-11,2285,1827,458,25.07,1201
2021-11-12,2074,1614,460,28.5,1201
2021-11-13,529,183,346,189.07,1201
2021-11-14,295,28,267,953.57,1201
2021-11-15,2304,1816,488,26.87,1201
2021-11-16,2285,1822,463,25.41,1201
2021-11-17,2285,1822,463,25.41,1201
2021-11-18,2285,1820,465,25.55,1201
2021-11-19,2074,1601,473,29.54,1201
2021-11-20,529,165,364,220.61,1201
2021-11-21,295,5,290,5800.0,1201
2021-11-22,2304,1789,515,28.79,1201
2021-11-23,2285,1791,494,27.58,1201
2021-11-24,2285,1788,497,27.8,1201
2021-11-25,2285,1782,503,28.23,1201
2021-11-26,2074,1561,513,32.86,1201
2021-11-27,529,124,405,326.61,1201
2021-11-28,295,97,198,204.12,1201
2021-11-29,2304,1747,557,31.88,1201
2021-11-30,2285,1750,535,30.57,1201
2021-12-01,2014,1747,267,15.28,1201
2021-12-02,2014,1744,270,15.48,1201
2021-12-03,1548,1525,23,1.51,1201
2021-12-04,609,91,518,569.23,1201
2021-12-05,286,81,205,253.09,1201
2021-12-06,2118,1720,398,23.14,1201
2021-12-07,2014,1727,287,16.62,1201
2021-12-08,2014,1728,286,16.55,1201
2021-12-09,2014,1728,286,16.55,1201
2021-12-10,1548,1513,35,2.31,1201
2021-12-11,609,81,528,651.85,1201
2021-12-12,286,79,207,262.03,1201
2021-12-13,2118,1714,404,23.57,1201
2021-12-14,2014,1722,292,16.96,1201
2021-12-15,2014,1723,291,16.89,1201
2021-12-16,2014,1723,291,16.89,1201
2021-12-17,1548,1506,42,2.79,1201
2021-12-18,609,72,537,745.83,1201
2021-12-19,286,79,207,262.03,1201
2021-12-20,2118,1699,419,24.66,1201
2021-12-21,2014,1703,311,18.26,1201
2021-12-22,2014,1699,315,18.54,1201
2021-12-23,2014,1693,321,18.96,1201
2021-12-24,1548,1471,77,5.23,1201
2021-12-25,609,32,577,1803.12,1201
2021-12-26,286,56,230,410.71,1201
2021-12-27,2118,1647,471,28.6,1201
2021-12-28,2014,1645,369,22.43,1201
2021-12-29,2014,1637,377,23.03,1201
2021-12-30,2014,1626,388,23.86,1201
2021-12-31,1548,1400,148,10.57,1201
2022-01-01,468,97,371,382.47,1201
2022-01-02,261,8,253,3162.5,1201
2022-01-03,1917,1569,348,22.18,1201
2022-01-04,1926,1567,359,22.91,1201
2022-01-05,1926,1559,367,23.54,1201
2022-01-06,1926,1550,376,24.26,1201
2022-01-07,1757,1326,431,32.5,1201
2022-01-08,468,63,405,642.86,1201
2022-01-09,261,63,198,314.29,1201
2022-01-10,1917,1508,409,27.12,1201
2022-01-11,1926,1511,415,27.47,1201
2022-01-12,1926,1509,417,27.63,1201
2022-01-13,1926,1507,419,27.8,1201
2022-01-14,1757,1290,467,36.2,1201
2022-01-15,468,51,417,817.65,1201
2022-01-16,261,51,210,411.76,1201
2022-01-17,1917,1494,423,28.31,1201
2022-01-18,1926,1504,422,28.06,1201
2022-01-19,1926,1509,417,27.63,1201
2022-01-20,1926,1513,413,27.3,1201
2022-01-21,1757,1302,455,34.95,1201
2022-01-22,468,58,410,706.9,1201
2022-01-23,261,58,203,350.0,1201
2022-01-24,1917,1518,399,26.28,1201
2022-01-25,1926,1530,396,25.88,1201
2022-01-26,1926,1537,389,25.31,1201
2022-01-27,1926,1542,384,24.9,1201
2022-01-28,1757,1331,426,32.01,1201
2022-01-29,468,79,389,492.41,1201
2022-01-30,261,79,182,230.38,1201
2020-02-01,242,98,144,146.94,1202
2020-02-02,107,23,84,365.22,1202
2020-02-03,1291,1299,-8,-0.62,1202
2020-02-04,1303,1289,14,1.09,1202
2020-02-05,1303,1292,11,0.85,1202
2020-02-06,1303,1295,8,0.62,1202
2020-02-07,1151,1092,59,5.4,1202
2020-02-08,242,116,126,108.62,1202
2020-02-09,107,33,74,224.24,1202
2020-02-10,1291,1313,-22,-1.68,1202
2020-02-11,1303,1301,2,0.15,1202
2020-02-12,1303,1303,0,0.0,1202
2020-02-13,1303,1306,-3,-0.23,1202
2020-02-14,1151,1102,49,4.45,1202
2020-02-15,242,126,116,92.06,1202
2020-02-16,107,39,68,174.36,1202
2020-02-17,1291,1325,-34,-2.57,1202
2020-02-18,1303,1314,-11,-0.84,1202
2020-02-19,1303,1318,-15,-1.14,1202
2020-02-20,1303,1323,-20,-1.51,1202
2020-02-21,1151,1121,30,2.68,1202
2020-02-22,242,148,94,63.51,1202
2020-02-23,107,17,90,529.41,1202
2020-02-24,1291,1351,-60,-4.44,1202
2020-02-25,1303,1343,-40,-2.98,1202
2020-02-26,1303,1349,-46,-3.41,1202
2020-02-27,1303,1355,-52,-3.84,1202
2020-02-28,1151,1155,-4,-0.35,1202
2020-02-29,242,183,59,32.24,1202
2020-03-01,113,52,61,117.31,1202
2020-03-02,1127,1387,-260,-18.75,1202
2020-03-03,1107,1379,-272,-19.72,1202
2020-03-04,1107,1384,-277,-20.01,1202
2020-03-05,1107,1389,-282,-20.3,1202
2020-03-06,972,1188,-216,-18.18,1202
2020-03-07,203,214,-11,-5.14,1202
2020-03-08,113,82,31,37.8,1202
2020-03-09,1127,1414,-287,-20.3,1202
2020-03-10,1107,1403,-296,-21.1,1202
2020-03-11,1107,1406,-299,-21.27,1202
2020-03-12,1107,1409,-302,-21.43,1202
2020-03-13,972,1205,-233,-19.34,1202
2020-03-14,203,229,-26,-11.35,1202
2020-03-15,113,94,19,20.21,1202
2020-03-16,1127,1425,-298,-20.91,1202
2020-03-17,1107,1413,-306,-21.66,1202
2020-03-18,1107,1414,-307,-21.71,1202
2020-03-19,1107,1416,-309,-21.82,1202
2020-03-20,972,1211,-239,-19.74,1202
2020-03-21,203,235,-32,-13.62,1202
2020-03-22,113,101,12,11.88,1202
2020-03-23,1127,1432,-305,-21.3,1202
2020-03-24,1107,1421,-314,-22.1,1202
2020-03-25,1107,1424,-317,-22.26,1202
2020-03-26,1107,1428,-321,-22.48,1202
2020-03-27,972,1225,-253,-20.65,1202
2020-03-28,203,251,-48,-19.12,1202
2020-03-29,113,119,-6,-5.04,1202
2020-03-30,1127,1452,-325,-22.38,1202
2020-03-31,1107,1443,-336,-23.28,1202
2020-04-01,1129,1448,-319,-22.03,1202
2020-04-02,1129,1453,-324,-22.3,1202
2020-04-03,924,1252,-328,-26.2,1202
2020-04-04,204,279,-75,-26.88,1202
2020-04-05,80,148,-68,-45.95,1202
2020-04-06,1119,1482,-363,-24.49,1202
2020-04-07,1129,1473,-344,-23.35,1202
2020-04-08,1129,1478,-349,-23.61,1202
2020-04-09,1129,1482,-353,-23.82,1202
2020-04-10,924,1280,-356,-27.81,1202
2020-04-11,204,306,-102,-33.33,1202
2020-04-12,80,173,-93,-53.76,1202
2020-04-13,1119,1504,-385,-25.6,1202
2020-04-14,1129,1493,-364,-24.38,1202
2020-04-15,1129,1495,-366,-24.48,1202
2020-04-16,1129,1497,-368,-24.58,1202
2020-04-17,924,1292,-368,-28.48,1202
2020-04-18,204,315,-111,-35.24,1202
2020-04-19,80,180,-100,-55.56,1202
2020-04-20,1119,1509,-390,-25.84,1202
2020-04-21,1129,1495,-366,-24.48,1202
2020-04-22,1129,1495,-366,-24.48,1202
2020-04-23,1129,1495,-366,-24.48,1202
2020-04-24,924,1289,-365,-28.32,1202
2020-04-25,204,311,-107,-34.41,1202
2020-04-26,80,174,-94,-54.02,1202
2020-04-27,1119,1503,-384,-25.55,1202
2020-04-28,1129,1489,-360,-24.18,1202
2020-04-29,1129,1490,-361,-24.23,1202
2020-04-30,1129,1490,-361,-24.23,1202
2020-05-01,1172,1284,-112,-8.72,1202
2020-05-02,260,307,-47,-15.31,1202
2020-05-03,113,172,-59,-34.3,1202
2020-05-04,1336,1502,-166,-11.05,1202
2020-05-05,1344,1489,-145,-9.74,1202
2020-05-06,1344,1491,-147,-9.86,1202
2020-05-07,1344,1492,-148,-9.92,1202
2020-05-08,1172,1288,-116,-9.01,1202
2020-05-09,260,312,-52,-16.67,1202
2020-05-10,113,177,-64,-36.16,1202
2020-05-11,1336,1508,-172,-11.41,1202
2020-05-12,1344,1496,-152,-10.16,1202
2020-05-13,1344,1498,-154,-10.28,1202
2020-05-14,1344,1500,-156,-10.4,1202
2020-05-15,1172,1295,-123,-9.5,1202
2020-05-16,260,318,-58,-18.24,1202
2020-05-17,113,183,-70,-38.25,1202
2020-05-18,1336,1513,-177,-11.7,1202
2020-05-19,1344,1501,-157,-10.46,1202
2020-05-20,1344,1502,-158,-10.52,1202
2020-05-21,1344,1503,-159,-10.58,1202
2020-05-22,1172,1297,-125,-9.64,1202
2020-05-23,260,320,-60,-18.75,1202
2020-05-24,113,185,-72,-38.92,1202
2020-05-25,1336,1514,-178,-11.76,1202
2020-05-26,1344,1501,-157,-10.46,1202
2020-05-27,1344,1502,-158,-10.52,1202
2020-05-28,1344,1503,-159,-10.58,1202
2020-05-29,1172,1298,-126,-9.71,1202
2020-05-30,260,322,-62,-19.25,1202
2020-05-31,113,187,-74,-39.57,1202
2020-06-01,1410,1518,-108,-7.11,1202
2020-06-02,1409,1506,-97,-6.44,1202
2020-06-03,1409,1508,-99,-6.56,1202
2020-06-04,1409,1510,-101,-6.69,1202
2020-06-05,1176,1307,-131,-10.02,1202
2020-06-06,270,331,-61,-18.43,1202
2020-06-07,115,198,-83,-41.92,1202
2020-06-08,1410,1529,-119,-7.78,1202
2020-06-09,1409,1518,-109,-7.18,1202
2020-06-10,1409,1521,-112,-7.36,1202
2020-06-11,1409,1524,-115,-7.55,1202
2020-06-12,1176,1319,-143,-10.84,1202
2020-06-13,270,343,-73,-21.28,1202
2020-06-14,115,209,-94,-44.98,1202
2020-06-15,1410,1539,-129,-8.38,1202
2020-06-16,1409,1525,-116,-7.61,1202
2020-06-17,1409,1526,-117,-7.67,1202
2020-06-18,1409,1525,-116,-7.61,1202
2020-06-19,1176,1318,-142,-10.77,1202
2020-06-20,270,338,-68,-20.12,1202
2020-06-21,115,199,-84,-42.21,1202
2020-06-22,1410,1525,-115,-7.54,1202
2020-06-23,1409,1508,-99,-6.56,1202
2020-06-24,1409,1503,-94,-6.25,1202
2020-06-25,1409,1499,-90,-6.0,1202
2020-06-26,1176,1287,-111,-8.62,1202
2020-06-27,270,304,-34,-11.18,1202
2020-06-28,115,162,-47,-29.01,1202
2020-06-29,1410,1484,-74,-4.99,1202
2020-06-30,1409,1464,-55,-3.76,1202
2020-07-01,1590,1458,132,9.05,1202
2020-07-02,1590,1452,138,9.5,1202
2020-07-03,1361,1240,121,9.76,1202
2020-07-04,306,256,50,19.53,1202
2020-07-05,166,115,51,44.35,1202
2020-07-06,1679,1438,241,16.76,1202
2020-07-07,1590,1420,170,11.97,1202
2020-07-08,1590,1416,174,12.29,1202
2020-07-09,1590,1413,177,12.53,1202
2020-07-10,1361,1204,157,13.04,1202
2020-07-11,306,224,82,36.61,1202
2020-07-12,166,86,80,93.02,1202
2020-07-13,1679,1414,265,18.74,1202
2020-07-14,1590,1400,190,13.57,1202
2020-07-15,1590,1400,190,13.57,1202
2020-07-16,1590,1401,189,13.49,1202
2020-07-17,1361,1196,165,13.8,1202
2020-07-18,306,219,87,39.73,1202
2020-07-19,166,84,82,97.62,1202
2020-07-20,1679,1414,265,18.74,1202
2020-07-21,1590,1401,189,13.49,1202
2020-07-22,1590,1403,187,13.33,1202
2020-07-23,1590,1404,186,13.25,1202
2020-07-24,1361,1198,163,13.61,1202
2020-07-25,306,220,86,39.09,1202
2020-07-26,166,84,82,97.62,1202
2020-07-27,1679,1412,267,18.91,1202
2020-07-28,1590,1397,193,13.82,1202
2020-07-29,1590,1395,195,13.98,1202
2020-07-30,1590,1393,197,14.14,1202
2020-07-31,1361,1183,178,15.05,1202
2020-08-01,323,202,121,59.9,1202
2020-08-02,184,62,122,196.77,1202
2020-08-03,1494,1386,108,7.79,1202
2020-08-04,1587,1368,219,16.01,1202
2020-08-05,1587,1363,224,16.43,1202
2020-08-06,1587,1359,228,16.78,1202
2020-08-07,1322,1148,174,15.16,1202
2020-08-08,323,165,158,95.76,1202
2020-08-09,184,24,160,666.67,1202
2020-08-10,1494,1349,145,10.75,1202
2020-08-11,1587,1331,256,19.23,1202
2020-08-12,1587,1329,258,19.41,1202
2020-08-13,1587,1326,261,19.68,1202
2020-08-14,1322,1118,204,18.25,1202
2020-08-15,323,140,183,130.71,1202
2020-08-16,184,3,181,6033.33,1202
2020-08-17,1494,1333,161,12.08,1202
2020-08-18,1587,1321,266,20.14,1202
2020-08-19,1587,1323,264,19.95,1202
2020-08-20,1587,1327,260,19.59,1202
2020-08-21,1322,1125,197,17.51,1202
2020-08-22,323,152,171,112.5,1202
2020-08-23,184,21,163,776.19,1202
2020-08-24,1494,1356,138,10.18,1202
2020-08-25,1587,1348,239,17.73,1202
2020-08-26,1587,1355,232,17.12,1202
2020-08-27,1587,1362,225,16.52,1202
2020-08-28,1322,1163,159,13.67,1202
2020-08-29,323,192,131,68.23,1202
2020-08-30,184,63,121,192.06,1202
2020-08-31,1494,1399,95,6.79,1202
2020-09-01,1426,1391,35,2.52,1202
2020-09-02,1426,1397,29,2.08,1202
2020-09-03,1426,1403,23,1.64,1202
2020-09-04,1254,1202,52,4.33,1202
2020-09-05,243,228,15,6.58,1202
2020-09-06,119,96,23,23.96,1202
2020-09-07,1432,1428,4,0.28,1202
2020-09-08,1426,1417,9,0.64,1202
2020-09-09,1426,1419,7,0.49,1202
2020-09-10,1426,1420,6,0.42,1202
2020-09-11,1254,1215,39,3.21,1202
2020-09-12,243,238,5,2.1,1202
2020-09-13,119,102,17,16.67,1202
2020-09-14,1432,1431,1,0.07,1202
2020-09-15,1426,1417,9,0.64,1202
2020-09-16,1426,1417,9,0.64,1202
2020-09-17,1426,1417,9,0.64,1202
2020-09-18,1254,1211,43,3.55,1202
2020-09-19,243,233,10,4.29,1202
2020-09-20,119,97,22,22.68,1202
2020-09-21,1432,1427,5,0.35,1202
2020-09-22,1426,1414,12,0.85,1202
2020-09-23,1426,1416,10,0.71,1202
2020-09-24,1426,1418,8,0.56,1202
2020-09-25,1254,1214,40,3.29,1202
2020-09-26,243,239,4,1.67,1202
2020-09-27,119,105,14,13.33,1202
2020-09-28,1432,1437,-5,-0.35,1202
2020-09-29,1426,1427,-1,-0.07,1202
2020-09-30,1426,1431,-5,-0.35,1202
2020-10-01,1509,1435,74,5.16,1202
2020-10-02,1324,1233,91,7.38,1202
2020-10-03,256,259,-3,-1.16,1202
2020-10-04,122,126,-4,-3.17,1202
2020-10-05,1517,1459,58,3.98,1202
2020-10-06,1509,1449,60,4.14,1202
2020-10-07,1509,1452,57,3.93,1202
2020-10-08,1509,1455,54,3.71,1202
2020-10-09,1324,1251,73,5.84,1202
2020-10-10,256,275,-19,-6.91,1202
2020-10-11,122,140,-18,-12.86,1202
2020-10-12,1517,1470,47,3.2,1202
2020-10-13,1509,1457,52,3.57,1202
2020-10-14,1509,1458,51,3.5,1202
2020-10-15,1509,1458,51,3.5,1202
2020-10-16,1324,1251,73,5.84,1202
2020-10-17,256,272,-16,-5.88,1202
2020-10-18,122,135,-13,-9.63,1202
2020-10-19,1517,1462,55,3.76,1202
2020-10-20,1509,1447,62,4.28,1202
2020-10-21,1509,1446,63,4.36,1202
2020-10-22,1509,1445,64,4.43,1202
2020-10-23,1324,1238,86,6.95,1202
2020-10-24,256,259,-3,-1.16,1202
2020-10-25,122,122,0,0.0,1202
2020-10-26,1517,1451,66,4.55,1202
2020-10-27,1509,1437,72,5.01,1202
2020-10-28,1509,1438,71,4.94,1202
2020-10-29,1509,1439,70,4.86,1202
2020-10-30,1324,1235,89,7.21,1202
2020-10-31,256,259,-3,-1.16,1202
2020-11-01,100,125,-25,-20.0,1202
2020-11-02,1458,1457,1,0.07,1202
2020-11-03,1425,1446,-21,-1.45,1202
2020-11-04,1425,1449,-24,-1.66,1202
2020-11-05,1425,1453,-28,-1.93,1202
2020-11-06,1190,1250,-60,-4.8,1202
2020-11-07,249,275,-26,-9.45,1202
2020-11-08,100,142,-42,-29.58,1202
2020-11-09,1458,1474,-16,-1.09,1202
2020-11-10,1425,1463,-38,-2.6,1202
2020-11-11,1425,1465,-40,-2.73,1202
2020-11-12,1425,1467,-42,-2.86,1202
2020-11-13,1190,1262,-72,-5.71,1202
2020-11-14,249,285,-36,-12.63,1202
2020-11-15,100,148,-48,-32.43,1202
2020-11-16,1458,1476,-18,-1.22,1202
2020-11-17,1425,1461,-36,-2.46,1202
2020-11-18,1425,1458,-33,-2.26,1202
2020-11-19,1425,1455,-30,-2.06,1202
2020-11-20,1190,1245,-55,-4.42,1202
2020-11-21,249,263,-14,-5.32,1202
2020-11-22,100,122,-22,-18.03,1202
2020-11-23,1458,1445,13,0.9,1202
2020-11-24,1425,1426,-1,-0.07,1202
2020-11-25,1425,1420,5,0.35,1202
2020-11-26,1425,1414,11,0.78,1202
2020-11-27,1190,1201,-11,-0.92,1202
2020-11-28,249,217,32,14.75,1202
2020-11-29,100,75,25,33.33,1202
2020-11-30,1458,1398,60,4.29,1202
2020-12-01,1136,1378,-242,-17.56,1202
2020-12-02,1136,1373,-237,-17.26,1202
2020-12-03,1136,1368,-232,-16.96,1202
2020-12-04,1237,1158,79,6.82,1202
2020-12-05,275,176,99,56.25,1202
2020-12-06,105,37,68,183.78,1202
2020-12-07,1237,1363,-126,-9.24,1202
2020-12-08,1136,1347,-211,-15.66,1202
2020-12-09,1136,1346,-210,-15.6,1202
2020-12-10,1136,1344,-208,-15.48,1202
2020-12-11,1237,1137,100,8.8,1202
2020-12-12,275,159,116,72.96,1202
2020-12-13,105,22,83,377.27,1202
2020-12-14,1237,1351,-114,-8.44,1202
2020-12-15,1136,1337,-201,-15.03,1202
2020-12-16,1136,1337,-201,-15.03,1202
2020-12-17,1136,1336,-200,-14.97,1202
2020-12-18,1237,1129,108,9.57,1202
2020-12-19,275,150,125,83.33,1202
2020-12-20,105,12,93,775.0,1202
2020-12-21,1237,1339,-102,-7.62,1202
2020-12-22,1136,1323,-187,-14.13,1202
2020-12-23,1136,1319,-183,-13.87,1202
2020-12-24,1136,1316,-180,-13.68,1202
2020-12-25,1237,1105,132,11.95,1202
2020-12-26,275,122,153,125.41,1202
2020-12-27,105,36,69,191.67,1202
2020-12-28,1237,1302,-65,-4.99,1202
2020-12-29,1136,1281,-145,-11.32,1202
2020-12-30,1136,1274,-138,-10.83,1202
2020-12-31,1136,1267,-131,-10.34,1202
2021-01-01,1004,1053,-49,-4.65,1202
2021-01-02,213,68,145,213.24,1202
2021-01-03,94,8,86,1075.0,1202
2021-01-04,1146,1245,-99,-7.95,1202
2021-01-05,1121,1224,-103,-8.42,1202
2021-01-06,1121,1218,-97,-7.96,1202
2021-01-07,1121,1212,-91,-7.51,1202
2021-01-08,1004,1000,4,0.4,1202
2021-01-09,213,17,196,1152.94,1202
2021-01-10,94,17,77,452.94,1202
2021-01-11,1146,1203,-57,-4.74,1202
2021-01-12,1121,1186,-65,-5.48,1202
2021-01-13,1121,1185,-64,-5.4,1202
2021-01-14,1121,1185,-64,-5.4,1202
2021-01-15,1004,979,25,2.55,1202
2021-01-16,213,3,210,7000.0,1202
2021-01-17,94,3,91,3033.33,1202
2021-01-18,1146,1200,-54,-4.5,1202
2021-01-19,1121,1190,-69,-5.8,1202
2021-01-20,1121,1195,-74,-6.19,1202
2021-01-21,1121,1199,-78,-6.51,1202
2021-01-22,1004,998,6,0.6,1202
2021-01-23,213,26,187,719.23,1202
2021-01-24,94,26,68,261.54,1202
2021-01-25,1146,1230,-84,-6.83,1202
2021-01-26,1121,1222,-101,-8.27,1202
2021-01-27,1121,1228,-107,-8.71,1202
2021-01-28,1121,1234,-113,-9.16,1202
2021-01-29,1004,1033,-29,-2.81,1202
2021-01-30,213,60,153,255.0,1202
2021-01-31,94,13,81,623.08,1202
2021-02-01,1302,1262,40,3.17,1202
2021-02-02,1277,1252,25,2.0,1202
2021-02-03,1277,1256,21,1.67,1202
2021-02-04,1277,1259,18,1.43,1202
2021-02-05,1124,1056,68,6.44,1202
2021-02-06,226,80,146,182.5,1202
2021-02-07,90,22,68,309.09,1202
2021-02-08,1302,1278,24,1.88,1202
2021-02-09,1277,1266,11,0.87,1202
2021-02-10,1277,1268,9,0.71,1202
2021-02-11,1277,1270,7,0.55,1202
2021-02-12,1124,1066,58,5.44,1202
2021-02-13,226,91,135,148.35,1202
2021-02-14,90,30,60,200.0,1202
2021-02-15,1302,1288,14,1.09,1202
2021-02-16,1277,1278,-1,-0.08,1202
2021-02-17,1277,1281,-4,-0.31,1202
2021-02-18,1277,1285,-8,-0.62,1202
2021-02-19,1124,1083,41,3.79,1202
2021-02-20,226,109,117,107.34,1202
2021-02-21,90,36,54,150.0,1202
2021-02-22,1302,1312,-10,-0.76,1202
2021-02-23,1277,1303,-26,-2.0,1202
2021-02-24,1277,1309,-32,-2.44,1202
2021-02-25,1277,1315,-38,-2.89,1202
2021-02-26,1124,1114,10,0.9,1202
2021-02-27,226,143,83,58.04,1202
2021-02-28,90,12,78,650.0,1202
2021-03-01,1434,1347,87,6.46,1202
2021-03-02,1412,1339,73,5.45,1202
2021-03-03,1412,1345,67,4.98,1202
2021-03-04,1412,1350,62,4.59,1202
2021-03-05,1224,1149,75,6.53,1202
2021-03-06,267,176,91,51.7,1202
2021-03-07,102,44,58,131.82,1202
2021-03-08,1434,1377,57,4.14,1202
2021-03-09,1412,1367,45,3.29,1202
2021-03-10,1412,1370,42,3.07,1202
2021-03-11,1412,1373,39,2.84,1202
2021-03-12,1224,1169,55,4.7,1202
2021-03-13,267,194,73,37.63,1202
2021-03-14,102,59,43,72.88,1202
2021-03-15,1434,1390,44,3.17,1202
2021-03-16,1412,1378,34,2.47,1202
2021-03-17,1412,1380,32,2.32,1202
2021-03-18,1412,1381,31,2.24,1202
2021-03-19,1224,1177,47,3.99,1202
2021-03-20,267,200,67,33.5,1202
2021-03-21,102,66,36,54.55,1202
2021-03-22,1434,1397,37,2.65,1202
2021-03-23,1412,1385,27,1.95,1202
2021-03-24,1412,1388,24,1.73,1202
2021-03-25,1412,1391,21,1.51,1202
2021-03-26,1224,1188,36,3.03,1202
2021-03-27,267,213,54,25.35,1202
2021-03-28,102,81,21,25.93,1202
2021-03-29,1434,1414,20,1.41,1202
2021-03-30,1412,1405,7,0.5,1202
2021-03-31,1412,1409,3,0.21,1202
2021-04-01,1443,1414,29,2.05,1202
2021-04-02,1192,1213,-21,-1.73,1202
2021-04-03,256,240,16,6.67,1202
2021-04-04,99,109,-10,-9.17,1202
2021-04-05,1455,1443,12,0.83,1202
2021-04-06,1443,1434,9,0.63,1202
2021-04-07,1443,1439,4,0.28,1202
2021-04-08,1443,1444,-1,-0.07,1202
2021-04-09,1192,1242,-50,-4.03,1202
2021-04-10,256,268,-12,-4.48,1202
2021-04-11,99,136,-37,-27.21,1202
2021-04-12,1455,1468,-13,-0.89,1202
2021-04-13,1443,1457,-14,-0.96,1202
2021-04-14,1443,1460,-17,-1.16,1202
2021-04-15,1443,1462,-19,-1.3,1202
2021-04-16,1192,1258,-66,-5.25,1202
2021-04-17,256,281,-25,-8.9,1202
2021-04-18,99,146,-47,-32.19,1202
2021-04-19,1455,1476,-21,-1.42,1202
2021-04-20,1443,1462,-19,-1.3,1202
2021-04-21,1443,1463,-20,-1.37,1202
2021-04-22,1443,1463,-20,-1.37,1202
2021-04-23,1192,1256,-64,-5.1,1202
2021-04-24,256,278,-22,-7.91,1202
2021-04-25,99,142,-43,-30.28,1202
2021-04-26,1455,1471,-16,-1.09,1202
2021-04-27,1443,1457,-14,-0.96,1202
2021-04-28,1443,1457,-14,-0.96,1202
2021-04-29,1443,1457,-14,-0.96,1202
2021-04-30,1192,1251,-59,-4.72,1202
2021-05-01,283,274,9,3.28,1202
2021-05-02,109,138,-29,-21.01,1202
2021-05-03,1494,1468,26,1.77,1202
2021-05-04,1537,1455,82,5.64,1202
2021-05-05,1537,1456,81,5.56,1202
2021-05-06,1537,1458,79,5.42,1202
2021-05-07,1354,1253,101,8.06,1202
2021-05-08,283,277,6,2.17,1202
2021-05-09,109,142,-33,-23.24,1202
2021-05-10,1494,1473,21,1.43,1202
2021-05-11,1537,1461,76,5.2,1202
2021-05-12,1537,1463,74,5.06,1202
2021-05-13,1537,1465,72,4.91,1202
2021-05-14,1354,1260,94,7.46,1202
2021-05-15,283,284,-1,-0.35,1202
2021-05-16,109,149,-40,-26.85,1202
2021-05-17,1494,1479,15,1.01,1202
2021-05-18,1537,1467,70,4.77,1202
2021-05-19,1537,1468,69,4.7,1202
2021-05-20,1537,1469,68,4.63,1202
2021-05-21,1354,1264,90,7.12,1202
2021-05-22,283,287,-4,-1.39,1202
2021-05-23,109,151,-42,-27.81,1202
2021-05-24,1494,1481,13,0.88,1202
2021-05-25,1537,1468,69,4.7,1202
2021-05-26,1537,1468,69,4.7,1202
2021-05-27,1537,1469,68,4.63,1202
2021-05-28,1354,1264,90,7.12,1202
2021-05-29,283,287,-4,-1.39,1202
2021-05-30,109,152,-43,-28.29,1202
2021-05-31,1494,1483,11,0.74,1202
2021-06-01,1582,1471,111,7.55,1202
2021-06-02,1582,1473,109,7.4,1202
2021-06-03,1582,1475,107,7.25,1202
2021-06-04,1290,1271,19,1.49,1202
2021-06-05,264,296,-32,-10.81,1202
2021-06-06,130,162,-32,-19.75,1202
2021-06-07,1564,1493,71,4.76,1202
2021-06-08,1582,1482,100,6.75,1202
2021-06-09,1582,1485,97,6.53,1202
2021-06-10,1582,1488,94,6.32,1202
2021-06-11,1290,1284,6,0.47,1202
2021-06-12,264,308,-44,-14.29,1202
2021-06-13,130,174,-44,-25.29,1202
2021-06-14,1564,1505,59,3.92,1202
2021-06-15,1582,1492,90,6.03,1202
2021-06-16,1582,1493,89,5.96,1202
2021-06-17,1582,1493,89,5.96,1202
2021-06-18,1290,1286,4,0.31,1202
2021-06-19,264,308,-44,-14.29,1202
2021-06-20,130,170,-40,-23.53,1202
2021-06-21,1564,1496,68,4.55,1202
2021-06-22,1582,1479,103,6.96,1202
2021-06-23,1582,1476,106,7.18,1202
2021-06-24,1582,1472,110,7.47,1202
2021-06-25,1290,1261,29,2.3,1202
2021-06-26,264,278,-14,-5.04,1202
2021-06-27,130,136,-6,-4.41,1202
2021-06-28,1564,1459,105,7.2,1202
2021-06-29,1582,1439,143,9.94,1202
2021-06-30,1582,1433,149,10.4,1202
2021-07-01,1432,1427,5,0.35,1202
2021-07-02,1269,1215,54,4.44,1202
2021-07-03,265,231,34,14.72,1202
2021-07-04,107,89,18,20.22,1202
2021-07-05,1392,1412,-20,-1.42,1202
2021-07-06,1432,1393,39,2.8,1202
2021-07-07,1432,1389,43,3.1,1202
2021-07-08,1432,1385,47,3.39,1202
2021-07-09,1269,1175,94,8.0,1202
2021-07-10,265,194,71,36.6,1202
2021-07-11,107,56,51,91.07,1202
2021-07-12,1392,1383,9,0.65,1202
2021-07-13,1432,1368,64,4.68,1202
2021-07-14,1432,1368,64,4.68,1202
2021-07-15,1432,1368,64,4.68,1202
2021-07-16,1269,1162,107,9.21,1202
2021-07-17,265,185,80,43.24,1202
2021-07-18,107,50,57,114.0,1202
2021-07-19,1392,1380,12,0.87,1202
2021-07-20,1432,1367,65,4.75,1202
2021-07-21,1432,1369,63,4.6,1202
2021-07-22,1432,1370,62,4.53,1202
2021-07-23,1269,1165,104,8.93,1202
2021-07-24,265,187,78,41.71,1202
2021-07-25,107,51,56,109.8,1202
2021-07-26,1392,1380,12,0.87,1202
2021-07-27,1432,1366,66,4.83,1202
2021-07-28,1432,1364,68,4.99,1202
2021-07-29,1432,1363,69,5.06,1202
2021-07-30,1269,1154,115,9.97,1202
2021-07-31,265,174,91,52.3,1202
2021-08-01,132,34,98,288.24,1202
2021-08-02,1397,1359,38,2.8,1202
2021-08-03,1345,1341,4,0.3,1202
2021-08-04,1345,1337,8,0.6,1202
2021-08-05,1345,1332,13,0.98,1202
2021-08-06,1180,1121,59,5.26,1202
2021-08-07,302,138,164,118.84,1202
2021-08-08,132,55,77,140.0,1202
2021-08-09,1397,1322,75,5.67,1202
2021-08-10,1345,1303,42,3.22,1202
2021-08-11,1345,1300,45,3.46,1202
2021-08-12,1345,1297,48,3.7,1202
2021-08-13,1180,1088,92,8.46,1202
2021-08-14,302,108,194,179.63,1202
2021-08-15,132,47,85,180.85,1202
2021-08-16,1397,1299,98,7.54,1202
2021-08-17,1345,1286,59,4.59,1202
2021-08-18,1345,1288,57,4.43,1202
2021-08-19,1345,1290,55,4.26,1202
2021-08-20,1180,1087,93,8.56,1202
2021-08-21,302,113,189,167.26,1202
2021-08-22,132,47,85,180.85,1202
2021-08-23,1397,1316,81,6.16,1202
2021-08-24,1345,1308,37,2.83,1202
2021-08-25,1345,1314,31,2.36,1202
2021-08-26,1345,1321,24,1.82,1202
2021-08-27,1180,1122,58,5.17,1202
2021-08-28,302,151,151,100.0,1202
2021-08-29,132,22,110,500.0,1202
2021-08-30,1397,1357,40,2.95,1202
2021-08-31,1345,1350,-5,-0.37,1202
2021-09-01,1464,1357,107,7.89,1202
2021-09-02,1464,1363,101,7.41,1202
2021-09-03,1298,1163,135,11.61,1202
2021-09-04,301,190,111,58.42,1202
2021-09-05,140,58,82,141.38,1202
2021-09-06,1484,1391,93,6.69,1202
2021-09-07,1464,1381,83,6.01,1202
2021-09-08,1464,1383,81,5.86,1202
2021-09-09,1464,1386,78,5.63,1202
2021-09-10,1298,1181,117,9.91,1202
2021-09-11,301,204,97,47.55,1202
2021-09-12,140,69,71,102.9,1202
2021-09-13,1484,1398,86,6.15,1202
2021-09-14,1464,1385,79,5.7,1202
2021-09-15,1464,1385,79,5.7,1202
2021-09-16,1464,1385,79,5.7,1202
2021-09-17,1298,1178,120,10.19,1202
2021-09-18,301,200,101,50.5,1202
2021-09-19,140,64,76,118.75,1202
2021-09-20,1484,1394,90,6.46,1202
2021-09-21,1464,1380,84,6.09,1202
2021-09-22,1464,1381,83,6.01,1202
2021-09-23,1464,1383,81,5.86,1202
2021-09-24,1298,1178,120,10.19,1202
2021-09-25,301,203,98,48.28,1202
2021-09-26,140,69,71,102.9,1202
2021-09-27,1484,1401,83,5.92,1202
2021-09-28,1464,1390,74,5.32,1202
2021-09-29,1464,1394,70,5.02,1202
2021-09-30,1464,1398,66,4.72,1202
2021-10-01,1329,1195,134,11.21,1202
2021-10-02,289,221,68,30.77,1202
2021-10-03,123,89,34,38.2,1202
2021-10-04,1464,1422,42,2.95,1202
2021-10-05,1500,1412,88,6.23,1202
2021-10-06,1500,1415,85,6.01,1202
2021-10-07,1500,1419,81,5.71,1202
2021-10-08,1329,1215,114,9.38,1202
2021-10-09,289,240,49,20.42,1202
2021-10-10,123,106,17,16.04,1202
2021-10-11,1464,1436,28,1.95,1202
2021-10-12,1500,1424,76,5.34,1202
2021-10-13,1500,1425,75,5.26,1202
2021-10-14,1500,1425,75,5.26,1202
2021-10-15,1329,1219,110,9.02,1202
2021-10-16,289,240,49,20.42,1202
2021-10-17,123,103,20,19.42,1202
2021-10-18,1464,1431,33,2.31,1202
2021-10-19,1500,1416,84,5.93,1202
2021-10-20,1500,1415,85,6.01,1202
2021-10-21,1500,1414,86,6.08,1202
2021-10-22,1329,1206,123,10.2,1202
2021-10-23,289,227,62,27.31,1202
2021-10-24,123,90,33,36.67,1202
2021-10-25,1464,1419,45,3.17,1202
2021-10-26,1500,1405,95,6.76,1202
2021-10-27,1500,1405,95,6.76,1202
2021-10-28,1500,1405,95,6.76,1202
2021-10-29,1329,1200,129,10.75,1202
2021-10-30,289,224,65,29.02,1202
2021-10-31,123,89,34,38.2,1202
2021-11-01,1504,1421,83,5.84,1202
2021-11-02,1500,1409,91,6.46,1202
2021-11-03,1500,1412,88,6.23,1202
2021-11-04,1500,1416,84,5.93,1202
2021-11-05,1268,1213,55,4.53,1202
2021-11-06,268,238,30,12.61,1202
2021-11-07,113,105,8,7.62,1202
2021-11-08,1504,1438,66,4.59,1202
2021-11-09,1500,1427,73,5.12,1202
2021-11-10,1500,1430,70,4.9,1202
2021-11-11,1500,1432,68,4.75,1202
2021-11-12,1268,1228,40,3.26,1202
2021-11-13,268,251,17,6.77,1202
2021-11-14,113,115,-2,-1.74,1202
2021-11-15,1504,1444,60,4.16,1202
2021-11-16,1500,1430,70,4.9,1202
2021-11-17,1500,1429,71,4.97,1202
2021-11-18,1500,1426,74,5.19,1202
2021-11-19,1268,1217,51,4.19,1202
2021-11-20,268,236,32,13.56,1202
2021-11-21,113,95,18,18.95,1202
2021-11-22,1504,1419,85,5.99,1202
2021-11-23,1500,1400,100,7.14,1202
2021-11-24,1500,1395,105,7.53,1202
2021-11-25,1500,1389,111,7.99,1202
2021-11-26,1268,1176,92,7.82,1202
2021-11-27,268,192,76,39.58,1202
2021-11-28,113,50,63,126.0,1202
2021-11-29,1504,1372,132,9.62,1202
2021-11-30,1500,1353,147,10.86,1202
2021-12-01,1201,1347,-146,-10.84,1202
2021-12-02,1201,1342,-141,-10.51,1202
2021-12-03,889,1131,-242,-21.4,1202
2021-12-04,281,148,133,89.86,1202
2021-12-05,86,8,78,975.0,1202
2021-12-06,1281,1334,-53,-3.97,1202
2021-12-07,1201,1317,-116,-8.81,1202
2021-12-08,1201,1315,-114,-8.67,1202
2021-12-09,1201,1313,-112,-8.53,1202
2021-12-10,889,1106,-217,-19.62,1202
2021-12-11,281,127,154,121.26,1202
2021-12-12,86,62,24,38.71,1202
2021-12-13,1281,1319,-38,-2.88,1202
2021-12-14,1201,1305,-104,-7.97,1202
2021-12-15,1201,1305,-104,-7.97,1202
2021-12-16,1201,1304,-103,-7.9,1202
2021-12-17,889,1098,-209,-19.03,1202
2021-12-18,281,119,162,136.13,1202
2021-12-19,86,62,24,38.71,1202
2021-12-20,1281,1309,-28,-2.14,1202
2021-12-21,1201,1293,-92,-7.12,1202
2021-12-22,1201,1291,-90,-6.97,1202
2021-12-23,1201,1288,-87,-6.75,1202
2021-12-24,889,1078,-189,-17.53,1202
2021-12-25,281,95,186,195.79,1202
2021-12-26,86,53,33,62.26,1202
2021-12-27,1281,1277,4,0.31,1202
2021-12-28,1201,1257,-56,-4.46,1202
2021-12-29,1201,1251,-50,-4.0,1202
2021-12-30,1201,1244,-43,-3.46,1202
2021-12-31,889,1030,-141,-13.69,1202
2022-01-01,199,45,154,342.22,1202
2022-01-02,90,23,67,291.3,1202
2022-01-03,1102,1222,-120,-9.82,1202
2022-01-04,1106,1201,-95,-7.91,1202
2022-01-05,1106,1193,-87,-7.29,1202
2022-01-06,1106,1187,-81,-6.82,1202
2022-01-07,923,974,-51,-5.24,1202
2022-01-08,199,66,133,201.52,1202
2022-01-09,90,2,88,4400.0,1202
2022-01-10,1102,1174,-72,-6.13,1202
2022-01-11,1106,1157,-51,-4.41,1202
2022-01-12,1106,1154,-48,-4.16,1202
2022-01-13,1106,1153,-47,-4.08,1202
2022-01-14,923,946,-23,-2.43,1202
2022-01-15,199,57,142,249.12,1202
2022-01-16,90,57,33,57.89,1202
2022-01-17,1102,1164,-62,-5.33,1202
2022-01-18,1106,1153,-47,-4.08,1202
2022-01-19,1106,1157,-51,-4.41,1202
2022-01-20,1106,1161,-55,-4.74,1202
2022-01-21,923,959,-36,-3.75,1202
2022-01-22,199,65,134,206.15,1202
2022-01-23,90,0,90,inf,1202
2022-01-24,1102,1190,-88,-7.39,1202
2022-01-25,1106,1182,-76,-6.43,1202
2022-01-26,1106,1188,-82,-6.9,1202
2022-01-27,1106,1194,-88,-7.37,1202
2022-01-28,923,993,-70,-7.05,1202
2022-01-29,199,21,178,847.62,1202
2022-01-30,90,19,71,373.68,1202
2020-02-01,1082,940,142,15.11,1211
2020-02-02,883,746,137,18.36,1211
2020-02-03,3714,3667,47,1.28,1211
2020-02-04,3718,3668,50,1.36,1211
2020-02-05,3718,3674,44,1.2,1211
2020-02-06,3718,3678,40,1.09,1211
2020-02-07,3347,3310,37,1.12,1211
2020-02-08,1082,975,107,10.97,1211
2020-02-09,883,777,106,13.64,1211
2020-02-10,3714,3695,19,0.51,1211
2020-02-11,3718,3693,25,0.68,1211
2020-02-12,3718,3698,20,0.54,1211
2020-02-13,3718,3701,17,0.46,1211
2020-02-14,3347,3332,15,0.45,1211
2020-02-15,1082,997,85,8.53,1211
2020-02-16,883,801,82,10.24,1211
2020-02-17,3714,3721,-7,-0.19,1211
2020-02-18,3718,3722,-4,-0.11,1211
2020-02-19,3718,3729,-11,-0.29,1211
2020-02-20,3718,3736,-18,-0.48,1211
2020-02-21,3347,3371,-24,-0.71,1211
2020-02-22,1082,1041,41,3.94,1211
2020-02-23,883,848,35,4.13,1211
2020-02-24,3714,3773,-59,-1.56,1211
2020-02-25,3718,3778,-60,-1.59,1211
2020-02-26,3718,3789,-71,-1.87,1211
2020-02-27,3718,3800,-82,-2.16,1211
2020-02-28,3347,3438,-91,-2.65,1211
2020-02-29,1082,1110,-28,-2.52,1211
2020-03-01,873,919,-46,-5.01,1211
2020-03-02,3489,3844,-355,-9.24,1211
2020-03-03,3506,3850,-344,-8.94,1211
2020-03-04,3506,3860,-354,-9.17,1211
2020-03-05,3506,3870,-364,-9.41,1211
2020-03-06,3217,3505,-288,-8.22,1211
2020-03-07,1019,1174,-155,-13.2,1211
2020-03-08,873,980,-107,-10.92,1211
2020-03-09,3489,3902,-413,-10.58,1211
2020-03-10,3506,3903,-397,-10.17,1211
2020-03-11,3506,3909,-403,-10.31,1211
2020-03-12,3506,3914,-408,-10.42,1211
2020-03-13,3217,3545,-328,-9.25,1211
2020-03-14,1019,1209,-190,-15.72,1211
2020-03-15,873,1011,-138,-13.65,1211
2020-03-16,3489,3929,-440,-11.2,1211
2020-03-17,3506,3927,-421,-10.72,1211
2020-03-18,3506,3930,-424,-10.79,1211
2020-03-19,3506,3933,-427,-10.86,1211
2020-03-20,3217,3563,-346,-9.71,1211
2020-03-21,1019,1227,-208,-16.95,1211
2020-03-22,873,1029,-156,-15.16,1211
2020-03-23,3489,3947,-458,-11.6,1211
2020-03-24,3506,3947,-441,-11.17,1211
2020-03-25,3506,3953,-447,-11.31,1211
2020-03-26,3506,3958,-452,-11.42,1211
2020-03-27,3217,3591,-374,-10.41,1211
2020-03-28,1019,1259,-240,-19.06,1211
2020-03-29,873,1065,-192,-18.03,1211
2020-03-30,3489,3988,-499,-12.51,1211
2020-03-31,3506,3991,-485,-12.15,1211
2020-04-01,3369,4001,-632,-15.8,1211
2020-04-02,3369,4010,-641,-15.99,1211
2020-04-03,2966,3647,-681,-18.67,1211
2020-04-04,829,1317,-488,-37.05,1211
2020-04-05,604,1125,-521,-46.31,1211
2020-04-06,3355,4050,-695,-17.16,1211
2020-04-07,3369,4054,-685,-16.9,1211
2020-04-08,3369,4064,-695,-17.1,1211
2020-04-09,3369,4072,-703,-17.26,1211
2020-04-10,2966,3707,-741,-19.99,1211
2020-04-11,829,1375,-546,-39.71,1211
2020-04-12,604,1180,-576,-48.81,1211
2020-04-13,3355,4100,-745,-18.17,1211
2020-04-14,3369,4100,-731,-17.83,1211
2020-04-15,3369,4105,-736,-17.93,1211
2020-04-16,3369,4108,-739,-17.99,1211
2020-04-17,2966,3738,-772,-20.65,1211
2020-04-18,829,1400,-571,-40.79,1211
2020-04-19,604,1200,-596,-49.67,1211
2020-04-20,3355,4115,-760,-18.47,1211
2020-04-21,3369,4110,-741,-18.03,1211
2020-04-22,3369,4111,-742,-18.05,1211
2020-04-23,3369,4110,-741,-18.03,1211
2020-04-24,2966,3736,-770,-20.61,1211
2020-04-25,829,1396,-567,-40.62,1211
2020-04-26,604,1193,-589,-49.37,1211
2020-04-27,3355,4107,-752,-18.31,1211
2020-04-28,3369,4101,-732,-17.85,1211
2020-04-29,3369,4101,-732,-17.85,1211
2020-04-30,3369,4101,-732,-17.85,1211
2020-05-01,3676,3729,-53,-1.42,1211
2020-05-02,1137,1390,-253,-18.2,1211
2020-05-03,873,1190,-317,-26.64,1211
2020-05-04,4002,4106,-104,-2.53,1211
2020-05-05,4016,4103,-87,-2.12,1211
2020-05-06,4016,4107,-91,-2.22,1211
2020-05-07,4016,4110,-94,-2.29,1211
2020-05-08,3676,3740,-64,-1.71,1211
2020-05-09,1137,1404,-267,-19.02,1211
2020-05-10,873,1207,-334,-27.67,1211
2020-05-11,4002,4125,-123,-2.98,1211
2020-05-12,4016,4124,-108,-2.62,1211
2020-05-13,4016,4129,-113,-2.74,1211
2020-05-14,4016,4133,-117,-2.83,1211
2020-05-15,3676,3764,-88,-2.34,1211
2020-05-16,1137,1428,-291,-20.38,1211
2020-05-17,873,1230,-357,-29.02,1211
2020-05-18,4002,4147,-145,-3.5,1211
2020-05-19,4016,4145,-129,-3.11,1211
2020-05-20,4016,4148,-132,-3.18,1211
2020-05-21,4016,4149,-133,-3.21,1211
2020-05-22,3676,3778,-102,-2.7,1211
2020-05-23,1137,1440,-303,-21.04,1211
2020-05-24,873,1239,-366,-29.54,1211
2020-05-25,4002,4154,-152,-3.66,1211
2020-05-26,4016,4150,-134,-3.23,1211
2020-05-27,4016,4151,-135,-3.25,1211
2020-05-28,4016,4151,-135,-3.25,1211
2020-05-29,3676,3778,-102,-2.7,1211
2020-05-30,1137,1439,-302,-20.99,1211
2020-05-31,873,1239,-366,-29.54,1211
2020-06-01,4158,4154,4,0.1,1211
2020-06-02,4221,4150,71,1.71,1211
2020-06-03,4221,4152,69,1.66,1211
2020-06-04,4221,4153,68,1.64,1211
2020-06-05,3883,3782,101,2.67,1211
2020-06-06,1283,1445,-162,-11.21,1211
2020-06-07,1102,1246,-144,-11.56,1211
2020-06-08,4158,4163,-5,-0.12,1211
2020-06-09,4221,4161,60,1.44,1211
2020-06-10,4221,4165,56,1.34,1211
2020-06-11,4221,4168,53,1.27,1211
2020-06-12,3883,3798,85,2.24,1211
2020-06-13,1283,1462,-179,-12.24,1211
2020-06-14,1102,1263,-161,-12.75,1211
2020-06-15,4158,4180,-22,-0.53,1211
2020-06-16,4221,4177,44,1.05,1211
2020-06-17,4221,4180,41,0.98,1211
2020-06-18,4221,4181,40,0.96,1211
2020-06-19,3883,3808,75,1.97,1211
2020-06-20,1283,1469,-186,-12.66,1211
2020-06-21,1102,1266,-164,-12.95,1211
2020-06-22,4158,4179,-21,-0.5,1211
2020-06-23,4221,4171,50,1.2,1211
2020-06-24,4221,4168,53,1.27,1211
2020-06-25,4221,4164,57,1.37,1211
2020-06-26,3883,3786,97,2.56,1211
2020-06-27,1283,1441,-158,-10.96,1211
2020-06-28,1102,1234,-132,-10.7,1211
2020-06-29,4158,4141,17,0.41,1211
2020-06-30,4221,4129,92,2.23,1211
2020-07-01,4008,4123,-115,-2.79,1211
2020-07-02,4008,4116,-108,-2.62,1211
2020-07-03,3558,3735,-177,-4.74,1211
2020-07-04,1208,1389,-181,-13.03,1211
2020-07-05,969,1181,-212,-17.95,1211
2020-07-06,3912,4089,-177,-4.33,1211
2020-07-07,4008,4078,-70,-1.72,1211
2020-07-08,4008,4073,-65,-1.6,1211
2020-07-09,4008,4069,-61,-1.5,1211
2020-07-10,3558,3692,-134,-3.63,1211
2020-07-11,1208,1350,-142,-10.52,1211
2020-07-12,969,1146,-177,-15.45,1211
2020-07-13,3912,4059,-147,-3.62,1211
2020-07-14,4008,4053,-45,-1.11,1211
2020-07-15,4008,4054,-46,-1.13,1211
2020-07-16,4008,4055,-47,-1.16,1211
2020-07-17,3558,3683,-125,-3.39,1211
2020-07-18,1208,1346,-138,-10.25,1211
2020-07-19,969,1146,-177,-15.45,1211
2020-07-20,3912,4063,-151,-3.72,1211
2020-07-21,4008,4060,-52,-1.28,1211
2020-07-22,4008,4063,-55,-1.35,1211
2020-07-23,4008,4065,-57,-1.4,1211
2020-07-24,3558,3693,-135,-3.66,1211
2020-07-25,1208,1355,-147,-10.85,1211
2020-07-26,969,1154,-185,-16.03,1211
2020-07-27,3912,4068,-156,-3.83,1211
2020-07-28,4008,4062,-54,-1.33,1211
2020-07-29,4008,4061,-53,-1.31,1211
2020-07-30,4008,4058,-50,-1.23,1211
2020-07-31,3558,3682,-124,-3.37,1211
2020-08-01,1227,1338,-111,-8.3,1211
2020-08-02,978,1132,-154,-13.6,1211
2020-08-03,3828,4041,-213,-5.27,1211
2020-08-04,3933,4029,-96,-2.38,1211
2020-08-05,3933,4023,-90,-2.24,1211
2020-08-06,3933,4016,-83,-2.07,1211
2020-08-07,3564,3636,-72,-1.98,1211
2020-08-08,1227,1290,-63,-4.88,1211
2020-08-09,978,1081,-103,-9.53,1211
2020-08-10,3828,3989,-161,-4.04,1211
2020-08-11,3933,3978,-45,-1.13,1211
2020-08-12,3933,3973,-40,-1.01,1211
2020-08-13,3933,3969,-36,-0.91,1211
2020-08-14,3564,3592,-28,-0.78,1211
2020-08-15,1227,1251,-24,-1.92,1211
2020-08-16,978,1048,-70,-6.68,1211
2020-08-17,3828,3963,-135,-3.41,1211
2020-08-18,3933,3959,-26,-0.66,1211
2020-08-19,3933,3963,-30,-0.76,1211
2020-08-20,3933,3967,-34,-0.86,1211
2020-08-21,3564,3599,-35,-0.97,1211
2020-08-22,1227,1267,-40,-3.16,1211
2020-08-23,978,1073,-95,-8.85,1211
2020-08-24,3828,3996,-168,-4.2,1211
2020-08-25,3933,4001,-68,-1.7,1211
2020-08-26,3933,4012,-79,-1.97,1211
2020-08-27,3933,4023,-90,-2.24,1211
2020-08-28,3564,3661,-97,-2.65,1211
2020-08-29,1227,1333,-106,-7.95,1211
2020-08-30,978,1142,-164,-14.36,1211
2020-08-31,3828,4068,-240,-5.9,1211
2020-09-01,4240,4073,167,4.1,1211
2020-09-02,4240,4084,156,3.82,1211
2020-09-03,4240,4093,147,3.59,1211
2020-09-04,3920,3729,191,5.12,1211
2020-09-05,1344,1397,-53,-3.79,1211
2020-09-06,1079,1203,-124,-10.31,1211
2020-09-07,4242,4123,119,2.89,1211
2020-09-08,4240,4122,118,2.86,1211
2020-09-09,4240,4127,113,2.74,1211
2020-09-10,4240,4129,111,2.69,1211
2020-09-11,3920,3758,162,4.31,1211
2020-09-12,1344,1419,-75,-5.29,1211
2020-09-13,1079,1218,-139,-11.41,1211
2020-09-14,4242,4132,110,2.66,1211
2020-09-15,4240,4125,115,2.79,1211
2020-09-16,4240,4125,115,2.79,1211
2020-09-17,4240,4122,118,2.86,1211
2020-09-18,3920,3747,173,4.62,1211
2020-09-19,1344,1406,-62,-4.41,1211
2020-09-20,1079,1203,-124,-10.31,1211
2020-09-21,4242,4115,127,3.09,1211
2020-09-22,4240,4109,131,3.19,1211
2020-09-23,4240,4108,132,3.21,1211
2020-09-24,4240,4107,133,3.24,1211
2020-09-25,3920,3734,186,4.98,1211
2020-09-26,1344,1395,-51,-3.66,1211
2020-09-27,1079,1194,-115,-9.63,1211
2020-09-28,4242,4110,132,3.21,1211
2020-09-29,4240,4107,133,3.24,1211
2020-09-30,4240,4109,131,3.19,1211
2020-10-01,4361,4111,250,6.08,1211
2020-10-02,4023,3741,282,7.54,1211
2020-10-03,1324,1404,-80,-5.7,1211
2020-10-04,978,1205,-227,-18.84,1211
2020-10-05,4359,4122,237,5.75,1211
2020-10-06,4361,4119,242,5.88,1211
2020-10-07,4361,4122,239,5.8,1211
2020-10-08,4361,4123,238,5.77,1211
2020-10-09,4023,3751,272,7.25,1211
2020-10-10,1324,1413,-89,-6.3,1211
2020-10-11,978,1211,-233,-19.24,1211
2020-10-12,4359,4125,234,5.67,1211
2020-10-13,4361,4119,242,5.88,1211
2020-10-14,4361,4119,242,5.88,1211
2020-10-15,4361,4116,245,5.95,1211
2020-10-16,4023,3741,282,7.54,1211
2020-10-17,1324,1399,-75,-5.36,1211
2020-10-18,978,1194,-216,-18.09,1211
2020-10-19,4359,4106,253,6.16,1211
2020-10-20,4361,4097,264,6.44,1211
2020-10-21,4361,4095,266,6.5,1211
2020-10-22,4361,4091,270,6.6,1211
2020-10-23,4023,3716,307,8.26,1211
2020-10-24,1324,1374,-50,-3.64,1211
2020-10-25,978,1170,-192,-16.41,1211
2020-10-26,4359,4083,276,6.76,1211
2020-10-27,4361,4077,284,6.97,1211
2020-10-28,4361,4078,283,6.94,1211
2020-10-29,4361,4078,283,6.94,1211
2020-10-30,4023,3706,317,8.55,1211
2020-10-31,1324,1368,-44,-3.22,1211
2020-11-01,1015,1169,-154,-13.17,1211
2020-11-02,4382,4087,295,7.22,1211
2020-11-03,4237,4085,152,3.72,1211
2020-11-04,4237,4089,148,3.62,1211
2020-11-05,4237,4093,144,3.52,1211
2020-11-06,3998,3724,274,7.36,1211
2020-11-07,1317,1388,-71,-5.12,1211
2020-11-08,1015,1190,-175,-14.71,1211
2020-11-09,4382,4108,274,6.67,1211
2020-11-10,4237,4106,131,3.19,1211
2020-11-11,4237,4108,129,3.14,1211
2020-11-12,4237,4109,128,3.12,1211
2020-11-13,3998,3736,262,7.01,1211
2020-11-14,1317,1396,-79,-5.66,1211
2020-11-15,1015,1193,-178,-14.92,1211
2020-11-16,4382,4104,278,6.77,1211
2020-11-17,4237,4095,142,3.47,1211
2020-11-18,4237,4090,147,3.59,1211
2020-11-19,4237,4082,155,3.8,1211
2020-11-20,3998,3701,297,8.02,1211
2020-11-21,1317,1353,-36,-2.66,1211
2020-11-22,1015,1141,-126,-11.04,1211
2020-11-23,4382,4045,337,8.33,1211
2020-11-24,4237,4028,209,5.19,1211
2020-11-25,4237,4016,221,5.5,1211
2020-11-26,4237,4003,234,5.85,1211
2020-11-27,3998,3617,381,10.53,1211
2020-11-28,1317,1265,52,4.11,1211
2020-11-29,1015,1051,-36,-3.43,1211
2020-11-30,4382,3953,429,10.85,1211
2020-12-01,3651,3935,-284,-7.22,1211
2020-12-02,3651,3925,-274,-6.98,1211
2020-12-03,3651,3914,-263,-6.72,1211
2020-12-04,4151,3531,620,17.56,1211
2020-12-05,1533,1182,351,29.7,1211
2020-12-06,934,973,-39,-4.01,1211
2020-12-07,3858,3880,-22,-0.57,1211
2020-12-08,3651,3869,-218,-5.63,1211
2020-12-09,3651,3864,-213,-5.51,1211
2020-12-10,3651,3860,-209,-5.41,1211
2020-12-11,4151,3483,668,19.18,1211
2020-12-12,1533,1141,392,34.36,1211
2020-12-13,934,937,-3,-0.32,1211
2020-12-14,3858,3849,9,0.23,1211
2020-12-15,3651,3842,-191,-4.97,1211
2020-12-16,3651,3841,-190,-4.95,1211
2020-12-17,3651,3839,-188,-4.9,1211
2020-12-18,4151,3464,687,19.83,1211
2020-12-19,1533,1122,411,36.63,1211
2020-12-20,934,918,16,1.74,1211
2020-12-21,3858,3828,30,0.78,1211
2020-12-22,3651,3819,-168,-4.4,1211
2020-12-23,3651,3814,-163,-4.27,1211
2020-12-24,3651,3807,-156,-4.1,1211
2020-12-25,4151,3427,724,21.13,1211
2020-12-26,1533,1079,454,42.08,1211
2020-12-27,934,869,65,7.48,1211
2020-12-28,3858,3773,85,2.25,1211
2020-12-29,3651,3757,-106,-2.82,1211
2020-12-30,3651,3747,-96,-2.56,1211
2020-12-31,3651,3734,-83,-2.22,1211
2021-01-01,3444,3349,95,2.84,1211
2021-01-02,1141,998,143,14.33,1211
2021-01-03,909,784,125,15.94,1211
2021-01-04,3631,3686,-55,-1.49,1211
2021-01-05,3695,3669,26,0.71,1211
2021-01-06,3695,3659,36,0.98,1211
2021-01-07,3695,3649,46,1.26,1211
2021-01-08,3444,3266,178,5.45,1211
2021-01-09,1141,919,222,24.16,1211
2021-01-10,909,710,199,28.03,1211
2021-01-11,3631,3619,12,0.33,1211
2021-01-12,3695,3610,85,2.35,1211
2021-01-13,3695,3608,87,2.41,1211
2021-01-14,3695,3606,89,2.47,1211
2021-01-15,3444,3233,211,6.53,1211
2021-01-16,1141,896,245,27.34,1211
2021-01-17,909,697,212,30.42,1211
2021-01-18,3631,3616,15,0.41,1211
2021-01-19,3695,3616,79,2.18,1211
2021-01-20,3695,3624,71,1.96,1211
2021-01-21,3695,3631,64,1.76,1211
2021-01-22,3444,3266,178,5.45,1211
2021-01-23,1141,935,206,22.03,1211
2021-01-24,909,743,166,22.34,1211
2021-01-25,3631,3667,-36,-0.98,1211
2021-01-26,3695,3671,24,0.65,1211
2021-01-27,3695,3681,14,0.38,1211
2021-01-28,3695,3690,5,0.14,1211
2021-01-29,3444,3326,118,3.55,1211
2021-01-30,1141,995,146,14.67,1211
2021-01-31,909,802,107,13.34,1211
2021-02-01,3965,3723,242,6.5,1211
2021-02-02,3904,3725,179,4.81,1211
2021-02-03,3904,3732,172,4.61,1211
2021-02-04,3904,3737,167,4.47,1211
2021-02-05,3646,3369,277,8.22,1211
2021-02-06,1207,1035,172,16.62,1211
2021-02-07,989,837,152,18.16,1211
2021-02-08,3965,3755,210,5.59,1211
2021-02-09,3904,3754,150,4.0,1211
2021-02-10,3904,3758,146,3.89,1211
2021-02-11,3904,3762,142,3.77,1211
2021-02-12,3646,3392,254,7.49,1211
2021-02-13,1207,1057,150,14.19,1211
2021-02-14,989,860,129,15.0,1211
2021-02-15,3965,3779,186,4.92,1211
2021-02-16,3904,3779,125,3.31,1211
2021-02-17,3904,3786,118,3.12,1211
2021-02-18,3904,3792,112,2.95,1211
2021-02-19,3646,3426,220,6.42,1211
2021-02-20,1207,1095,112,10.23,1211
2021-02-21,989,902,87,9.65,1211
2021-02-22,3965,3826,139,3.63,1211
2021-02-23,3904,3830,74,1.93,1211
2021-02-24,3904,3841,63,1.64,1211
2021-02-25,3904,3851,53,1.38,1211
2021-02-26,3646,3489,157,4.5,1211
2021-02-27,1207,1161,46,3.96,1211
2021-02-28,989,970,19,1.96,1211
2021-03-01,4267,3896,371,9.52,1211
2021-03-02,4303,3902,401,10.28,1211
2021-03-03,4303,3913,390,9.97,1211
2021-03-04,4303,3923,380,9.69,1211
2021-03-05,3924,3559,365,10.26,1211
2021-03-06,1351,1229,122,9.93,1211
2021-03-07,1059,1036,23,2.22,1211
2021-03-08,4267,3958,309,7.81,1211
2021-03-09,4303,3960,343,8.66,1211
2021-03-10,4303,3967,336,8.47,1211
2021-03-11,4303,3973,330,8.31,1211
2021-03-12,3924,3605,319,8.85,1211
2021-03-13,1351,1270,81,6.38,1211
2021-03-14,1059,1072,-13,-1.21,1211
2021-03-15,4267,3990,277,6.94,1211
2021-03-16,4303,3988,315,7.9,1211
2021-03-17,4303,3992,311,7.79,1211
2021-03-18,4303,3994,309,7.74,1211
2021-03-19,3924,3624,300,8.28,1211
2021-03-20,1351,1288,63,4.89,1211
2021-03-21,1059,1090,-31,-2.84,1211
2021-03-22,4267,4007,260,6.49,1211
2021-03-23,4303,4006,297,7.41,1211
2021-03-24,4303,4011,292,7.28,1211
2021-03-25,4303,4016,287,7.15,1211
2021-03-26,3924,3649,275,7.54,1211
2021-03-27,1351,1316,35,2.66,1211
2021-03-28,1059,1121,-62,-5.53,1211
2021-03-29,4267,4043,224,5.54,1211
2021-03-30,4303,4046,257,6.35,1211
2021-03-31,4303,4055,248,6.12,1211
2021-04-01,4353,4064,289,7.11,1211
2021-04-02,4000,3700,300,8.11,1211
2021-04-03,1440,1370,70,5.11,1211
2021-04-04,1012,1178,-166,-14.09,1211
2021-04-05,4409,4103,306,7.46,1211
2021-04-06,4353,4107,246,5.99,1211
2021-04-07,4353,4117,236,5.73,1211
2021-04-08,4353,4126,227,5.5,1211
2021-04-09,4000,3762,238,6.33,1211
2021-04-10,1440,1431,9,0.63,1211
2021-04-11,1012,1237,-225,-18.19,1211
2021-04-12,4409,4158,251,6.04,1211
2021-04-13,4353,4159,194,4.66,1211
2021-04-14,4353,4165,188,4.51,1211
2021-04-15,4353,4169,184,4.41,1211
2021-04-16,4000,3800,200,5.26,1211
2021-04-17,1440,1463,-23,-1.57,1211
2021-04-18,1012,1264,-252,-19.94,1211
2021-04-19,4409,4180,229,5.48,1211
2021-04-20,4353,4175,178,4.26,1211
2021-04-21,4353,4176,177,4.24,1211
2021-04-22,4353,4176,177,4.24,1211
2021-04-23,4000,3802,198,5.21,1211
2021-04-24,1440,1462,-22,-1.5,1211
2021-04-25,1012,1260,-248,-19.68,1211
2021-04-26,4409,4173,236,5.66,1211
2021-04-27,4353,4167,186,4.46,1211
2021-04-28,4353,4167,186,4.46,1211
2021-04-29,4353,4166,187,4.49,1211
2021-04-30,4000,3793,207,5.46,1211
2021-05-01,1559,1454,105,7.22,1211
2021-05-02,1047,1254,-207,-16.51,1211
2021-05-03,4473,4169,304,7.29,1211
2021-05-04,4583,4166,417,10.01,1211
2021-05-05,4583,4169,414,9.93,1211
2021-05-06,4583,4171,412,9.88,1211
2021-05-07,4224,3801,423,11.13,1211
2021-05-08,1559,1465,94,6.42,1211
2021-05-09,1047,1267,-220,-17.36,1211
2021-05-10,4473,4185,288,6.88,1211
2021-05-11,4583,4184,399,9.54,1211
2021-05-12,4583,4189,394,9.41,1211
2021-05-13,4583,4193,390,9.3,1211
2021-05-14,4224,3824,400,10.46,1211
2021-05-15,1559,1489,70,4.7,1211
2021-05-16,1047,1291,-244,-18.9,1211
2021-05-17,4473,4209,264,6.27,1211
2021-05-18,4583,4207,376,8.94,1211
2021-05-19,4583,4210,373,8.86,1211
2021-05-20,4583,4212,371,8.81,1211
2021-05-21,4224,3841,383,9.97,1211
2021-05-22,1559,1503,56,3.73,1211
2021-05-23,1047,1303,-256,-19.65,1211
2021-05-24,4473,4219,254,6.02,1211
2021-05-25,4583,4214,369,8.76,1211
2021-05-26,4583,4216,367,8.7,1211
2021-05-27,4583,4216,367,8.7,1211
2021-05-28,4224,3843,381,9.91,1211
2021-05-29,1559,1504,55,3.66,1211
2021-05-30,1047,1303,-256,-19.65,1211
2021-05-31,4473,4218,255,6.05,1211
2021-06-01,4684,4214,470,11.15,1211
2021-06-02,4684,4215,469,11.13,1211
2021-06-03,4684,4216,468,11.1,1211
2021-06-04,4312,3845,467,12.15,1211
2021-06-05,1600,1507,93,6.17,1211
2021-06-06,1227,1308,-81,-6.19,1211
2021-06-07,4612,4225,387,9.16,1211
2021-06-08,4684,4222,462,10.94,1211
2021-06-09,4684,4226,458,10.84,1211
2021-06-10,4684,4229,455,10.76,1211
2021-06-11,4312,3859,453,11.74,1211
2021-06-12,1600,1523,77,5.06,1211
2021-06-13,1227,1325,-98,-7.4,1211
2021-06-14,4612,4242,370,8.72,1211
2021-06-15,4684,4240,444,10.47,1211
2021-06-16,4684,4243,441,10.39,1211
2021-06-17,4684,4244,440,10.37,1211
2021-06-18,4312,3873,439,11.33,1211
2021-06-19,1600,1534,66,4.3,1211
2021-06-20,1227,1332,-105,-7.88,1211
2021-06-21,4612,4246,366,8.62,1211
2021-06-22,4684,4239,445,10.5,1211
2021-06-23,4684,4238,446,10.52,1211
2021-06-24,4684,4234,450,10.63,1211
2021-06-25,4312,3857,455,11.8,1211
2021-06-26,1600,1513,87,5.75,1211
2021-06-27,1227,1306,-79,-6.05,1211
2021-06-28,4612,4215,397,9.42,1211
2021-06-29,4684,4203,481,11.44,1211
2021-06-30,4684,4197,487,11.6,1211
2021-07-01,3938,4190,-252,-6.01,1211
2021-07-02,3582,3809,-227,-5.96,1211
2021-07-03,1432,1463,-31,-2.12,1211
2021-07-04,982,1254,-272,-21.69,1211
2021-07-05,3643,4162,-519,-12.47,1211
2021-07-06,3938,4150,-212,-5.11,1211
2021-07-07,3938,4145,-207,-4.99,1211
2021-07-08,3938,4140,-202,-4.88,1211
2021-07-09,3582,3762,-180,-4.78,1211
2021-07-10,1432,1419,13,0.92,1211
2021-07-11,982,1214,-232,-19.11,1211
2021-07-12,3643,4126,-483,-11.71,1211
2021-07-13,3938,4119,-181,-4.39,1211
2021-07-14,3938,4119,-181,-4.39,1211
2021-07-15,3938,4119,-181,-4.39,1211
2021-07-16,3582,3747,-165,-4.4,1211
2021-07-17,1432,1409,23,1.63,1211
2021-07-18,982,1209,-227,-18.78,1211
2021-07-19,3643,4125,-482,-11.68,1211
2021-07-20,3938,4122,-184,-4.46,1211
2021-07-21,3938,4125,-187,-4.53,1211
2021-07-22,3938,4127,-189,-4.58,1211
2021-07-23,3582,3756,-174,-4.63,1211
2021-07-24,1432,1419,13,0.92,1211
2021-07-25,982,1219,-237,-19.44,1211
2021-07-26,3643,4134,-491,-11.88,1211
2021-07-27,3938,4129,-191,-4.63,1211
2021-07-28,3938,4128,-190,-4.6,1211
2021-07-29,3938,4127,-189,-4.58,1211
2021-07-30,3582,3751,-169,-4.51,1211
2021-07-31,1432,1409,23,1.63,1211
2021-08-01,1038,1203,-165,-13.72,1211
2021-08-02,3218,4113,-895,-21.76,1211
2021-08-03,3425,4102,-677,-16.5,1211
2021-08-04,3425,4097,-672,-16.4,1211
2021-08-05,3425,4090,-665,-16.26,1211
2021-08-06,3154,3710,-556,-14.99,1211
2021-08-07,1270,1364,-94,-6.89,1211
2021-08-08,1038,1155,-117,-10.13,1211
2021-08-09,3218,4062,-844,-20.78,1211
2021-08-10,3425,4051,-626,-15.45,1211
2021-08-11,3425,4045,-620,-15.33,1211
2021-08-12,3425,4040,-615,-15.22,1211
2021-08-13,3154,3662,-508,-13.87,1211
2021-08-14,1270,1319,-49,-3.71,1211
2021-08-15,1038,1115,-77,-6.91,1211
2021-08-16,3218,4028,-810,-20.11,1211
2021-08-17,3425,4023,-598,-14.86,1211
2021-08-18,3425,4025,-600,-14.91,1211
2021-08-19,3425,4027,-602,-14.95,1211
2021-08-20,3154,3658,-504,-13.78,1211
2021-08-21,1270,1324,-54,-4.08,1211
2021-08-22,1038,1129,-91,-8.06,1211
2021-08-23,3218,4051,-833,-20.56,1211
2021-08-24,3425,4054,-629,-15.52,1211
2021-08-25,3425,4064,-639,-15.72,1211
2021-08-26,3425,4074,-649,-15.93,1211
2021-08-27,3154,3712,-558,-15.03,1211
2021-08-28,1270,1384,-114,-8.24,1211
2021-08-29,1038,1193,-155,-12.99,1211
2021-08-30,3218,4119,-901,-21.87,1211
2021-08-31,3425,4125,-700,-16.97,1211
2021-09-01,3640,4137,-497,-12.01,1211
2021-09-02,3640,4147,-507,-12.23,1211
2021-09-03,3347,3783,-436,-11.53,1211
2021-09-04,1421,1453,-32,-2.2,1211
2021-09-05,1064,1259,-195,-15.49,1211
2021-09-06,3436,4181,-745,-17.82,1211
2021-09-07,3640,4182,-542,-12.96,1211
2021-09-08,3640,4187,-547,-13.06,1211
2021-09-09,3640,4191,-551,-13.15,1211
2021-09-10,3347,3821,-474,-12.41,1211
2021-09-11,1421,1483,-62,-4.18,1211
2021-09-12,1064,1283,-219,-17.07,1211
2021-09-13,3436,4197,-761,-18.13,1211
2021-09-14,3640,4192,-552,-13.17,1211
2021-09-15,3640,4192,-552,-13.17,1211
2021-09-16,3640,4190,-550,-13.13,1211
2021-09-17,3347,3815,-468,-12.27,1211
2021-09-18,1421,1474,-53,-3.6,1211
2021-09-19,1064,1270,-206,-16.22,1211
2021-09-20,3436,4183,-747,-17.86,1211
2021-09-21,3640,4176,-536,-12.84,1211
2021-09-22,3640,4175,-535,-12.81,1211
2021-09-23,3640,4173,-533,-12.77,1211
2021-09-24,3347,3800,-453,-11.92,1211
2021-09-25,1421,1460,-39,-2.67,1211
2021-09-26,1064,1259,-195,-15.49,1211
2021-09-27,3436,4174,-738,-17.68,1211
2021-09-28,3640,4170,-530,-12.71,1211
2021-09-29,3640,4172,-532,-12.75,1211
2021-09-30,3640,4174,-534,-12.79,1211
2021-10-01,3634,3803,-169,-4.44,1211
2021-10-02,1440,1466,-26,-1.77,1211
2021-10-03,983,1267,-284,-22.42,1211
2021-10-04,3453,4184,-731,-17.47,1211
2021-10-05,3775,4181,-406,-9.71,1211
2021-10-06,3775,4184,-409,-9.78,1211
2021-10-07,3775,4186,-411,-9.82,1211
2021-10-08,3634,3815,-181,-4.74,1211
2021-10-09,1440,1477,-37,-2.51,1211
2021-10-10,983,1276,-293,-22.96,1211
2021-10-11,3453,4191,-738,-17.61,1211
2021-10-12,3775,4186,-411,-9.82,1211
2021-10-13,3775,4186,-411,-9.82,1211
2021-10-14,3775,4184,-409,-9.78,1211
2021-10-15,3634,3809,-175,-4.59,1211
2021-10-16,1440,1468,-28,-1.91,1211
2021-10-17,983,1263,-280,-22.17,1211
2021-10-18,3453,4175,-722,-17.29,1211
2021-10-19,3775,4167,-392,-9.41,1211
2021-10-20,3775,4164,-389,-9.34,1211
2021-10-21,3775,4160,-385,-9.25,1211
2021-10-22,3634,3784,-150,-3.96,1211
2021-10-23,1440,1442,-2,-0.14,1211
2021-10-24,983,1238,-255,-20.6,1211
2021-10-25,3453,4150,-697,-16.8,1211
2021-10-26,3775,4144,-369,-8.9,1211
2021-10-27,3775,4143,-368,-8.88,1211
2021-10-28,3775,4143,-368,-8.88,1211
2021-10-29,3634,3770,-136,-3.61,1211
2021-10-30,1440,1431,9,0.63,1211
2021-10-31,983,1232,-249,-20.21,1211
2021-11-01,3686,4148,-462,-11.14,1211
2021-11-02,3760,4146,-386,-9.31,1211
2021-11-03,3760,4150,-390,-9.4,1211
2021-11-04,3760,4153,-393,-9.46,1211
2021-11-05,3405,3784,-379,-10.02,1211
2021-11-06,1406,1449,-43,-2.97,1211
2021-11-07,987,1251,-264,-21.1,1211
2021-11-08,3686,4169,-483,-11.59,1211
2021-11-09,3760,4167,-407,-9.77,1211
2021-11-10,3760,4171,-411,-9.85,1211
2021-11-11,3760,4173,-413,-9.9,1211
2021-11-12,3405,3801,-396,-10.42,1211
2021-11-13,1406,1462,-56,-3.83,1211
2021-11-14,987,1260,-273,-21.67,1211
2021-11-15,3686,4173,-487,-11.67,1211
2021-11-16,3760,4165,-405,-9.72,1211
2021-11-17,3760,4162,-402,-9.66,1211
2021-11-18,3760,4156,-396,-9.53,1211
2021-11-19,3405,3776,-371,-9.83,1211
2021-11-20,1406,1429,-23,-1.61,1211
2021-11-21,987,1219,-232,-19.03,1211
2021-11-22,3686,4123,-437,-10.6,1211
2021-11-23,3760,4108,-348,-8.47,1211
2021-11-24,3760,4097,-337,-8.23,1211
2021-11-25,3760,4084,-324,-7.93,1211
2021-11-26,3405,3699,-294,-7.95,1211
2021-11-27,1406,1346,60,4.46,1211
2021-11-28,987,1132,-145,-12.81,1211
2021-11-29,3686,4033,-347,-8.6,1211
2021-11-30,3760,4016,-256,-6.37,1211
2021-12-01,3248,4004,-756,-18.88,1211
2021-12-02,3248,3992,-744,-18.64,1211
2021-12-03,2484,3608,-1124,-31.15,1211
2021-12-04,1478,1259,219,17.39,1211
2021-12-05,940,1048,-108,-10.31,1211
2021-12-06,3295,3954,-659,-16.67,1211
2021-12-07,3248,3942,-694,-17.61,1211
2021-12-08,3248,3936,-688,-17.48,1211
2021-12-09,3248,3930,-682,-17.35,1211
2021-12-10,2484,3553,-1069,-30.09,1211
2021-12-11,1478,1210,268,22.15,1211
2021-12-12,940,1005,-65,-6.47,1211
2021-12-13,3295,3917,-622,-15.88,1211
2021-12-14,3248,3910,-662,-16.93,1211
2021-12-15,3248,3909,-661,-16.91,1211
2021-12-16,3248,3907,-659,-16.87,1211
2021-12-17,2484,3532,-1048,-29.67,1211
2021-12-18,1478,1190,288,24.2,1211
2021-12-19,940,987,-47,-4.76,1211
2021-12-20,3295,3898,-603,-15.47,1211
2021-12-21,3248,3889,-641,-16.48,1211
2021-12-22,3248,3886,-638,-16.42,1211
2021-12-23,3248,3880,-632,-16.29,1211
2021-12-24,2484,3501,-1017,-29.05,1211
2021-12-25,1478,1155,323,27.97,1211
2021-12-26,940,945,-5,-0.53,1211
2021-12-27,3295,3851,-556,-14.44,1211
2021-12-28,3248,3836,-588,-15.33,1211
2021-12-29,3248,3826,-578,-15.11,1211
2021-12-30,3248,3814,-566,-14.84,1211
2021-12-31,2484,3430,-946,-27.58,1211
2022-01-01,1138,1078,60,5.57,1211
2022-01-02,776,864,-88,-10.19,1211
2022-01-03,2918,3766,-848,-22.52,1211
2022-01-04,3037,3749,-712,-18.99,1211
2022-01-05,3037,3738,-701,-18.75,1211
2022-01-06,3037,3727,-690,-18.51,1211
2022-01-07,2753,3343,-590,-17.65,1211
2022-01-08,1138,994,144,14.49,1211
2022-01-09,776,784,-8,-1.02,1211
2022-01-10,2918,3691,-773,-20.94,1211
2022-01-11,3037,3680,-643,-17.47,1211
2022-01-12,3037,3677,-640,-17.41,1211
2022-01-13,3037,3673,-636,-17.32,1211
2022-01-14,2753,3298,-545,-16.53,1211
2022-01-15,1138,959,179,18.67,1211
2022-01-16,776,759,17,2.24,1211
2022-01-17,2918,3676,-758,-20.62,1211
2022-01-18,3037,3675,-638,-17.36,1211
2022-01-19,3037,3681,-644,-17.5,1211
2022-01-20,3037,3687,-650,-17.63,1211
2022-01-21,2753,3321,-568,-17.1,1211
2022-01-22,1138,990,148,14.95,1211
2022-01-23,776,797,-21,-2.63,1211
2022-01-24,2918,3720,-802,-21.56,1211
2022-01-25,3037,3725,-688,-18.47,1211
2022-01-26,3037,3735,-698,-18.69,1211
2022-01-27,3037,3744,-707,-18.88,1211
2022-01-28,2753,3380,-627,-18.55,1211
2022-01-29,1138,1050,88,8.38,1211
2022-01-30,776,857,-81,-9.45,1211
2020-02-01,151,130,21,16.15,1216
2020-02-02,116,92,24,26.09,1216
2020-02-03,261,262,-1,-0.38,1216
2020-02-04,272,266,6,2.26,1216
2020-02-05,272,266,6,2.26,1216
2020-02-06,272,266,6,2.26,1216
2020-02-07,261,255,6,2.35,1216
2020-02-08,151,129,22,17.05,1216
2020-02-09,116,91,25,27.47,1216
2020-02-10,261,261,0,0.0,1216
2020-02-11,272,266,6,2.26,1216
2020-02-12,272,266,6,2.26,1216
2020-02-13,272,265,7,2.64,1216
2020-02-14,261,255,6,2.35,1216
2020-02-15,151,129,22,17.05,1216
2020-02-16,116,91,25,27.47,1216
2020-02-17,261,262,-1,-0.38,1216
2020-02-18,272,267,5,1.87,1216
2020-02-19,272,267,5,1.87,1216
2020-02-20,272,268,4,1.49,1216
2020-02-21,261,258,3,1.16,1216
2020-02-22,151,132,19,14.39,1216
2020-02-23,116,95,21,22.11,1216
2020-02-24,261,266,-5,-1.88,1216
2020-02-25,272,272,0,0.0,1216
2020-02-26,272,273,-1,-0.37,1216
2020-02-27,272,273,-1,-0.37,1216
2020-02-28,261,264,-3,-1.14,1216
2020-02-29,151,139,12,8.63,1216
2020-03-01,117,102,15,14.71,1216
2020-03-02,255,273,-18,-6.59,1216
2020-03-03,252,278,-26,-9.35,1216
2020-03-04,252,279,-27,-9.68,1216
2020-03-05,252,280,-28,-10.0,1216
2020-03-06,252,270,-18,-6.67,1216
2020-03-07,147,144,3,2.08,1216
2020-03-08,117,107,10,9.35,1216
2020-03-09,255,277,-22,-7.94,1216
2020-03-10,252,282,-30,-10.64,1216
2020-03-11,252,283,-31,-10.95,1216
2020-03-12,252,283,-31,-10.95,1216
2020-03-13,252,272,-20,-7.35,1216
2020-03-14,147,146,1,0.68,1216
2020-03-15,117,108,9,8.33,1216
2020-03-16,255,279,-24,-8.6,1216
2020-03-17,252,284,-32,-11.27,1216
2020-03-18,252,284,-32,-11.27,1216
2020-03-19,252,283,-31,-10.95,1216
2020-03-20,252,273,-21,-7.69,1216
2020-03-21,147,147,0,0.0,1216
2020-03-22,117,109,8,7.34,1216
2020-03-23,255,280,-25,-8.93,1216
2020-03-24,252,285,-33,-11.58,1216
2020-03-25,252,286,-34,-11.89,1216
2020-03-26,252,286,-34,-11.89,1216
2020-03-27,252,276,-24,-8.7,1216
2020-03-28,147,150,-3,-2.0,1216
2020-03-29,117,113,4,3.54,1216
2020-03-30,255,284,-29,-10.21,1216
2020-03-31,252,290,-38,-13.1,1216
2020-04-01,258,291,-33,-11.34,1216
2020-04-02,258,291,-33,-11.34,1216
2020-04-03,244,282,-38,-13.48,1216
2020-04-04,143,156,-13,-8.33,1216
2020-04-05,114,119,-5,-4.2,1216
2020-04-06,256,291,-35,-12.03,1216
2020-04-07,258,296,-38,-12.84,1216
2020-04-08,258,297,-39,-13.13,1216
2020-04-09,258,297,-39,-13.13,1216
2020-04-10,244,287,-43,-14.98,1216
2020-04-11,143,162,-19,-11.73,1216
2020-04-12,114,124,-10,-8.06,1216
2020-04-13,256,295,-39,-13.22,1216
2020-04-14,258,300,-42,-14.0,1216
2020-04-15,258,300,-42,-14.0,1216
2020-04-16,258,300,-42,-14.0,1216
2020-04-17,244,289,-45,-15.57,1216
2020-04-18,143,163,-20,-12.27,1216
2020-04-19,114,125,-11,-8.8,1216
2020-04-20,256,296,-40,-13.51,1216
2020-04-21,258,300,-42,-14.0,1216
2020-04-22,258,300,-42,-14.0,1216
2020-04-23,258,299,-41,-13.71,1216
2020-04-24,244,288,-44,-15.28,1216
2020-04-25,143,162,-19,-11.73,1216
2020-04-26,114,124,-10,-8.06,1216
2020-04-27,256,294,-38,-12.93,1216
2020-04-28,258,298,-40,-13.42,1216
2020-04-29,258,298,-40,-13.42,1216
2020-04-30,258,298,-40,-13.42,1216
2020-05-01,277,287,-10,-3.48,1216
2020-05-02,159,161,-2,-1.24,1216
2020-05-03,118,123,-5,-4.07,1216
2020-05-04,287,294,-7,-2.38,1216
2020-05-05,281,298,-17,-5.7,1216
2020-05-06,281,299,-18,-6.02,1216
2020-05-07,281,298,-17,-5.7,1216
2020-05-08,277,288,-11,-3.82,1216
2020-05-09,159,162,-3,-1.85,1216
2020-05-10,118,124,-6,-4.84,1216
2020-05-11,287,295,-8,-2.71,1216
2020-05-12,281,300,-19,-6.33,1216
2020-05-13,281,300,-19,-6.33,1216
2020-05-14,281,300,-19,-6.33,1216
2020-05-15,277,289,-12,-4.15,1216
2020-05-16,159,164,-5,-3.05,1216
2020-05-17,118,126,-8,-6.35,1216
2020-05-18,287,296,-9,-3.04,1216
2020-05-19,281,301,-20,-6.64,1216
2020-05-20,281,301,-20,-6.64,1216
2020-05-21,281,300,-19,-6.33,1216
2020-05-22,277,289,-12,-4.15,1216
2020-05-23,159,163,-4,-2.45,1216
2020-05-24,118,125,-7,-5.6,1216
2020-05-25,287,295,-8,-2.71,1216
2020-05-26,281,300,-19,-6.33,1216
2020-05-27,281,300,-19,-6.33,1216
2020-05-28,281,299,-18,-6.02,1216
2020-05-29,277,289,-12,-4.15,1216
2020-05-30,159,163,-4,-2.45,1216
2020-05-31,118,125,-7,-5.6,1216
2020-06-01,267,295,-28,-9.49,1216
2020-06-02,282,300,-18,-6.0,1216
2020-06-03,282,300,-18,-6.0,1216
2020-06-04,282,300,-18,-6.0,1216
2020-06-05,283,289,-6,-2.08,1216
2020-06-06,158,164,-6,-3.66,1216
2020-06-07,118,126,-8,-6.35,1216
2020-06-08,267,296,-29,-9.8,1216
2020-06-09,282,301,-19,-6.31,1216
2020-06-10,282,302,-20,-6.62,1216
2020-06-11,282,302,-20,-6.62,1216
2020-06-12,283,291,-8,-2.75,1216
2020-06-13,158,166,-8,-4.82,1216
2020-06-14,118,128,-10,-7.81,1216
2020-06-15,267,298,-31,-10.4,1216
2020-06-16,282,303,-21,-6.93,1216
2020-06-17,282,303,-21,-6.93,1216
2020-06-18,282,302,-20,-6.62,1216
2020-06-19,283,292,-9,-3.08,1216
2020-06-20,158,165,-7,-4.24,1216
2020-06-21,118,126,-8,-6.35,1216
2020-06-22,267,296,-29,-9.8,1216
2020-06-23,282,300,-18,-6.0,1216
2020-06-24,282,299,-17,-5.69,1216
2020-06-25,282,298,-16,-5.37,1216
2020-06-26,283,286,-3,-1.05,1216
2020-06-27,158,159,-1,-0.63,1216
2020-06-28,118,119,-1,-0.84,1216
2020-06-29,267,288,-21,-7.29,1216
2020-06-30,282,291,-9,-3.09,1216
2020-07-01,261,290,-29,-10.0,1216
2020-07-02,261,288,-27,-9.38,1216
2020-07-03,255,276,-21,-7.61,1216
2020-07-04,143,148,-5,-3.38,1216
2020-07-05,117,109,8,7.34,1216
2020-07-06,264,278,-14,-5.04,1216
2020-07-07,261,282,-21,-7.45,1216
2020-07-08,261,281,-20,-7.12,1216
2020-07-09,261,279,-18,-6.45,1216
2020-07-10,255,268,-13,-4.85,1216
2020-07-11,143,141,2,1.42,1216
2020-07-12,117,103,14,13.59,1216
2020-07-13,264,273,-9,-3.3,1216
2020-07-14,261,277,-16,-5.78,1216
2020-07-15,261,277,-16,-5.78,1216
2020-07-16,261,277,-16,-5.78,1216
2020-07-17,255,267,-12,-4.49,1216
2020-07-18,143,141,2,1.42,1216
2020-07-19,117,103,14,13.59,1216
2020-07-20,264,274,-10,-3.65,1216
2020-07-21,261,279,-18,-6.45,1216
2020-07-22,261,280,-19,-6.79,1216
2020-07-23,261,280,-19,-6.79,1216
2020-07-24,255,270,-15,-5.56,1216
2020-07-25,143,144,-1,-0.69,1216
2020-07-26,117,106,11,10.38,1216
2020-07-27,264,277,-13,-4.69,1216
2020-07-28,261,282,-21,-7.45,1216
2020-07-29,261,282,-21,-7.45,1216
2020-07-30,261,281,-20,-7.12,1216
2020-07-31,255,271,-16,-5.9,1216
2020-08-01,152,144,8,5.56,1216
2020-08-02,124,106,18,16.98,1216
2020-08-03,258,276,-18,-6.52,1216
2020-08-04,262,280,-18,-6.43,1216
2020-08-05,262,279,-17,-6.09,1216
2020-08-06,262,278,-16,-5.76,1216
2020-08-07,246,267,-21,-7.87,1216
2020-08-08,152,140,12,8.57,1216
2020-08-09,124,101,23,22.77,1216
2020-08-10,258,271,-13,-4.8,1216
2020-08-11,262,275,-13,-4.73,1216
2020-08-12,262,274,-12,-4.38,1216
2020-08-13,262,273,-11,-4.03,1216
2020-08-14,246,262,-16,-6.11,1216
2020-08-15,152,136,16,11.76,1216
2020-08-16,124,98,26,26.53,1216
2020-08-17,258,268,-10,-3.73,1216
2020-08-18,262,273,-11,-4.03,1216
2020-08-19,262,274,-12,-4.38,1216
2020-08-20,262,274,-12,-4.38,1216
2020-08-21,246,264,-18,-6.82,1216
2020-08-22,152,139,13,9.35,1216
2020-08-23,124,102,22,21.57,1216
2020-08-24,258,273,-15,-5.49,1216
2020-08-25,262,279,-17,-6.09,1216
2020-08-26,262,280,-18,-6.43,1216
2020-08-27,262,281,-19,-6.76,1216
2020-08-28,246,272,-26,-9.56,1216
2020-08-29,152,148,4,2.7,1216
2020-08-30,124,111,13,11.71,1216
2020-08-31,258,283,-25,-8.83,1216
2020-09-01,295,289,6,2.08,1216
2020-09-02,295,290,5,1.72,1216
2020-09-03,295,291,4,1.37,1216
2020-09-04,287,282,5,1.77,1216
2020-09-05,164,157,7,4.46,1216
2020-09-06,127,119,8,6.72,1216
2020-09-07,281,291,-10,-3.44,1216
2020-09-08,295,296,-1,-0.34,1216
2020-09-09,295,296,-1,-0.34,1216
2020-09-10,295,296,-1,-0.34,1216
2020-09-11,287,286,1,0.35,1216
2020-09-12,164,160,4,2.5,1216
2020-09-13,127,122,5,4.1,1216
2020-09-14,281,293,-12,-4.1,1216
2020-09-15,295,297,-2,-0.67,1216
2020-09-16,295,297,-2,-0.67,1216
2020-09-17,295,297,-2,-0.67,1216
2020-09-18,287,286,1,0.35,1216
2020-09-19,164,160,4,2.5,1216
2020-09-20,127,121,6,4.96,1216
2020-09-21,281,292,-11,-3.77,1216
2020-09-22,295,296,-1,-0.34,1216
2020-09-23,295,296,-1,-0.34,1216
2020-09-24,295,296,-1,-0.34,1216
2020-09-25,287,286,1,0.35,1216
2020-09-26,164,160,4,2.5,1216
2020-09-27,127,122,5,4.1,1216
2020-09-28,281,293,-12,-4.1,1216
2020-09-29,295,298,-3,-1.01,1216
2020-09-30,295,299,-4,-1.34,1216
2020-10-01,302,299,3,1.0,1216
2020-10-02,294,289,5,1.73,1216
2020-10-03,182,164,18,10.98,1216
2020-10-04,148,126,22,17.46,1216
2020-10-05,285,297,-12,-4.04,1216
2020-10-06,302,302,0,0.0,1216
2020-10-07,302,303,-1,-0.33,1216
2020-10-08,302,303,-1,-0.33,1216
2020-10-09,294,293,1,0.34,1216
2020-10-10,182,168,14,8.33,1216
2020-10-11,148,130,18,13.85,1216
2020-10-12,285,300,-15,-5.0,1216
2020-10-13,302,305,-3,-0.98,1216
2020-10-14,302,305,-3,-0.98,1216
2020-10-15,302,305,-3,-0.98,1216
2020-10-16,294,294,0,0.0,1216
2020-10-17,182,168,14,8.33,1216
2020-10-18,148,129,19,14.73,1216
2020-10-19,285,299,-14,-4.68,1216
2020-10-20,302,303,-1,-0.33,1216
2020-10-21,302,303,-1,-0.33,1216
2020-10-22,302,302,0,0.0,1216
2020-10-23,294,290,4,1.38,1216
2020-10-24,182,164,18,10.98,1216
2020-10-25,148,125,23,18.4,1216
2020-10-26,285,295,-10,-3.39,1216
2020-10-27,302,299,3,1.0,1216
2020-10-28,302,298,4,1.34,1216
2020-10-29,302,297,5,1.68,1216
2020-10-30,294,286,8,2.8,1216
2020-10-31,182,160,22,13.75,1216
2020-11-01,136,122,14,11.48,1216
2020-11-02,289,292,-3,-1.03,1216
2020-11-03,291,296,-5,-1.69,1216
2020-11-04,291,296,-5,-1.69,1216
2020-11-05,291,295,-4,-1.36,1216
2020-11-06,288,285,3,1.05,1216
2020-11-07,150,159,-9,-5.66,1216
2020-11-08,136,121,15,12.4,1216
2020-11-09,289,291,-2,-0.69,1216
2020-11-10,291,296,-5,-1.69,1216
2020-11-11,291,296,-5,-1.69,1216
2020-11-12,291,295,-4,-1.36,1216
2020-11-13,288,285,3,1.05,1216
2020-11-14,150,159,-9,-5.66,1216
2020-11-15,136,120,16,13.33,1216
2020-11-16,289,290,-1,-0.34,1216
2020-11-17,291,295,-4,-1.36,1216
2020-11-18,291,294,-3,-1.02,1216
2020-11-19,291,293,-2,-0.68,1216
2020-11-20,288,282,6,2.13,1216
2020-11-21,150,155,-5,-3.23,1216
2020-11-22,136,117,19,16.24,1216
2020-11-23,289,286,3,1.05,1216
2020-11-24,291,290,1,0.34,1216
2020-11-25,291,289,2,0.69,1216
2020-11-26,291,287,4,1.39,1216
2020-11-27,288,276,12,4.35,1216
2020-11-28,150,149,1,0.67,1216
2020-11-29,136,109,27,24.77,1216
2020-11-30,289,279,10,3.58,1216
2020-12-01,256,282,-26,-9.22,1216
2020-12-02,256,281,-25,-8.9,1216
2020-12-03,256,280,-24,-8.57,1216
2020-12-04,280,268,12,4.48,1216
2020-12-05,150,142,8,5.63,1216
2020-12-06,117,103,14,13.59,1216
2020-12-07,255,273,-18,-6.59,1216
2020-12-08,256,277,-21,-7.58,1216
2020-12-09,256,276,-20,-7.25,1216
2020-12-10,256,275,-19,-6.91,1216
2020-12-11,280,264,16,6.06,1216
2020-12-12,150,138,12,8.7,1216
2020-12-13,117,100,17,17.0,1216
2020-12-14,255,270,-15,-5.56,1216
2020-12-15,256,274,-18,-6.57,1216
2020-12-16,256,274,-18,-6.57,1216
2020-12-17,256,274,-18,-6.57,1216
2020-12-18,280,263,17,6.46,1216
2020-12-19,150,137,13,9.49,1216
2020-12-20,117,99,18,18.18,1216
2020-12-21,255,269,-14,-5.2,1216
2020-12-22,256,273,-17,-6.23,1216
2020-12-23,256,273,-17,-6.23,1216
2020-12-24,256,272,-16,-5.88,1216
2020-12-25,280,261,19,7.28,1216
2020-12-26,150,135,15,11.11,1216
2020-12-27,117,96,21,21.88,1216
2020-12-28,255,266,-11,-4.14,1216
2020-12-29,256,270,-14,-5.19,1216
2020-12-30,256,269,-13,-4.83,1216
2020-12-31,256,268,-12,-4.48,1216
2021-01-01,241,257,-16,-6.23,1216
2021-01-02,138,130,8,6.15,1216
2021-01-03,115,91,24,26.37,1216
2021-01-04,245,261,-16,-6.13,1216
2021-01-05,254,264,-10,-3.79,1216
2021-01-06,254,264,-10,-3.79,1216
2021-01-07,254,263,-9,-3.42,1216
2021-01-08,241,251,-10,-3.98,1216
2021-01-09,138,125,13,10.4,1216
2021-01-10,115,86,29,33.72,1216
2021-01-11,245,256,-11,-4.3,1216
2021-01-12,254,261,-7,-2.68,1216
2021-01-13,254,261,-7,-2.68,1216
2021-01-14,254,260,-6,-2.31,1216
2021-01-15,241,249,-8,-3.21,1216
2021-01-16,138,124,14,11.29,1216
2021-01-17,115,86,29,33.72,1216
2021-01-18,245,256,-11,-4.3,1216
2021-01-19,254,261,-7,-2.68,1216
2021-01-20,254,261,-7,-2.68,1216
2021-01-21,254,261,-7,-2.68,1216
2021-01-22,241,251,-10,-3.98,1216
2021-01-23,138,125,13,10.4,1216
2021-01-24,115,88,27,30.68,1216
2021-01-25,245,258,-13,-5.04,1216
2021-01-26,254,263,-9,-3.42,1216
2021-01-27,254,264,-10,-3.79,1216
2021-01-28,254,263,-9,-3.42,1216
2021-01-29,241,253,-12,-4.74,1216
2021-01-30,138,127,11,8.66,1216
2021-01-31,115,89,26,29.21,1216
2021-02-01,258,260,-2,-0.77,1216
2021-02-02,261,264,-3,-1.14,1216
2021-02-03,261,264,-3,-1.14,1216
2021-02-04,261,264,-3,-1.14,1216
2021-02-05,249,253,-4,-1.58,1216
2021-02-06,144,127,17,13.39,1216
2021-02-07,114,88,26,29.55,1216
2021-02-08,258,259,-1,-0.39,1216
2021-02-09,261,263,-2,-0.76,1216
2021-02-10,261,263,-2,-0.76,1216
2021-02-11,261,263,-2,-0.76,1216
2021-02-12,249,252,-3,-1.19,1216
2021-02-13,144,126,18,14.29,1216
2021-02-14,114,88,26,29.55,1216
2021-02-15,258,259,-1,-0.39,1216
2021-02-16,261,264,-3,-1.14,1216
2021-02-17,261,264,-3,-1.14,1216
2021-02-18,261,264,-3,-1.14,1216
2021-02-19,249,254,-5,-1.97,1216
2021-02-20,144,129,15,11.63,1216
2021-02-21,114,92,22,23.91,1216
2021-02-22,258,263,-5,-1.9,1216
2021-02-23,261,268,-7,-2.61,1216
2021-02-24,261,269,-8,-2.97,1216
2021-02-25,261,270,-9,-3.33,1216
2021-02-26,249,260,-11,-4.23,1216
2021-02-27,144,135,9,6.67,1216
2021-02-28,114,98,16,16.33,1216
2021-03-01,284,269,15,5.58,1216
2021-03-02,289,275,14,5.09,1216
2021-03-03,289,276,13,4.71,1216
2021-03-04,289,276,13,4.71,1216
2021-03-05,278,266,12,4.51,1216
2021-03-06,150,141,9,6.38,1216
2021-03-07,118,103,15,14.56,1216
2021-03-08,284,274,10,3.65,1216
2021-03-09,289,279,10,3.58,1216
2021-03-10,289,280,9,3.21,1216
2021-03-11,289,280,9,3.21,1216
2021-03-12,278,269,9,3.35,1216
2021-03-13,150,144,6,4.17,1216
2021-03-14,118,106,12,11.32,1216
2021-03-15,284,276,8,2.9,1216
2021-03-16,289,281,8,2.85,1216
2021-03-17,289,281,8,2.85,1216
2021-03-18,289,281,8,2.85,1216
2021-03-19,278,270,8,2.96,1216
2021-03-20,150,144,6,4.17,1216
2021-03-21,118,107,11,10.28,1216
2021-03-22,284,277,7,2.53,1216
2021-03-23,289,282,7,2.48,1216
2021-03-24,289,283,6,2.12,1216
2021-03-25,289,283,6,2.12,1216
2021-03-26,278,272,6,2.21,1216
2021-03-27,150,147,3,2.04,1216
2021-03-28,118,110,8,7.27,1216
2021-03-29,284,281,3,1.07,1216
2021-03-30,289,286,3,1.05,1216
2021-03-31,289,287,2,0.7,1216
2021-04-01,283,288,-5,-1.74,1216
2021-04-02,274,278,-4,-1.44,1216
2021-04-03,153,153,0,0.0,1216
2021-04-04,116,116,0,0.0,1216
2021-04-05,280,287,-7,-2.44,1216
2021-04-06,283,292,-9,-3.08,1216
2021-04-07,283,293,-10,-3.41,1216
2021-04-08,283,294,-11,-3.74,1216
2021-04-09,274,284,-10,-3.52,1216
2021-04-10,153,159,-6,-3.77,1216
2021-04-11,116,121,-5,-4.13,1216
2021-04-12,280,292,-12,-4.11,1216
2021-04-13,283,297,-14,-4.71,1216
2021-04-14,283,297,-14,-4.71,1216
2021-04-15,283,297,-14,-4.71,1216
2021-04-16,274,287,-13,-4.53,1216
2021-04-17,153,161,-8,-4.97,1216
2021-04-18,116,123,-7,-5.69,1216
2021-04-19,280,293,-13,-4.44,1216
2021-04-20,283,298,-15,-5.03,1216
2021-04-21,283,298,-15,-5.03,1216
2021-04-22,283,297,-14,-4.71,1216
2021-04-23,274,286,-12,-4.2,1216
2021-04-24,153,160,-7,-4.38,1216
2021-04-25,116,122,-6,-4.92,1216
2021-04-26,280,292,-12,-4.11,1216
2021-04-27,283,296,-13,-4.39,1216
2021-04-28,283,296,-13,-4.39,1216
2021-04-29,283,295,-12,-4.07,1216
2021-04-30,274,285,-11,-3.86,1216
2021-05-01,152,159,-7,-4.4,1216
2021-05-02,117,121,-4,-3.31,1216
2021-05-03,298,291,7,2.41,1216
2021-05-04,298,296,2,0.68,1216
2021-05-05,298,296,2,0.68,1216
2021-05-06,298,296,2,0.68,1216
2021-05-07,290,285,5,1.75,1216
2021-05-08,152,159,-7,-4.4,1216
2021-05-09,117,122,-5,-4.1,1216
2021-05-10,298,292,6,2.05,1216
2021-05-11,298,297,1,0.34,1216
2021-05-12,298,297,1,0.34,1216
2021-05-13,298,297,1,0.34,1216
2021-05-14,290,287,3,1.05,1216
2021-05-15,152,161,-9,-5.59,1216
2021-05-16,117,123,-6,-4.88,1216
2021-05-17,298,293,5,1.71,1216
2021-05-18,298,298,0,0.0,1216
2021-05-19,298,298,0,0.0,1216
2021-05-20,298,298,0,0.0,1216
2021-05-21,290,287,3,1.05,1216
2021-05-22,152,161,-9,-5.59,1216
2021-05-23,117,123,-6,-4.88,1216
2021-05-24,298,293,5,1.71,1216
2021-05-25,298,297,1,0.34,1216
2021-05-26,298,297,1,0.34,1216
2021-05-27,298,297,1,0.34,1216
2021-05-28,290,286,4,1.4,1216
2021-05-29,152,160,-8,-5.0,1216
2021-05-30,117,122,-5,-4.1,1216
2021-05-31,298,292,6,2.05,1216
2021-06-01,278,297,-19,-6.4,1216
2021-06-02,278,297,-19,-6.4,1216
2021-06-03,278,297,-19,-6.4,1216
2021-06-04,278,286,-8,-2.8,1216
2021-06-05,132,161,-29,-18.01,1216
2021-06-06,113,123,-10,-8.13,1216
2021-06-07,280,294,-14,-4.76,1216
2021-06-08,278,298,-20,-6.71,1216
2021-06-09,278,299,-21,-7.02,1216
2021-06-10,278,299,-21,-7.02,1216
2021-06-11,278,289,-11,-3.81,1216
2021-06-12,132,163,-31,-19.02,1216
2021-06-13,113,125,-12,-9.6,1216
2021-06-14,280,296,-16,-5.41,1216
2021-06-15,278,300,-22,-7.33,1216
2021-06-16,278,301,-23,-7.64,1216
2021-06-17,278,300,-22,-7.33,1216
2021-06-18,278,289,-11,-3.81,1216
2021-06-19,132,163,-31,-19.02,1216
2021-06-20,113,125,-12,-9.6,1216
2021-06-21,280,294,-14,-4.76,1216
2021-06-22,278,298,-20,-6.71,1216
2021-06-23,278,298,-20,-6.71,1216
2021-06-24,278,296,-18,-6.08,1216
2021-06-25,278,285,-7,-2.46,1216
2021-06-26,132,158,-26,-16.46,1216
2021-06-27,113,118,-5,-4.24,1216
2021-06-28,280,287,-7,-2.44,1216
2021-06-29,278,290,-12,-4.14,1216
2021-06-30,278,289,-11,-3.81,1216
2021-07-01,238,287,-49,-17.07,1216
2021-07-02,252,275,-23,-8.36,1216
2021-07-03,108,148,-40,-27.03,1216
2021-07-04,104,108,-4,-3.7,1216
2021-07-05,232,277,-45,-16.25,1216
2021-07-06,238,280,-42,-15.0,1216
2021-07-07,238,279,-41,-14.7,1216
2021-07-08,238,278,-40,-14.39,1216
2021-07-09,252,266,-14,-5.26,1216
2021-07-10,108,140,-32,-22.86,1216
2021-07-11,104,101,3,2.97,1216
2021-07-12,232,271,-39,-14.39,1216
2021-07-13,238,275,-37,-13.45,1216
2021-07-14,238,275,-37,-13.45,1216
2021-07-15,238,274,-36,-13.14,1216
2021-07-16,252,264,-12,-4.55,1216
2021-07-17,108,138,-30,-21.74,1216
2021-07-18,104,100,4,4.0,1216
2021-07-19,232,271,-39,-14.39,1216
2021-07-20,238,276,-38,-13.77,1216
2021-07-21,238,277,-39,-14.08,1216
2021-07-22,238,277,-39,-14.08,1216
2021-07-23,252,267,-15,-5.62,1216
2021-07-24,108,141,-33,-23.4,1216
2021-07-25,104,103,1,0.97,1216
2021-07-26,232,274,-42,-15.33,1216
2021-07-27,238,279,-41,-14.7,1216
2021-07-28,238,279,-41,-14.7,1216
2021-07-29,238,279,-41,-14.7,1216
2021-07-30,252,268,-16,-5.97,1216
2021-07-31,108,142,-34,-23.94,1216
2021-08-01,110,104,6,5.77,1216
2021-08-02,234,274,-40,-14.6,1216
2021-08-03,240,278,-38,-13.67,1216
2021-08-04,240,277,-37,-13.36,1216
2021-08-05,240,276,-36,-13.04,1216
2021-08-06,253,265,-12,-4.53,1216
2021-08-07,111,138,-27,-19.57,1216
2021-08-08,110,100,10,10.0,1216
2021-08-09,234,269,-35,-13.01,1216
2021-08-10,240,273,-33,-12.09,1216
2021-08-11,240,273,-33,-12.09,1216
2021-08-12,240,271,-31,-11.44,1216
2021-08-13,253,260,-7,-2.69,1216
2021-08-14,111,134,-23,-17.16,1216
2021-08-15,110,96,14,14.58,1216
2021-08-16,234,266,-32,-12.03,1216
2021-08-17,240,270,-30,-11.11,1216
2021-08-18,240,271,-31,-11.44,1216
2021-08-19,240,271,-31,-11.44,1216
2021-08-20,253,260,-7,-2.69,1216
2021-08-21,111,135,-24,-17.78,1216
2021-08-22,110,98,12,12.24,1216
2021-08-23,234,269,-35,-13.01,1216
2021-08-24,240,275,-35,-12.73,1216
2021-08-25,240,276,-36,-13.04,1216
2021-08-26,240,277,-37,-13.36,1216
2021-08-27,253,268,-15,-5.6,1216
2021-08-28,111,143,-32,-22.38,1216
2021-08-29,110,107,3,2.8,1216
2021-08-30,234,278,-44,-15.83,1216
2021-08-31,240,284,-44,-15.49,1216
2021-09-01,286,286,0,0.0,1216
2021-09-02,286,287,-1,-0.35,1216
2021-09-03,300,278,22,7.91,1216
2021-09-04,127,153,-26,-16.99,1216
2021-09-05,127,116,11,9.48,1216
2021-09-06,284,287,-3,-1.05,1216
2021-09-07,286,292,-6,-2.05,1216
2021-09-08,286,293,-7,-2.39,1216
2021-09-09,286,293,-7,-2.39,1216
2021-09-10,300,283,17,6.01,1216
2021-09-11,127,157,-30,-19.11,1216
2021-09-12,127,120,7,5.83,1216
2021-09-13,284,290,-6,-2.07,1216
2021-09-14,286,295,-9,-3.05,1216
2021-09-15,286,295,-9,-3.05,1216
2021-09-16,286,294,-8,-2.72,1216
2021-09-17,300,283,17,6.01,1216
2021-09-18,127,157,-30,-19.11,1216
2021-09-19,127,119,8,6.72,1216
2021-09-20,284,289,-5,-1.73,1216
2021-09-21,286,294,-8,-2.72,1216
2021-09-22,286,294,-8,-2.72,1216
2021-09-23,286,293,-7,-2.39,1216
2021-09-24,300,283,17,6.01,1216
2021-09-25,127,157,-30,-19.11,1216
2021-09-26,127,119,8,6.72,1216
2021-09-27,284,290,-6,-2.07,1216
2021-09-28,286,295,-9,-3.05,1216
2021-09-29,286,295,-9,-3.05,1216
2021-09-30,286,296,-10,-3.38,1216
2021-10-01,310,286,24,8.39,1216
2021-10-02,153,160,-7,-4.38,1216
2021-10-03,132,123,9,7.32,1216
2021-10-04,301,294,7,2.38,1216
2021-10-05,293,299,-6,-2.01,1216
2021-10-06,293,300,-7,-2.33,1216
2021-10-07,293,300,-7,-2.33,1216
2021-10-08,310,290,20,6.9,1216
2021-10-09,153,165,-12,-7.27,1216
2021-10-10,132,127,5,3.94,1216
2021-10-11,301,298,3,1.01,1216
2021-10-12,293,302,-9,-2.98,1216
2021-10-13,293,303,-10,-3.3,1216
2021-10-14,293,302,-9,-2.98,1216
2021-10-15,310,292,18,6.16,1216
2021-10-16,153,165,-12,-7.27,1216
2021-10-17,132,127,5,3.94,1216
2021-10-18,301,297,4,1.35,1216
2021-10-19,293,301,-8,-2.66,1216
2021-10-20,293,301,-8,-2.66,1216
2021-10-21,293,300,-7,-2.33,1216
2021-10-22,310,289,21,7.27,1216
2021-10-23,153,162,-9,-5.56,1216
2021-10-24,132,123,9,7.32,1216
2021-10-25,301,293,8,2.73,1216
2021-10-26,293,297,-4,-1.35,1216
2021-10-27,293,296,-3,-1.01,1216
2021-10-28,293,295,-2,-0.68,1216
2021-10-29,310,284,26,9.15,1216
2021-10-30,153,158,-5,-3.16,1216
2021-10-31,132,119,13,10.92,1216
2021-11-01,291,289,2,0.69,1216
2021-11-02,305,294,11,3.74,1216
2021-11-03,305,294,11,3.74,1216
2021-11-04,305,293,12,4.1,1216
2021-11-05,303,282,21,7.45,1216
2021-11-06,164,156,8,5.13,1216
2021-11-07,130,118,12,10.17,1216
2021-11-08,291,289,2,0.69,1216
2021-11-09,305,293,12,4.1,1216
2021-11-10,305,293,12,4.1,1216
2021-11-11,305,293,12,4.1,1216
2021-11-12,303,282,21,7.45,1216
2021-11-13,164,156,8,5.13,1216
2021-11-14,130,118,12,10.17,1216
2021-11-15,291,288,3,1.04,1216
2021-11-16,305,293,12,4.1,1216
2021-11-17,305,292,13,4.45,1216
2021-11-18,305,292,13,4.45,1216
2021-11-19,303,280,23,8.21,1216
2021-11-20,164,154,10,6.49,1216
2021-11-21,130,115,15,13.04,1216
2021-11-22,291,285,6,2.11,1216
2021-11-23,305,288,17,5.9,1216
2021-11-24,305,288,17,5.9,1216
2021-11-25,305,286,19,6.64,1216
2021-11-26,303,274,29,10.58,1216
2021-11-27,164,147,17,11.56,1216
2021-11-28,130,108,22,20.37,1216
2021-11-29,291,278,13,4.68,1216
2021-11-30,305,281,24,8.54,1216
2021-12-01,261,280,-19,-6.79,1216
2021-12-02,261,279,-18,-6.45,1216
2021-12-03,234,267,-33,-12.36,1216
2021-12-04,161,140,21,15.0,1216
2021-12-05,122,101,21,20.79,1216
2021-12-06,272,271,1,0.37,1216
2021-12-07,261,275,-14,-5.09,1216
2021-12-08,261,274,-13,-4.74,1216
2021-12-09,261,273,-12,-4.4,1216
2021-12-10,234,262,-28,-10.69,1216
2021-12-11,161,136,25,18.38,1216
2021-12-12,122,98,24,24.49,1216
2021-12-13,272,268,4,1.49,1216
2021-12-14,261,272,-11,-4.04,1216
2021-12-15,261,272,-11,-4.04,1216
2021-12-16,261,271,-10,-3.69,1216
2021-12-17,234,261,-27,-10.34,1216
2021-12-18,161,135,26,19.26,1216
2021-12-19,122,96,26,27.08,1216
2021-12-20,272,267,5,1.87,1216
2021-12-21,261,271,-10,-3.69,1216
2021-12-22,261,271,-10,-3.69,1216
2021-12-23,261,270,-9,-3.33,1216
2021-12-24,234,259,-25,-9.65,1216
2021-12-25,161,133,28,21.05,1216
2021-12-26,122,94,28,29.79,1216
2021-12-27,272,264,8,3.03,1216
2021-12-28,261,268,-7,-2.61,1216
2021-12-29,261,267,-6,-2.25,1216
2021-12-30,261,266,-5,-1.88,1216
2021-12-31,234,255,-21,-8.24,1216
2022-01-01,150,128,22,17.19,1216
2022-01-02,124,89,35,39.33,1216
2022-01-03,263,259,4,1.54,1216
2022-01-04,262,263,-1,-0.38,1216
2022-01-05,262,262,0,0.0,1216
2022-01-06,262,261,1,0.38,1216
2022-01-07,249,250,-1,-0.4,1216
2022-01-08,150,123,27,21.95,1216
2022-01-09,124,85,39,45.88,1216
2022-01-10,263,254,9,3.54,1216
2022-01-11,262,259,3,1.16,1216
2022-01-12,262,258,4,1.55,1216
2022-01-13,262,258,4,1.55,1216
2022-01-14,249,247,2,0.81,1216
2022-01-15,150,121,29,23.97,1216
2022-01-16,124,83,41,49.4,1216
2022-01-17,263,253,10,3.95,1216
2022-01-18,262,258,4,1.55,1216
2022-01-19,262,259,3,1.16,1216
2022-01-20,262,258,4,1.55,1216
2022-01-21,249,248,1,0.4,1216
2022-01-22,150,122,28,22.95,1216
2022-01-23,124,85,39,45.88,1216
2022-01-24,263,255,8,3.14,1216
2022-01-25,262,260,2,0.77,1216
2022-01-26,262,261,1,0.38,1216
2022-01-27,262,261,1,0.38,1216
2022-01-28,249,250,-1,-0.4,1216
2022-01-29,150,124,26,20.97,1216
2022-01-30,124,87,37,42.53,1216
2020-02-01,338,398,-60,-15.08,1619
2020-02-02,276,321,-45,-14.02,1619
2020-02-03,739,755,-16,-2.12,1619
2020-02-04,745,760,-15,-1.97,1619
2020-02-05,745,760,-15,-1.97,1619
2020-02-06,745,760,-15,-1.97,1619
2020-02-07,718,734,-16,-2.18,1619
2020-02-08,338,400,-62,-15.5,1619
2020-02-09,276,322,-46,-14.29,1619
2020-02-10,739,755,-16,-2.12,1619
2020-02-11,745,759,-14,-1.84,1619
2020-02-12,745,759,-14,-1.84,1619
2020-02-13,745,759,-14,-1.84,1619
2020-02-14,718,733,-15,-2.05,1619
2020-02-15,338,399,-61,-15.29,1619
2020-02-16,276,321,-45,-14.02,1619
2020-02-17,739,755,-16,-2.12,1619
2020-02-18,745,760,-15,-1.97,1619
2020-02-19,745,760,-15,-1.97,1619
2020-02-20,745,760,-15,-1.97,1619
2020-02-21,718,735,-17,-2.31,1619
2020-02-22,338,402,-64,-15.92,1619
2020-02-23,276,325,-49,-15.08,1619
2020-02-24,739,759,-20,-2.64,1619
2020-02-25,745,765,-20,-2.61,1619
2020-02-26,745,766,-21,-2.74,1619
2020-02-27,745,767,-22,-2.87,1619
2020-02-28,718,742,-24,-3.23,1619
2020-02-29,338,409,-71,-17.36,1619
2020-03-01,258,332,-74,-22.29,1619
2020-03-02,605,767,-162,-21.12,1619
2020-03-03,609,772,-163,-21.11,1619
2020-03-04,609,773,-164,-21.22,1619
2020-03-05,609,773,-164,-21.22,1619
2020-03-06,602,748,-146,-19.52,1619
2020-03-07,312,414,-102,-24.64,1619
2020-03-08,258,337,-79,-23.44,1619
2020-03-09,605,771,-166,-21.53,1619
2020-03-10,609,775,-166,-21.42,1619
2020-03-11,609,775,-166,-21.42,1619
2020-03-12,609,775,-166,-21.42,1619
2020-03-13,602,749,-147,-19.63,1619
2020-03-14,312,414,-102,-24.64,1619
2020-03-15,258,337,-79,-23.44,1619
2020-03-16,605,770,-165,-21.43,1619
2020-03-17,609,774,-165,-21.32,1619
2020-03-18,609,773,-164,-21.22,1619
2020-03-19,609,773,-164,-21.22,1619
2020-03-20,602,747,-145,-19.41,1619
2020-03-21,312,413,-101,-24.46,1619
2020-03-22,258,335,-77,-22.99,1619
2020-03-23,605,769,-164,-21.33,1619
2020-03-24,609,773,-164,-21.22,1619
2020-03-25,609,774,-165,-21.32,1619
2020-03-26,609,774,-165,-21.32,1619
2020-03-27,602,749,-147,-19.63,1619
2020-03-28,312,416,-104,-25.0,1619
2020-03-29,258,339,-81,-23.89,1619
2020-03-30,605,774,-169,-21.83,1619
2020-03-31,609,779,-170,-21.82,1619
2020-04-01,547,780,-233,-29.87,1619
2020-04-02,547,781,-234,-29.96,1619
2020-04-03,475,757,-282,-37.25,1619
2020-04-04,288,424,-136,-32.08,1619
2020-04-05,242,347,-105,-30.26,1619
2020-04-06,552,782,-230,-29.41,1619
2020-04-07,547,787,-240,-30.5,1619
2020-04-08,547,788,-241,-30.58,1619
2020-04-09,547,789,-242,-30.67,1619
2020-04-10,475,764,-289,-37.83,1619
2020-04-11,288,430,-142,-33.02,1619
2020-04-12,242,353,-111,-31.44,1619
2020-04-13,552,786,-234,-29.77,1619
2020-04-14,547,791,-244,-30.85,1619
2020-04-15,547,790,-243,-30.76,1619
2020-04-16,547,790,-243,-30.76,1619
2020-04-17,475,764,-289,-37.83,1619
2020-04-18,288,429,-141,-32.87,1619
2020-04-19,242,351,-109,-31.05,1619
2020-04-20,552,783,-231,-29.5,1619
2020-04-21,547,787,-240,-30.5,1619
2020-04-22,547,786,-239,-30.41,1619
2020-04-23,547,785,-238,-30.32,1619
2020-04-24,475,758,-283,-37.34,1619
2020-04-25,288,423,-135,-31.91,1619
2020-04-26,242,345,-103,-29.86,1619
2020-04-27,552,778,-226,-29.05,1619
2020-04-28,547,781,-234,-29.96,1619
2020-04-29,547,781,-234,-29.96,1619
2020-04-30,547,781,-234,-29.96,1619
2020-05-01,674,755,-81,-10.73,1619
2020-05-02,347,421,-74,-17.58,1619
2020-05-03,261,343,-82,-23.91,1619
2020-05-04,668,777,-109,-14.03,1619
2020-05-05,691,782,-91,-11.64,1619
2020-05-06,691,782,-91,-11.64,1619
2020-05-07,691,783,-92,-11.75,1619
2020-05-08,674,758,-84,-11.08,1619
2020-05-09,347,424,-77,-18.16,1619
2020-05-10,261,347,-86,-24.78,1619
2020-05-11,668,781,-113,-14.47,1619
2020-05-12,691,786,-95,-12.09,1619
2020-05-13,691,787,-96,-12.2,1619
2020-05-14,691,787,-96,-12.2,1619
2020-05-15,674,762,-88,-11.55,1619
2020-05-16,347,428,-81,-18.93,1619
2020-05-17,261,350,-89,-25.43,1619
2020-05-18,668,783,-115,-14.69,1619
2020-05-19,691,787,-96,-12.2,1619
2020-05-20,691,786,-95,-12.09,1619
2020-05-21,691,786,-95,-12.09,1619
2020-05-22,674,759,-85,-11.2,1619
2020-05-23,347,423,-76,-17.97,1619
2020-05-24,261,345,-84,-24.35,1619
2020-05-25,668,776,-108,-13.92,1619
2020-05-26,691,779,-88,-11.3,1619
2020-05-27,691,777,-86,-11.07,1619
2020-05-28,691,776,-85,-10.95,1619
2020-05-29,674,748,-74,-9.89,1619
2020-05-30,347,412,-65,-15.78,1619
2020-05-31,261,333,-72,-21.62,1619
2020-06-01,724,764,-40,-5.24,1619
2020-06-02,716,767,-51,-6.65,1619
2020-06-03,716,765,-49,-6.41,1619
2020-06-04,716,764,-48,-6.28,1619
2020-06-05,711,737,-26,-3.53,1619
2020-06-06,318,401,-83,-20.7,1619
2020-06-07,259,323,-64,-19.81,1619
2020-06-08,724,755,-31,-4.11,1619
2020-06-09,716,759,-43,-5.67,1619
2020-06-10,716,758,-42,-5.54,1619
2020-06-11,716,758,-42,-5.54,1619
2020-06-12,711,732,-21,-2.87,1619
2020-06-13,318,398,-80,-20.1,1619
2020-06-14,259,321,-62,-19.31,1619
2020-06-15,724,755,-31,-4.11,1619
2020-06-16,716,759,-43,-5.67,1619
2020-06-17,716,760,-44,-5.79,1619
2020-06-18,716,760,-44,-5.79,1619
2020-06-19,711,735,-24,-3.27,1619
2020-06-20,318,401,-83,-20.7,1619
2020-06-21,259,324,-65,-20.06,1619
2020-06-22,724,758,-34,-4.49,1619
2020-06-23,716,763,-47,-6.16,1619
2020-06-24,716,763,-47,-6.16,1619
2020-06-25,716,764,-48,-6.28,1619
2020-06-26,711,738,-27,-3.66,1619
2020-06-27,318,404,-86,-21.29,1619
2020-06-28,259,327,-68,-20.8,1619
2020-06-29,724,760,-36,-4.74,1619
2020-06-30,716,764,-48,-6.28,1619
2020-07-01,662,764,-102,-13.35,1619
2020-07-02,662,764,-102,-13.35,1619
2020-07-03,643,738,-95,-12.87,1619
2020-07-04,326,404,-78,-19.31,1619
2020-07-05,270,326,-56,-17.18,1619
2020-07-06,675,760,-85,-11.18,1619
2020-07-07,662,764,-102,-13.35,1619
2020-07-08,662,764,-102,-13.35,1619
2020-07-09,662,764,-102,-13.35,1619
2020-07-10,643,739,-96,-12.99,1619
2020-07-11,326,405,-79,-19.51,1619
2020-07-12,270,327,-57,-17.43,1619
2020-07-13,675,761,-86,-11.3,1619
2020-07-14,662,766,-104,-13.58,1619
2020-07-15,662,766,-104,-13.58,1619
2020-07-16,662,766,-104,-13.58,1619
2020-07-17,643,741,-98,-13.23,1619
2020-07-18,326,407,-81,-19.9,1619
2020-07-19,270,330,-60,-18.18,1619
2020-07-20,675,764,-89,-11.65,1619
2020-07-21,662,769,-107,-13.91,1619
2020-07-22,662,769,-107,-13.91,1619
2020-07-23,662,769,-107,-13.91,1619
2020-07-24,643,743,-100,-13.46,1619
2020-07-25,326,408,-82,-20.1,1619
2020-07-26,270,330,-60,-18.18,1619
2020-07-27,675,763,-88,-11.53,1619
2020-07-28,662,767,-105,-13.69,1619
2020-07-29,662,766,-104,-13.58,1619
2020-07-30,662,764,-102,-13.35,1619
2020-07-31,643,737,-94,-12.75,1619
2020-08-01,281,402,-121,-30.1,1619
2020-08-02,218,323,-105,-32.51,1619
2020-08-03,597,754,-157,-20.82,1619
2020-08-04,625,757,-132,-17.44,1619
2020-08-05,625,755,-130,-17.22,1619
2020-08-06,625,754,-129,-17.11,1619
2020-08-07,622,726,-104,-14.33,1619
2020-08-08,281,391,-110,-28.13,1619
2020-08-09,218,312,-94,-30.13,1619
2020-08-10,597,744,-147,-19.76,1619
2020-08-11,625,747,-122,-16.33,1619
2020-08-12,625,747,-122,-16.33,1619
2020-08-13,625,746,-121,-16.22,1619
2020-08-14,622,721,-99,-13.73,1619
2020-08-15,281,387,-106,-27.39,1619
2020-08-16,218,310,-92,-29.68,1619
2020-08-17,597,744,-147,-19.76,1619
2020-08-18,625,750,-125,-16.67,1619
2020-08-19,625,752,-127,-16.89,1619
2020-08-20,625,754,-129,-17.11,1619
2020-08-21,622,731,-109,-14.91,1619
2020-08-22,281,400,-119,-29.75,1619
2020-08-23,218,325,-107,-32.92,1619
2020-08-24,597,762,-165,-21.65,1619
2020-08-25,625,770,-145,-18.83,1619
2020-08-26,625,774,-149,-19.25,1619
2020-08-27,625,778,-153,-19.67,1619
2020-08-28,622,757,-135,-17.83,1619
2020-08-29,281,427,-146,-34.19,1619
2020-08-30,218,353,-135,-38.24,1619
2020-08-31,597,791,-194,-24.53,1619
2020-09-01,679,799,-120,-15.02,1619
2020-09-02,679,803,-124,-15.44,1619
2020-09-03,679,807,-128,-15.86,1619
2020-09-04,675,784,-109,-13.9,1619
2020-09-05,334,454,-120,-26.43,1619
2020-09-06,282,379,-97,-25.59,1619
2020-09-07,698,815,-117,-14.36,1619
2020-09-08,679,822,-143,-17.4,1619
2020-09-09,679,824,-145,-17.6,1619
2020-09-10,679,826,-147,-17.8,1619
2020-09-11,675,802,-127,-15.84,1619
2020-09-12,334,470,-136,-28.94,1619
2020-09-13,282,394,-112,-28.43,1619
2020-09-14,698,828,-130,-15.7,1619
2020-09-15,679,834,-155,-18.59,1619
2020-09-16,679,835,-156,-18.68,1619
2020-09-17,679,836,-157,-18.78,1619
2020-09-18,675,811,-136,-16.77,1619
2020-09-19,334,478,-144,-30.13,1619
2020-09-20,282,401,-119,-29.68,1619
2020-09-21,698,836,-138,-16.51,1619
2020-09-22,679,841,-162,-19.26,1619
2020-09-23,679,843,-164,-19.45,1619
2020-09-24,679,844,-165,-19.55,1619
2020-09-25,675,820,-145,-17.68,1619
2020-09-26,334,487,-153,-31.42,1619
2020-09-27,282,412,-130,-31.55,1619
2020-09-28,698,847,-149,-17.59,1619
2020-09-29,679,853,-174,-20.4,1619
2020-09-30,679,855,-176,-20.58,1619
2020-10-01,692,858,-166,-19.35,1619
2020-10-02,682,834,-152,-18.23,1619
2020-10-03,332,503,-171,-34.0,1619
2020-10-04,265,427,-162,-37.94,1619
2020-10-05,727,863,-136,-15.76,1619
2020-10-06,692,870,-178,-20.46,1619
2020-10-07,692,872,-180,-20.64,1619
2020-10-08,692,874,-182,-20.82,1619
2020-10-09,682,850,-168,-19.76,1619
2020-10-10,332,518,-186,-35.91,1619
2020-10-11,265,442,-177,-40.05,1619
2020-10-12,727,877,-150,-17.1,1619
2020-10-13,692,882,-190,-21.54,1619
2020-10-14,692,883,-191,-21.63,1619
2020-10-15,692,884,-192,-21.72,1619
2020-10-16,682,859,-177,-20.61,1619
2020-10-17,332,526,-194,-36.88,1619
2020-10-18,265,449,-184,-40.98,1619
2020-10-19,727,883,-156,-17.67,1619
2020-10-20,692,887,-195,-21.98,1619
2020-10-21,692,887,-195,-21.98,1619
2020-10-22,692,888,-196,-22.07,1619
2020-10-23,682,862,-180,-20.88,1619
2020-10-24,332,528,-196,-37.12,1619
2020-10-25,265,451,-186,-41.24,1619
2020-10-26,727,884,-157,-17.76,1619
2020-10-27,692,889,-197,-22.16,1619
2020-10-28,692,889,-197,-22.16,1619
2020-10-29,692,890,-198,-22.25,1619
2020-10-30,682,865,-183,-21.16,1619
2020-10-31,332,532,-200,-37.59,1619
2020-11-01,280,455,-175,-38.46,1619
2020-11-02,695,890,-195,-21.91,1619
2020-11-03,697,896,-199,-22.21,1619
2020-11-04,697,897,-200,-22.3,1619
2020-11-05,697,899,-202,-22.47,1619
2020-11-06,688,874,-186,-21.28,1619
2020-11-07,332,542,-210,-38.75,1619
2020-11-08,280,466,-186,-39.91,1619
2020-11-09,695,901,-206,-22.86,1619
2020-11-10,697,907,-210,-23.15,1619
2020-11-11,697,908,-211,-23.24,1619
2020-11-12,697,909,-212,-23.32,1619
2020-11-13,688,885,-197,-22.26,1619
2020-11-14,332,552,-220,-39.86,1619
2020-11-15,280,475,-195,-41.05,1619
2020-11-16,695,909,-214,-23.54,1619
2020-11-17,697,913,-216,-23.66,1619
2020-11-18,697,913,-216,-23.66,1619
2020-11-19,697,913,-216,-23.66,1619
2020-11-20,688,887,-199,-22.44,1619
2020-11-21,332,552,-220,-39.86,1619
2020-11-22,280,474,-194,-40.93,1619
2020-11-23,695,906,-211,-23.29,1619
2020-11-24,697,909,-212,-23.32,1619
2020-11-25,697,908,-211,-23.24,1619
2020-11-26,697,906,-209,-23.07,1619
2020-11-27,688,879,-191,-21.73,1619
2020-11-28,332,543,-211,-38.86,1619
2020-11-29,280,464,-184,-39.66,1619
2020-11-30,695,895,-200,-22.35,1619
2020-12-01,644,898,-254,-28.29,1619
2020-12-02,644,896,-252,-28.12,1619
2020-12-03,644,895,-251,-28.04,1619
2020-12-04,702,868,-166,-19.12,1619
2020-12-05,338,533,-195,-36.59,1619
2020-12-06,270,454,-184,-40.53,1619
2020-12-07,667,887,-220,-24.8,1619
2020-12-08,644,890,-246,-27.64,1619
2020-12-09,644,890,-246,-27.64,1619
2020-12-10,644,889,-245,-27.56,1619
2020-12-11,702,864,-162,-18.75,1619
2020-12-12,338,529,-191,-36.11,1619
2020-12-13,270,452,-182,-40.27,1619
2020-12-14,667,886,-219,-24.72,1619
2020-12-15,644,890,-246,-27.64,1619
2020-12-16,644,890,-246,-27.64,1619
2020-12-17,644,891,-247,-27.72,1619
2020-12-18,702,865,-163,-18.84,1619
2020-12-19,338,531,-193,-36.35,1619
2020-12-20,270,454,-184,-40.53,1619
2020-12-21,667,888,-221,-24.89,1619
2020-12-22,644,892,-248,-27.8,1619
2020-12-23,644,892,-248,-27.8,1619
2020-12-24,644,891,-247,-27.72,1619
2020-12-25,702,865,-163,-18.84,1619
2020-12-26,338,530,-192,-36.23,1619
2020-12-27,270,452,-182,-40.27,1619
2020-12-28,667,884,-217,-24.55,1619
2020-12-29,644,887,-243,-27.4,1619
2020-12-30,644,886,-242,-27.31,1619
2020-12-31,644,885,-241,-27.23,1619
2021-01-01,642,858,-216,-25.17,1619
2021-01-02,323,522,-199,-38.12,1619
2021-01-03,276,443,-167,-37.7,1619
2021-01-04,636,875,-239,-27.31,1619
2021-01-05,660,877,-217,-24.74,1619
2021-01-06,660,876,-216,-24.66,1619
2021-01-07,660,875,-215,-24.57,1619
2021-01-08,642,848,-206,-24.29,1619
2021-01-09,323,512,-189,-36.91,1619
2021-01-10,276,434,-158,-36.41,1619
2021-01-11,636,867,-231,-26.64,1619
2021-01-12,660,871,-211,-24.23,1619
2021-01-13,660,870,-210,-24.14,1619
2021-01-14,660,870,-210,-24.14,1619
2021-01-15,642,845,-203,-24.02,1619
2021-01-16,323,511,-188,-36.79,1619
2021-01-17,276,434,-158,-36.41,1619
2021-01-18,636,868,-232,-26.73,1619
2021-01-19,660,873,-213,-24.4,1619
2021-01-20,660,874,-214,-24.49,1619
2021-01-21,660,875,-215,-24.57,1619
2021-01-22,642,850,-208,-24.47,1619
2021-01-23,323,518,-195,-37.64,1619
2021-01-24,276,441,-165,-37.41,1619
2021-01-25,636,876,-240,-27.4,1619
2021-01-26,660,881,-221,-25.09,1619
2021-01-27,660,882,-222,-25.17,1619
2021-01-28,660,883,-223,-25.25,1619
2021-01-29,642,859,-217,-25.26,1619
2021-01-30,323,525,-202,-38.48,1619
2021-01-31,276,448,-172,-38.39,1619
2021-02-01,684,882,-198,-22.45,1619
2021-02-02,670,887,-217,-24.46,1619
2021-02-03,670,887,-217,-24.46,1619
2021-02-04,670,888,-218,-24.55,1619
2021-02-05,643,862,-219,-25.41,1619
2021-02-06,333,528,-195,-36.93,1619
2021-02-07,267,450,-183,-40.67,1619
2021-02-08,684,883,-199,-22.54,1619
2021-02-09,670,888,-218,-24.55,1619
2021-02-10,670,887,-217,-24.46,1619
2021-02-11,670,887,-217,-24.46,1619
2021-02-12,643,861,-218,-25.32,1619
2021-02-13,333,527,-194,-36.81,1619
2021-02-14,267,449,-182,-40.53,1619
2021-02-15,684,883,-199,-22.54,1619
2021-02-16,670,887,-217,-24.46,1619
2021-02-17,670,887,-217,-24.46,1619
2021-02-18,670,888,-218,-24.55,1619
2021-02-19,643,862,-219,-25.41,1619
2021-02-20,333,529,-196,-37.05,1619
2021-02-21,267,452,-185,-40.93,1619
2021-02-22,684,886,-202,-22.8,1619
2021-02-23,670,891,-221,-24.8,1619
2021-02-24,670,892,-222,-24.89,1619
2021-02-25,670,893,-223,-24.97,1619
2021-02-26,643,869,-226,-26.01,1619
2021-02-27,333,536,-203,-37.87,1619
2021-02-28,267,459,-192,-41.83,1619
2021-03-01,701,894,-193,-21.59,1619
2021-03-02,686,899,-213,-23.69,1619
2021-03-03,686,900,-214,-23.78,1619
2021-03-04,686,900,-214,-23.78,1619
2021-03-05,683,875,-192,-21.94,1619
2021-03-06,340,542,-202,-37.27,1619
2021-03-07,260,465,-205,-44.09,1619
2021-03-08,701,898,-197,-21.94,1619
2021-03-09,686,903,-217,-24.03,1619
2021-03-10,686,903,-217,-24.03,1619
2021-03-11,686,903,-217,-24.03,1619
2021-03-12,683,877,-194,-22.12,1619
2021-03-13,340,543,-203,-37.38,1619
2021-03-14,260,465,-205,-44.09,1619
2021-03-15,701,898,-197,-21.94,1619
2021-03-16,686,902,-216,-23.95,1619
2021-03-17,686,902,-216,-23.95,1619
2021-03-18,686,901,-215,-23.86,1619
2021-03-19,683,875,-192,-21.94,1619
2021-03-20,340,541,-201,-37.15,1619
2021-03-21,260,463,-203,-43.84,1619
2021-03-22,701,897,-196,-21.85,1619
2021-03-23,686,901,-215,-23.86,1619
2021-03-24,686,901,-215,-23.86,1619
2021-03-25,686,901,-215,-23.86,1619
2021-03-26,683,876,-193,-22.03,1619
2021-03-27,340,543,-203,-37.38,1619
2021-03-28,260,466,-206,-44.21,1619
2021-03-29,701,900,-199,-22.11,1619
2021-03-30,686,906,-220,-24.28,1619
2021-03-31,686,906,-220,-24.28,1619
2021-04-01,671,908,-237,-26.1,1619
2021-04-02,641,883,-242,-27.41,1619
2021-04-03,329,550,-221,-40.18,1619
2021-04-04,262,474,-212,-44.73,1619
2021-04-05,664,909,-245,-26.95,1619
2021-04-06,671,914,-243,-26.59,1619
2021-04-07,671,915,-244,-26.67,1619
2021-04-08,671,916,-245,-26.75,1619
2021-04-09,641,891,-250,-28.06,1619
2021-04-10,329,557,-228,-40.93,1619
2021-04-11,262,480,-218,-45.42,1619
2021-04-12,664,914,-250,-27.35,1619
2021-04-13,671,919,-248,-26.99,1619
2021-04-14,671,919,-248,-26.99,1619
2021-04-15,671,918,-247,-26.91,1619
2021-04-16,641,892,-251,-28.14,1619
2021-04-17,329,558,-229,-41.04,1619
2021-04-18,262,480,-218,-45.42,1619
2021-04-19,664,912,-248,-27.19,1619
2021-04-20,671,916,-245,-26.75,1619
2021-04-21,671,915,-244,-26.67,1619
2021-04-22,671,914,-243,-26.59,1619
2021-04-23,641,887,-246,-27.73,1619
2021-04-24,329,552,-223,-40.4,1619
2021-04-25,262,474,-212,-44.73,1619
2021-04-26,664,906,-242,-26.71,1619
2021-04-27,671,910,-239,-26.26,1619
2021-04-28,671,909,-238,-26.18,1619
2021-04-29,671,909,-238,-26.18,1619
2021-04-30,641,883,-242,-27.41,1619
2021-05-01,330,549,-219,-39.89,1619
2021-05-02,260,471,-211,-44.8,1619
2021-05-03,687,905,-218,-24.09,1619
2021-05-04,709,909,-200,-22.0,1619
2021-05-05,709,909,-200,-22.0,1619
2021-05-06,709,910,-201,-22.09,1619
2021-05-07,688,885,-197,-22.26,1619
2021-05-08,330,551,-221,-40.11,1619
2021-05-09,260,474,-214,-45.15,1619
2021-05-10,687,909,-222,-24.42,1619
2021-05-11,709,914,-205,-22.43,1619
2021-05-12,709,914,-205,-22.43,1619
2021-05-13,709,915,-206,-22.51,1619
2021-05-14,688,889,-201,-22.61,1619
2021-05-15,330,555,-225,-40.54,1619
2021-05-16,260,478,-218,-45.61,1619
2021-05-17,687,911,-224,-24.59,1619
2021-05-18,709,916,-207,-22.6,1619
2021-05-19,709,915,-206,-22.51,1619
2021-05-20,709,915,-206,-22.51,1619
2021-05-21,688,888,-200,-22.52,1619
2021-05-22,330,553,-223,-40.33,1619
2021-05-23,260,474,-214,-45.15,1619
2021-05-24,687,906,-219,-24.17,1619
2021-05-25,709,909,-200,-22.0,1619
2021-05-26,709,907,-198,-21.83,1619
2021-05-27,709,906,-197,-21.74,1619
2021-05-28,688,878,-190,-21.64,1619
2021-05-29,330,542,-212,-39.11,1619
2021-05-30,260,463,-203,-43.84,1619
2021-05-31,687,894,-207,-23.15,1619
2021-06-01,669,897,-228,-25.42,1619
2021-06-02,669,895,-226,-25.25,1619
2021-06-03,669,894,-225,-25.17,1619
2021-06-04,636,866,-230,-26.56,1619
2021-06-05,312,531,-219,-41.24,1619
2021-06-06,256,452,-196,-43.36,1619
2021-06-07,678,884,-206,-23.3,1619
2021-06-08,669,888,-219,-24.66,1619
2021-06-09,669,887,-218,-24.58,1619
2021-06-10,669,887,-218,-24.58,1619
2021-06-11,636,861,-225,-26.13,1619
2021-06-12,312,526,-214,-40.68,1619
2021-06-13,256,449,-193,-42.98,1619
2021-06-14,678,882,-204,-23.13,1619
2021-06-15,669,887,-218,-24.58,1619
2021-06-16,669,887,-218,-24.58,1619
2021-06-17,669,888,-219,-24.66,1619
2021-06-18,636,862,-226,-26.22,1619
2021-06-19,312,529,-217,-41.02,1619
2021-06-20,256,452,-196,-43.36,1619
2021-06-21,678,885,-207,-23.39,1619
2021-06-22,669,890,-221,-24.83,1619
2021-06-23,669,891,-222,-24.92,1619
2021-06-24,669,891,-222,-24.92,1619
2021-06-25,636,866,-230,-26.56,1619
2021-06-26,312,532,-220,-41.35,1619
2021-06-27,256,454,-198,-43.61,1619
2021-06-28,678,888,-210,-23.65,1619
2021-06-29,669,892,-223,-25.0,1619
2021-06-30,669,892,-223,-25.0,1619
2021-07-01,615,892,-277,-31.05,1619
2021-07-02,591,866,-275,-31.76,1619
2021-07-03,305,532,-227,-42.67,1619
2021-07-04,254,455,-201,-44.18,1619
2021-07-05,627,888,-261,-29.39,1619
2021-07-06,615,892,-277,-31.05,1619
2021-07-07,615,892,-277,-31.05,1619
2021-07-08,615,892,-277,-31.05,1619
2021-07-09,591,866,-275,-31.76,1619
2021-07-10,305,532,-227,-42.67,1619
2021-07-11,254,455,-201,-44.18,1619
2021-07-12,627,889,-262,-29.47,1619
2021-07-13,615,893,-278,-31.13,1619
2021-07-14,615,893,-278,-31.13,1619
2021-07-15,615,894,-279,-31.21,1619
2021-07-16,591,869,-278,-31.99,1619
2021-07-17,305,535,-230,-42.99,1619
2021-07-18,254,458,-204,-44.54,1619
2021-07-19,627,892,-265,-29.71,1619
2021-07-20,615,896,-281,-31.36,1619
2021-07-21,615,896,-281,-31.36,1619
2021-07-22,615,897,-282,-31.44,1619
2021-07-23,591,871,-280,-32.15,1619
2021-07-24,305,537,-232,-43.2,1619
2021-07-25,254,459,-205,-44.66,1619
2021-07-26,627,892,-265,-29.71,1619
2021-07-27,615,896,-281,-31.36,1619
2021-07-28,615,895,-280,-31.28,1619
2021-07-29,615,894,-279,-31.21,1619
2021-07-30,591,867,-276,-31.83,1619
2021-07-31,305,532,-227,-42.67,1619
2021-08-01,295,453,-158,-34.88,1619
2021-08-02,807,884,-77,-8.71,1619
2021-08-03,742,887,-145,-16.35,1619
2021-08-04,742,885,-143,-16.16,1619
2021-08-05,742,884,-142,-16.06,1619
2021-08-06,665,856,-191,-22.31,1619
2021-08-07,341,521,-180,-34.55,1619
2021-08-08,295,441,-146,-33.11,1619
2021-08-09,807,873,-66,-7.56,1619
2021-08-10,742,877,-135,-15.39,1619
2021-08-11,742,875,-133,-15.2,1619
2021-08-12,742,875,-133,-15.2,1619
2021-08-13,665,849,-184,-21.67,1619
2021-08-14,341,514,-173,-33.66,1619
2021-08-15,295,437,-142,-32.49,1619
2021-08-16,807,871,-64,-7.35,1619
2021-08-17,742,876,-134,-15.3,1619
2021-08-18,742,878,-136,-15.49,1619
2021-08-19,742,879,-137,-15.59,1619
2021-08-20,665,856,-191,-22.31,1619
2021-08-21,341,524,-183,-34.92,1619
2021-08-22,295,449,-154,-34.3,1619
2021-08-23,807,886,-79,-8.92,1619
2021-08-24,742,894,-152,-17.0,1619
2021-08-25,742,897,-155,-17.28,1619
2021-08-26,742,901,-159,-17.65,1619
2021-08-27,665,879,-214,-24.35,1619
2021-08-28,341,549,-208,-37.89,1619
2021-08-29,295,476,-181,-38.03,1619
2021-08-30,807,914,-107,-11.71,1619
2021-08-31,742,922,-180,-19.52,1619
2021-09-01,655,926,-271,-29.27,1619
2021-09-02,655,930,-275,-29.57,1619
2021-09-03,642,908,-266,-29.3,1619
2021-09-04,315,577,-262,-45.41,1619
2021-09-05,256,503,-247,-49.11,1619
2021-09-06,678,940,-262,-27.87,1619
2021-09-07,655,947,-292,-30.83,1619
2021-09-08,655,949,-294,-30.98,1619
2021-09-09,655,952,-297,-31.2,1619
2021-09-10,642,928,-286,-30.82,1619
2021-09-11,315,596,-281,-47.15,1619
2021-09-12,256,520,-264,-50.77,1619
2021-09-13,678,955,-277,-29.01,1619
2021-09-14,655,960,-305,-31.77,1619
2021-09-15,655,961,-306,-31.84,1619
2021-09-16,655,963,-308,-31.98,1619
2021-09-17,642,938,-296,-31.56,1619
2021-09-18,315,605,-290,-47.93,1619
2021-09-19,256,528,-272,-51.52,1619
2021-09-20,678,963,-285,-29.6,1619
2021-09-21,655,968,-313,-32.33,1619
2021-09-22,655,969,-314,-32.4,1619
2021-09-23,655,970,-315,-32.47,1619
2021-09-24,642,946,-304,-32.14,1619
2021-09-25,315,613,-298,-48.61,1619
2021-09-26,256,537,-281,-52.33,1619
2021-09-27,678,973,-295,-30.32,1619
2021-09-28,655,979,-324,-33.09,1619
2021-09-29,655,981,-326,-33.23,1619
2021-09-30,655,983,-328,-33.37,1619
2021-10-01,675,959,-284,-29.61,1619
2021-10-02,313,628,-315,-50.16,1619
2021-10-03,266,552,-286,-51.81,1619
2021-10-04,696,988,-292,-29.55,1619
2021-10-05,693,995,-302,-30.35,1619
2021-10-06,693,997,-304,-30.49,1619
2021-10-07,693,999,-306,-30.63,1619
2021-10-08,675,976,-301,-30.84,1619
2021-10-09,313,643,-330,-51.32,1619
2021-10-10,266,568,-302,-53.17,1619
2021-10-11,696,1003,-307,-30.61,1619
2021-10-12,693,1009,-316,-31.32,1619
2021-10-13,693,1010,-317,-31.39,1619
2021-10-14,693,1011,-318,-31.45,1619
2021-10-15,675,986,-311,-31.54,1619
2021-10-16,313,653,-340,-52.07,1619
2021-10-17,266,576,-310,-53.82,1619
2021-10-18,696,1010,-314,-31.09,1619
2021-10-19,693,1015,-322,-31.72,1619
2021-10-20,693,1015,-322,-31.72,1619
2021-10-21,693,1015,-322,-31.72,1619
2021-10-22,675,990,-315,-31.82,1619
2021-10-23,313,656,-343,-52.29,1619
2021-10-24,266,578,-312,-53.98,1619
2021-10-25,696,1012,-316,-31.23,1619
2021-10-26,693,1017,-324,-31.86,1619
2021-10-27,693,1017,-324,-31.86,1619
2021-10-28,693,1017,-324,-31.86,1619
2021-10-29,675,992,-317,-31.96,1619
2021-10-30,313,659,-346,-52.5,1619
2021-10-31,266,582,-316,-54.3,1619
2021-11-01,692,1017,-325,-31.96,1619
2021-11-02,709,1022,-313,-30.63,1619
2021-11-03,709,1023,-314,-30.69,1619
2021-11-04,709,1025,-316,-30.83,1619
2021-11-05,716,1000,-284,-28.4,1619
2021-11-06,340,668,-328,-49.1,1619
2021-11-07,283,592,-309,-52.2,1619
2021-11-08,692,1027,-335,-32.62,1619
2021-11-09,709,1033,-324,-31.36,1619
2021-11-10,709,1034,-325,-31.43,1619
2021-11-11,709,1036,-327,-31.56,1619
2021-11-12,716,1011,-295,-29.18,1619
2021-11-13,340,678,-338,-49.85,1619
2021-11-14,283,602,-319,-52.99,1619
2021-11-15,692,1036,-344,-33.2,1619
2021-11-16,709,1041,-332,-31.89,1619
2021-11-17,709,1041,-332,-31.89,1619
2021-11-18,709,1041,-332,-31.89,1619
2021-11-19,716,1015,-299,-29.46,1619
2021-11-20,340,681,-341,-50.07,1619
2021-11-21,283,603,-320,-53.07,1619
2021-11-22,692,1035,-343,-33.14,1619
2021-11-23,709,1039,-330,-31.76,1619
2021-11-24,709,1037,-328,-31.63,1619
2021-11-25,709,1036,-327,-31.56,1619
2021-11-26,716,1009,-293,-29.04,1619
2021-11-27,340,673,-333,-49.48,1619
2021-11-28,283,594,-311,-52.36,1619
2021-11-29,692,1025,-333,-32.49,1619
2021-11-30,709,1028,-319,-31.03,1619
2021-12-01,635,1026,-391,-38.11,1619
2021-12-02,635,1025,-390,-38.05,1619
2021-12-03,554,998,-444,-44.49,1619
2021-12-04,322,662,-340,-51.36,1619
2021-12-05,269,583,-314,-53.86,1619
2021-12-06,668,1016,-348,-34.25,1619
2021-12-07,635,1019,-384,-37.68,1619
2021-12-08,635,1018,-383,-37.62,1619
2021-12-09,635,1018,-383,-37.62,1619
2021-12-10,554,992,-438,-44.15,1619
2021-12-11,322,657,-335,-50.99,1619
2021-12-12,269,580,-311,-53.62,1619
2021-12-13,668,1013,-345,-34.06,1619
2021-12-14,635,1018,-383,-37.62,1619
2021-12-15,635,1018,-383,-37.62,1619
2021-12-16,635,1018,-383,-37.62,1619
2021-12-17,554,993,-439,-44.21,1619
2021-12-18,322,659,-337,-51.14,1619
2021-12-19,269,582,-313,-53.78,1619
2021-12-20,668,1015,-347,-34.19,1619
2021-12-21,635,1020,-385,-37.75,1619
2021-12-22,635,1020,-385,-37.75,1619
2021-12-23,635,1020,-385,-37.75,1619
2021-12-24,554,994,-440,-44.27,1619
2021-12-25,322,659,-337,-51.14,1619
2021-12-26,269,581,-312,-53.7,1619
2021-12-27,668,1013,-345,-34.06,1619
2021-12-28,635,1017,-382,-37.56,1619
2021-12-29,635,1016,-381,-37.5,1619
2021-12-30,635,1014,-379,-37.38,1619
2021-12-31,554,987,-433,-43.87,1619
2022-01-01,325,652,-327,-50.15,1619
2022-01-02,260,573,-313,-54.62,1619
2022-01-03,654,1005,-351,-34.93,1619
2022-01-04,650,1007,-357,-35.45,1619
2022-01-05,650,1006,-356,-35.39,1619
2022-01-06,650,1004,-354,-35.26,1619
2022-01-07,626,977,-351,-35.93,1619
2022-01-08,325,642,-317,-49.38,1619
2022-01-09,260,563,-303,-53.82,1619
2022-01-10,654,996,-342,-34.34,1619
2022-01-11,650,999,-349,-34.93,1619
2022-01-12,650,999,-349,-34.93,1619
2022-01-13,650,998,-348,-34.87,1619
2022-01-14,626,972,-346,-35.6,1619
2022-01-15,325,638,-313,-49.06,1619
2022-01-16,260,561,-301,-53.65,1619
2022-01-17,654,995,-341,-34.27,1619
2022-01-18,650,1000,-350,-35.0,1619
2022-01-19,650,1001,-351,-35.06,1619
2022-01-20,650,1002,-352,-35.13,1619
2022-01-21,626,977,-351,-35.93,1619
2022-01-22,325,644,-319,-49.53,1619
2022-01-23,260,568,-308,-54.23,1619
2022-01-24,654,1002,-348,-34.73,1619
2022-01-25,650,1008,-358,-35.52,1619
2022-01-26,650,1009,-359,-35.58,1619
2022-01-27,650,1010,-360,-35.64,1619
2022-01-28,626,985,-359,-36.45,1619
2022-01-29,325,652,-327,-50.15,1619
2022-01-30,260,576,-316,-54.86,1619
2020-02-01,209,350,-141,-40.29,1620
2020-02-02,164,318,-154,-48.43,1620
2020-02-03,508,559,-51,-9.12,1620
2020-02-04,537,564,-27,-4.79,1620
2020-02-05,537,566,-29,-5.12,1620
2020-02-06,537,567,-30,-5.29,1620
2020-02-07,511,545,-34,-6.24,1620
2020-02-08,209,360,-151,-41.94,1620
2020-02-09,164,328,-164,-50.0,1620
2020-02-10,508,568,-60,-10.56,1620
2020-02-11,537,573,-36,-6.28,1620
2020-02-12,537,575,-38,-6.61,1620
2020-02-13,537,576,-39,-6.77,1620
2020-02-14,511,553,-42,-7.59,1620
2020-02-15,209,368,-159,-43.21,1620
2020-02-16,164,336,-172,-51.19,1620
2020-02-17,508,576,-68,-11.81,1620
2020-02-18,537,581,-44,-7.57,1620
2020-02-19,537,583,-46,-7.89,1620
2020-02-20,537,584,-47,-8.05,1620
2020-02-21,511,561,-50,-8.91,1620
2020-02-22,209,377,-168,-44.56,1620
2020-02-23,164,346,-182,-52.6,1620
2020-02-24,508,586,-78,-13.31,1620
2020-02-25,537,592,-55,-9.29,1620
2020-02-26,537,594,-57,-9.6,1620
2020-02-27,537,596,-59,-9.9,1620
2020-02-28,511,573,-62,-10.82,1620
2020-02-29,209,390,-181,-46.41,1620
2020-03-01,167,358,-191,-53.35,1620
2020-03-02,471,599,-128,-21.37,1620
2020-03-03,512,605,-93,-15.37,1620
2020-03-04,512,607,-95,-15.65,1620
2020-03-05,512,609,-97,-15.93,1620
2020-03-06,480,587,-107,-18.23,1620
2020-03-07,207,403,-196,-48.64,1620
2020-03-08,167,372,-205,-55.11,1620
2020-03-09,471,612,-141,-23.04,1620
2020-03-10,512,618,-106,-17.15,1620
2020-03-11,512,620,-108,-17.42,1620
2020-03-12,512,621,-109,-17.55,1620
2020-03-13,480,598,-118,-19.73,1620
2020-03-14,207,414,-207,-50.0,1620
2020-03-15,167,382,-215,-56.28,1620
2020-03-16,471,622,-151,-24.28,1620
2020-03-17,512,627,-115,-18.34,1620
2020-03-18,512,628,-116,-18.47,1620
2020-03-19,512,629,-117,-18.6,1620
2020-03-20,480,606,-126,-20.79,1620
2020-03-21,207,421,-214,-50.83,1620
2020-03-22,167,389,-222,-57.07,1620
2020-03-23,471,628,-157,-25.0,1620
2020-03-24,512,633,-121,-19.12,1620
2020-03-25,512,634,-122,-19.24,1620
2020-03-26,512,635,-123,-19.37,1620
2020-03-27,480,612,-132,-21.57,1620
2020-03-28,207,427,-220,-51.52,1620
2020-03-29,167,395,-228,-57.72,1620
2020-03-30,471,635,-164,-25.83,1620
2020-03-31,512,640,-128,-20.0,1620
2020-04-01,476,641,-165,-25.74,1620
2020-04-02,476,642,-166,-25.86,1620
2020-04-03,418,619,-201,-32.47,1620
2020-04-04,204,435,-231,-53.1,1620
2020-04-05,149,403,-254,-63.03,1620
2020-04-06,461,643,-182,-28.3,1620
2020-04-07,476,649,-173,-26.66,1620
2020-04-08,476,650,-174,-26.77,1620
2020-04-09,476,652,-176,-26.99,1620
2020-04-10,418,629,-211,-33.55,1620
2020-04-11,204,445,-241,-54.16,1620
2020-04-12,149,413,-264,-63.92,1620
2020-04-13,461,653,-192,-29.4,1620
2020-04-14,476,658,-182,-27.66,1620
2020-04-15,476,660,-184,-27.88,1620
2020-04-16,476,661,-185,-27.99,1620
2020-04-17,418,638,-220,-34.48,1620
2020-04-18,204,453,-249,-54.97,1620
2020-04-19,149,421,-272,-64.61,1620
2020-04-20,461,660,-199,-30.15,1620
2020-04-21,476,665,-189,-28.42,1620
2020-04-22,476,666,-190,-28.53,1620
2020-04-23,476,667,-191,-28.64,1620
2020-04-24,418,643,-225,-34.99,1620
2020-04-25,204,458,-254,-55.46,1620
2020-04-26,149,425,-276,-64.94,1620
2020-04-27,461,664,-203,-30.57,1620
2020-04-28,476,669,-193,-28.85,1620
2020-04-29,476,669,-193,-28.85,1620
2020-04-30,476,670,-194,-28.96,1620
2020-05-01,525,646,-121,-18.73,1620
2020-05-02,237,461,-224,-48.59,1620
2020-05-03,158,428,-270,-63.08,1620
2020-05-04,550,667,-117,-17.54,1620
2020-05-05,572,671,-99,-14.75,1620
2020-05-06,572,672,-100,-14.88,1620
2020-05-07,572,673,-101,-15.01,1620
2020-05-08,525,649,-124,-19.11,1620
2020-05-09,237,464,-227,-48.92,1620
2020-05-10,158,432,-274,-63.43,1620
2020-05-11,550,671,-121,-18.03,1620
2020-05-12,572,676,-104,-15.38,1620
2020-05-13,572,677,-105,-15.51,1620
2020-05-14,572,678,-106,-15.63,1620
2020-05-15,525,655,-130,-19.85,1620
2020-05-16,237,471,-234,-49.68,1620
2020-05-17,158,439,-281,-64.01,1620
2020-05-18,550,679,-129,-19.0,1620
2020-05-19,572,684,-112,-16.37,1620
2020-05-20,572,686,-114,-16.62,1620
2020-05-21,572,687,-115,-16.74,1620
2020-05-22,525,664,-139,-20.93,1620
2020-05-23,237,480,-243,-50.62,1620
2020-05-24,158,448,-290,-64.73,1620
2020-05-25,550,689,-139,-20.17,1620
2020-05-26,572,694,-122,-17.58,1620
2020-05-27,572,696,-124,-17.82,1620
2020-05-28,572,698,-126,-18.05,1620
2020-05-29,525,675,-150,-22.22,1620
2020-05-30,237,491,-254,-51.73,1620
2020-05-31,158,459,-301,-65.58,1620
2020-06-01,594,700,-106,-15.14,1620
2020-06-02,605,705,-100,-14.18,1620
2020-06-03,605,707,-102,-14.43,1620
2020-06-04,605,709,-104,-14.67,1620
2020-06-05,529,686,-157,-22.89,1620
2020-06-06,240,502,-262,-52.19,1620
2020-06-07,156,471,-315,-66.88,1620
2020-06-08,594,711,-117,-16.46,1620
2020-06-09,605,717,-112,-15.62,1620
2020-06-10,605,718,-113,-15.74,1620
2020-06-11,605,720,-115,-15.97,1620
2020-06-12,529,697,-168,-24.1,1620
2020-06-13,240,513,-273,-53.22,1620
2020-06-14,156,481,-325,-67.57,1620
2020-06-15,594,721,-127,-17.61,1620
2020-06-16,605,726,-121,-16.67,1620
2020-06-17,605,728,-123,-16.9,1620
2020-06-18,605,729,-124,-17.01,1620
2020-06-19,529,706,-177,-25.07,1620
2020-06-20,240,521,-281,-53.93,1620
2020-06-21,156,489,-333,-68.1,1620
2020-06-22,594,729,-135,-18.52,1620
2020-06-23,605,733,-128,-17.46,1620
2020-06-24,605,734,-129,-17.57,1620
2020-06-25,605,735,-130,-17.69,1620
2020-06-26,529,711,-182,-25.6,1620
2020-06-27,240,526,-286,-54.37,1620
2020-06-28,156,493,-337,-68.36,1620
2020-06-29,594,732,-138,-18.85,1620
2020-06-30,605,737,-132,-17.91,1620
2020-07-01,556,737,-181,-24.56,1620
2020-07-02,556,738,-182,-24.66,1620
2020-07-03,495,714,-219,-30.67,1620
2020-07-04,199,529,-330,-62.38,1620
2020-07-05,166,496,-330,-66.53,1620
2020-07-06,545,735,-190,-25.85,1620
2020-07-07,556,739,-183,-24.76,1620
2020-07-08,556,740,-184,-24.86,1620
2020-07-09,556,741,-185,-24.97,1620
2020-07-10,495,717,-222,-30.96,1620
2020-07-11,199,532,-333,-62.59,1620
2020-07-12,166,499,-333,-66.73,1620
2020-07-13,545,739,-194,-26.25,1620
2020-07-14,556,744,-188,-25.27,1620
2020-07-15,556,745,-189,-25.37,1620
2020-07-16,556,746,-190,-25.47,1620
2020-07-17,495,723,-228,-31.54,1620
2020-07-18,199,538,-339,-63.01,1620
2020-07-19,166,506,-340,-67.19,1620
2020-07-20,545,745,-200,-26.85,1620
2020-07-21,556,750,-194,-25.87,1620
2020-07-22,556,751,-195,-25.97,1620
2020-07-23,556,752,-196,-26.06,1620
2020-07-24,495,729,-234,-32.1,1620
2020-07-25,199,544,-345,-63.42,1620
2020-07-26,166,511,-345,-67.51,1620
2020-07-27,545,750,-205,-27.33,1620
2020-07-28,556,755,-199,-26.36,1620
2020-07-29,556,755,-199,-26.36,1620
2020-07-30,556,756,-200,-26.46,1620
2020-07-31,495,732,-237,-32.38,1620
2020-08-01,200,546,-346,-63.37,1620
2020-08-02,157,513,-356,-69.4,1620
2020-08-03,481,752,-271,-36.04,1620
2020-08-04,502,755,-253,-33.51,1620
2020-08-05,502,756,-254,-33.6,1620
2020-08-06,502,755,-253,-33.51,1620
2020-08-07,466,731,-265,-36.25,1620
2020-08-08,200,546,-346,-63.37,1620
2020-08-09,157,512,-355,-69.34,1620
2020-08-10,481,751,-270,-35.95,1620
2020-08-11,502,755,-253,-33.51,1620
2020-08-12,502,755,-253,-33.51,1620
2020-08-13,502,756,-254,-33.6,1620
2020-08-14,466,732,-266,-36.34,1620
2020-08-15,200,547,-347,-63.44,1620
2020-08-16,157,515,-358,-69.51,1620
2020-08-17,481,755,-274,-36.29,1620
2020-08-18,502,760,-258,-33.95,1620
2020-08-19,502,762,-260,-34.12,1620
2020-08-20,502,763,-261,-34.21,1620
2020-08-21,466,741,-275,-37.11,1620
2020-08-22,200,557,-357,-64.09,1620
2020-08-23,157,526,-369,-70.15,1620
2020-08-24,481,767,-286,-37.29,1620
2020-08-25,502,774,-272,-35.14,1620
2020-08-26,502,777,-275,-35.39,1620
2020-08-27,502,779,-277,-35.56,1620
2020-08-28,466,758,-292,-38.52,1620
2020-08-29,200,575,-375,-65.22,1620
2020-08-30,157,544,-387,-71.14,1620
2020-08-31,481,786,-305,-38.8,1620
2020-09-01,588,793,-205,-25.85,1620
2020-09-02,588,796,-208,-26.13,1620
2020-09-03,588,798,-210,-26.32,1620
2020-09-04,515,777,-262,-33.72,1620
2020-09-05,226,593,-367,-61.89,1620
2020-09-06,169,562,-393,-69.93,1620
2020-09-07,575,803,-228,-28.39,1620
2020-09-08,588,809,-221,-27.32,1620
2020-09-09,588,811,-223,-27.5,1620
2020-09-10,588,813,-225,-27.68,1620
2020-09-11,515,790,-275,-34.81,1620
2020-09-12,226,606,-380,-62.71,1620
2020-09-13,169,573,-404,-70.51,1620
2020-09-14,575,813,-238,-29.27,1620
2020-09-15,588,818,-230,-28.12,1620
2020-09-16,588,819,-231,-28.21,1620
2020-09-17,588,820,-232,-28.29,1620
2020-09-18,515,796,-281,-35.3,1620
2020-09-19,226,611,-385,-63.01,1620
2020-09-20,169,578,-409,-70.76,1620
2020-09-21,575,817,-242,-29.62,1620
2020-09-22,588,822,-234,-28.47,1620
2020-09-23,588,823,-235,-28.55,1620
2020-09-24,588,823,-235,-28.55,1620
2020-09-25,515,800,-285,-35.62,1620
2020-09-26,226,615,-389,-63.25,1620
2020-09-27,169,582,-413,-70.96,1620
2020-09-28,575,822,-247,-30.05,1620
2020-09-29,588,827,-239,-28.9,1620
2020-09-30,588,828,-240,-28.99,1620
2020-10-01,606,829,-223,-26.9,1620
2020-10-02,562,806,-244,-30.27,1620
2020-10-03,238,621,-383,-61.67,1620
2020-10-04,168,589,-421,-71.48,1620
2020-10-05,587,829,-242,-29.19,1620
2020-10-06,606,834,-228,-27.34,1620
2020-10-07,606,836,-230,-27.51,1620
2020-10-08,606,837,-231,-27.6,1620
2020-10-09,562,814,-252,-30.96,1620
2020-10-10,238,629,-391,-62.16,1620
2020-10-11,168,597,-429,-71.86,1620
2020-10-12,587,837,-250,-29.87,1620
2020-10-13,606,842,-236,-28.03,1620
2020-10-14,606,843,-237,-28.11,1620
2020-10-15,606,843,-237,-28.11,1620
2020-10-16,562,820,-258,-31.46,1620
2020-10-17,238,635,-397,-62.52,1620
2020-10-18,168,602,-434,-72.09,1620
2020-10-19,587,841,-254,-30.2,1620
2020-10-20,606,845,-239,-28.28,1620
2020-10-21,606,846,-240,-28.37,1620
2020-10-22,606,846,-240,-28.37,1620
2020-10-23,562,822,-260,-31.63,1620
2020-10-24,238,636,-398,-62.58,1620
2020-10-25,168,603,-435,-72.14,1620
2020-10-26,587,842,-255,-30.29,1620
2020-10-27,606,846,-240,-28.37,1620
2020-10-28,606,846,-240,-28.37,1620
2020-10-29,606,847,-241,-28.45,1620
2020-10-30,562,822,-260,-31.63,1620
2020-10-31,238,637,-399,-62.64,1620
2020-11-01,173,604,-431,-71.36,1620
2020-11-02,643,843,-200,-23.72,1620
2020-11-03,624,848,-224,-26.42,1620
2020-11-04,624,848,-224,-26.42,1620
2020-11-05,624,849,-225,-26.5,1620
2020-11-06,566,825,-259,-31.39,1620
2020-11-07,238,641,-403,-62.87,1620
2020-11-08,173,608,-435,-71.55,1620
2020-11-09,643,847,-204,-24.09,1620
2020-11-10,624,852,-228,-26.76,1620
2020-11-11,624,853,-229,-26.85,1620
2020-11-12,624,854,-230,-26.93,1620
2020-11-13,566,830,-264,-31.81,1620
2020-11-14,238,645,-407,-63.1,1620
2020-11-15,173,612,-439,-71.73,1620
2020-11-16,643,851,-208,-24.44,1620
2020-11-17,624,856,-232,-27.1,1620
2020-11-18,624,856,-232,-27.1,1620
2020-11-19,624,856,-232,-27.1,1620
2020-11-20,566,832,-266,-31.97,1620
2020-11-21,238,646,-408,-63.16,1620
2020-11-22,173,613,-440,-71.78,1620
2020-11-23,643,851,-208,-24.44,1620
2020-11-24,624,855,-231,-27.02,1620
2020-11-25,624,854,-230,-26.93,1620
2020-11-26,624,854,-230,-26.93,1620
2020-11-27,566,829,-263,-31.72,1620
2020-11-28,238,643,-405,-62.99,1620
2020-11-29,173,609,-436,-71.59,1620
2020-11-30,643,847,-204,-24.09,1620
2020-12-01,498,850,-352,-41.41,1620
2020-12-02,498,849,-351,-41.34,1620
2020-12-03,498,849,-351,-41.34,1620
2020-12-04,576,824,-248,-30.1,1620
2020-12-05,246,638,-392,-61.44,1620
2020-12-06,172,604,-432,-71.52,1620
2020-12-07,519,842,-323,-38.36,1620
2020-12-08,498,846,-348,-41.13,1620
2020-12-09,498,846,-348,-41.13,1620
2020-12-10,498,846,-348,-41.13,1620
2020-12-11,576,822,-246,-29.93,1620
2020-12-12,246,636,-390,-61.32,1620
2020-12-13,172,603,-431,-71.48,1620
2020-12-14,519,843,-324,-38.43,1620
2020-12-15,498,847,-349,-41.2,1620
2020-12-16,498,848,-350,-41.27,1620
2020-12-17,498,848,-350,-41.27,1620
2020-12-18,576,825,-249,-30.18,1620
2020-12-19,246,640,-394,-61.56,1620
2020-12-20,172,607,-435,-71.66,1620
2020-12-21,519,847,-328,-38.72,1620
2020-12-22,498,852,-354,-41.55,1620
2020-12-23,498,853,-355,-41.62,1620
2020-12-24,498,853,-355,-41.62,1620
2020-12-25,576,830,-254,-30.6,1620
2020-12-26,246,645,-399,-61.86,1620
2020-12-27,172,612,-440,-71.9,1620
2020-12-28,519,851,-332,-39.01,1620
2020-12-29,498,855,-357,-41.75,1620
2020-12-30,498,855,-357,-41.75,1620
2020-12-31,498,856,-358,-41.82,1620
2021-01-01,494,831,-337,-40.55,1620
2021-01-02,223,646,-423,-65.48,1620
2021-01-03,174,613,-439,-71.62,1620
2021-01-04,492,851,-359,-42.19,1620
2021-01-05,523,855,-332,-38.83,1620
2021-01-06,523,855,-332,-38.83,1620
2021-01-07,523,855,-332,-38.83,1620
2021-01-08,494,831,-337,-40.55,1620
2021-01-09,223,646,-423,-65.48,1620
2021-01-10,174,613,-439,-71.62,1620
2021-01-11,492,852,-360,-42.25,1620
2021-01-12,523,856,-333,-38.9,1620
2021-01-13,523,857,-334,-38.97,1620
2021-01-14,523,857,-334,-38.97,1620
2021-01-15,494,834,-340,-40.77,1620
2021-01-16,223,649,-426,-65.64,1620
2021-01-17,174,617,-443,-71.8,1620
2021-01-18,492,856,-364,-42.52,1620
2021-01-19,523,862,-339,-39.33,1620
2021-01-20,523,863,-340,-39.4,1620
2021-01-21,523,865,-342,-39.54,1620
2021-01-22,494,842,-348,-41.33,1620
2021-01-23,223,658,-435,-66.11,1620
2021-01-24,174,626,-452,-72.2,1620
2021-01-25,492,867,-375,-43.25,1620
2021-01-26,523,873,-350,-40.09,1620
2021-01-27,523,875,-352,-40.23,1620
2021-01-28,523,877,-354,-40.36,1620
2021-01-29,494,854,-360,-42.15,1620
2021-01-30,223,670,-447,-66.72,1620
2021-01-31,174,639,-465,-72.77,1620
2021-02-01,528,879,-351,-39.93,1620
2021-02-02,554,885,-331,-37.4,1620
2021-02-03,554,887,-333,-37.54,1620
2021-02-04,554,888,-334,-37.61,1620
2021-02-05,520,865,-345,-39.88,1620
2021-02-06,226,681,-455,-66.81,1620
2021-02-07,170,649,-479,-73.81,1620
2021-02-08,528,889,-361,-40.61,1620
2021-02-09,554,895,-341,-38.1,1620
2021-02-10,554,896,-342,-38.17,1620
2021-02-11,554,897,-343,-38.24,1620
2021-02-12,520,874,-354,-40.5,1620
2021-02-13,226,690,-464,-67.25,1620
2021-02-14,170,657,-487,-74.12,1620
2021-02-15,528,897,-369,-41.14,1620
2021-02-16,554,902,-348,-38.58,1620
2021-02-17,554,904,-350,-38.72,1620
2021-02-18,554,905,-351,-38.78,1620
2021-02-19,520,882,-362,-41.04,1620
2021-02-20,226,698,-472,-67.62,1620
2021-02-21,170,666,-496,-74.47,1620
2021-02-22,528,907,-379,-41.79,1620
2021-02-23,554,912,-358,-39.25,1620
2021-02-24,554,914,-360,-39.39,1620
2021-02-25,554,916,-362,-39.52,1620
2021-02-26,520,893,-373,-41.77,1620
2021-02-27,226,710,-484,-68.17,1620
2021-02-28,170,678,-508,-74.93,1620
2021-03-01,574,919,-345,-37.54,1620
2021-03-02,575,925,-350,-37.84,1620
2021-03-03,575,927,-352,-37.97,1620
2021-03-04,575,929,-354,-38.11,1620
2021-03-05,533,907,-374,-41.23,1620
2021-03-06,229,724,-495,-68.37,1620
2021-03-07,171,692,-521,-75.29,1620
2021-03-08,574,933,-359,-38.48,1620
2021-03-09,575,938,-363,-38.7,1620
2021-03-10,575,940,-365,-38.83,1620
2021-03-11,575,942,-367,-38.96,1620
2021-03-12,533,919,-386,-42.0,1620
2021-03-13,229,735,-506,-68.84,1620
2021-03-14,171,703,-532,-75.68,1620
2021-03-15,574,943,-369,-39.13,1620
2021-03-16,575,948,-373,-39.35,1620
2021-03-17,575,950,-375,-39.47,1620
2021-03-18,575,951,-376,-39.54,1620
2021-03-19,533,927,-394,-42.5,1620
2021-03-20,229,743,-514,-69.18,1620
2021-03-21,171,710,-539,-75.92,1620
2021-03-22,574,950,-376,-39.58,1620
2021-03-23,575,955,-380,-39.79,1620
2021-03-24,575,956,-381,-39.85,1620
2021-03-25,575,957,-382,-39.92,1620
2021-03-26,533,933,-400,-42.87,1620
2021-03-27,229,749,-520,-69.43,1620
2021-03-28,171,716,-545,-76.12,1620
2021-03-29,574,956,-382,-39.96,1620
2021-03-30,575,961,-386,-40.17,1620
2021-03-31,575,962,-387,-40.23,1620
2021-04-01,592,964,-372,-38.59,1620
2021-04-02,559,940,-381,-40.53,1620
2021-04-03,227,756,-529,-69.97,1620
2021-04-04,163,724,-561,-77.49,1620
2021-04-05,602,964,-362,-37.55,1620
2021-04-06,592,970,-378,-38.97,1620
2021-04-07,592,971,-379,-39.03,1620
2021-04-08,592,973,-381,-39.16,1620
2021-04-09,559,950,-391,-41.16,1620
2021-04-10,227,766,-539,-70.37,1620
2021-04-11,163,734,-571,-77.79,1620
2021-04-12,602,974,-372,-38.19,1620
2021-04-13,592,979,-387,-39.53,1620
2021-04-14,592,981,-389,-39.65,1620
2021-04-15,592,982,-390,-39.71,1620
2021-04-16,559,959,-400,-41.71,1620
2021-04-17,227,775,-548,-70.71,1620
2021-04-18,163,742,-579,-78.03,1620
2021-04-19,602,982,-380,-38.7,1620
2021-04-20,592,987,-395,-40.02,1620
2021-04-21,592,988,-396,-40.08,1620
2021-04-22,592,989,-397,-40.14,1620
2021-04-23,559,965,-406,-42.07,1620
2021-04-24,227,780,-553,-70.9,1620
2021-04-25,163,747,-584,-78.18,1620
2021-04-26,602,986,-384,-38.95,1620
2021-04-27,592,991,-399,-40.26,1620
2021-04-28,592,991,-399,-40.26,1620
2021-04-29,592,992,-400,-40.32,1620
2021-04-30,559,968,-409,-42.25,1620
2021-05-01,236,783,-547,-69.86,1620
2021-05-02,159,750,-591,-78.8,1620
2021-05-03,580,989,-409,-41.35,1620
2021-05-04,580,993,-413,-41.59,1620
2021-05-05,580,994,-414,-41.65,1620
2021-05-06,580,995,-415,-41.71,1620
2021-05-07,545,971,-426,-43.87,1620
2021-05-08,236,786,-550,-69.97,1620
2021-05-09,159,753,-594,-78.88,1620
2021-05-10,580,993,-413,-41.59,1620
2021-05-11,580,998,-418,-41.88,1620
2021-05-12,580,999,-419,-41.94,1620
2021-05-13,580,1000,-420,-42.0,1620
2021-05-14,545,976,-431,-44.16,1620
2021-05-15,236,792,-556,-70.2,1620
2021-05-16,159,760,-601,-79.08,1620
2021-05-17,580,1000,-420,-42.0,1620
2021-05-18,580,1005,-425,-42.29,1620
2021-05-19,580,1007,-427,-42.4,1620
2021-05-20,580,1008,-428,-42.46,1620
2021-05-21,545,985,-440,-44.67,1620
2021-05-22,236,801,-565,-70.54,1620
2021-05-23,159,769,-610,-79.32,1620
2021-05-24,580,1009,-429,-42.52,1620
2021-05-25,580,1015,-435,-42.86,1620
2021-05-26,580,1017,-437,-42.97,1620
2021-05-27,580,1018,-438,-43.03,1620
2021-05-28,545,995,-450,-45.23,1620
2021-05-29,236,812,-576,-70.94,1620
2021-05-30,159,780,-621,-79.62,1620
2021-05-31,580,1020,-440,-43.14,1620
2021-06-01,589,1026,-437,-42.59,1620
2021-06-02,589,1028,-439,-42.7,1620
2021-06-03,589,1029,-440,-42.76,1620
2021-06-04,530,1007,-477,-47.37,1620
2021-06-05,227,823,-596,-72.42,1620
2021-06-06,173,791,-618,-78.13,1620
2021-06-07,590,1032,-442,-42.83,1620
2021-06-08,589,1037,-448,-43.2,1620
2021-06-09,589,1039,-450,-43.31,1620
2021-06-10,589,1041,-452,-43.42,1620
2021-06-11,530,1018,-488,-47.94,1620
2021-06-12,227,834,-607,-72.78,1620
2021-06-13,173,802,-629,-78.43,1620
2021-06-14,590,1042,-452,-43.38,1620
2021-06-15,589,1047,-458,-43.74,1620
2021-06-16,589,1049,-460,-43.85,1620
2021-06-17,589,1050,-461,-43.9,1620
2021-06-18,530,1027,-497,-48.39,1620
2021-06-19,227,843,-616,-73.07,1620
2021-06-20,173,810,-637,-78.64,1620
2021-06-21,590,1050,-460,-43.81,1620
2021-06-22,589,1055,-466,-44.17,1620
2021-06-23,589,1056,-467,-44.22,1620
2021-06-24,589,1057,-468,-44.28,1620
2021-06-25,530,1033,-503,-48.69,1620
2021-06-26,227,848,-621,-73.23,1620
2021-06-27,173,815,-642,-78.77,1620
2021-06-28,590,1054,-464,-44.02,1620
2021-06-29,589,1059,-470,-44.38,1620
2021-06-30,589,1059,-470,-44.38,1620
2021-07-01,518,1060,-542,-51.13,1620
2021-07-02,487,1036,-549,-52.99,1620
2021-07-03,188,851,-663,-77.91,1620
2021-07-04,161,818,-657,-80.32,1620
2021-07-05,506,1057,-551,-52.13,1620
2021-07-06,518,1061,-543,-51.18,1620
2021-07-07,518,1062,-544,-51.22,1620
2021-07-08,518,1063,-545,-51.27,1620
2021-07-09,487,1039,-552,-53.13,1620
2021-07-10,188,854,-666,-77.99,1620
2021-07-11,161,821,-660,-80.39,1620
2021-07-12,506,1061,-555,-52.31,1620
2021-07-13,518,1065,-547,-51.36,1620
2021-07-14,518,1066,-548,-51.41,1620
2021-07-15,518,1067,-549,-51.45,1620
2021-07-16,487,1044,-557,-53.35,1620
2021-07-17,188,859,-671,-78.11,1620
2021-07-18,161,827,-666,-80.53,1620
2021-07-19,506,1067,-561,-52.58,1620
2021-07-20,518,1072,-554,-51.68,1620
2021-07-21,518,1073,-555,-51.72,1620
2021-07-22,518,1074,-556,-51.77,1620
2021-07-23,487,1050,-563,-53.62,1620
2021-07-24,188,866,-678,-78.29,1620
2021-07-25,161,833,-672,-80.67,1620
2021-07-26,506,1072,-566,-52.8,1620
2021-07-27,518,1077,-559,-51.9,1620
2021-07-28,518,1078,-560,-51.95,1620
2021-07-29,518,1078,-560,-51.95,1620
2021-07-30,487,1054,-567,-53.8,1620
2021-07-31,188,869,-681,-78.37,1620
2021-08-01,151,835,-684,-81.92,1620
2021-08-02,470,1074,-604,-56.24,1620
2021-08-03,482,1078,-596,-55.29,1620
2021-08-04,482,1078,-596,-55.29,1620
2021-08-05,482,1078,-596,-55.29,1620
2021-08-06,449,1054,-605,-57.4,1620
2021-08-07,194,868,-674,-77.65,1620
2021-08-08,151,835,-684,-81.92,1620
2021-08-09,470,1073,-603,-56.2,1620
2021-08-10,482,1077,-595,-55.25,1620
2021-08-11,482,1078,-596,-55.29,1620
2021-08-12,482,1078,-596,-55.29,1620
2021-08-13,449,1054,-605,-57.4,1620
2021-08-14,194,869,-675,-77.68,1620
2021-08-15,151,836,-685,-81.94,1620
2021-08-16,470,1076,-606,-56.32,1620
2021-08-17,482,1081,-599,-55.41,1620
2021-08-18,482,1082,-600,-55.45,1620
2021-08-19,482,1084,-602,-55.54,1620
2021-08-20,449,1061,-612,-57.68,1620
2021-08-21,194,877,-683,-77.88,1620
2021-08-22,151,846,-695,-82.15,1620
2021-08-23,470,1087,-617,-56.76,1620
2021-08-24,482,1093,-611,-55.9,1620
2021-08-25,482,1096,-614,-56.02,1620
2021-08-26,482,1099,-617,-56.14,1620
2021-08-27,449,1077,-628,-58.31,1620
2021-08-28,194,894,-700,-78.3,1620
2021-08-29,151,864,-713,-82.52,1620
2021-08-30,470,1105,-635,-57.47,1620
2021-08-31,482,1112,-630,-56.65,1620
2021-09-01,577,1115,-538,-48.25,1620
2021-09-02,577,1118,-541,-48.39,1620
2021-09-03,566,1096,-530,-48.36,1620
2021-09-04,225,913,-688,-75.36,1620
2021-09-05,177,882,-705,-79.93,1620
2021-09-06,576,1123,-547,-48.71,1620
2021-09-07,577,1129,-552,-48.89,1620
2021-09-08,577,1131,-554,-48.98,1620
2021-09-09,577,1133,-556,-49.07,1620
2021-09-10,566,1111,-545,-49.05,1620
2021-09-11,225,926,-701,-75.7,1620
2021-09-12,177,894,-717,-80.2,1620
2021-09-13,576,1134,-558,-49.21,1620
2021-09-14,577,1139,-562,-49.34,1620
2021-09-15,577,1140,-563,-49.39,1620
2021-09-16,577,1141,-564,-49.43,1620
2021-09-17,566,1118,-552,-49.37,1620
2021-09-18,225,933,-708,-75.88,1620
2021-09-19,177,900,-723,-80.33,1620
2021-09-20,576,1139,-563,-49.43,1620
2021-09-21,577,1144,-567,-49.56,1620
2021-09-22,577,1145,-568,-49.61,1620
2021-09-23,577,1145,-568,-49.61,1620
2021-09-24,566,1121,-555,-49.51,1620
2021-09-25,225,937,-712,-75.99,1620
2021-09-26,177,904,-727,-80.42,1620
2021-09-27,576,1143,-567,-49.61,1620
2021-09-28,577,1148,-571,-49.74,1620
2021-09-29,577,1149,-572,-49.78,1620
2021-09-30,577,1150,-573,-49.83,1620
2021-10-01,568,1127,-559,-49.6,1620
2021-10-02,238,943,-705,-74.76,1620
2021-10-03,171,910,-739,-81.21,1620
2021-10-04,547,1150,-603,-52.43,1620
2021-10-05,562,1155,-593,-51.34,1620
2021-10-06,562,1157,-595,-51.43,1620
2021-10-07,562,1158,-596,-51.47,1620
2021-10-08,568,1135,-567,-49.96,1620
2021-10-09,238,951,-713,-74.97,1620
2021-10-10,171,918,-747,-81.37,1620
2021-10-11,547,1158,-611,-52.76,1620
2021-10-12,562,1163,-601,-51.68,1620
2021-10-13,562,1164,-602,-51.72,1620
2021-10-14,562,1165,-603,-51.76,1620
2021-10-15,568,1142,-574,-50.26,1620
2021-10-16,238,957,-719,-75.13,1620
2021-10-17,171,924,-753,-81.49,1620
2021-10-18,547,1163,-616,-52.97,1620
2021-10-19,562,1168,-606,-51.88,1620
2021-10-20,562,1168,-606,-51.88,1620
2021-10-21,562,1168,-606,-51.88,1620
2021-10-22,568,1144,-576,-50.35,1620
2021-10-23,238,959,-721,-75.18,1620
2021-10-24,171,926,-755,-81.53,1620
2021-10-25,547,1164,-617,-53.01,1620
2021-10-26,562,1168,-606,-51.88,1620
2021-10-27,562,1169,-607,-51.92,1620
2021-10-28,562,1169,-607,-51.92,1620
2021-10-29,568,1145,-577,-50.39,1620
2021-10-30,238,960,-722,-75.21,1620
2021-10-31,171,926,-755,-81.53,1620
2021-11-01,577,1165,-588,-50.47,1620
2021-11-02,583,1170,-587,-50.17,1620
2021-11-03,583,1170,-587,-50.17,1620
2021-11-04,583,1171,-588,-50.21,1620
2021-11-05,554,1147,-593,-51.7,1620
2021-11-06,238,962,-724,-75.26,1620
2021-11-07,169,930,-761,-81.83,1620
2021-11-08,577,1169,-592,-50.64,1620
2021-11-09,583,1174,-591,-50.34,1620
2021-11-10,583,1175,-592,-50.38,1620
2021-11-11,583,1175,-592,-50.38,1620
2021-11-12,554,1152,-598,-51.91,1620
2021-11-13,238,967,-729,-75.39,1620
2021-11-14,169,934,-765,-81.91,1620
2021-11-15,577,1173,-596,-50.81,1620
2021-11-16,583,1178,-595,-50.51,1620
2021-11-17,583,1178,-595,-50.51,1620
2021-11-18,583,1179,-596,-50.55,1620
2021-11-19,554,1155,-601,-52.03,1620
2021-11-20,238,969,-731,-75.44,1620
2021-11-21,169,936,-767,-81.94,1620
2021-11-22,577,1174,-597,-50.85,1620
2021-11-23,583,1178,-595,-50.51,1620
2021-11-24,583,1178,-595,-50.51,1620
2021-11-25,583,1177,-594,-50.47,1620
2021-11-26,554,1152,-598,-51.91,1620
2021-11-27,238,966,-728,-75.36,1620
2021-11-28,169,932,-763,-81.87,1620
2021-11-29,577,1170,-593,-50.68,1620
2021-11-30,583,1173,-590,-50.3,1620
2021-12-01,500,1173,-673,-57.37,1620
2021-12-02,500,1172,-672,-57.34,1620
2021-12-03,435,1147,-712,-62.07,1620
2021-12-04,240,961,-721,-75.03,1620
2021-12-05,175,927,-752,-81.12,1620
2021-12-06,519,1165,-646,-55.45,1620
2021-12-07,500,1169,-669,-57.23,1620
2021-12-08,500,1169,-669,-57.23,1620
2021-12-09,500,1169,-669,-57.23,1620
2021-12-10,435,1144,-709,-61.98,1620
2021-12-11,240,959,-719,-74.97,1620
2021-12-12,175,926,-751,-81.1,1620
2021-12-13,519,1165,-646,-55.45,1620
2021-12-14,500,1169,-669,-57.23,1620
2021-12-15,500,1170,-670,-57.26,1620
2021-12-16,500,1170,-670,-57.26,1620
2021-12-17,435,1147,-712,-62.07,1620
2021-12-18,240,962,-722,-75.05,1620
2021-12-19,175,929,-754,-81.16,1620
2021-12-20,519,1169,-650,-55.6,1620
2021-12-21,500,1173,-673,-57.37,1620
2021-12-22,500,1174,-674,-57.41,1620
2021-12-23,500,1175,-675,-57.45,1620
2021-12-24,435,1151,-716,-62.21,1620
2021-12-25,240,966,-726,-75.16,1620
2021-12-26,175,934,-759,-81.26,1620
2021-12-27,519,1173,-654,-55.75,1620
2021-12-28,500,1177,-677,-57.52,1620
2021-12-29,500,1178,-678,-57.56,1620
2021-12-30,500,1178,-678,-57.56,1620
2021-12-31,435,1154,-719,-62.31,1620
2022-01-01,210,969,-759,-78.33,1620
2022-01-02,159,935,-776,-82.99,1620
2022-01-03,484,1174,-690,-58.77,1620
2022-01-04,492,1178,-686,-58.23,1620
2022-01-05,492,1178,-686,-58.23,1620
2022-01-06,492,1178,-686,-58.23,1620
2022-01-07,483,1154,-671,-58.15,1620
2022-01-08,210,968,-758,-78.31,1620
2022-01-09,159,935,-776,-82.99,1620
2022-01-10,484,1174,-690,-58.77,1620
2022-01-11,492,1178,-686,-58.23,1620
2022-01-12,492,1179,-687,-58.27,1620
2022-01-13,492,1179,-687,-58.27,1620
2022-01-14,483,1155,-672,-58.18,1620
2022-01-15,210,971,-761,-78.37,1620
2022-01-16,159,938,-779,-83.05,1620
2022-01-17,484,1178,-694,-58.91,1620
2022-01-18,492,1183,-691,-58.41,1620
2022-01-19,492,1184,-692,-58.45,1620
2022-01-20,492,1185,-693,-58.48,1620
2022-01-21,483,1163,-680,-58.47,1620
2022-01-22,210,979,-769,-78.55,1620
2022-01-23,159,947,-788,-83.21,1620
2022-01-24,484,1187,-703,-59.22,1620
2022-01-25,492,1193,-701,-58.76,1620
2022-01-26,492,1195,-703,-58.83,1620
2022-01-27,492,1197,-705,-58.9,1620
2022-01-28,483,1174,-691,-58.86,1620
2022-01-29,210,991,-781,-78.81,1620
2022-01-30,159,959,-800,-83.42,1620
